Land,Jahr,Monat,export_wert,import_wert,handelsvolumen_wert
Afghanistan,2008,1,12807000,1222000,14029000
Afghanistan,2008,2,16739000,123000,16862000
Afghanistan,2008,3,33294000,232000,33526000
Afghanistan,2008,4,25499000,143000,25642000
Afghanistan,2008,5,18672000,50000,18722000
Afghanistan,2008,6,26715000,131000,26846000
Afghanistan,2008,7,21714000,99000,21813000
Afghanistan,2008,8,26744000,170000,26914000
Afghanistan,2008,9,15184000,108000,15292000
Afghanistan,2008,10,31851000,244000,32095000
Afghanistan,2008,11,23621000,137000,23758000
Afghanistan,2008,12,14647000,104000,14751000
Afghanistan,2009,1,19246000,84000,19330000
Afghanistan,2009,2,15474000,235000,15709000
Afghanistan,2009,3,23073000,872000,23945000
Afghanistan,2009,4,18522000,45000,18567000
Afghanistan,2009,5,14809000,84000,14893000
Afghanistan,2009,6,16079000,34000,16113000
Afghanistan,2009,7,19889000,112000,20001000
Afghanistan,2009,8,14519000,60000,14579000
Afghanistan,2009,9,16380000,65000,16445000
Afghanistan,2009,10,15080000,187000,15267000
Afghanistan,2009,11,15819000,611000,16430000
Afghanistan,2009,12,35998000,1850000,37848000
Afghanistan,2010,1,16961000,1792000,18753000
Afghanistan,2010,2,20724000,2260000,22984000
Afghanistan,2010,3,28705000,2521000,31226000
Afghanistan,2010,4,25172000,604000,25776000
Afghanistan,2010,5,20278000,4001000,24279000
Afghanistan,2010,6,20714000,1709000,22423000
Afghanistan,2010,7,19092000,485000,19577000
Afghanistan,2010,8,17845000,530000,18375000
Afghanistan,2010,9,19509000,4074000,23583000
Afghanistan,2010,10,19452000,847000,20299000
Afghanistan,2010,11,31529000,2387000,33916000
Afghanistan,2010,12,28631000,1976000,30607000
Afghanistan,2011,1,32759000,2899000,35658000
Afghanistan,2011,2,24005000,617000,24622000
Afghanistan,2011,3,27016000,888000,27904000
Afghanistan,2011,4,24950000,622000,25572000
Afghanistan,2011,5,24227000,480000,24707000
Afghanistan,2011,6,17163000,502000,17665000
Afghanistan,2011,7,17604000,259000,17863000
Afghanistan,2011,8,23984000,415000,24399000
Afghanistan,2011,9,23529000,198000,23727000
Afghanistan,2011,10,19173000,1128000,20301000
Afghanistan,2011,11,23027000,587000,23614000
Afghanistan,2011,12,25049000,2288000,27337000
Afghanistan,2012,1,25099000,836000,25935000
Afghanistan,2012,2,26480000,4712000,31192000
Afghanistan,2012,3,43389000,643000,44032000
Afghanistan,2012,4,20982000,129000,21111000
Afghanistan,2012,5,19683000,5237000,24920000
Afghanistan,2012,6,24208000,162000,24370000
Afghanistan,2012,7,26465000,374000,26839000
Afghanistan,2012,8,31659000,742000,32401000
Afghanistan,2012,9,21560000,77000,21637000
Afghanistan,2012,10,18354000,363000,18717000
Afghanistan,2012,11,21323000,435000,21758000
Afghanistan,2012,12,14866000,544000,15410000
Afghanistan,2013,1,24342000,944000,25286000
Afghanistan,2013,2,10455000,203000,10658000
Afghanistan,2013,3,7074000,788000,7862000
Afghanistan,2013,4,8042000,783000,8825000
Afghanistan,2013,5,8698000,526000,9224000
Afghanistan,2013,6,18021000,280000,18301000
Afghanistan,2013,7,21856000,167000,22023000
Afghanistan,2013,8,12429000,951000,13380000
Afghanistan,2013,9,14787000,444000,15231000
Afghanistan,2013,10,13828000,1859000,15687000
Afghanistan,2013,11,11684000,394000,12078000
Afghanistan,2013,12,11796000,5804000,17600000
Afghanistan,2014,1,10406000,538000,10944000
Afghanistan,2014,2,8877000,982000,9859000
Afghanistan,2014,3,8475000,977000,9452000
Afghanistan,2014,4,8913000,10251000,19164000
Afghanistan,2014,5,6807000,3799000,10606000
Afghanistan,2014,6,6928000,773000,7701000
Afghanistan,2014,7,5113000,310000,5423000
Afghanistan,2014,8,6307000,332000,6639000
Afghanistan,2014,9,10222000,1063000,11285000
Afghanistan,2014,10,9474000,1050000,10524000
Afghanistan,2014,11,20855000,1582000,22437000
Afghanistan,2014,12,12766000,745000,13511000
Afghanistan,2015,1,11537000,635000,12172000
Afghanistan,2015,2,11040000,1820000,12860000
Afghanistan,2015,3,8000000,1003000,9003000
Afghanistan,2015,4,7835000,985000,8820000
Afghanistan,2015,5,8139000,63000,8202000
Afghanistan,2015,6,6203000,449000,6652000
Afghanistan,2015,7,4455000,581000,5036000
Afghanistan,2015,8,3477000,315000,3792000
Afghanistan,2015,9,4206000,1009000,5215000
Afghanistan,2015,10,4287000,354000,4641000
Afghanistan,2015,11,5266000,135000,5401000
Afghanistan,2015,12,6068000,859000,6927000
Afghanistan,2016,1,3456000,394000,3850000
Afghanistan,2016,2,3977000,782000,4759000
Afghanistan,2016,3,2741000,171000,2912000
Afghanistan,2016,4,4046000,4898000,8944000
Afghanistan,2016,5,4696000,307000,5003000
Afghanistan,2016,6,3541000,290000,3831000
Afghanistan,2016,7,4840000,2103000,6943000
Afghanistan,2016,8,5005000,404000,5409000
Afghanistan,2016,9,4542000,1294000,5836000
Afghanistan,2016,10,4418000,365000,4783000
Afghanistan,2016,11,4572000,516000,5088000
Afghanistan,2016,12,4289000,395000,4684000
Afghanistan,2017,1,6221000,602000,6823000
Afghanistan,2017,2,5579000,571000,6150000
Afghanistan,2017,3,5488000,354000,5842000
Afghanistan,2017,4,4181000,126000,4307000
Afghanistan,2017,5,7208000,594000,7802000
Afghanistan,2017,6,6441000,403000,6844000
Afghanistan,2017,7,6410000,790000,7200000
Afghanistan,2017,8,5654000,1119000,6773000
Afghanistan,2017,9,3280000,1650000,4930000
Afghanistan,2017,10,5995000,431000,6426000
Afghanistan,2017,11,15728000,1290000,17018000
Afghanistan,2017,12,11291000,1252000,12543000
Afghanistan,2018,1,4306000,1184000,5490000
Afghanistan,2018,2,5510000,1399000,6909000
Afghanistan,2018,3,8708000,1776000,10484000
Afghanistan,2018,4,10884000,382000,11266000
Afghanistan,2018,5,5310000,836000,6146000
Afghanistan,2018,6,9924000,1015000,10939000
Afghanistan,2018,7,10262000,1132000,11394000
Afghanistan,2018,8,5064000,583000,5647000
Afghanistan,2018,9,7829000,574000,8403000
Afghanistan,2018,10,3919000,576000,4495000
Afghanistan,2018,11,5114000,855000,5969000
Afghanistan,2018,12,3778000,1124000,4902000
Afghanistan,2019,1,6081000,1796000,7877000
Afghanistan,2019,2,5660000,1931000,7591000
Afghanistan,2019,3,7224000,1104000,8328000
Afghanistan,2019,4,6171000,1461000,7632000
Afghanistan,2019,5,8001000,1872000,9873000
Afghanistan,2019,6,4535000,2124000,6659000
Afghanistan,2019,7,4209000,2650000,6859000
Afghanistan,2019,8,4902000,1215000,6117000
Afghanistan,2019,9,3316000,946000,4262000
Afghanistan,2019,10,3194000,885000,4079000
Afghanistan,2019,11,7453000,1071000,8524000
Afghanistan,2019,12,4542000,1922000,6464000
Afghanistan,2020,1,4299000,1217000,5516000
Afghanistan,2020,2,5898000,908000,6806000
Afghanistan,2020,3,5788000,893000,6681000
Afghanistan,2020,4,2538000,311000,2849000
Afghanistan,2020,5,7112000,562000,7674000
Afghanistan,2020,6,4872000,297000,5169000
Afghanistan,2020,7,10871000,4786000,15657000
Afghanistan,2020,8,5419000,1614000,7033000
Afghanistan,2020,9,4255000,638000,4893000
Afghanistan,2020,10,6186000,937000,7123000
Afghanistan,2020,11,4218000,1272000,5490000
Afghanistan,2020,12,7752000,1328000,9080000
Afghanistan,2021,1,8610000,657000,9267000
Afghanistan,2021,2,5873000,675000,6548000
Afghanistan,2021,3,8041000,1060000,9101000
Afghanistan,2021,4,4278000,1096000,5374000
Afghanistan,2021,5,4618000,795000,5413000
Afghanistan,2021,6,5996000,943000,6939000
Afghanistan,2021,7,5745000,997000,6742000
Afghanistan,2021,8,3320000,477000,3797000
Afghanistan,2021,9,2625000,665000,3290000
Afghanistan,2021,10,3353000,682000,4035000
Afghanistan,2021,11,2064000,1104000,3168000
Afghanistan,2021,12,1659000,1914000,3573000
Afghanistan,2022,1,1558000,851000,2409000
Afghanistan,2022,2,1947000,933000,2880000
Afghanistan,2022,3,2625000,881000,3506000
Afghanistan,2022,4,3333000,1144000,4477000
Afghanistan,2022,5,3627000,1341000,4968000
Afghanistan,2022,6,2224000,986000,3210000
Afghanistan,2022,7,2695000,584000,3279000
Afghanistan,2022,8,2714000,542000,3256000
Afghanistan,2022,9,2521000,1258000,3779000
Afghanistan,2022,10,2623000,925000,3548000
Afghanistan,2022,11,3725000,943000,4668000
Afghanistan,2022,12,2263000,1025000,3288000
Afghanistan,2023,1,1905000,1825000,3730000
Afghanistan,2023,2,3848000,994000,4842000
Afghanistan,2023,3,3874000,1357000,5231000
Afghanistan,2023,4,2808000,1141000,3949000
Afghanistan,2023,5,5299000,1735000,7034000
Afghanistan,2023,6,5050000,620000,5670000
Afghanistan,2023,7,3404000,426000,3830000
Afghanistan,2023,8,3585000,403000,3988000
Afghanistan,2023,9,1604000,509000,2113000
Afghanistan,2023,10,1422000,809000,2231000
Afghanistan,2023,11,2608000,1835000,4443000
Afghanistan,2023,12,3470000,2057000,5527000
Afghanistan,2024,1,3751000,1338000,5089000
Afghanistan,2024,2,7075000,509000,7584000
Afghanistan,2024,3,6537000,1167000,7704000
Afghanistan,2024,4,6467000,2280000,8747000
Afghanistan,2024,5,5775000,1053000,6828000
Afghanistan,2024,6,5574000,1233000,6807000
Afghanistan,2024,7,5586000,2026000,7612000
Afghanistan,2024,8,4290000,470000,4760000
Afghanistan,2024,9,5878000,1434000,7312000
Afghanistan,2024,10,5083000,964000,6047000
Afghanistan,2024,11,6466000,1050000,7516000
Afghanistan,2024,12,5174000,1918000,7092000
Albanien,2008,1,12511000,1426000,13937000
Albanien,2008,2,13264000,2359000,15623000
Albanien,2008,3,17776000,1981000,19757000
Albanien,2008,4,12668000,3199000,15867000
Albanien,2008,5,13317000,1884000,15201000
Albanien,2008,6,15993000,2440000,18433000
Albanien,2008,7,17579000,2784000,20363000
Albanien,2008,8,12340000,3046000,15386000
Albanien,2008,9,17919000,2786000,20705000
Albanien,2008,10,26162000,3979000,30141000
Albanien,2008,11,16282000,4152000,20434000
Albanien,2008,12,17849000,1868000,19717000
Albanien,2009,1,14288000,2143000,16431000
Albanien,2009,2,17406000,3647000,21053000
Albanien,2009,3,17147000,3462000,20609000
Albanien,2009,4,20437000,2979000,23416000
Albanien,2009,5,16308000,3360000,19668000
Albanien,2009,6,14912000,3274000,18186000
Albanien,2009,7,19168000,3679000,22847000
Albanien,2009,8,14828000,2279000,17107000
Albanien,2009,9,14936000,2211000,17147000
Albanien,2009,10,15057000,3193000,18250000
Albanien,2009,11,14606000,2859000,17465000
Albanien,2009,12,14257000,2074000,16331000
Albanien,2010,1,9863000,2786000,12649000
Albanien,2010,2,11780000,2867000,14647000
Albanien,2010,3,15309000,3516000,18825000
Albanien,2010,4,12922000,1967000,14889000
Albanien,2010,5,13005000,2888000,15893000
Albanien,2010,6,14946000,2993000,17939000
Albanien,2010,7,11714000,3503000,15217000
Albanien,2010,8,11381000,3403000,14784000
Albanien,2010,9,14474000,3220000,17694000
Albanien,2010,10,15205000,3689000,18894000
Albanien,2010,11,12787000,3103000,15890000
Albanien,2010,12,10967000,3459000,14426000
Albanien,2011,1,9970000,3470000,13440000
Albanien,2011,2,11984000,4293000,16277000
Albanien,2011,3,15595000,4296000,19891000
Albanien,2011,4,14106000,2728000,16834000
Albanien,2011,5,15372000,4619000,19991000
Albanien,2011,6,12546000,11751000,24297000
Albanien,2011,7,12098000,4167000,16265000
Albanien,2011,8,10250000,5873000,16123000
Albanien,2011,9,13754000,4329000,18083000
Albanien,2011,10,13632000,8680000,22312000
Albanien,2011,11,15229000,4435000,19664000
Albanien,2011,12,14633000,3181000,17814000
Albanien,2012,1,9261000,12990000,22251000
Albanien,2012,2,11463000,3279000,14742000
Albanien,2012,3,16814000,4843000,21657000
Albanien,2012,4,11945000,3103000,15048000
Albanien,2012,5,13405000,3477000,16882000
Albanien,2012,6,15276000,14295000,29571000
Albanien,2012,7,36861000,4206000,41067000
Albanien,2012,8,15192000,3992000,19184000
Albanien,2012,9,11591000,4281000,15872000
Albanien,2012,10,13962000,14674000,28636000
Albanien,2012,11,13206000,4643000,17849000
Albanien,2012,12,9095000,3731000,12826000
Albanien,2013,1,8966000,3996000,12962000
Albanien,2013,2,11068000,3772000,14840000
Albanien,2013,3,13346000,3605000,16951000
Albanien,2013,4,10124000,13475000,23599000
Albanien,2013,5,12790000,4082000,16872000
Albanien,2013,6,11928000,12594000,24522000
Albanien,2013,7,14357000,5882000,20239000
Albanien,2013,8,10517000,14655000,25172000
Albanien,2013,9,11284000,5115000,16399000
Albanien,2013,10,13171000,5244000,18415000
Albanien,2013,11,11348000,4981000,16329000
Albanien,2013,12,11993000,4410000,16403000
Albanien,2014,1,11877000,4492000,16369000
Albanien,2014,2,11694000,5623000,17317000
Albanien,2014,3,11019000,5001000,16020000
Albanien,2014,4,12015000,6552000,18567000
Albanien,2014,5,12365000,3426000,15791000
Albanien,2014,6,13415000,3722000,17137000
Albanien,2014,7,14552000,4657000,19209000
Albanien,2014,8,11097000,9329000,20426000
Albanien,2014,9,13056000,6388000,19444000
Albanien,2014,10,17279000,3663000,20942000
Albanien,2014,11,14317000,4103000,18420000
Albanien,2014,12,14817000,3661000,18478000
Albanien,2015,1,13738000,4857000,18595000
Albanien,2015,2,14190000,5551000,19741000
Albanien,2015,3,14213000,5952000,20165000
Albanien,2015,4,13692000,4961000,18653000
Albanien,2015,5,17006000,4359000,21365000
Albanien,2015,6,18656000,6349000,25005000
Albanien,2015,7,17034000,6559000,23593000
Albanien,2015,8,11927000,9790000,21717000
Albanien,2015,9,15239000,6880000,22119000
Albanien,2015,10,29467000,7267000,36734000
Albanien,2015,11,17330000,4925000,22255000
Albanien,2015,12,17354000,5369000,22723000
Albanien,2016,1,12069000,6309000,18378000
Albanien,2016,2,16187000,7240000,23427000
Albanien,2016,3,28183000,7171000,35354000
Albanien,2016,4,52620000,4860000,57480000
Albanien,2016,5,22430000,6580000,29010000
Albanien,2016,6,24710000,5736000,30446000
Albanien,2016,7,15182000,8589000,23771000
Albanien,2016,8,35176000,7499000,42675000
Albanien,2016,9,28577000,7648000,36225000
Albanien,2016,10,19898000,7422000,27320000
Albanien,2016,11,33024000,6109000,39133000
Albanien,2016,12,22381000,6176000,28557000
Albanien,2017,1,14944000,6553000,21497000
Albanien,2017,2,31514000,7287000,38801000
Albanien,2017,3,25584000,8823000,34407000
Albanien,2017,4,18280000,7155000,25435000
Albanien,2017,5,27861000,9718000,37579000
Albanien,2017,6,30106000,8714000,38820000
Albanien,2017,7,22849000,9764000,32613000
Albanien,2017,8,17589000,9358000,26947000
Albanien,2017,9,20107000,8475000,28582000
Albanien,2017,10,20873000,8404000,29277000
Albanien,2017,11,22185000,9547000,31732000
Albanien,2017,12,19079000,6196000,25275000
Albanien,2018,1,17123000,9856000,26979000
Albanien,2018,2,21755000,11092000,32847000
Albanien,2018,3,22247000,9585000,31832000
Albanien,2018,4,19659000,7745000,27404000
Albanien,2018,5,22634000,8830000,31464000
Albanien,2018,6,22711000,9968000,32679000
Albanien,2018,7,19986000,12608000,32594000
Albanien,2018,8,18370000,11249000,29619000
Albanien,2018,9,19555000,9428000,28983000
Albanien,2018,10,23128000,12321000,35449000
Albanien,2018,11,27652000,11198000,38850000
Albanien,2018,12,16253000,9029000,25282000
Albanien,2019,1,18390000,9907000,28297000
Albanien,2019,2,21946000,13664000,35610000
Albanien,2019,3,20876000,11920000,32796000
Albanien,2019,4,19462000,11096000,30558000
Albanien,2019,5,24477000,11797000,36274000
Albanien,2019,6,21155000,12503000,33658000
Albanien,2019,7,23292000,13082000,36374000
Albanien,2019,8,24028000,12759000,36787000
Albanien,2019,9,19739000,13965000,33704000
Albanien,2019,10,23736000,13002000,36738000
Albanien,2019,11,23862000,11716000,35578000
Albanien,2019,12,18487000,10168000,28655000
Albanien,2020,1,22363000,11832000,34195000
Albanien,2020,2,23757000,14670000,38427000
Albanien,2020,3,18963000,12826000,31789000
Albanien,2020,4,13206000,11321000,24527000
Albanien,2020,5,14446000,10609000,25055000
Albanien,2020,6,19707000,12725000,32432000
Albanien,2020,7,25957000,13056000,39013000
Albanien,2020,8,17415000,12297000,29712000
Albanien,2020,9,24960000,12010000,36970000
Albanien,2020,10,28592000,12101000,40693000
Albanien,2020,11,23920000,11928000,35848000
Albanien,2020,12,23067000,11012000,34079000
Albanien,2021,1,19760000,8714000,28474000
Albanien,2021,2,24117000,11379000,35496000
Albanien,2021,3,30410000,12436000,42846000
Albanien,2021,4,27350000,11805000,39155000
Albanien,2021,5,23841000,10562000,34403000
Albanien,2021,6,31611000,12310000,43921000
Albanien,2021,7,28216000,14580000,42796000
Albanien,2021,8,23145000,10286000,33431000
Albanien,2021,9,23670000,13765000,37435000
Albanien,2021,10,26755000,12763000,39518000
Albanien,2021,11,27316000,16671000,43987000
Albanien,2021,12,21310000,15761000,37071000
Albanien,2022,1,22191000,15291000,37482000
Albanien,2022,2,27631000,17014000,44645000
Albanien,2022,3,31115000,21191000,52306000
Albanien,2022,4,28143000,14988000,43131000
Albanien,2022,5,32842000,15501000,48343000
Albanien,2022,6,32976000,17741000,50717000
Albanien,2022,7,30579000,16577000,47156000
Albanien,2022,8,26595000,18802000,45397000
Albanien,2022,9,29529000,18789000,48318000
Albanien,2022,10,27715000,18575000,46290000
Albanien,2022,11,29654000,20115000,49769000
Albanien,2022,12,24884000,17362000,42246000
Albanien,2023,1,27985000,18823000,46808000
Albanien,2023,2,35862000,18396000,54258000
Albanien,2023,3,39981000,19194000,59175000
Albanien,2023,4,29751000,15220000,44971000
Albanien,2023,5,32378000,20165000,52543000
Albanien,2023,6,39880000,18551000,58431000
Albanien,2023,7,31570000,17198000,48768000
Albanien,2023,8,29350000,18162000,47512000
Albanien,2023,9,33353000,17252000,50605000
Albanien,2023,10,33016000,22692000,55708000
Albanien,2023,11,35430000,20216000,55646000
Albanien,2023,12,31370000,15835000,47205000
Albanien,2024,1,32264000,17764000,50028000
Albanien,2024,2,38967000,18013000,56980000
Albanien,2024,3,36255000,16104000,52359000
Albanien,2024,4,38290000,16392000,54682000
Albanien,2024,5,34001000,17565000,51566000
Albanien,2024,6,41780000,17831000,59611000
Albanien,2024,7,42147000,22101000,64248000
Albanien,2024,8,35263000,16843000,52106000
Albanien,2024,9,37907000,16830000,54737000
Albanien,2024,10,47982000,21602000,69584000
Albanien,2024,11,39898000,21345000,61243000
Albanien,2024,12,32962000,16258000,49220000
Algerien,2008,1,102707000,63814000,166521000
Algerien,2008,2,104842000,155811000,260653000
Algerien,2008,3,94105000,150873000,244978000
Algerien,2008,4,115374000,171850000,287224000
Algerien,2008,5,126462000,244656000,371118000
Algerien,2008,6,147684000,80207000,227891000
Algerien,2008,7,125541000,106236000,231777000
Algerien,2008,8,116974000,317828000,434802000
Algerien,2008,9,125165000,175767000,300932000
Algerien,2008,10,133028000,96637000,229665000
Algerien,2008,11,137484000,92141000,229625000
Algerien,2008,12,160036000,79373000,239409000
Algerien,2009,1,137972000,88449000,226421000
Algerien,2009,2,108548000,68729000,177277000
Algerien,2009,3,153362000,66357000,219719000
Algerien,2009,4,135309000,44721000,180030000
Algerien,2009,5,133726000,25875000,159601000
Algerien,2009,6,154151000,94037000,248188000
Algerien,2009,7,136793000,98418000,235211000
Algerien,2009,8,92806000,19615000,112421000
Algerien,2009,9,83753000,1297000,85050000
Algerien,2009,10,122592000,44850000,167442000
Algerien,2009,11,164610000,60069000,224679000
Algerien,2009,12,153986000,41370000,195356000
Algerien,2010,1,95280000,45550000,140830000
Algerien,2010,2,113832000,51943000,165775000
Algerien,2010,3,127861000,68352000,196213000
Algerien,2010,4,113489000,37342000,150831000
Algerien,2010,5,116307000,92262000,208569000
Algerien,2010,6,135232000,80514000,215746000
Algerien,2010,7,123889000,26176000,150065000
Algerien,2010,8,139501000,45060000,184561000
Algerien,2010,9,115812000,66173000,181985000
Algerien,2010,10,86780000,95084000,181864000
Algerien,2010,11,119685000,58156000,177841000
Algerien,2010,12,134744000,26814000,161558000
Algerien,2011,1,107458000,26522000,133980000
Algerien,2011,2,132902000,239495000,372397000
Algerien,2011,3,166490000,201872000,368362000
Algerien,2011,4,123900000,214514000,338414000
Algerien,2011,5,135804000,132276000,268080000
Algerien,2011,6,166513000,113020000,279533000
Algerien,2011,7,108788000,134325000,243113000
Algerien,2011,8,89232000,277548000,366780000
Algerien,2011,9,108267000,173345000,281612000
Algerien,2011,10,118383000,195493000,313876000
Algerien,2011,11,136700000,185824000,322524000
Algerien,2011,12,156214000,89749000,245963000
Algerien,2012,1,130331000,108537000,238868000
Algerien,2012,2,133987000,194634000,328621000
Algerien,2012,3,164901000,135633000,300534000
Algerien,2012,4,128068000,152074000,280142000
Algerien,2012,5,148692000,139075000,287767000
Algerien,2012,6,175179000,49484000,224663000
Algerien,2012,7,154547000,122524000,277071000
Algerien,2012,8,149681000,170580000,320261000
Algerien,2012,9,143975000,236981000,380956000
Algerien,2012,10,157187000,145886000,303073000
Algerien,2012,11,175073000,126143000,301216000
Algerien,2012,12,196696000,319111000,515807000
Algerien,2013,1,141856000,207702000,349558000
Algerien,2013,2,157666000,150356000,308022000
Algerien,2013,3,160917000,160074000,320991000
Algerien,2013,4,185801000,112006000,297807000
Algerien,2013,5,187289000,64967000,252256000
Algerien,2013,6,192071000,174475000,366546000
Algerien,2013,7,166262000,142175000,308437000
Algerien,2013,8,152999000,288646000,441645000
Algerien,2013,9,130750000,82467000,213217000
Algerien,2013,10,166627000,226147000,392774000
Algerien,2013,11,202679000,276890000,479569000
Algerien,2013,12,224883000,161943000,386826000
Algerien,2014,1,133968000,218287000,352255000
Algerien,2014,2,170458000,188551000,359009000
Algerien,2014,3,211771000,224075000,435846000
Algerien,2014,4,280646000,162230000,442876000
Algerien,2014,5,222541000,186469000,409010000
Algerien,2014,6,272106000,273757000,545863000
Algerien,2014,7,172248000,226993000,399241000
Algerien,2014,8,143288000,198637000,341925000
Algerien,2014,9,200683000,333847000,534530000
Algerien,2014,10,240763000,219535000,460298000
Algerien,2014,11,271250000,110069000,381319000
Algerien,2014,12,284781000,182157000,466938000
Algerien,2015,1,165149000,214150000,379299000
Algerien,2015,2,195799000,87079000,282878000
Algerien,2015,3,277543000,65444000,342987000
Algerien,2015,4,249253000,209826000,459079000
Algerien,2015,5,191905000,182682000,374587000
Algerien,2015,6,199470000,141934000,341404000
Algerien,2015,7,170641000,152413000,323054000
Algerien,2015,8,150686000,73514000,224200000
Algerien,2015,9,157620000,122001000,279621000
Algerien,2015,10,182989000,97484000,280473000
Algerien,2015,11,232313000,119494000,351807000
Algerien,2015,12,229411000,91010000,320421000
Algerien,2016,1,127539000,102096000,229635000
Algerien,2016,2,160153000,35738000,195891000
Algerien,2016,3,777278000,74171000,851449000
Algerien,2016,4,271497000,114243000,385740000
Algerien,2016,5,202940000,42577000,245517000
Algerien,2016,6,184392000,125983000,310375000
Algerien,2016,7,144264000,141751000,286015000
Algerien,2016,8,185683000,85907000,271590000
Algerien,2016,9,229004000,87982000,316986000
Algerien,2016,10,418827000,200481000,619308000
Algerien,2016,11,270013000,112323000,382336000
Algerien,2016,12,233676000,193187000,426863000
Algerien,2017,1,118527000,196293000,314820000
Algerien,2017,2,140688000,133454000,274142000
Algerien,2017,3,210443000,78414000,288857000
Algerien,2017,4,809305000,101861000,911166000
Algerien,2017,5,438297000,123196000,561493000
Algerien,2017,6,191444000,81942000,273386000
Algerien,2017,7,188485000,67546000,256031000
Algerien,2017,8,200586000,69102000,269688000
Algerien,2017,9,183047000,47968000,231015000
Algerien,2017,10,201197000,97117000,298314000
Algerien,2017,11,242334000,92044000,334378000
Algerien,2017,12,182273000,79590000,261863000
Algerien,2018,1,168806000,48370000,217176000
Algerien,2018,2,163756000,48560000,212316000
Algerien,2018,3,216918000,36525000,253443000
Algerien,2018,4,158831000,58880000,217711000
Algerien,2018,5,192090000,32804000,224894000
Algerien,2018,6,178356000,51880000,230236000
Algerien,2018,7,212790000,71498000,284288000
Algerien,2018,8,164059000,59557000,223616000
Algerien,2018,9,130693000,49401000,180094000
Algerien,2018,10,147951000,56086000,204037000
Algerien,2018,11,214447000,73058000,287505000
Algerien,2018,12,215329000,59489000,274818000
Algerien,2019,1,112710000,40892000,153602000
Algerien,2019,2,170899000,70229000,241128000
Algerien,2019,3,212630000,44935000,257565000
Algerien,2019,4,147291000,84224000,231515000
Algerien,2019,5,215506000,19905000,235411000
Algerien,2019,6,188776000,46970000,235746000
Algerien,2019,7,151490000,35407000,186897000
Algerien,2019,8,132000000,60525000,192525000
Algerien,2019,9,188085000,116119000,304204000
Algerien,2019,10,172897000,64269000,237166000
Algerien,2019,11,190624000,51994000,242618000
Algerien,2019,12,154367000,27967000,182334000
Algerien,2020,1,93723000,65441000,159164000
Algerien,2020,2,168695000,53446000,222141000
Algerien,2020,3,182651000,58367000,241018000
Algerien,2020,4,143427000,62478000,205905000
Algerien,2020,5,123772000,39393000,163165000
Algerien,2020,6,118857000,32721000,151578000
Algerien,2020,7,107533000,85441000,192974000
Algerien,2020,8,93422000,58592000,152014000
Algerien,2020,9,97859000,44170000,142029000
Algerien,2020,10,141483000,21049000,162532000
Algerien,2020,11,167376000,44483000,211859000
Algerien,2020,12,204677000,60904000,265581000
Algerien,2021,1,149061000,38525000,187586000
Algerien,2021,2,125252000,13427000,138679000
Algerien,2021,3,176234000,40102000,216336000
Algerien,2021,4,133914000,83199000,217113000
Algerien,2021,5,174658000,79330000,253988000
Algerien,2021,6,116636000,34254000,150890000
Algerien,2021,7,111144000,92231000,203375000
Algerien,2021,8,140854000,75794000,216648000
Algerien,2021,9,206178000,58368000,264546000
Algerien,2021,10,171459000,85282000,256741000
Algerien,2021,11,166357000,97086000,263443000
Algerien,2021,12,174471000,76531000,251002000
Algerien,2022,1,130056000,153971000,284027000
Algerien,2022,2,110749000,151451000,262200000
Algerien,2022,3,144918000,120372000,265290000
Algerien,2022,4,120190000,145072000,265262000
Algerien,2022,5,133591000,322665000,456256000
Algerien,2022,6,114831000,240323000,355154000
Algerien,2022,7,123278000,127181000,250459000
Algerien,2022,8,141082000,151103000,292185000
Algerien,2022,9,162883000,212655000,375538000
Algerien,2022,10,153035000,130316000,283351000
Algerien,2022,11,175109000,137581000,312690000
Algerien,2022,12,162329000,79801000,242130000
Algerien,2023,1,165333000,130320000,295653000
Algerien,2023,2,150799000,146806000,297605000
Algerien,2023,3,199500000,164018000,363518000
Algerien,2023,4,168927000,57538000,226465000
Algerien,2023,5,206635000,99302000,305937000
Algerien,2023,6,191569000,153479000,345048000
Algerien,2023,7,156427000,47933000,204360000
Algerien,2023,8,162168000,86565000,248733000
Algerien,2023,9,145231000,126437000,271668000
Algerien,2023,10,149129000,173032000,322161000
Algerien,2023,11,168491000,146782000,315273000
Algerien,2023,12,189976000,180522000,370498000
Algerien,2024,1,179887000,210516000,390403000
Algerien,2024,2,194734000,204269000,399003000
Algerien,2024,3,179605000,91636000,271241000
Algerien,2024,4,181414000,46141000,227555000
Algerien,2024,5,160731000,91611000,252342000
Algerien,2024,6,147391000,207031000,354422000
Algerien,2024,7,183173000,148141000,331314000
Algerien,2024,8,158771000,8101000,166872000
Algerien,2024,9,166593000,19730000,186323000
Algerien,2024,10,191402000,76709000,268111000
Algerien,2024,11,205243000,63990000,269233000
Algerien,2024,12,145171000,49239000,194410000
Amerikanisch-Ozeanien (bis 2000),2008,1,0,0,0
Amerikanisch-Ozeanien (bis 2000),2008,2,0,0,0
Amerikanisch-Ozeanien (bis 2000),2008,3,0,0,0
Amerikanisch-Ozeanien (bis 2000),2008,4,0,0,0
Amerikanisch-Ozeanien (bis 2000),2008,5,0,0,0
Amerikanisch-Ozeanien (bis 2000),2008,6,0,0,0
Amerikanisch-Ozeanien (bis 2000),2008,7,0,0,0
Amerikanisch-Ozeanien (bis 2000),2008,8,0,0,0
Amerikanisch-Ozeanien (bis 2000),2008,9,0,0,0
Amerikanisch-Ozeanien (bis 2000),2008,10,0,0,0
Amerikanisch-Ozeanien (bis 2000),2008,11,0,0,0
Amerikanisch-Ozeanien (bis 2000),2008,12,0,0,0
Amerikanisch-Ozeanien (bis 2000),2009,1,0,0,0
Amerikanisch-Ozeanien (bis 2000),2009,2,0,0,0
Amerikanisch-Ozeanien (bis 2000),2009,3,0,0,0
Amerikanisch-Ozeanien (bis 2000),2009,4,0,0,0
Amerikanisch-Ozeanien (bis 2000),2009,5,0,0,0
Amerikanisch-Ozeanien (bis 2000),2009,6,0,0,0
Amerikanisch-Ozeanien (bis 2000),2009,7,0,0,0
Amerikanisch-Ozeanien (bis 2000),2009,8,0,0,0
Amerikanisch-Ozeanien (bis 2000),2009,9,0,0,0
Amerikanisch-Ozeanien (bis 2000),2009,10,0,0,0
Amerikanisch-Ozeanien (bis 2000),2009,11,0,0,0
Amerikanisch-Ozeanien (bis 2000),2009,12,0,0,0
Amerikanisch-Ozeanien (bis 2000),2010,1,0,0,0
Amerikanisch-Ozeanien (bis 2000),2010,2,0,0,0
Amerikanisch-Ozeanien (bis 2000),2010,3,0,0,0
Amerikanisch-Ozeanien (bis 2000),2010,4,0,0,0
Amerikanisch-Ozeanien (bis 2000),2010,5,0,0,0
Amerikanisch-Ozeanien (bis 2000),2010,6,0,0,0
Amerikanisch-Ozeanien (bis 2000),2010,7,0,0,0
Amerikanisch-Ozeanien (bis 2000),2010,8,0,0,0
Amerikanisch-Ozeanien (bis 2000),2010,9,0,0,0
Amerikanisch-Ozeanien (bis 2000),2010,10,0,0,0
Amerikanisch-Ozeanien (bis 2000),2010,11,0,0,0
Amerikanisch-Ozeanien (bis 2000),2010,12,0,0,0
Amerikanisch-Ozeanien (bis 2000),2011,1,0,0,0
Amerikanisch-Ozeanien (bis 2000),2011,2,0,0,0
Amerikanisch-Ozeanien (bis 2000),2011,3,0,0,0
Amerikanisch-Ozeanien (bis 2000),2011,4,0,0,0
Amerikanisch-Ozeanien (bis 2000),2011,5,0,0,0
Amerikanisch-Ozeanien (bis 2000),2011,6,0,0,0
Amerikanisch-Ozeanien (bis 2000),2011,7,0,0,0
Amerikanisch-Ozeanien (bis 2000),2011,8,0,0,0
Amerikanisch-Ozeanien (bis 2000),2011,9,0,0,0
Amerikanisch-Ozeanien (bis 2000),2011,10,0,0,0
Amerikanisch-Ozeanien (bis 2000),2011,11,0,0,0
Amerikanisch-Ozeanien (bis 2000),2011,12,0,0,0
Amerikanisch-Ozeanien (bis 2000),2012,1,0,0,0
Amerikanisch-Ozeanien (bis 2000),2012,2,0,0,0
Amerikanisch-Ozeanien (bis 2000),2012,3,0,0,0
Amerikanisch-Ozeanien (bis 2000),2012,4,0,0,0
Amerikanisch-Ozeanien (bis 2000),2012,5,0,0,0
Amerikanisch-Ozeanien (bis 2000),2012,6,0,0,0
Amerikanisch-Ozeanien (bis 2000),2012,7,0,0,0
Amerikanisch-Ozeanien (bis 2000),2012,8,0,0,0
Amerikanisch-Ozeanien (bis 2000),2012,9,0,0,0
Amerikanisch-Ozeanien (bis 2000),2012,10,0,0,0
Amerikanisch-Ozeanien (bis 2000),2012,11,0,0,0
Amerikanisch-Ozeanien (bis 2000),2012,12,0,0,0
Amerikanisch-Ozeanien (bis 2000),2013,1,0,0,0
Amerikanisch-Ozeanien (bis 2000),2013,2,0,0,0
Amerikanisch-Ozeanien (bis 2000),2013,3,0,0,0
Amerikanisch-Ozeanien (bis 2000),2013,4,0,0,0
Amerikanisch-Ozeanien (bis 2000),2013,5,0,0,0
Amerikanisch-Ozeanien (bis 2000),2013,6,0,0,0
Amerikanisch-Ozeanien (bis 2000),2013,7,0,0,0
Amerikanisch-Ozeanien (bis 2000),2013,8,0,0,0
Amerikanisch-Ozeanien (bis 2000),2013,9,0,0,0
Amerikanisch-Ozeanien (bis 2000),2013,10,0,0,0
Amerikanisch-Ozeanien (bis 2000),2013,11,0,0,0
Amerikanisch-Ozeanien (bis 2000),2013,12,0,0,0
Amerikanisch-Ozeanien (bis 2000),2014,1,0,0,0
Amerikanisch-Ozeanien (bis 2000),2014,2,0,0,0
Amerikanisch-Ozeanien (bis 2000),2014,3,0,0,0
Amerikanisch-Ozeanien (bis 2000),2014,4,0,0,0
Amerikanisch-Ozeanien (bis 2000),2014,5,0,0,0
Amerikanisch-Ozeanien (bis 2000),2014,6,0,0,0
Amerikanisch-Ozeanien (bis 2000),2014,7,0,0,0
Amerikanisch-Ozeanien (bis 2000),2014,8,0,0,0
Amerikanisch-Ozeanien (bis 2000),2014,9,0,0,0
Amerikanisch-Ozeanien (bis 2000),2014,10,0,0,0
Amerikanisch-Ozeanien (bis 2000),2014,11,0,0,0
Amerikanisch-Ozeanien (bis 2000),2014,12,0,0,0
Amerikanisch-Ozeanien (bis 2000),2015,1,0,0,0
Amerikanisch-Ozeanien (bis 2000),2015,2,0,0,0
Amerikanisch-Ozeanien (bis 2000),2015,3,0,0,0
Amerikanisch-Ozeanien (bis 2000),2015,4,0,0,0
Amerikanisch-Ozeanien (bis 2000),2015,5,0,0,0
Amerikanisch-Ozeanien (bis 2000),2015,6,0,0,0
Amerikanisch-Ozeanien (bis 2000),2015,7,0,0,0
Amerikanisch-Ozeanien (bis 2000),2015,8,0,0,0
Amerikanisch-Ozeanien (bis 2000),2015,9,0,0,0
Amerikanisch-Ozeanien (bis 2000),2015,10,0,0,0
Amerikanisch-Ozeanien (bis 2000),2015,11,0,0,0
Amerikanisch-Ozeanien (bis 2000),2015,12,0,0,0
Amerikanisch-Ozeanien (bis 2000),2016,1,0,0,0
Amerikanisch-Ozeanien (bis 2000),2016,2,0,0,0
Amerikanisch-Ozeanien (bis 2000),2016,3,0,0,0
Amerikanisch-Ozeanien (bis 2000),2016,4,0,0,0
Amerikanisch-Ozeanien (bis 2000),2016,5,0,0,0
Amerikanisch-Ozeanien (bis 2000),2016,6,0,0,0
Amerikanisch-Ozeanien (bis 2000),2016,7,0,0,0
Amerikanisch-Ozeanien (bis 2000),2016,8,0,0,0
Amerikanisch-Ozeanien (bis 2000),2016,9,0,0,0
Amerikanisch-Ozeanien (bis 2000),2016,10,0,0,0
Amerikanisch-Ozeanien (bis 2000),2016,11,0,0,0
Amerikanisch-Ozeanien (bis 2000),2016,12,0,0,0
Amerikanisch-Ozeanien (bis 2000),2017,1,0,0,0
Amerikanisch-Ozeanien (bis 2000),2017,2,0,0,0
Amerikanisch-Ozeanien (bis 2000),2017,3,0,0,0
Amerikanisch-Ozeanien (bis 2000),2017,4,0,0,0
Amerikanisch-Ozeanien (bis 2000),2017,5,0,0,0
Amerikanisch-Ozeanien (bis 2000),2017,6,0,0,0
Amerikanisch-Ozeanien (bis 2000),2017,7,0,0,0
Amerikanisch-Ozeanien (bis 2000),2017,8,0,0,0
Amerikanisch-Ozeanien (bis 2000),2017,9,0,0,0
Amerikanisch-Ozeanien (bis 2000),2017,10,0,0,0
Amerikanisch-Ozeanien (bis 2000),2017,11,0,0,0
Amerikanisch-Ozeanien (bis 2000),2017,12,0,0,0
Amerikanisch-Ozeanien (bis 2000),2018,1,0,0,0
Amerikanisch-Ozeanien (bis 2000),2018,2,0,0,0
Amerikanisch-Ozeanien (bis 2000),2018,3,0,0,0
Amerikanisch-Ozeanien (bis 2000),2018,4,0,0,0
Amerikanisch-Ozeanien (bis 2000),2018,5,0,0,0
Amerikanisch-Ozeanien (bis 2000),2018,6,0,0,0
Amerikanisch-Ozeanien (bis 2000),2018,7,0,0,0
Amerikanisch-Ozeanien (bis 2000),2018,8,0,0,0
Amerikanisch-Ozeanien (bis 2000),2018,9,0,0,0
Amerikanisch-Ozeanien (bis 2000),2018,10,0,0,0
Amerikanisch-Ozeanien (bis 2000),2018,11,0,0,0
Amerikanisch-Ozeanien (bis 2000),2018,12,0,0,0
Amerikanisch-Ozeanien (bis 2000),2019,1,0,0,0
Amerikanisch-Ozeanien (bis 2000),2019,2,0,0,0
Amerikanisch-Ozeanien (bis 2000),2019,3,0,0,0
Amerikanisch-Ozeanien (bis 2000),2019,4,0,0,0
Amerikanisch-Ozeanien (bis 2000),2019,5,0,0,0
Amerikanisch-Ozeanien (bis 2000),2019,6,0,0,0
Amerikanisch-Ozeanien (bis 2000),2019,7,0,0,0
Amerikanisch-Ozeanien (bis 2000),2019,8,0,0,0
Amerikanisch-Ozeanien (bis 2000),2019,9,0,0,0
Amerikanisch-Ozeanien (bis 2000),2019,10,0,0,0
Amerikanisch-Ozeanien (bis 2000),2019,11,0,0,0
Amerikanisch-Ozeanien (bis 2000),2019,12,0,0,0
Amerikanisch-Ozeanien (bis 2000),2020,1,0,0,0
Amerikanisch-Ozeanien (bis 2000),2020,2,0,0,0
Amerikanisch-Ozeanien (bis 2000),2020,3,0,0,0
Amerikanisch-Ozeanien (bis 2000),2020,4,0,0,0
Amerikanisch-Ozeanien (bis 2000),2020,5,0,0,0
Amerikanisch-Ozeanien (bis 2000),2020,6,0,0,0
Amerikanisch-Ozeanien (bis 2000),2020,7,0,0,0
Amerikanisch-Ozeanien (bis 2000),2020,8,0,0,0
Amerikanisch-Ozeanien (bis 2000),2020,9,0,0,0
Amerikanisch-Ozeanien (bis 2000),2020,10,0,0,0
Amerikanisch-Ozeanien (bis 2000),2020,11,0,0,0
Amerikanisch-Ozeanien (bis 2000),2020,12,0,0,0
Amerikanisch-Ozeanien (bis 2000),2021,1,0,0,0
Amerikanisch-Ozeanien (bis 2000),2021,2,0,0,0
Amerikanisch-Ozeanien (bis 2000),2021,3,0,0,0
Amerikanisch-Ozeanien (bis 2000),2021,4,0,0,0
Amerikanisch-Ozeanien (bis 2000),2021,5,0,0,0
Amerikanisch-Ozeanien (bis 2000),2021,6,0,0,0
Amerikanisch-Ozeanien (bis 2000),2021,7,0,0,0
Amerikanisch-Ozeanien (bis 2000),2021,8,0,0,0
Amerikanisch-Ozeanien (bis 2000),2021,9,0,0,0
Amerikanisch-Ozeanien (bis 2000),2021,10,0,0,0
Amerikanisch-Ozeanien (bis 2000),2021,11,0,0,0
Amerikanisch-Ozeanien (bis 2000),2021,12,0,0,0
Amerikanisch-Ozeanien (bis 2000),2022,1,0,0,0
Amerikanisch-Ozeanien (bis 2000),2022,2,0,0,0
Amerikanisch-Ozeanien (bis 2000),2022,3,0,0,0
Amerikanisch-Ozeanien (bis 2000),2022,4,0,0,0
Amerikanisch-Ozeanien (bis 2000),2022,5,0,0,0
Amerikanisch-Ozeanien (bis 2000),2022,6,0,0,0
Amerikanisch-Ozeanien (bis 2000),2022,7,0,0,0
Amerikanisch-Ozeanien (bis 2000),2022,8,0,0,0
Amerikanisch-Ozeanien (bis 2000),2022,9,0,0,0
Amerikanisch-Ozeanien (bis 2000),2022,10,0,0,0
Amerikanisch-Ozeanien (bis 2000),2022,11,0,0,0
Amerikanisch-Ozeanien (bis 2000),2022,12,0,0,0
Amerikanisch-Ozeanien (bis 2000),2023,1,0,0,0
Amerikanisch-Ozeanien (bis 2000),2023,2,0,0,0
Amerikanisch-Ozeanien (bis 2000),2023,3,0,0,0
Amerikanisch-Ozeanien (bis 2000),2023,4,0,0,0
Amerikanisch-Ozeanien (bis 2000),2023,5,0,0,0
Amerikanisch-Ozeanien (bis 2000),2023,6,0,0,0
Amerikanisch-Ozeanien (bis 2000),2023,7,0,0,0
Amerikanisch-Ozeanien (bis 2000),2023,8,0,0,0
Amerikanisch-Ozeanien (bis 2000),2023,9,0,0,0
Amerikanisch-Ozeanien (bis 2000),2023,10,0,0,0
Amerikanisch-Ozeanien (bis 2000),2023,11,0,0,0
Amerikanisch-Ozeanien (bis 2000),2023,12,0,0,0
Amerikanisch-Ozeanien (bis 2000),2024,1,0,0,0
Amerikanisch-Ozeanien (bis 2000),2024,2,0,0,0
Amerikanisch-Ozeanien (bis 2000),2024,3,0,0,0
Amerikanisch-Ozeanien (bis 2000),2024,4,0,0,0
Amerikanisch-Ozeanien (bis 2000),2024,5,0,0,0
Amerikanisch-Ozeanien (bis 2000),2024,6,0,0,0
Amerikanisch-Ozeanien (bis 2000),2024,7,0,0,0
Amerikanisch-Ozeanien (bis 2000),2024,8,0,0,0
Amerikanisch-Ozeanien (bis 2000),2024,9,0,0,0
Amerikanisch-Ozeanien (bis 2000),2024,10,0,0,0
Amerikanisch-Ozeanien (bis 2000),2024,11,0,0,0
Amerikanisch-Ozeanien (bis 2000),2024,12,0,0,0
Amerikanisch-Samoa (ab 2001),2008,1,27000,1000,28000
Amerikanisch-Samoa (ab 2001),2008,2,10000,0,10000
Amerikanisch-Samoa (ab 2001),2008,3,25000,0,25000
Amerikanisch-Samoa (ab 2001),2008,4,3000,3000,6000
Amerikanisch-Samoa (ab 2001),2008,5,8000,1000,9000
Amerikanisch-Samoa (ab 2001),2008,6,13000,0,13000
Amerikanisch-Samoa (ab 2001),2008,7,28000,19000,47000
Amerikanisch-Samoa (ab 2001),2008,8,7000,0,7000
Amerikanisch-Samoa (ab 2001),2008,9,15000,0,15000
Amerikanisch-Samoa (ab 2001),2008,10,0,2000,2000
Amerikanisch-Samoa (ab 2001),2008,11,1000,21000,22000
Amerikanisch-Samoa (ab 2001),2008,12,46000,0,46000
Amerikanisch-Samoa (ab 2001),2009,1,115000,0,115000
Amerikanisch-Samoa (ab 2001),2009,2,17000,0,17000
Amerikanisch-Samoa (ab 2001),2009,3,6000,0,6000
Amerikanisch-Samoa (ab 2001),2009,4,47000,3000,50000
Amerikanisch-Samoa (ab 2001),2009,5,176000,0,176000
Amerikanisch-Samoa (ab 2001),2009,6,57000,0,57000
Amerikanisch-Samoa (ab 2001),2009,7,23000,0,23000
Amerikanisch-Samoa (ab 2001),2009,8,19000,0,19000
Amerikanisch-Samoa (ab 2001),2009,9,60000,0,60000
Amerikanisch-Samoa (ab 2001),2009,10,18000,0,18000
Amerikanisch-Samoa (ab 2001),2009,11,17000,0,17000
Amerikanisch-Samoa (ab 2001),2009,12,0,23000,23000
Amerikanisch-Samoa (ab 2001),2010,1,274000,1000,275000
Amerikanisch-Samoa (ab 2001),2010,2,33000,0,33000
Amerikanisch-Samoa (ab 2001),2010,3,12000,0,12000
Amerikanisch-Samoa (ab 2001),2010,4,1000,18000,19000
Amerikanisch-Samoa (ab 2001),2010,5,1000,0,1000
Amerikanisch-Samoa (ab 2001),2010,6,65000,86000,151000
Amerikanisch-Samoa (ab 2001),2010,7,14000,0,14000
Amerikanisch-Samoa (ab 2001),2010,8,0,0,0
Amerikanisch-Samoa (ab 2001),2010,9,0,0,0
Amerikanisch-Samoa (ab 2001),2010,10,5000,11000,16000
Amerikanisch-Samoa (ab 2001),2010,11,3000,8000,11000
Amerikanisch-Samoa (ab 2001),2010,12,0,0,0
Amerikanisch-Samoa (ab 2001),2011,1,9000,0,9000
Amerikanisch-Samoa (ab 2001),2011,2,0,0,0
Amerikanisch-Samoa (ab 2001),2011,3,0,0,0
Amerikanisch-Samoa (ab 2001),2011,4,10000,0,10000
Amerikanisch-Samoa (ab 2001),2011,5,0,0,0
Amerikanisch-Samoa (ab 2001),2011,6,0,0,0
Amerikanisch-Samoa (ab 2001),2011,7,31000,0,31000
Amerikanisch-Samoa (ab 2001),2011,8,0,21000,21000
Amerikanisch-Samoa (ab 2001),2011,9,0,0,0
Amerikanisch-Samoa (ab 2001),2011,10,85000,0,85000
Amerikanisch-Samoa (ab 2001),2011,11,0,0,0
Amerikanisch-Samoa (ab 2001),2011,12,30000,0,30000
Amerikanisch-Samoa (ab 2001),2012,1,1000,33000,34000
Amerikanisch-Samoa (ab 2001),2012,2,0,29000,29000
Amerikanisch-Samoa (ab 2001),2012,3,0,0,0
Amerikanisch-Samoa (ab 2001),2012,4,0,0,0
Amerikanisch-Samoa (ab 2001),2012,5,8000,0,8000
Amerikanisch-Samoa (ab 2001),2012,6,33000,24000,57000
Amerikanisch-Samoa (ab 2001),2012,7,7000,29000,36000
Amerikanisch-Samoa (ab 2001),2012,8,22000,0,22000
Amerikanisch-Samoa (ab 2001),2012,9,14000,0,14000
Amerikanisch-Samoa (ab 2001),2012,10,0,0,0
Amerikanisch-Samoa (ab 2001),2012,11,11000,0,11000
Amerikanisch-Samoa (ab 2001),2012,12,7000,0,7000
Amerikanisch-Samoa (ab 2001),2013,1,4000,0,4000
Amerikanisch-Samoa (ab 2001),2013,2,5000,0,5000
Amerikanisch-Samoa (ab 2001),2013,3,0,0,0
Amerikanisch-Samoa (ab 2001),2013,4,14000,0,14000
Amerikanisch-Samoa (ab 2001),2013,5,8000,0,8000
Amerikanisch-Samoa (ab 2001),2013,6,16000,0,16000
Amerikanisch-Samoa (ab 2001),2013,7,1000,0,1000
Amerikanisch-Samoa (ab 2001),2013,8,0,0,0
Amerikanisch-Samoa (ab 2001),2013,9,16000,0,16000
Amerikanisch-Samoa (ab 2001),2013,10,0,0,0
Amerikanisch-Samoa (ab 2001),2013,11,29000,0,29000
Amerikanisch-Samoa (ab 2001),2013,12,10000,0,10000
Amerikanisch-Samoa (ab 2001),2014,1,0,0,0
Amerikanisch-Samoa (ab 2001),2014,2,11000,0,11000
Amerikanisch-Samoa (ab 2001),2014,3,0,0,0
Amerikanisch-Samoa (ab 2001),2014,4,0,0,0
Amerikanisch-Samoa (ab 2001),2014,5,0,0,0
Amerikanisch-Samoa (ab 2001),2014,6,79000,0,79000
Amerikanisch-Samoa (ab 2001),2014,7,18000,0,18000
Amerikanisch-Samoa (ab 2001),2014,8,8000,0,8000
Amerikanisch-Samoa (ab 2001),2014,9,0,0,0
Amerikanisch-Samoa (ab 2001),2014,10,6000,0,6000
Amerikanisch-Samoa (ab 2001),2014,11,0,0,0
Amerikanisch-Samoa (ab 2001),2014,12,0,0,0
Amerikanisch-Samoa (ab 2001),2015,1,0,0,0
Amerikanisch-Samoa (ab 2001),2015,2,14000,0,14000
Amerikanisch-Samoa (ab 2001),2015,3,21000,0,21000
Amerikanisch-Samoa (ab 2001),2015,4,13000,0,13000
Amerikanisch-Samoa (ab 2001),2015,5,0,0,0
Amerikanisch-Samoa (ab 2001),2015,6,15000,0,15000
Amerikanisch-Samoa (ab 2001),2015,7,2000,0,2000
Amerikanisch-Samoa (ab 2001),2015,8,1000,0,1000
Amerikanisch-Samoa (ab 2001),2015,9,1000,4000,5000
Amerikanisch-Samoa (ab 2001),2015,10,0,0,0
Amerikanisch-Samoa (ab 2001),2015,11,3000,0,3000
Amerikanisch-Samoa (ab 2001),2015,12,0,0,0
Amerikanisch-Samoa (ab 2001),2016,1,0,0,0
Amerikanisch-Samoa (ab 2001),2016,2,0,0,0
Amerikanisch-Samoa (ab 2001),2016,3,1000,0,1000
Amerikanisch-Samoa (ab 2001),2016,4,0,0,0
Amerikanisch-Samoa (ab 2001),2016,5,1000,0,1000
Amerikanisch-Samoa (ab 2001),2016,6,23000,0,23000
Amerikanisch-Samoa (ab 2001),2016,7,0,0,0
Amerikanisch-Samoa (ab 2001),2016,8,7000,0,7000
Amerikanisch-Samoa (ab 2001),2016,9,8000,0,8000
Amerikanisch-Samoa (ab 2001),2016,10,0,0,0
Amerikanisch-Samoa (ab 2001),2016,11,3000,0,3000
Amerikanisch-Samoa (ab 2001),2016,12,11000,0,11000
Amerikanisch-Samoa (ab 2001),2017,1,0,2000,2000
Amerikanisch-Samoa (ab 2001),2017,2,38000,0,38000
Amerikanisch-Samoa (ab 2001),2017,3,0,0,0
Amerikanisch-Samoa (ab 2001),2017,4,1000,0,1000
Amerikanisch-Samoa (ab 2001),2017,5,16000,0,16000
Amerikanisch-Samoa (ab 2001),2017,6,0,0,0
Amerikanisch-Samoa (ab 2001),2017,7,0,0,0
Amerikanisch-Samoa (ab 2001),2017,8,5000,0,5000
Amerikanisch-Samoa (ab 2001),2017,9,5000,0,5000
Amerikanisch-Samoa (ab 2001),2017,10,0,1000,1000
Amerikanisch-Samoa (ab 2001),2017,11,0,0,0
Amerikanisch-Samoa (ab 2001),2017,12,0,3000,3000
Amerikanisch-Samoa (ab 2001),2018,1,0,0,0
Amerikanisch-Samoa (ab 2001),2018,2,0,0,0
Amerikanisch-Samoa (ab 2001),2018,3,0,0,0
Amerikanisch-Samoa (ab 2001),2018,4,7000,0,7000
Amerikanisch-Samoa (ab 2001),2018,5,0,14000,14000
Amerikanisch-Samoa (ab 2001),2018,6,0,0,0
Amerikanisch-Samoa (ab 2001),2018,7,0,4000,4000
Amerikanisch-Samoa (ab 2001),2018,8,0,0,0
Amerikanisch-Samoa (ab 2001),2018,9,0,7000,7000
Amerikanisch-Samoa (ab 2001),2018,10,0,5000,5000
Amerikanisch-Samoa (ab 2001),2018,11,0,2000,2000
Amerikanisch-Samoa (ab 2001),2018,12,0,0,0
Amerikanisch-Samoa (ab 2001),2019,1,0,56000,56000
Amerikanisch-Samoa (ab 2001),2019,2,0,33000,33000
Amerikanisch-Samoa (ab 2001),2019,3,0,0,0
Amerikanisch-Samoa (ab 2001),2019,4,0,0,0
Amerikanisch-Samoa (ab 2001),2019,5,10000,0,10000
Amerikanisch-Samoa (ab 2001),2019,6,0,10000,10000
Amerikanisch-Samoa (ab 2001),2019,7,0,0,0
Amerikanisch-Samoa (ab 2001),2019,8,7000,2000,9000
Amerikanisch-Samoa (ab 2001),2019,9,0,0,0
Amerikanisch-Samoa (ab 2001),2019,10,3000,1000,4000
Amerikanisch-Samoa (ab 2001),2019,11,1000,8000,9000
Amerikanisch-Samoa (ab 2001),2019,12,0,4000,4000
Amerikanisch-Samoa (ab 2001),2020,1,0,5000,5000
Amerikanisch-Samoa (ab 2001),2020,2,0,35000,35000
Amerikanisch-Samoa (ab 2001),2020,3,0,39000,39000
Amerikanisch-Samoa (ab 2001),2020,4,0,0,0
Amerikanisch-Samoa (ab 2001),2020,5,0,2000,2000
Amerikanisch-Samoa (ab 2001),2020,6,4000,0,4000
Amerikanisch-Samoa (ab 2001),2020,7,63000,10000,73000
Amerikanisch-Samoa (ab 2001),2020,8,0,0,0
Amerikanisch-Samoa (ab 2001),2020,9,60000,0,60000
Amerikanisch-Samoa (ab 2001),2020,10,0,5000,5000
Amerikanisch-Samoa (ab 2001),2020,11,29000,4000,33000
Amerikanisch-Samoa (ab 2001),2020,12,0,0,0
Amerikanisch-Samoa (ab 2001),2021,1,0,21000,21000
Amerikanisch-Samoa (ab 2001),2021,2,0,32000,32000
Amerikanisch-Samoa (ab 2001),2021,3,0,42000,42000
Amerikanisch-Samoa (ab 2001),2021,4,0,27000,27000
Amerikanisch-Samoa (ab 2001),2021,5,13000,1000,14000
Amerikanisch-Samoa (ab 2001),2021,6,0,0,0
Amerikanisch-Samoa (ab 2001),2021,7,2000,0,2000
Amerikanisch-Samoa (ab 2001),2021,8,11000,0,11000
Amerikanisch-Samoa (ab 2001),2021,9,0,0,0
Amerikanisch-Samoa (ab 2001),2021,10,0,78000,78000
Amerikanisch-Samoa (ab 2001),2021,11,0,0,0
Amerikanisch-Samoa (ab 2001),2021,12,121000,0,121000
Amerikanisch-Samoa (ab 2001),2022,1,5000,29000,34000
Amerikanisch-Samoa (ab 2001),2022,2,0,3000,3000
Amerikanisch-Samoa (ab 2001),2022,3,0,5000,5000
Amerikanisch-Samoa (ab 2001),2022,4,0,0,0
Amerikanisch-Samoa (ab 2001),2022,5,0,0,0
Amerikanisch-Samoa (ab 2001),2022,6,0,0,0
Amerikanisch-Samoa (ab 2001),2022,7,6000,0,6000
Amerikanisch-Samoa (ab 2001),2022,8,23000,0,23000
Amerikanisch-Samoa (ab 2001),2022,9,5000,2000,7000
Amerikanisch-Samoa (ab 2001),2022,10,0,0,0
Amerikanisch-Samoa (ab 2001),2022,11,0,0,0
Amerikanisch-Samoa (ab 2001),2022,12,9000,0,9000
Amerikanisch-Samoa (ab 2001),2023,1,1000,11000,12000
Amerikanisch-Samoa (ab 2001),2023,2,0,0,0
Amerikanisch-Samoa (ab 2001),2023,3,0,0,0
Amerikanisch-Samoa (ab 2001),2023,4,0,0,0
Amerikanisch-Samoa (ab 2001),2023,5,126000,0,126000
Amerikanisch-Samoa (ab 2001),2023,6,3000,0,3000
Amerikanisch-Samoa (ab 2001),2023,7,207000,0,207000
Amerikanisch-Samoa (ab 2001),2023,8,0,0,0
Amerikanisch-Samoa (ab 2001),2023,9,0,6000,6000
Amerikanisch-Samoa (ab 2001),2023,10,0,0,0
Amerikanisch-Samoa (ab 2001),2023,11,0,0,0
Amerikanisch-Samoa (ab 2001),2023,12,0,134000,134000
Amerikanisch-Samoa (ab 2001),2024,1,0,0,0
Amerikanisch-Samoa (ab 2001),2024,2,0,1000,1000
Amerikanisch-Samoa (ab 2001),2024,3,4000,0,4000
Amerikanisch-Samoa (ab 2001),2024,4,0,0,0
Amerikanisch-Samoa (ab 2001),2024,5,0,0,0
Amerikanisch-Samoa (ab 2001),2024,6,0,2000,2000
Amerikanisch-Samoa (ab 2001),2024,7,0,0,0
Amerikanisch-Samoa (ab 2001),2024,8,4000,0,4000
Amerikanisch-Samoa (ab 2001),2024,9,0,0,0
Amerikanisch-Samoa (ab 2001),2024,10,0,0,0
Amerikanisch-Samoa (ab 2001),2024,11,0,0,0
Amerikanisch-Samoa (ab 2001),2024,12,0,0,0
Amerikanische Jungferninseln,2008,1,38000,11000,49000
Amerikanische Jungferninseln,2008,2,308000,5000,313000
Amerikanische Jungferninseln,2008,3,20000,3000,23000
Amerikanische Jungferninseln,2008,4,337000,11000,348000
Amerikanische Jungferninseln,2008,5,191000,0,191000
Amerikanische Jungferninseln,2008,6,8000,8000,16000
Amerikanische Jungferninseln,2008,7,48000,0,48000
Amerikanische Jungferninseln,2008,8,239000,0,239000
Amerikanische Jungferninseln,2008,9,86000,3000,89000
Amerikanische Jungferninseln,2008,10,342000,0,342000
Amerikanische Jungferninseln,2008,11,94000,8000,102000
Amerikanische Jungferninseln,2008,12,71000,27000,98000
Amerikanische Jungferninseln,2009,1,164000,4000,168000
Amerikanische Jungferninseln,2009,2,199000,0,199000
Amerikanische Jungferninseln,2009,3,167000,33000,200000
Amerikanische Jungferninseln,2009,4,495000,0,495000
Amerikanische Jungferninseln,2009,5,5000,0,5000
Amerikanische Jungferninseln,2009,6,3000,2000,5000
Amerikanische Jungferninseln,2009,7,8238000,23000,8261000
Amerikanische Jungferninseln,2009,8,130000,0,130000
Amerikanische Jungferninseln,2009,9,11000,2000,13000
Amerikanische Jungferninseln,2009,10,126000,0,126000
Amerikanische Jungferninseln,2009,11,103000,0,103000
Amerikanische Jungferninseln,2009,12,76000,6000,82000
Amerikanische Jungferninseln,2010,1,343000,0,343000
Amerikanische Jungferninseln,2010,2,186000,0,186000
Amerikanische Jungferninseln,2010,3,295000,1006000,1301000
Amerikanische Jungferninseln,2010,4,39000,15000,54000
Amerikanische Jungferninseln,2010,5,38000,0,38000
Amerikanische Jungferninseln,2010,6,235000,0,235000
Amerikanische Jungferninseln,2010,7,27000,15000,42000
Amerikanische Jungferninseln,2010,8,64000,0,64000
Amerikanische Jungferninseln,2010,9,155000,0,155000
Amerikanische Jungferninseln,2010,10,12000,0,12000
Amerikanische Jungferninseln,2010,11,46000,0,46000
Amerikanische Jungferninseln,2010,12,145000,2000,147000
Amerikanische Jungferninseln,2011,1,784000,4000,788000
Amerikanische Jungferninseln,2011,2,182000,0,182000
Amerikanische Jungferninseln,2011,3,18000,6000,24000
Amerikanische Jungferninseln,2011,4,17000,3000,20000
Amerikanische Jungferninseln,2011,5,121000,3000,124000
Amerikanische Jungferninseln,2011,6,135000,0,135000
Amerikanische Jungferninseln,2011,7,41000,0,41000
Amerikanische Jungferninseln,2011,8,153000,2000,155000
Amerikanische Jungferninseln,2011,9,100000,1000,101000
Amerikanische Jungferninseln,2011,10,196000,0,196000
Amerikanische Jungferninseln,2011,11,18000,3000,21000
Amerikanische Jungferninseln,2011,12,158000,1000,159000
Amerikanische Jungferninseln,2012,1,1000,0,1000
Amerikanische Jungferninseln,2012,2,37000,8000,45000
Amerikanische Jungferninseln,2012,3,13000,9000,22000
Amerikanische Jungferninseln,2012,4,0,0,0
Amerikanische Jungferninseln,2012,5,237000,4000,241000
Amerikanische Jungferninseln,2012,6,31000,11000,42000
Amerikanische Jungferninseln,2012,7,402000,2000,404000
Amerikanische Jungferninseln,2012,8,74000,73000,147000
Amerikanische Jungferninseln,2012,9,82000,6000,88000
Amerikanische Jungferninseln,2012,10,303000,0,303000
Amerikanische Jungferninseln,2012,11,217000,1000,218000
Amerikanische Jungferninseln,2012,12,67000,10000,77000
Amerikanische Jungferninseln,2013,1,35000,6000,41000
Amerikanische Jungferninseln,2013,2,273000,17000,290000
Amerikanische Jungferninseln,2013,3,17000,3000,20000
Amerikanische Jungferninseln,2013,4,46000,7000,53000
Amerikanische Jungferninseln,2013,5,57000,2000,59000
Amerikanische Jungferninseln,2013,6,15000,12000,27000
Amerikanische Jungferninseln,2013,7,0,8000,8000
Amerikanische Jungferninseln,2013,8,10000,7000,17000
Amerikanische Jungferninseln,2013,9,24000,35000,59000
Amerikanische Jungferninseln,2013,10,81000,8000,89000
Amerikanische Jungferninseln,2013,11,223000,9000,232000
Amerikanische Jungferninseln,2013,12,59000,1000,60000
Amerikanische Jungferninseln,2014,1,56000,112000,168000
Amerikanische Jungferninseln,2014,2,127000,0,127000
Amerikanische Jungferninseln,2014,3,73000,0,73000
Amerikanische Jungferninseln,2014,4,46000,0,46000
Amerikanische Jungferninseln,2014,5,34000,0,34000
Amerikanische Jungferninseln,2014,6,70000,0,70000
Amerikanische Jungferninseln,2014,7,23000,0,23000
Amerikanische Jungferninseln,2014,8,0,2000,2000
Amerikanische Jungferninseln,2014,9,32000,9000,41000
Amerikanische Jungferninseln,2014,10,100000,9000,109000
Amerikanische Jungferninseln,2014,11,155000,6000,161000
Amerikanische Jungferninseln,2014,12,307000,6000,313000
Amerikanische Jungferninseln,2015,1,104000,0,104000
Amerikanische Jungferninseln,2015,2,5000,18000,23000
Amerikanische Jungferninseln,2015,3,15000,0,15000
Amerikanische Jungferninseln,2015,4,27000,6000,33000
Amerikanische Jungferninseln,2015,5,316000,0,316000
Amerikanische Jungferninseln,2015,6,0,0,0
Amerikanische Jungferninseln,2015,7,33000,0,33000
Amerikanische Jungferninseln,2015,8,24000,0,24000
Amerikanische Jungferninseln,2015,9,1000,40000,41000
Amerikanische Jungferninseln,2015,10,88000,0,88000
Amerikanische Jungferninseln,2015,11,59000,0,59000
Amerikanische Jungferninseln,2015,12,247000,8000,255000
Amerikanische Jungferninseln,2016,1,16000,0,16000
Amerikanische Jungferninseln,2016,2,72000,0,72000
Amerikanische Jungferninseln,2016,3,95000,0,95000
Amerikanische Jungferninseln,2016,4,12000,0,12000
Amerikanische Jungferninseln,2016,5,24000,0,24000
Amerikanische Jungferninseln,2016,6,50000,0,50000
Amerikanische Jungferninseln,2016,7,4000,3000,7000
Amerikanische Jungferninseln,2016,8,74000,0,74000
Amerikanische Jungferninseln,2016,9,197000,67000,264000
Amerikanische Jungferninseln,2016,10,177000,0,177000
Amerikanische Jungferninseln,2016,11,76000,8000,84000
Amerikanische Jungferninseln,2016,12,91000,0,91000
Amerikanische Jungferninseln,2017,1,84000,0,84000
Amerikanische Jungferninseln,2017,2,0,0,0
Amerikanische Jungferninseln,2017,3,124000,1000,125000
Amerikanische Jungferninseln,2017,4,41000,0,41000
Amerikanische Jungferninseln,2017,5,98000,37000,135000
Amerikanische Jungferninseln,2017,6,27000,10000,37000
Amerikanische Jungferninseln,2017,7,23000,11000,34000
Amerikanische Jungferninseln,2017,8,32000,0,32000
Amerikanische Jungferninseln,2017,9,30000,8000,38000
Amerikanische Jungferninseln,2017,10,0,2000,2000
Amerikanische Jungferninseln,2017,11,0,2000,2000
Amerikanische Jungferninseln,2017,12,23000,0,23000
Amerikanische Jungferninseln,2018,1,96000,18000,114000
Amerikanische Jungferninseln,2018,2,8000,2000,10000
Amerikanische Jungferninseln,2018,3,51000,1000,52000
Amerikanische Jungferninseln,2018,4,57000,31000,88000
Amerikanische Jungferninseln,2018,5,109000,0,109000
Amerikanische Jungferninseln,2018,6,208000,0,208000
Amerikanische Jungferninseln,2018,7,47000,80000,127000
Amerikanische Jungferninseln,2018,8,127000,81000,208000
Amerikanische Jungferninseln,2018,9,57000,109000,166000
Amerikanische Jungferninseln,2018,10,78000,8000,86000
Amerikanische Jungferninseln,2018,11,235000,28000,263000
Amerikanische Jungferninseln,2018,12,348000,17000,365000
Amerikanische Jungferninseln,2019,1,8000,47000,55000
Amerikanische Jungferninseln,2019,2,94000,4000,98000
Amerikanische Jungferninseln,2019,3,42000,29000,71000
Amerikanische Jungferninseln,2019,4,217000,62000,279000
Amerikanische Jungferninseln,2019,5,100000,32000,132000
Amerikanische Jungferninseln,2019,6,23000,36000,59000
Amerikanische Jungferninseln,2019,7,99000,0,99000
Amerikanische Jungferninseln,2019,8,79000,0,79000
Amerikanische Jungferninseln,2019,9,19000,10000,29000
Amerikanische Jungferninseln,2019,10,20000,4000,24000
Amerikanische Jungferninseln,2019,11,133000,25000,158000
Amerikanische Jungferninseln,2019,12,84000,0,84000
Amerikanische Jungferninseln,2020,1,130000,23000,153000
Amerikanische Jungferninseln,2020,2,138000,0,138000
Amerikanische Jungferninseln,2020,3,97000,7000,104000
Amerikanische Jungferninseln,2020,4,22000,10000,32000
Amerikanische Jungferninseln,2020,5,23000,0,23000
Amerikanische Jungferninseln,2020,6,116000,1000,117000
Amerikanische Jungferninseln,2020,7,20000,9000,29000
Amerikanische Jungferninseln,2020,8,61000,0,61000
Amerikanische Jungferninseln,2020,9,251000,8000,259000
Amerikanische Jungferninseln,2020,10,51000,92000,143000
Amerikanische Jungferninseln,2020,11,105000,28000,133000
Amerikanische Jungferninseln,2020,12,122000,187000,309000
Amerikanische Jungferninseln,2021,1,25000,0,25000
Amerikanische Jungferninseln,2021,2,74000,88000,162000
Amerikanische Jungferninseln,2021,3,54000,0,54000
Amerikanische Jungferninseln,2021,4,17000,0,17000
Amerikanische Jungferninseln,2021,5,43000,10000,53000
Amerikanische Jungferninseln,2021,6,178000,0,178000
Amerikanische Jungferninseln,2021,7,157000,0,157000
Amerikanische Jungferninseln,2021,8,153000,1000,154000
Amerikanische Jungferninseln,2021,9,99000,0,99000
Amerikanische Jungferninseln,2021,10,147000,0,147000
Amerikanische Jungferninseln,2021,11,186000,17000,203000
Amerikanische Jungferninseln,2021,12,231000,17000,248000
Amerikanische Jungferninseln,2022,1,254000,122000,376000
Amerikanische Jungferninseln,2022,2,107000,32000,139000
Amerikanische Jungferninseln,2022,3,42000,27000,69000
Amerikanische Jungferninseln,2022,4,38000,0,38000
Amerikanische Jungferninseln,2022,5,79000,0,79000
Amerikanische Jungferninseln,2022,6,33000,0,33000
Amerikanische Jungferninseln,2022,7,113000,0,113000
Amerikanische Jungferninseln,2022,8,74000,20000,94000
Amerikanische Jungferninseln,2022,9,105000,0,105000
Amerikanische Jungferninseln,2022,10,196000,0,196000
Amerikanische Jungferninseln,2022,11,1099000,0,1099000
Amerikanische Jungferninseln,2022,12,624000,0,624000
Amerikanische Jungferninseln,2023,1,33000,0,33000
Amerikanische Jungferninseln,2023,2,43000,1000,44000
Amerikanische Jungferninseln,2023,3,172000,179000,351000
Amerikanische Jungferninseln,2023,4,138000,0,138000
Amerikanische Jungferninseln,2023,5,828000,6000,834000
Amerikanische Jungferninseln,2023,6,651000,1000,652000
Amerikanische Jungferninseln,2023,7,51000,0,51000
Amerikanische Jungferninseln,2023,8,121000,0,121000
Amerikanische Jungferninseln,2023,9,30000,0,30000
Amerikanische Jungferninseln,2023,10,159000,0,159000
Amerikanische Jungferninseln,2023,11,103000,1000,104000
Amerikanische Jungferninseln,2023,12,44000,2000,46000
Amerikanische Jungferninseln,2024,1,742000,0,742000
Amerikanische Jungferninseln,2024,2,173000,0,173000
Amerikanische Jungferninseln,2024,3,19000,0,19000
Amerikanische Jungferninseln,2024,4,255000,3000,258000
Amerikanische Jungferninseln,2024,5,183000,2000,185000
Amerikanische Jungferninseln,2024,6,247000,1000,248000
Amerikanische Jungferninseln,2024,7,18000,17000,35000
Amerikanische Jungferninseln,2024,8,30000,25000,55000
Amerikanische Jungferninseln,2024,9,553000,3000,556000
Amerikanische Jungferninseln,2024,10,188000,0,188000
Amerikanische Jungferninseln,2024,11,14000,1000,15000
Amerikanische Jungferninseln,2024,12,109000,2000,111000
"Amerikanische Überseeinseln, kleinere (ab 2001)",2008,1,6000,1000,7000
"Amerikanische Überseeinseln, kleinere (ab 2001)",2008,2,1000,3000,4000
"Amerikanische Überseeinseln, kleinere (ab 2001)",2008,3,18000,78000,96000
"Amerikanische Überseeinseln, kleinere (ab 2001)",2008,4,87000,0,87000
"Amerikanische Überseeinseln, kleinere (ab 2001)",2008,5,0,0,0
"Amerikanische Überseeinseln, kleinere (ab 2001)",2008,6,111000,0,111000
"Amerikanische Überseeinseln, kleinere (ab 2001)",2008,7,4000,4000,8000
"Amerikanische Überseeinseln, kleinere (ab 2001)",2008,8,0,4000,4000
"Amerikanische Überseeinseln, kleinere (ab 2001)",2008,9,0,7000,7000
"Amerikanische Überseeinseln, kleinere (ab 2001)",2008,10,2000,3000,5000
"Amerikanische Überseeinseln, kleinere (ab 2001)",2008,11,8000,2000,10000
"Amerikanische Überseeinseln, kleinere (ab 2001)",2008,12,1000,3000,4000
"Amerikanische Überseeinseln, kleinere (ab 2001)",2009,1,21000,0,21000
"Amerikanische Überseeinseln, kleinere (ab 2001)",2009,2,3000,0,3000
"Amerikanische Überseeinseln, kleinere (ab 2001)",2009,3,59000,0,59000
"Amerikanische Überseeinseln, kleinere (ab 2001)",2009,4,3000,0,3000
"Amerikanische Überseeinseln, kleinere (ab 2001)",2009,5,65000,0,65000
"Amerikanische Überseeinseln, kleinere (ab 2001)",2009,6,2000,0,2000
"Amerikanische Überseeinseln, kleinere (ab 2001)",2009,7,1000,0,1000
"Amerikanische Überseeinseln, kleinere (ab 2001)",2009,8,23000,0,23000
"Amerikanische Überseeinseln, kleinere (ab 2001)",2009,9,15000,0,15000
"Amerikanische Überseeinseln, kleinere (ab 2001)",2009,10,14000,0,14000
"Amerikanische Überseeinseln, kleinere (ab 2001)",2009,11,0,0,0
"Amerikanische Überseeinseln, kleinere (ab 2001)",2009,12,0,0,0
"Amerikanische Überseeinseln, kleinere (ab 2001)",2010,1,13000,0,13000
"Amerikanische Überseeinseln, kleinere (ab 2001)",2010,2,27000,0,27000
"Amerikanische Überseeinseln, kleinere (ab 2001)",2010,3,0,0,0
"Amerikanische Überseeinseln, kleinere (ab 2001)",2010,4,0,0,0
"Amerikanische Überseeinseln, kleinere (ab 2001)",2010,5,169000,0,169000
"Amerikanische Überseeinseln, kleinere (ab 2001)",2010,6,0,0,0
"Amerikanische Überseeinseln, kleinere (ab 2001)",2010,7,4000,0,4000
"Amerikanische Überseeinseln, kleinere (ab 2001)",2010,8,31000,0,31000
"Amerikanische Überseeinseln, kleinere (ab 2001)",2010,9,27000,0,27000
"Amerikanische Überseeinseln, kleinere (ab 2001)",2010,10,3000,0,3000
"Amerikanische Überseeinseln, kleinere (ab 2001)",2010,11,217000,0,217000
"Amerikanische Überseeinseln, kleinere (ab 2001)",2010,12,25000,0,25000
"Amerikanische Überseeinseln, kleinere (ab 2001)",2011,1,503000,0,503000
"Amerikanische Überseeinseln, kleinere (ab 2001)",2011,2,0,0,0
"Amerikanische Überseeinseln, kleinere (ab 2001)",2011,3,77000,0,77000
"Amerikanische Überseeinseln, kleinere (ab 2001)",2011,4,26000,0,26000
"Amerikanische Überseeinseln, kleinere (ab 2001)",2011,5,143000,0,143000
"Amerikanische Überseeinseln, kleinere (ab 2001)",2011,6,0,0,0
"Amerikanische Überseeinseln, kleinere (ab 2001)",2011,7,40000,0,40000
"Amerikanische Überseeinseln, kleinere (ab 2001)",2011,8,138000,0,138000
"Amerikanische Überseeinseln, kleinere (ab 2001)",2011,9,276000,0,276000
"Amerikanische Überseeinseln, kleinere (ab 2001)",2011,10,0,4000,4000
"Amerikanische Überseeinseln, kleinere (ab 2001)",2011,11,123000,7000,130000
"Amerikanische Überseeinseln, kleinere (ab 2001)",2011,12,134000,0,134000
"Amerikanische Überseeinseln, kleinere (ab 2001)",2012,1,163000,0,163000
"Amerikanische Überseeinseln, kleinere (ab 2001)",2012,2,29421000,0,29421000
"Amerikanische Überseeinseln, kleinere (ab 2001)",2012,3,0,0,0
"Amerikanische Überseeinseln, kleinere (ab 2001)",2012,4,0,0,0
"Amerikanische Überseeinseln, kleinere (ab 2001)",2012,5,131000,0,131000
"Amerikanische Überseeinseln, kleinere (ab 2001)",2012,6,5579000,0,5579000
"Amerikanische Überseeinseln, kleinere (ab 2001)",2012,7,12331000,0,12331000
"Amerikanische Überseeinseln, kleinere (ab 2001)",2012,8,10000,13000,23000
"Amerikanische Überseeinseln, kleinere (ab 2001)",2012,9,189000,0,189000
"Amerikanische Überseeinseln, kleinere (ab 2001)",2012,10,45000,0,45000
"Amerikanische Überseeinseln, kleinere (ab 2001)",2012,11,216000,0,216000
"Amerikanische Überseeinseln, kleinere (ab 2001)",2012,12,38000,0,38000
"Amerikanische Überseeinseln, kleinere (ab 2001)",2013,1,162000,0,162000
"Amerikanische Überseeinseln, kleinere (ab 2001)",2013,2,3000,0,3000
"Amerikanische Überseeinseln, kleinere (ab 2001)",2013,3,129000,0,129000
"Amerikanische Überseeinseln, kleinere (ab 2001)",2013,4,114000,0,114000
"Amerikanische Überseeinseln, kleinere (ab 2001)",2013,5,4000,0,4000
"Amerikanische Überseeinseln, kleinere (ab 2001)",2013,6,31000,0,31000
"Amerikanische Überseeinseln, kleinere (ab 2001)",2013,7,235000,0,235000
"Amerikanische Überseeinseln, kleinere (ab 2001)",2013,8,173000,0,173000
"Amerikanische Überseeinseln, kleinere (ab 2001)",2013,9,234000,0,234000
"Amerikanische Überseeinseln, kleinere (ab 2001)",2013,10,139000,0,139000
"Amerikanische Überseeinseln, kleinere (ab 2001)",2013,11,71000,0,71000
"Amerikanische Überseeinseln, kleinere (ab 2001)",2013,12,142000,0,142000
"Amerikanische Überseeinseln, kleinere (ab 2001)",2014,1,129000,0,129000
"Amerikanische Überseeinseln, kleinere (ab 2001)",2014,2,2000,0,2000
"Amerikanische Überseeinseln, kleinere (ab 2001)",2014,3,2000,0,2000
"Amerikanische Überseeinseln, kleinere (ab 2001)",2014,4,146000,0,146000
"Amerikanische Überseeinseln, kleinere (ab 2001)",2014,5,134000,0,134000
"Amerikanische Überseeinseln, kleinere (ab 2001)",2014,6,4000,0,4000
"Amerikanische Überseeinseln, kleinere (ab 2001)",2014,7,214000,0,214000
"Amerikanische Überseeinseln, kleinere (ab 2001)",2014,8,26000,0,26000
"Amerikanische Überseeinseln, kleinere (ab 2001)",2014,9,145000,1000,146000
"Amerikanische Überseeinseln, kleinere (ab 2001)",2014,10,168000,0,168000
"Amerikanische Überseeinseln, kleinere (ab 2001)",2014,11,141000,0,141000
"Amerikanische Überseeinseln, kleinere (ab 2001)",2014,12,139000,0,139000
"Amerikanische Überseeinseln, kleinere (ab 2001)",2015,1,48000,0,48000
"Amerikanische Überseeinseln, kleinere (ab 2001)",2015,2,2000,0,2000
"Amerikanische Überseeinseln, kleinere (ab 2001)",2015,3,198000,0,198000
"Amerikanische Überseeinseln, kleinere (ab 2001)",2015,4,193000,0,193000
"Amerikanische Überseeinseln, kleinere (ab 2001)",2015,5,157000,0,157000
"Amerikanische Überseeinseln, kleinere (ab 2001)",2015,6,84000,0,84000
"Amerikanische Überseeinseln, kleinere (ab 2001)",2015,7,292000,0,292000
"Amerikanische Überseeinseln, kleinere (ab 2001)",2015,8,43000,0,43000
"Amerikanische Überseeinseln, kleinere (ab 2001)",2015,9,161000,0,161000
"Amerikanische Überseeinseln, kleinere (ab 2001)",2015,10,141000,0,141000
"Amerikanische Überseeinseln, kleinere (ab 2001)",2015,11,151000,0,151000
"Amerikanische Überseeinseln, kleinere (ab 2001)",2015,12,17000,0,17000
"Amerikanische Überseeinseln, kleinere (ab 2001)",2016,1,77000,0,77000
"Amerikanische Überseeinseln, kleinere (ab 2001)",2016,2,0,0,0
"Amerikanische Überseeinseln, kleinere (ab 2001)",2016,3,13000,4000,17000
"Amerikanische Überseeinseln, kleinere (ab 2001)",2016,4,21000,0,21000
"Amerikanische Überseeinseln, kleinere (ab 2001)",2016,5,8000,0,8000
"Amerikanische Überseeinseln, kleinere (ab 2001)",2016,6,0,0,0
"Amerikanische Überseeinseln, kleinere (ab 2001)",2016,7,0,0,0
"Amerikanische Überseeinseln, kleinere (ab 2001)",2016,8,43000,0,43000
"Amerikanische Überseeinseln, kleinere (ab 2001)",2016,9,31000,0,31000
"Amerikanische Überseeinseln, kleinere (ab 2001)",2016,10,46000,0,46000
"Amerikanische Überseeinseln, kleinere (ab 2001)",2016,11,0,0,0
"Amerikanische Überseeinseln, kleinere (ab 2001)",2016,12,0,7000,7000
"Amerikanische Überseeinseln, kleinere (ab 2001)",2017,1,32000,0,32000
"Amerikanische Überseeinseln, kleinere (ab 2001)",2017,2,13000,0,13000
"Amerikanische Überseeinseln, kleinere (ab 2001)",2017,3,3000,0,3000
"Amerikanische Überseeinseln, kleinere (ab 2001)",2017,4,51000,0,51000
"Amerikanische Überseeinseln, kleinere (ab 2001)",2017,5,0,0,0
"Amerikanische Überseeinseln, kleinere (ab 2001)",2017,6,0,0,0
"Amerikanische Überseeinseln, kleinere (ab 2001)",2017,7,0,0,0
"Amerikanische Überseeinseln, kleinere (ab 2001)",2017,8,68000,0,68000
"Amerikanische Überseeinseln, kleinere (ab 2001)",2017,9,2000,0,2000
"Amerikanische Überseeinseln, kleinere (ab 2001)",2017,10,0,0,0
"Amerikanische Überseeinseln, kleinere (ab 2001)",2017,11,1000,0,1000
"Amerikanische Überseeinseln, kleinere (ab 2001)",2017,12,0,0,0
"Amerikanische Überseeinseln, kleinere (ab 2001)",2018,1,2000,0,2000
"Amerikanische Überseeinseln, kleinere (ab 2001)",2018,2,0,0,0
"Amerikanische Überseeinseln, kleinere (ab 2001)",2018,3,46000,0,46000
"Amerikanische Überseeinseln, kleinere (ab 2001)",2018,4,2000,0,2000
"Amerikanische Überseeinseln, kleinere (ab 2001)",2018,5,0,9000,9000
"Amerikanische Überseeinseln, kleinere (ab 2001)",2018,6,0,0,0
"Amerikanische Überseeinseln, kleinere (ab 2001)",2018,7,8000,0,8000
"Amerikanische Überseeinseln, kleinere (ab 2001)",2018,8,2000,17000,19000
"Amerikanische Überseeinseln, kleinere (ab 2001)",2018,9,56000,0,56000
"Amerikanische Überseeinseln, kleinere (ab 2001)",2018,10,0,3000,3000
"Amerikanische Überseeinseln, kleinere (ab 2001)",2018,11,10000,2000,12000
"Amerikanische Überseeinseln, kleinere (ab 2001)",2018,12,0,2000,2000
"Amerikanische Überseeinseln, kleinere (ab 2001)",2019,1,4000,0,4000
"Amerikanische Überseeinseln, kleinere (ab 2001)",2019,2,7000,0,7000
"Amerikanische Überseeinseln, kleinere (ab 2001)",2019,3,1000,0,1000
"Amerikanische Überseeinseln, kleinere (ab 2001)",2019,4,2000,0,2000
"Amerikanische Überseeinseln, kleinere (ab 2001)",2019,5,14000,1000,15000
"Amerikanische Überseeinseln, kleinere (ab 2001)",2019,6,5000,0,5000
"Amerikanische Überseeinseln, kleinere (ab 2001)",2019,7,19000,0,19000
"Amerikanische Überseeinseln, kleinere (ab 2001)",2019,8,10000,8000,18000
"Amerikanische Überseeinseln, kleinere (ab 2001)",2019,9,1000,25000,26000
"Amerikanische Überseeinseln, kleinere (ab 2001)",2019,10,2000,0,2000
"Amerikanische Überseeinseln, kleinere (ab 2001)",2019,11,5000,0,5000
"Amerikanische Überseeinseln, kleinere (ab 2001)",2019,12,1000,0,1000
"Amerikanische Überseeinseln, kleinere (ab 2001)",2020,1,5000,0,5000
"Amerikanische Überseeinseln, kleinere (ab 2001)",2020,2,57000,25000,82000
"Amerikanische Überseeinseln, kleinere (ab 2001)",2020,3,143000,45000,188000
"Amerikanische Überseeinseln, kleinere (ab 2001)",2020,4,223000,26000,249000
"Amerikanische Überseeinseln, kleinere (ab 2001)",2020,5,177000,0,177000
"Amerikanische Überseeinseln, kleinere (ab 2001)",2020,6,255000,1000,256000
"Amerikanische Überseeinseln, kleinere (ab 2001)",2020,7,10000,12000,22000
"Amerikanische Überseeinseln, kleinere (ab 2001)",2020,8,10000,0,10000
"Amerikanische Überseeinseln, kleinere (ab 2001)",2020,9,64000,0,64000
"Amerikanische Überseeinseln, kleinere (ab 2001)",2020,10,12000,30000,42000
"Amerikanische Überseeinseln, kleinere (ab 2001)",2020,11,9000,7000,16000
"Amerikanische Überseeinseln, kleinere (ab 2001)",2020,12,35000,52000,87000
"Amerikanische Überseeinseln, kleinere (ab 2001)",2021,1,4000,192000,196000
"Amerikanische Überseeinseln, kleinere (ab 2001)",2021,2,6000,8000,14000
"Amerikanische Überseeinseln, kleinere (ab 2001)",2021,3,0,0,0
"Amerikanische Überseeinseln, kleinere (ab 2001)",2021,4,49000,0,49000
"Amerikanische Überseeinseln, kleinere (ab 2001)",2021,5,39000,0,39000
"Amerikanische Überseeinseln, kleinere (ab 2001)",2021,6,0,79000,79000
"Amerikanische Überseeinseln, kleinere (ab 2001)",2021,7,27000,8000,35000
"Amerikanische Überseeinseln, kleinere (ab 2001)",2021,8,3000,20000,23000
"Amerikanische Überseeinseln, kleinere (ab 2001)",2021,9,64000,0,64000
"Amerikanische Überseeinseln, kleinere (ab 2001)",2021,10,17000,3000,20000
"Amerikanische Überseeinseln, kleinere (ab 2001)",2021,11,94000,10000,104000
"Amerikanische Überseeinseln, kleinere (ab 2001)",2021,12,9000,2000,11000
"Amerikanische Überseeinseln, kleinere (ab 2001)",2022,1,2000,10000,12000
"Amerikanische Überseeinseln, kleinere (ab 2001)",2022,2,58000,22000,80000
"Amerikanische Überseeinseln, kleinere (ab 2001)",2022,3,34000,7000,41000
"Amerikanische Überseeinseln, kleinere (ab 2001)",2022,4,0,8000,8000
"Amerikanische Überseeinseln, kleinere (ab 2001)",2022,5,15000,0,15000
"Amerikanische Überseeinseln, kleinere (ab 2001)",2022,6,27000,0,27000
"Amerikanische Überseeinseln, kleinere (ab 2001)",2022,7,64000,0,64000
"Amerikanische Überseeinseln, kleinere (ab 2001)",2022,8,26000,0,26000
"Amerikanische Überseeinseln, kleinere (ab 2001)",2022,9,206000,0,206000
"Amerikanische Überseeinseln, kleinere (ab 2001)",2022,10,18000,0,18000
"Amerikanische Überseeinseln, kleinere (ab 2001)",2022,11,7000,0,7000
"Amerikanische Überseeinseln, kleinere (ab 2001)",2022,12,1000,0,1000
"Amerikanische Überseeinseln, kleinere (ab 2001)",2023,1,46000,0,46000
"Amerikanische Überseeinseln, kleinere (ab 2001)",2023,2,4000,0,4000
"Amerikanische Überseeinseln, kleinere (ab 2001)",2023,3,27000,0,27000
"Amerikanische Überseeinseln, kleinere (ab 2001)",2023,4,32000,0,32000
"Amerikanische Überseeinseln, kleinere (ab 2001)",2023,5,112000,0,112000
"Amerikanische Überseeinseln, kleinere (ab 2001)",2023,6,7000,0,7000
"Amerikanische Überseeinseln, kleinere (ab 2001)",2023,7,13000,0,13000
"Amerikanische Überseeinseln, kleinere (ab 2001)",2023,8,13000,228000,241000
"Amerikanische Überseeinseln, kleinere (ab 2001)",2023,9,1000,226000,227000
"Amerikanische Überseeinseln, kleinere (ab 2001)",2023,10,1000,59000,60000
"Amerikanische Überseeinseln, kleinere (ab 2001)",2023,11,9000,165000,174000
"Amerikanische Überseeinseln, kleinere (ab 2001)",2023,12,0,0,0
"Amerikanische Überseeinseln, kleinere (ab 2001)",2024,1,11000,147000,158000
"Amerikanische Überseeinseln, kleinere (ab 2001)",2024,2,7000,0,7000
"Amerikanische Überseeinseln, kleinere (ab 2001)",2024,3,29000,26000,55000
"Amerikanische Überseeinseln, kleinere (ab 2001)",2024,4,1000,0,1000
"Amerikanische Überseeinseln, kleinere (ab 2001)",2024,5,22000,0,22000
"Amerikanische Überseeinseln, kleinere (ab 2001)",2024,6,26000,68000,94000
"Amerikanische Überseeinseln, kleinere (ab 2001)",2024,7,6000,251000,257000
"Amerikanische Überseeinseln, kleinere (ab 2001)",2024,8,5000,23000,28000
"Amerikanische Überseeinseln, kleinere (ab 2001)",2024,9,22000,81000,103000
"Amerikanische Überseeinseln, kleinere (ab 2001)",2024,10,17000,260000,277000
"Amerikanische Überseeinseln, kleinere (ab 2001)",2024,11,9000,0,9000
"Amerikanische Überseeinseln, kleinere (ab 2001)",2024,12,0,0,0
Andorra,2008,1,2403000,894000,3297000
Andorra,2008,2,2613000,795000,3408000
Andorra,2008,3,2256000,9000,2265000
Andorra,2008,4,2989000,14000,3003000
Andorra,2008,5,2895000,11000,2906000
Andorra,2008,6,3750000,17000,3767000
Andorra,2008,7,3471000,12000,3483000
Andorra,2008,8,2955000,2000,2957000
Andorra,2008,9,2617000,4000,2621000
Andorra,2008,10,2915000,21000,2936000
Andorra,2008,11,2083000,18000,2101000
Andorra,2008,12,3609000,55000,3664000
Andorra,2009,1,2252000,65000,2317000
Andorra,2009,2,2511000,29000,2540000
Andorra,2009,3,1768000,21000,1789000
Andorra,2009,4,1221000,41000,1262000
Andorra,2009,5,1295000,30000,1325000
Andorra,2009,6,4354000,26000,4380000
Andorra,2009,7,3427000,56000,3483000
Andorra,2009,8,1849000,20000,1869000
Andorra,2009,9,2624000,26000,2650000
Andorra,2009,10,3375000,31000,3406000
Andorra,2009,11,2502000,24000,2526000
Andorra,2009,12,1809000,44000,1853000
Andorra,2010,1,1986000,24000,2010000
Andorra,2010,2,3418000,242000,3660000
Andorra,2010,3,2960000,12000,2972000
Andorra,2010,4,3080000,23000,3103000
Andorra,2010,5,3971000,23000,3994000
Andorra,2010,6,2658000,63000,2721000
Andorra,2010,7,2976000,30000,3006000
Andorra,2010,8,2068000,5000,2073000
Andorra,2010,9,5743000,10000,5753000
Andorra,2010,10,2695000,33000,2728000
Andorra,2010,11,3092000,4000,3096000
Andorra,2010,12,1921000,10000,1931000
Andorra,2011,1,3420000,165000,3585000
Andorra,2011,2,4607000,34000,4641000
Andorra,2011,3,2518000,113000,2631000
Andorra,2011,4,1584000,5000,1589000
Andorra,2011,5,4196000,115000,4311000
Andorra,2011,6,1858000,64000,1922000
Andorra,2011,7,2094000,110000,2204000
Andorra,2011,8,2715000,206000,2921000
Andorra,2011,9,3267000,144000,3411000
Andorra,2011,10,2399000,8000,2407000
Andorra,2011,11,2856000,36000,2892000
Andorra,2011,12,2070000,8000,2078000
Andorra,2012,1,4652000,33000,4685000
Andorra,2012,2,2634000,16000,2650000
Andorra,2012,3,2234000,30000,2264000
Andorra,2012,4,1587000,12000,1599000
Andorra,2012,5,1462000,8000,1470000
Andorra,2012,6,2794000,28000,2822000
Andorra,2012,7,3740000,35000,3775000
Andorra,2012,8,1761000,90000,1851000
Andorra,2012,9,2797000,9000,2806000
Andorra,2012,10,2597000,73000,2670000
Andorra,2012,11,2411000,30000,2441000
Andorra,2012,12,1219000,78000,1297000
Andorra,2013,1,2158000,27000,2185000
Andorra,2013,2,2350000,19000,2369000
Andorra,2013,3,3274000,15000,3289000
Andorra,2013,4,3251000,17000,3268000
Andorra,2013,5,1753000,46000,1799000
Andorra,2013,6,4808000,6000,4814000
Andorra,2013,7,1866000,106000,1972000
Andorra,2013,8,3404000,68000,3472000
Andorra,2013,9,3023000,102000,3125000
Andorra,2013,10,2435000,490000,2925000
Andorra,2013,11,1565000,597000,2162000
Andorra,2013,12,1746000,50000,1796000
Andorra,2014,1,2589000,0,2589000
Andorra,2014,2,2314000,2000,2316000
Andorra,2014,3,2068000,48000,2116000
Andorra,2014,4,2393000,41000,2434000
Andorra,2014,5,2251000,29000,2280000
Andorra,2014,6,4083000,8000,4091000
Andorra,2014,7,4004000,85000,4089000
Andorra,2014,8,3058000,33000,3091000
Andorra,2014,9,5986000,73000,6059000
Andorra,2014,10,5013000,57000,5070000
Andorra,2014,11,3029000,0,3029000
Andorra,2014,12,2224000,53000,2277000
Andorra,2015,1,2618000,10000,2628000
Andorra,2015,2,2155000,13000,2168000
Andorra,2015,3,2354000,284000,2638000
Andorra,2015,4,2940000,177000,3117000
Andorra,2015,5,2476000,189000,2665000
Andorra,2015,6,2645000,43000,2688000
Andorra,2015,7,3434000,111000,3545000
Andorra,2015,8,3379000,44000,3423000
Andorra,2015,9,3395000,89000,3484000
Andorra,2015,10,3061000,128000,3189000
Andorra,2015,11,3008000,221000,3229000
Andorra,2015,12,1692000,118000,1810000
Andorra,2016,1,3172000,17000,3189000
Andorra,2016,2,2664000,3000,2667000
Andorra,2016,3,3429000,796000,4225000
Andorra,2016,4,3145000,32000,3177000
Andorra,2016,5,2389000,101000,2490000
Andorra,2016,6,3362000,8000,3370000
Andorra,2016,7,3490000,757000,4247000
Andorra,2016,8,2629000,271000,2900000
Andorra,2016,9,3326000,83000,3409000
Andorra,2016,10,3124000,2000,3126000
Andorra,2016,11,3060000,10000,3070000
Andorra,2016,12,6826000,48000,6874000
Andorra,2017,1,5043000,135000,5178000
Andorra,2017,2,2618000,43000,2661000
Andorra,2017,3,3224000,111000,3335000
Andorra,2017,4,2508000,50000,2558000
Andorra,2017,5,3280000,130000,3410000
Andorra,2017,6,4227000,604000,4831000
Andorra,2017,7,3099000,352000,3451000
Andorra,2017,8,2731000,245000,2976000
Andorra,2017,9,3239000,372000,3611000
Andorra,2017,10,3193000,16000,3209000
Andorra,2017,11,3424000,58000,3482000
Andorra,2017,12,2566000,424000,2990000
Andorra,2018,1,4783000,220000,5003000
Andorra,2018,2,3648000,457000,4105000
Andorra,2018,3,2863000,162000,3025000
Andorra,2018,4,3835000,759000,4594000
Andorra,2018,5,2225000,267000,2492000
Andorra,2018,6,3351000,975000,4326000
Andorra,2018,7,2992000,51000,3043000
Andorra,2018,8,3571000,88000,3659000
Andorra,2018,9,4146000,1438000,5584000
Andorra,2018,10,3949000,1577000,5526000
Andorra,2018,11,5011000,4150000,9161000
Andorra,2018,12,2714000,2116000,4830000
Andorra,2019,1,4076000,322000,4398000
Andorra,2019,2,3374000,55000,3429000
Andorra,2019,3,5386000,358000,5744000
Andorra,2019,4,3655000,63000,3718000
Andorra,2019,5,3673000,22000,3695000
Andorra,2019,6,2613000,24000,2637000
Andorra,2019,7,3444000,196000,3640000
Andorra,2019,8,3815000,51000,3866000
Andorra,2019,9,3936000,58000,3994000
Andorra,2019,10,3709000,103000,3812000
Andorra,2019,11,3605000,263000,3868000
Andorra,2019,12,2579000,378000,2957000
Andorra,2020,1,3010000,551000,3561000
Andorra,2020,2,4022000,498000,4520000
Andorra,2020,3,2845000,586000,3431000
Andorra,2020,4,816000,109000,925000
Andorra,2020,5,1832000,637000,2469000
Andorra,2020,6,3853000,121000,3974000
Andorra,2020,7,4086000,1493000,5579000
Andorra,2020,8,3359000,178000,3537000
Andorra,2020,9,3486000,171000,3657000
Andorra,2020,10,3443000,234000,3677000
Andorra,2020,11,3040000,205000,3245000
Andorra,2020,12,2277000,467000,2744000
Andorra,2021,1,2329000,161000,2490000
Andorra,2021,2,5211000,117000,5328000
Andorra,2021,3,2860000,177000,3037000
Andorra,2021,4,6343000,247000,6590000
Andorra,2021,5,6293000,165000,6458000
Andorra,2021,6,4635000,165000,4800000
Andorra,2021,7,7853000,256000,8109000
Andorra,2021,8,3648000,136000,3784000
Andorra,2021,9,5028000,212000,5240000
Andorra,2021,10,8887000,169000,9056000
Andorra,2021,11,4873000,70000,4943000
Andorra,2021,12,4396000,430000,4826000
Andorra,2022,1,6714000,394000,7108000
Andorra,2022,2,4394000,210000,4604000
Andorra,2022,3,5355000,2715000,8070000
Andorra,2022,4,4813000,240000,5053000
Andorra,2022,5,6785000,795000,7580000
Andorra,2022,6,4521000,208000,4729000
Andorra,2022,7,3801000,160000,3961000
Andorra,2022,8,4031000,274000,4305000
Andorra,2022,9,4867000,150000,5017000
Andorra,2022,10,5043000,374000,5417000
Andorra,2022,11,7569000,507000,8076000
Andorra,2022,12,3692000,190000,3882000
Andorra,2023,1,5485000,658000,6143000
Andorra,2023,2,6076000,258000,6334000
Andorra,2023,3,5511000,253000,5764000
Andorra,2023,4,4871000,193000,5064000
Andorra,2023,5,4810000,180000,4990000
Andorra,2023,6,5657000,244000,5901000
Andorra,2023,7,5096000,2070000,7166000
Andorra,2023,8,4195000,124000,4319000
Andorra,2023,9,5565000,106000,5671000
Andorra,2023,10,4664000,512000,5176000
Andorra,2023,11,5713000,386000,6099000
Andorra,2023,12,4714000,344000,5058000
Andorra,2024,1,6021000,210000,6231000
Andorra,2024,2,6231000,524000,6755000
Andorra,2024,3,5339000,162000,5501000
Andorra,2024,4,6672000,1030000,7702000
Andorra,2024,5,7272000,374000,7646000
Andorra,2024,6,4899000,38000,4937000
Andorra,2024,7,6197000,237000,6434000
Andorra,2024,8,5251000,109000,5360000
Andorra,2024,9,8882000,24000,8906000
Andorra,2024,10,5460000,70000,5530000
Andorra,2024,11,8452000,229000,8681000
Andorra,2024,12,5517000,721000,6238000
Angola,2008,1,20361000,58823000,79184000
Angola,2008,2,22670000,55934000,78604000
Angola,2008,3,34754000,50827000,85581000
Angola,2008,4,24678000,94775000,119453000
Angola,2008,5,30007000,9732000,39739000
Angola,2008,6,21891000,13063000,34954000
Angola,2008,7,26069000,90159000,116228000
Angola,2008,8,66403000,5289000,71692000
Angola,2008,9,26054000,958000,27012000
Angola,2008,10,37279000,36414000,73693000
Angola,2008,11,27801000,29416000,57217000
Angola,2008,12,46063000,23197000,69260000
Angola,2009,1,25862000,60351000,86213000
Angola,2009,2,34991000,21517000,56508000
Angola,2009,3,32270000,13287000,45557000
Angola,2009,4,17117000,19243000,36360000
Angola,2009,5,20304000,50312000,70616000
Angola,2009,6,17497000,33567000,51064000
Angola,2009,7,25785000,23916000,49701000
Angola,2009,8,29335000,5590000,34925000
Angola,2009,9,27366000,11162000,38528000
Angola,2009,10,24128000,11199000,35327000
Angola,2009,11,27440000,277000,27717000
Angola,2009,12,15468000,1649000,17117000
Angola,2010,1,14983000,48779000,63762000
Angola,2010,2,15883000,26008000,41891000
Angola,2010,3,18589000,23704000,42293000
Angola,2010,4,12336000,6409000,18745000
Angola,2010,5,20923000,321000,21244000
Angola,2010,6,14361000,907000,15268000
Angola,2010,7,21588000,229000,21817000
Angola,2010,8,24789000,18980000,43769000
Angola,2010,9,26339000,10513000,36852000
Angola,2010,10,43897000,26393000,70290000
Angola,2010,11,14944000,32841000,47785000
Angola,2010,12,32383000,32452000,64835000
Angola,2011,1,21733000,17942000,39675000
Angola,2011,2,19155000,114471000,133626000
Angola,2011,3,17674000,29114000,46788000
Angola,2011,4,21044000,56759000,77803000
Angola,2011,5,21441000,64022000,85463000
Angola,2011,6,19977000,128372000,148349000
Angola,2011,7,12691000,83917000,96608000
Angola,2011,8,15854000,83055000,98909000
Angola,2011,9,17203000,105304000,122507000
Angola,2011,10,21542000,151428000,172970000
Angola,2011,11,33689000,16782000,50471000
Angola,2011,12,29547000,5957000,35504000
Angola,2012,1,14273000,3222000,17495000
Angola,2012,2,30203000,100000,30303000
Angola,2012,3,55260000,49000,55309000
Angola,2012,4,29984000,458000,30442000
Angola,2012,5,23611000,328000,23939000
Angola,2012,6,28645000,29197000,57842000
Angola,2012,7,30353000,131000,30484000
Angola,2012,8,29942000,37463000,67405000
Angola,2012,9,25525000,261000,25786000
Angola,2012,10,53977000,60395000,114372000
Angola,2012,11,46577000,42820000,89397000
Angola,2012,12,31199000,90924000,122123000
Angola,2013,1,19158000,30305000,49463000
Angola,2013,2,18297000,16000,18313000
Angola,2013,3,16454000,13940000,30394000
Angola,2013,4,15715000,83927000,99642000
Angola,2013,5,20789000,82301000,103090000
Angola,2013,6,25875000,56941000,82816000
Angola,2013,7,30122000,53910000,84032000
Angola,2013,8,30860000,93000,30953000
Angola,2013,9,24883000,198000,25081000
Angola,2013,10,27849000,55020000,82869000
Angola,2013,11,28016000,31967000,59983000
Angola,2013,12,25644000,60843000,86487000
Angola,2014,1,27658000,758000,28416000
Angola,2014,2,21932000,360000,22292000
Angola,2014,3,19471000,18534000,38005000
Angola,2014,4,29372000,61852000,91224000
Angola,2014,5,23106000,10203000,33309000
Angola,2014,6,34399000,37704000,72103000
Angola,2014,7,42072000,151000,42223000
Angola,2014,8,60168000,298000,60466000
Angola,2014,9,33915000,13000,33928000
Angola,2014,10,30207000,91000,30298000
Angola,2014,11,26604000,10000,26614000
Angola,2014,12,23688000,115000,23803000
Angola,2015,1,41129000,2873000,44002000
Angola,2015,2,27192000,7307000,34499000
Angola,2015,3,24989000,3743000,28732000
Angola,2015,4,24912000,9584000,34496000
Angola,2015,5,20109000,37347000,57456000
Angola,2015,6,23975000,1997000,25972000
Angola,2015,7,20659000,7405000,28064000
Angola,2015,8,28918000,107000,29025000
Angola,2015,9,36259000,73000,36332000
Angola,2015,10,28487000,765000,29252000
Angola,2015,11,18339000,541000,18880000
Angola,2015,12,38209000,4320000,42529000
Angola,2016,1,10434000,5211000,15645000
Angola,2016,2,29165000,218000,29383000
Angola,2016,3,19552000,3335000,22887000
Angola,2016,4,16557000,13295000,29852000
Angola,2016,5,19720000,518000,20238000
Angola,2016,6,14163000,5053000,19216000
Angola,2016,7,13272000,7346000,20618000
Angola,2016,8,17784000,3892000,21676000
Angola,2016,9,25025000,19074000,44099000
Angola,2016,10,40844000,52034000,92878000
Angola,2016,11,25360000,31333000,56693000
Angola,2016,12,24988000,5665000,30653000
Angola,2017,1,10063000,1061000,11124000
Angola,2017,2,18649000,375000,19024000
Angola,2017,3,14934000,236000,15170000
Angola,2017,4,20502000,2775000,23277000
Angola,2017,5,20593000,22802000,43395000
Angola,2017,6,22920000,319000,23239000
Angola,2017,7,30809000,557000,31366000
Angola,2017,8,15285000,15782000,31067000
Angola,2017,9,47590000,118000,47708000
Angola,2017,10,31378000,42000,31420000
Angola,2017,11,12993000,268000,13261000
Angola,2017,12,10443000,176000,10619000
Angola,2018,1,8051000,161000,8212000
Angola,2018,2,8457000,95000,8552000
Angola,2018,3,8729000,231000,8960000
Angola,2018,4,14899000,70000,14969000
Angola,2018,5,10999000,635000,11634000
Angola,2018,6,14924000,1682000,16606000
Angola,2018,7,13003000,86000,13089000
Angola,2018,8,14360000,40502000,54862000
Angola,2018,9,7103000,2355000,9458000
Angola,2018,10,13560000,135000,13695000
Angola,2018,11,13107000,61000,13168000
Angola,2018,12,7607000,348000,7955000
Angola,2019,1,11305000,124000,11429000
Angola,2019,2,15802000,86000,15888000
Angola,2019,3,10515000,35000,10550000
Angola,2019,4,9630000,101000,9731000
Angola,2019,5,10284000,159000,10443000
Angola,2019,6,10261000,31000,10292000
Angola,2019,7,10759000,27000,10786000
Angola,2019,8,10721000,487000,11208000
Angola,2019,9,10114000,26000,10140000
Angola,2019,10,11151000,19000,11170000
Angola,2019,11,8210000,442000,8652000
Angola,2019,12,9019000,333000,9352000
Angola,2020,1,7299000,117000,7416000
Angola,2020,2,12849000,143000,12992000
Angola,2020,3,10670000,103000,10773000
Angola,2020,4,12974000,11000,12985000
Angola,2020,5,6598000,53000,6651000
Angola,2020,6,8929000,207000,9136000
Angola,2020,7,9903000,58000,9961000
Angola,2020,8,18473000,68000,18541000
Angola,2020,9,8127000,62000,8189000
Angola,2020,10,8730000,23000,8753000
Angola,2020,11,8873000,39000,8912000
Angola,2020,12,7400000,617000,8017000
Angola,2021,1,5749000,207000,5956000
Angola,2021,2,9406000,272000,9678000
Angola,2021,3,11236000,98000,11334000
Angola,2021,4,8575000,187000,8762000
Angola,2021,5,9185000,210000,9395000
Angola,2021,6,16950000,110000,17060000
Angola,2021,7,12076000,97000,12173000
Angola,2021,8,9325000,212000,9537000
Angola,2021,9,18334000,1141000,19475000
Angola,2021,10,9109000,155000,9264000
Angola,2021,11,27822000,50000,27872000
Angola,2021,12,10964000,112000,11076000
Angola,2022,1,13379000,181000,13560000
Angola,2022,2,15873000,83000,15956000
Angola,2022,3,21785000,171000,21956000
Angola,2022,4,11042000,83000,11125000
Angola,2022,5,13528000,144000,13672000
Angola,2022,6,21551000,53000,21604000
Angola,2022,7,18471000,162000,18633000
Angola,2022,8,21321000,57696000,79017000
Angola,2022,9,23066000,53025000,76091000
Angola,2022,10,35424000,57000,35481000
Angola,2022,11,16242000,40000,16282000
Angola,2022,12,26405000,286000,26691000
Angola,2023,1,16628000,94260000,110888000
Angola,2023,2,20532000,42402000,62934000
Angola,2023,3,24471000,49000,24520000
Angola,2023,4,42700000,4558000,47258000
Angola,2023,5,33445000,76595000,110040000
Angola,2023,6,22684000,567000,23251000
Angola,2023,7,16107000,59000,16166000
Angola,2023,8,18817000,39000,18856000
Angola,2023,9,18202000,16224000,34426000
Angola,2023,10,18604000,36129000,54733000
Angola,2023,11,22877000,201000,23078000
Angola,2023,12,26966000,85760000,112726000
Angola,2024,1,15977000,125128000,141105000
Angola,2024,2,13806000,14255000,28061000
Angola,2024,3,12977000,1127000,14104000
Angola,2024,4,23648000,566000,24214000
Angola,2024,5,21941000,406000,22347000
Angola,2024,6,34202000,612000,34814000
Angola,2024,7,28522000,981000,29503000
Angola,2024,8,21036000,160000,21196000
Angola,2024,9,28023000,175000,28198000
Angola,2024,10,27447000,155000,27602000
Angola,2024,11,24385000,48630000,73015000
Angola,2024,12,23124000,125000,23249000
Anguilla,2008,1,383000,1136000,1519000
Anguilla,2008,2,114000,22000,136000
Anguilla,2008,3,165000,38000,203000
Anguilla,2008,4,418000,10000,428000
Anguilla,2008,5,105000,4000,109000
Anguilla,2008,6,136000,4000,140000
Anguilla,2008,7,272000,7000,279000
Anguilla,2008,8,81000,30000,111000
Anguilla,2008,9,1102000,135000,1237000
Anguilla,2008,10,58000,0,58000
Anguilla,2008,11,216000,0,216000
Anguilla,2008,12,381000,2000,383000
Anguilla,2009,1,43000,599000,642000
Anguilla,2009,2,68000,135000,203000
Anguilla,2009,3,80000,237000,317000
Anguilla,2009,4,175000,182000,357000
Anguilla,2009,5,247000,330000,577000
Anguilla,2009,6,50000,236000,286000
Anguilla,2009,7,163000,73000,236000
Anguilla,2009,8,18000,8000,26000
Anguilla,2009,9,17000,136000,153000
Anguilla,2009,10,3000,53000,56000
Anguilla,2009,11,208000,57000,265000
Anguilla,2009,12,9000,89000,98000
Anguilla,2010,1,0,189000,189000
Anguilla,2010,2,70000,636000,706000
Anguilla,2010,3,5000,76000,81000
Anguilla,2010,4,0,65000,65000
Anguilla,2010,5,6000,36000,42000
Anguilla,2010,6,261000,17000,278000
Anguilla,2010,7,271000,16000,287000
Anguilla,2010,8,6000,1000,7000
Anguilla,2010,9,465000,11000,476000
Anguilla,2010,10,457000,22000,479000
Anguilla,2010,11,4000,44000,48000
Anguilla,2010,12,9000,5000,14000
Anguilla,2011,1,0,21000,21000
Anguilla,2011,2,12000,30000,42000
Anguilla,2011,3,0,289000,289000
Anguilla,2011,4,4000,109000,113000
Anguilla,2011,5,4000,35000,39000
Anguilla,2011,6,5000,50000,55000
Anguilla,2011,7,4000,223000,227000
Anguilla,2011,8,6000,48000,54000
Anguilla,2011,9,0,47000,47000
Anguilla,2011,10,8000,29000,37000
Anguilla,2011,11,0,40000,40000
Anguilla,2011,12,8000,27000,35000
Anguilla,2012,1,382000,65000,447000
Anguilla,2012,2,28000,48000,76000
Anguilla,2012,3,7000,28000,35000
Anguilla,2012,4,0,29000,29000
Anguilla,2012,5,44000,6000,50000
Anguilla,2012,6,29000,0,29000
Anguilla,2012,7,90000,1000,91000
Anguilla,2012,8,0,0,0
Anguilla,2012,9,26000,8000,34000
Anguilla,2012,10,27000,7000,34000
Anguilla,2012,11,0,29000,29000
Anguilla,2012,12,5000,7000,12000
Anguilla,2013,1,2000,5000,7000
Anguilla,2013,2,0,2000,2000
Anguilla,2013,3,1000,0,1000
Anguilla,2013,4,4000,1000,5000
Anguilla,2013,5,24000,9000,33000
Anguilla,2013,6,3505000,1000,3506000
Anguilla,2013,7,2172000,5000,2177000
Anguilla,2013,8,2000,0,2000
Anguilla,2013,9,35000,19000,54000
Anguilla,2013,10,2000,0,2000
Anguilla,2013,11,24000,2000,26000
Anguilla,2013,12,0,0,0
Anguilla,2014,1,2000,2000,4000
Anguilla,2014,2,2000,0,2000
Anguilla,2014,3,0,0,0
Anguilla,2014,4,0,0,0
Anguilla,2014,5,1000,2000,3000
Anguilla,2014,6,8000,0,8000
Anguilla,2014,7,2000,1000,3000
Anguilla,2014,8,4000,1000,5000
Anguilla,2014,9,0,1000,1000
Anguilla,2014,10,2000,3000,5000
Anguilla,2014,11,0,2000,2000
Anguilla,2014,12,0,1000,1000
Anguilla,2015,1,2000,2000,4000
Anguilla,2015,2,0,1000,1000
Anguilla,2015,3,57000,1000,58000
Anguilla,2015,4,0,0,0
Anguilla,2015,5,2000,3000,5000
Anguilla,2015,6,0,0,0
Anguilla,2015,7,743000,0,743000
Anguilla,2015,8,553000,0,553000
Anguilla,2015,9,551000,0,551000
Anguilla,2015,10,601000,0,601000
Anguilla,2015,11,819000,4000,823000
Anguilla,2015,12,340000,1000,341000
Anguilla,2016,1,352000,0,352000
Anguilla,2016,2,574000,0,574000
Anguilla,2016,3,159000,2000,161000
Anguilla,2016,4,1000,2000,3000
Anguilla,2016,5,39000,5000,44000
Anguilla,2016,6,39000,0,39000
Anguilla,2016,7,11000,1000,12000
Anguilla,2016,8,8000,2000,10000
Anguilla,2016,9,7000,0,7000
Anguilla,2016,10,49000,0,49000
Anguilla,2016,11,17000,1000,18000
Anguilla,2016,12,21000,0,21000
Anguilla,2017,1,1000,0,1000
Anguilla,2017,2,25000,1000,26000
Anguilla,2017,3,78000,0,78000
Anguilla,2017,4,185000,7000,192000
Anguilla,2017,5,6000,1000,7000
Anguilla,2017,6,3000,2000,5000
Anguilla,2017,7,0,1000,1000
Anguilla,2017,8,0,1000,1000
Anguilla,2017,9,14000,2000,16000
Anguilla,2017,10,0,0,0
Anguilla,2017,11,0,0,0
Anguilla,2017,12,0,1000,1000
Anguilla,2018,1,0,1000,1000
Anguilla,2018,2,74000,0,74000
Anguilla,2018,3,3000,1000,4000
Anguilla,2018,4,71000,53000,124000
Anguilla,2018,5,430000,0,430000
Anguilla,2018,6,6000,0,6000
Anguilla,2018,7,93000,2000,95000
Anguilla,2018,8,29000,0,29000
Anguilla,2018,9,26000,0,26000
Anguilla,2018,10,275000,1000,276000
Anguilla,2018,11,33000,0,33000
Anguilla,2018,12,27000,0,27000
Anguilla,2019,1,10000,40000,50000
Anguilla,2019,2,2000,0,2000
Anguilla,2019,3,0,3000,3000
Anguilla,2019,4,14000,0,14000
Anguilla,2019,5,8000,2000,10000
Anguilla,2019,6,21000,0,21000
Anguilla,2019,7,6000,0,6000
Anguilla,2019,8,0,0,0
Anguilla,2019,9,2000,0,2000
Anguilla,2019,10,155000,0,155000
Anguilla,2019,11,0,0,0
Anguilla,2019,12,195000,0,195000
Anguilla,2020,1,278000,0,278000
Anguilla,2020,2,61000,0,61000
Anguilla,2020,3,32000,0,32000
Anguilla,2020,4,0,0,0
Anguilla,2020,5,46000,0,46000
Anguilla,2020,6,291000,32000,323000
Anguilla,2020,7,337000,2000,339000
Anguilla,2020,8,40000,1000,41000
Anguilla,2020,9,13000,0,13000
Anguilla,2020,10,4000,0,4000
Anguilla,2020,11,115000,0,115000
Anguilla,2020,12,5000,0,5000
Anguilla,2021,1,113000,0,113000
Anguilla,2021,2,6000,1000,7000
Anguilla,2021,3,48000,0,48000
Anguilla,2021,4,6000,0,6000
Anguilla,2021,5,7000,0,7000
Anguilla,2021,6,18000,0,18000
Anguilla,2021,7,0,3000,3000
Anguilla,2021,8,90000,1000,91000
Anguilla,2021,9,0,0,0
Anguilla,2021,10,0,0,0
Anguilla,2021,11,6000,2000,8000
Anguilla,2021,12,6000,2000,8000
Anguilla,2022,1,1000,1000,2000
Anguilla,2022,2,0,23000,23000
Anguilla,2022,3,75000,9000,84000
Anguilla,2022,4,4000,3000,7000
Anguilla,2022,5,139000,10000,149000
Anguilla,2022,6,2000,3000,5000
Anguilla,2022,7,1000,4000,5000
Anguilla,2022,8,221000,14000,235000
Anguilla,2022,9,1000,9000,10000
Anguilla,2022,10,1000,18000,19000
Anguilla,2022,11,11000,11000,22000
Anguilla,2022,12,4000,128000,132000
Anguilla,2023,1,1000,62000,63000
Anguilla,2023,2,0,4000,4000
Anguilla,2023,3,0,4000,4000
Anguilla,2023,4,0,3000,3000
Anguilla,2023,5,1000,7000,8000
Anguilla,2023,6,0,14000,14000
Anguilla,2023,7,0,3000,3000
Anguilla,2023,8,0,1000,1000
Anguilla,2023,9,0,1000,1000
Anguilla,2023,10,0,1000,1000
Anguilla,2023,11,4000,2000,6000
Anguilla,2023,12,3000,1000,4000
Anguilla,2024,1,1000,2000,3000
Anguilla,2024,2,7000,18000,25000
Anguilla,2024,3,4000,73000,77000
Anguilla,2024,4,0,10000,10000
Anguilla,2024,5,8000,1000,9000
Anguilla,2024,6,4000,2000,6000
Anguilla,2024,7,0,5000,5000
Anguilla,2024,8,3000,0,3000
Anguilla,2024,9,0,2000,2000
Anguilla,2024,10,0,0,0
Anguilla,2024,11,50000,2000,52000
Anguilla,2024,12,0,7000,7000
Antarktis (ab 2001),2008,1,26000,0,26000
Antarktis (ab 2001),2008,2,7000,0,7000
Antarktis (ab 2001),2008,3,1019000,7000,1026000
Antarktis (ab 2001),2008,4,0,0,0
Antarktis (ab 2001),2008,5,2000,11000,13000
Antarktis (ab 2001),2008,6,63000,8000,71000
Antarktis (ab 2001),2008,7,99000,1000,100000
Antarktis (ab 2001),2008,8,0,9000,9000
Antarktis (ab 2001),2008,9,9000,6000,15000
Antarktis (ab 2001),2008,10,343000,88000,431000
Antarktis (ab 2001),2008,11,9000,0,9000
Antarktis (ab 2001),2008,12,1294000,0,1294000
Antarktis (ab 2001),2009,1,58000,33000,91000
Antarktis (ab 2001),2009,2,29546000,100000,29646000
Antarktis (ab 2001),2009,3,424000,30000,454000
Antarktis (ab 2001),2009,4,333000,1054000,1387000
Antarktis (ab 2001),2009,5,5917000,27000,5944000
Antarktis (ab 2001),2009,6,26298000,764000,27062000
Antarktis (ab 2001),2009,7,3000,0,3000
Antarktis (ab 2001),2009,8,5000,0,5000
Antarktis (ab 2001),2009,9,2595000,0,2595000
Antarktis (ab 2001),2009,10,221000,0,221000
Antarktis (ab 2001),2009,11,344000,171000,515000
Antarktis (ab 2001),2009,12,12000,0,12000
Antarktis (ab 2001),2010,1,38000,72000,110000
Antarktis (ab 2001),2010,2,0,0,0
Antarktis (ab 2001),2010,3,0,218000,218000
Antarktis (ab 2001),2010,4,0,826000,826000
Antarktis (ab 2001),2010,5,7729000,204000,7933000
Antarktis (ab 2001),2010,6,2000,48000,50000
Antarktis (ab 2001),2010,7,7000,0,7000
Antarktis (ab 2001),2010,8,3000,14000,17000
Antarktis (ab 2001),2010,9,1080000,131000,1211000
Antarktis (ab 2001),2010,10,1665000,0,1665000
Antarktis (ab 2001),2010,11,143000,0,143000
Antarktis (ab 2001),2010,12,815000,220000,1035000
Antarktis (ab 2001),2011,1,0,17000,17000
Antarktis (ab 2001),2011,2,0,1412000,1412000
Antarktis (ab 2001),2011,3,4031000,24000,4055000
Antarktis (ab 2001),2011,4,716000,10000,726000
Antarktis (ab 2001),2011,5,4889000,138000,5027000
Antarktis (ab 2001),2011,6,510000,491000,1001000
Antarktis (ab 2001),2011,7,874000,0,874000
Antarktis (ab 2001),2011,8,42000,582000,624000
Antarktis (ab 2001),2011,9,11212000,1568000,12780000
Antarktis (ab 2001),2011,10,427000,1599000,2026000
Antarktis (ab 2001),2011,11,987000,0,987000
Antarktis (ab 2001),2011,12,187000,177000,364000
Antarktis (ab 2001),2012,1,20000,0,20000
Antarktis (ab 2001),2012,2,0,0,0
Antarktis (ab 2001),2012,3,0,171000,171000
Antarktis (ab 2001),2012,4,0,709000,709000
Antarktis (ab 2001),2012,5,106000,0,106000
Antarktis (ab 2001),2012,6,11000,0,11000
Antarktis (ab 2001),2012,7,4000,0,4000
Antarktis (ab 2001),2012,8,35000,0,35000
Antarktis (ab 2001),2012,9,80000,330000,410000
Antarktis (ab 2001),2012,10,123000,0,123000
Antarktis (ab 2001),2012,11,21000,3651000,3672000
Antarktis (ab 2001),2012,12,28000,574000,602000
Antarktis (ab 2001),2013,1,211000,0,211000
Antarktis (ab 2001),2013,2,0,103000,103000
Antarktis (ab 2001),2013,3,9000,28000,37000
Antarktis (ab 2001),2013,4,2000,156000,158000
Antarktis (ab 2001),2013,5,0,0,0
Antarktis (ab 2001),2013,6,7000,0,7000
Antarktis (ab 2001),2013,7,0,0,0
Antarktis (ab 2001),2013,8,2000,191000,193000
Antarktis (ab 2001),2013,9,337000,0,337000
Antarktis (ab 2001),2013,10,194000,0,194000
Antarktis (ab 2001),2013,11,22000,9000,31000
Antarktis (ab 2001),2013,12,7000,0,7000
Antarktis (ab 2001),2014,1,0,1000,1000
Antarktis (ab 2001),2014,2,1000,0,1000
Antarktis (ab 2001),2014,3,228000,1000,229000
Antarktis (ab 2001),2014,4,3000,4000,7000
Antarktis (ab 2001),2014,5,0,2000,2000
Antarktis (ab 2001),2014,6,0,0,0
Antarktis (ab 2001),2014,7,0,0,0
Antarktis (ab 2001),2014,8,2000,69000,71000
Antarktis (ab 2001),2014,9,25000,2000,27000
Antarktis (ab 2001),2014,10,235000,0,235000
Antarktis (ab 2001),2014,11,22000,0,22000
Antarktis (ab 2001),2014,12,32000,0,32000
Antarktis (ab 2001),2015,1,0,0,0
Antarktis (ab 2001),2015,2,0,0,0
Antarktis (ab 2001),2015,3,1000,21000,22000
Antarktis (ab 2001),2015,4,0,107000,107000
Antarktis (ab 2001),2015,5,0,4000,4000
Antarktis (ab 2001),2015,6,9000,0,9000
Antarktis (ab 2001),2015,7,0,0,0
Antarktis (ab 2001),2015,8,47000,0,47000
Antarktis (ab 2001),2015,9,153000,0,153000
Antarktis (ab 2001),2015,10,1474000,1000,1475000
Antarktis (ab 2001),2015,11,74000,0,74000
Antarktis (ab 2001),2015,12,7000,9000,16000
Antarktis (ab 2001),2016,1,5000,0,5000
Antarktis (ab 2001),2016,2,0,0,0
Antarktis (ab 2001),2016,3,0,3000,3000
Antarktis (ab 2001),2016,4,0,214000,214000
Antarktis (ab 2001),2016,5,0,501000,501000
Antarktis (ab 2001),2016,6,0,16000,16000
Antarktis (ab 2001),2016,7,24000,14000,38000
Antarktis (ab 2001),2016,8,20000,0,20000
Antarktis (ab 2001),2016,9,88000,0,88000
Antarktis (ab 2001),2016,10,34000,0,34000
Antarktis (ab 2001),2016,11,37000,0,37000
Antarktis (ab 2001),2016,12,0,0,0
Antarktis (ab 2001),2017,1,0,0,0
Antarktis (ab 2001),2017,2,0,0,0
Antarktis (ab 2001),2017,3,158000,3000,161000
Antarktis (ab 2001),2017,4,0,0,0
Antarktis (ab 2001),2017,5,6000,6000,12000
Antarktis (ab 2001),2017,6,2684000,10000,2694000
Antarktis (ab 2001),2017,7,0,0,0
Antarktis (ab 2001),2017,8,4000,0,4000
Antarktis (ab 2001),2017,9,2296000,0,2296000
Antarktis (ab 2001),2017,10,1716000,298000,2014000
Antarktis (ab 2001),2017,11,69000,0,69000
Antarktis (ab 2001),2017,12,0,0,0
Antarktis (ab 2001),2018,1,0,0,0
Antarktis (ab 2001),2018,2,3000,0,3000
Antarktis (ab 2001),2018,3,2000,0,2000
Antarktis (ab 2001),2018,4,0,0,0
Antarktis (ab 2001),2018,5,0,1000,1000
Antarktis (ab 2001),2018,6,6000,36000,42000
Antarktis (ab 2001),2018,7,0,101000,101000
Antarktis (ab 2001),2018,8,1000,1000,2000
Antarktis (ab 2001),2018,9,20000,62000,82000
Antarktis (ab 2001),2018,10,26000,0,26000
Antarktis (ab 2001),2018,11,0,3000,3000
Antarktis (ab 2001),2018,12,23000,0,23000
Antarktis (ab 2001),2019,1,18000,107000,125000
Antarktis (ab 2001),2019,2,0,0,0
Antarktis (ab 2001),2019,3,0,17000,17000
Antarktis (ab 2001),2019,4,0,0,0
Antarktis (ab 2001),2019,5,1005000,0,1005000
Antarktis (ab 2001),2019,6,0,0,0
Antarktis (ab 2001),2019,7,601000,197000,798000
Antarktis (ab 2001),2019,8,813000,0,813000
Antarktis (ab 2001),2019,9,22000,118000,140000
Antarktis (ab 2001),2019,10,3715000,0,3715000
Antarktis (ab 2001),2019,11,47000,0,47000
Antarktis (ab 2001),2019,12,2000,9000,11000
Antarktis (ab 2001),2020,1,37000,0,37000
Antarktis (ab 2001),2020,2,0,0,0
Antarktis (ab 2001),2020,3,1000,1000,2000
Antarktis (ab 2001),2020,4,0,0,0
Antarktis (ab 2001),2020,5,0,6000,6000
Antarktis (ab 2001),2020,6,0,862000,862000
Antarktis (ab 2001),2020,7,0,13000,13000
Antarktis (ab 2001),2020,8,2616000,1000,2617000
Antarktis (ab 2001),2020,9,8102000,3000,8105000
Antarktis (ab 2001),2020,10,1219000,1000,1220000
Antarktis (ab 2001),2020,11,0,120000,120000
Antarktis (ab 2001),2020,12,187000,1000,188000
Antarktis (ab 2001),2021,1,0,0,0
Antarktis (ab 2001),2021,2,0,0,0
Antarktis (ab 2001),2021,3,0,4000,4000
Antarktis (ab 2001),2021,4,0,22000,22000
Antarktis (ab 2001),2021,5,0,20000,20000
Antarktis (ab 2001),2021,6,0,0,0
Antarktis (ab 2001),2021,7,0,311000,311000
Antarktis (ab 2001),2021,8,64000,2000,66000
Antarktis (ab 2001),2021,9,378000,0,378000
Antarktis (ab 2001),2021,10,376000,13000,389000
Antarktis (ab 2001),2021,11,1519000,9000,1528000
Antarktis (ab 2001),2021,12,4000,7000,11000
Antarktis (ab 2001),2022,1,150000,23000,173000
Antarktis (ab 2001),2022,2,64000,346000,410000
Antarktis (ab 2001),2022,3,0,52000,52000
Antarktis (ab 2001),2022,4,0,0,0
Antarktis (ab 2001),2022,5,0,20000,20000
Antarktis (ab 2001),2022,6,1000,270000,271000
Antarktis (ab 2001),2022,7,1000,2000,3000
Antarktis (ab 2001),2022,8,331000,11000,342000
Antarktis (ab 2001),2022,9,88000,0,88000
Antarktis (ab 2001),2022,10,190000,1000,191000
Antarktis (ab 2001),2022,11,7000,45000,52000
Antarktis (ab 2001),2022,12,3000,0,3000
Antarktis (ab 2001),2023,1,0,1000,1000
Antarktis (ab 2001),2023,2,3000,3000,6000
Antarktis (ab 2001),2023,3,0,29000,29000
Antarktis (ab 2001),2023,4,0,3000,3000
Antarktis (ab 2001),2023,5,0,31000,31000
Antarktis (ab 2001),2023,6,0,290000,290000
Antarktis (ab 2001),2023,7,0,12000,12000
Antarktis (ab 2001),2023,8,0,0,0
Antarktis (ab 2001),2023,9,12000,0,12000
Antarktis (ab 2001),2023,10,20000,1000,21000
Antarktis (ab 2001),2023,11,237000,0,237000
Antarktis (ab 2001),2023,12,0,0,0
Antarktis (ab 2001),2024,1,0,0,0
Antarktis (ab 2001),2024,2,16000,1000,17000
Antarktis (ab 2001),2024,3,0,52000,52000
Antarktis (ab 2001),2024,4,0,0,0
Antarktis (ab 2001),2024,5,0,33000,33000
Antarktis (ab 2001),2024,6,0,41000,41000
Antarktis (ab 2001),2024,7,230000,0,230000
Antarktis (ab 2001),2024,8,0,0,0
Antarktis (ab 2001),2024,9,8000,0,8000
Antarktis (ab 2001),2024,10,266000,0,266000
Antarktis (ab 2001),2024,11,164000,20000,184000
Antarktis (ab 2001),2024,12,0,0,0
Antigua und Barbuda,2008,1,460000,1000,461000
Antigua und Barbuda,2008,2,922000,15026000,15948000
Antigua und Barbuda,2008,3,221000,1000,222000
Antigua und Barbuda,2008,4,21799000,9000,21808000
Antigua und Barbuda,2008,5,14661000,10000,14671000
Antigua und Barbuda,2008,6,283000,0,283000
Antigua und Barbuda,2008,7,5884000,103000,5987000
Antigua und Barbuda,2008,8,20147000,4000,20151000
Antigua und Barbuda,2008,9,2165000,0,2165000
Antigua und Barbuda,2008,10,512000,10078000,10590000
Antigua und Barbuda,2008,11,20304000,751000,21055000
Antigua und Barbuda,2008,12,78000,9428000,9506000
Antigua und Barbuda,2009,1,334000,148000,482000
Antigua und Barbuda,2009,2,555000,31000,586000
Antigua und Barbuda,2009,3,487000,15000,502000
Antigua und Barbuda,2009,4,21869000,30000,21899000
Antigua und Barbuda,2009,5,303000,8000,311000
Antigua und Barbuda,2009,6,195000,4000,199000
Antigua und Barbuda,2009,7,382000,6000,388000
Antigua und Barbuda,2009,8,49000,61000,110000
Antigua und Barbuda,2009,9,139000,460000,599000
Antigua und Barbuda,2009,10,7532000,7000,7539000
Antigua und Barbuda,2009,11,255000,44000,299000
Antigua und Barbuda,2009,12,181000,17000,198000
Antigua und Barbuda,2010,1,5652000,4000,5656000
Antigua und Barbuda,2010,2,343000,5000,348000
Antigua und Barbuda,2010,3,24417000,10013000,34430000
Antigua und Barbuda,2010,4,10189000,5550000,15739000
Antigua und Barbuda,2010,5,326000,0,326000
Antigua und Barbuda,2010,6,422000,14000,436000
Antigua und Barbuda,2010,7,367000,1000,368000
Antigua und Barbuda,2010,8,472000,6000,478000
Antigua und Barbuda,2010,9,651000,2000,653000
Antigua und Barbuda,2010,10,1211000,32000,1243000
Antigua und Barbuda,2010,11,541000,7000,548000
Antigua und Barbuda,2010,12,552000,90000,642000
Antigua und Barbuda,2011,1,254000,6000,260000
Antigua und Barbuda,2011,2,343000,5000,348000
Antigua und Barbuda,2011,3,593000,25000,618000
Antigua und Barbuda,2011,4,288000,34000,322000
Antigua und Barbuda,2011,5,4411000,3774000,8185000
Antigua und Barbuda,2011,6,268000,3000,271000
Antigua und Barbuda,2011,7,4722000,36000,4758000
Antigua und Barbuda,2011,8,190000,724000,914000
Antigua und Barbuda,2011,9,614000,499000,1113000
Antigua und Barbuda,2011,10,289000,60000,349000
Antigua und Barbuda,2011,11,95000,4000,99000
Antigua und Barbuda,2011,12,210000,0,210000
Antigua und Barbuda,2012,1,235000,0,235000
Antigua und Barbuda,2012,2,154000,27000,181000
Antigua und Barbuda,2012,3,110000,26000,136000
Antigua und Barbuda,2012,4,45000,10000,55000
Antigua und Barbuda,2012,5,1592000,0,1592000
Antigua und Barbuda,2012,6,2760000,3000,2763000
Antigua und Barbuda,2012,7,290000,17000,307000
Antigua und Barbuda,2012,8,116000,21000,137000
Antigua und Barbuda,2012,9,96000,13000,109000
Antigua und Barbuda,2012,10,255000,8000,263000
Antigua und Barbuda,2012,11,845000,7000,852000
Antigua und Barbuda,2012,12,761000,39000,800000
Antigua und Barbuda,2013,1,520000,4000,524000
Antigua und Barbuda,2013,2,14214000,53000,14267000
Antigua und Barbuda,2013,3,968000,21000,989000
Antigua und Barbuda,2013,4,497000,323000,820000
Antigua und Barbuda,2013,5,387000,19000,406000
Antigua und Barbuda,2013,6,817000,7000,824000
Antigua und Barbuda,2013,7,601000,139000,740000
Antigua und Barbuda,2013,8,779000,10000,789000
Antigua und Barbuda,2013,9,382000,14000,396000
Antigua und Barbuda,2013,10,559000,14000,573000
Antigua und Barbuda,2013,11,1053000,5000,1058000
Antigua und Barbuda,2013,12,608000,8000,616000
Antigua und Barbuda,2014,1,707000,9000,716000
Antigua und Barbuda,2014,2,631000,26000,657000
Antigua und Barbuda,2014,3,464000,31000,495000
Antigua und Barbuda,2014,4,846000,19000,865000
Antigua und Barbuda,2014,5,1767000,0,1767000
Antigua und Barbuda,2014,6,420000,5000,425000
Antigua und Barbuda,2014,7,752000,2000,754000
Antigua und Barbuda,2014,8,1272000,8000,1280000
Antigua und Barbuda,2014,9,570000,23000,593000
Antigua und Barbuda,2014,10,792000,12000,804000
Antigua und Barbuda,2014,11,619000,3000,622000
Antigua und Barbuda,2014,12,977000,1000,978000
Antigua und Barbuda,2015,1,574000,7000,581000
Antigua und Barbuda,2015,2,827000,2000,829000
Antigua und Barbuda,2015,3,1850000,43000,1893000
Antigua und Barbuda,2015,4,285000,7000,292000
Antigua und Barbuda,2015,5,725000,1000,726000
Antigua und Barbuda,2015,6,502000,33000,535000
Antigua und Barbuda,2015,7,2522000,5000,2527000
Antigua und Barbuda,2015,8,550000,5000,555000
Antigua und Barbuda,2015,9,1819000,3000,1822000
Antigua und Barbuda,2015,10,763000,13000,776000
Antigua und Barbuda,2015,11,862000,2000,864000
Antigua und Barbuda,2015,12,4344000,10000,4354000
Antigua und Barbuda,2016,1,449000,3000,452000
Antigua und Barbuda,2016,2,4030000,15807000,19837000
Antigua und Barbuda,2016,3,737000,22000,759000
Antigua und Barbuda,2016,4,890000,12000,902000
Antigua und Barbuda,2016,5,1220000,9000,1229000
Antigua und Barbuda,2016,6,1286000,11000,1297000
Antigua und Barbuda,2016,7,1130000,10000,1140000
Antigua und Barbuda,2016,8,791000,24000,815000
Antigua und Barbuda,2016,9,863000,20000,883000
Antigua und Barbuda,2016,10,918000,154000,1072000
Antigua und Barbuda,2016,11,686000,5000,691000
Antigua und Barbuda,2016,12,584000,107000,691000
Antigua und Barbuda,2017,1,820000,97000,917000
Antigua und Barbuda,2017,2,632000,13000,645000
Antigua und Barbuda,2017,3,504000,168000,672000
Antigua und Barbuda,2017,4,5148000,32000,5180000
Antigua und Barbuda,2017,5,440000,23000,463000
Antigua und Barbuda,2017,6,510000,63000,573000
Antigua und Barbuda,2017,7,1515000,6000,1521000
Antigua und Barbuda,2017,8,777000,719000,1496000
Antigua und Barbuda,2017,9,713000,33000,746000
Antigua und Barbuda,2017,10,831000,12000,843000
Antigua und Barbuda,2017,11,930000,8000,938000
Antigua und Barbuda,2017,12,758000,4000,762000
Antigua und Barbuda,2018,1,346000,18000,364000
Antigua und Barbuda,2018,2,381000,30000,411000
Antigua und Barbuda,2018,3,5760000,82000,5842000
Antigua und Barbuda,2018,4,655000,18000,673000
Antigua und Barbuda,2018,5,576000,62000,638000
Antigua und Barbuda,2018,6,439000,9000,448000
Antigua und Barbuda,2018,7,697000,31000,728000
Antigua und Barbuda,2018,8,4544000,866000,5410000
Antigua und Barbuda,2018,9,194000,24000,218000
Antigua und Barbuda,2018,10,349000,24000,373000
Antigua und Barbuda,2018,11,646000,12000,658000
Antigua und Barbuda,2018,12,308000,9838000,10146000
Antigua und Barbuda,2019,1,1894000,20000,1914000
Antigua und Barbuda,2019,2,985000,24000,1009000
Antigua und Barbuda,2019,3,291000,30000,321000
Antigua und Barbuda,2019,4,96000,51000,147000
Antigua und Barbuda,2019,5,949000,114000,1063000
Antigua und Barbuda,2019,6,345000,7337000,7682000
Antigua und Barbuda,2019,7,770000,60000,830000
Antigua und Barbuda,2019,8,446000,78000,524000
Antigua und Barbuda,2019,9,588000,30000,618000
Antigua und Barbuda,2019,10,369000,105000,474000
Antigua und Barbuda,2019,11,279000,13000,292000
Antigua und Barbuda,2019,12,781000,15000,796000
Antigua und Barbuda,2020,1,779000,23000,802000
Antigua und Barbuda,2020,2,152000,16000,168000
Antigua und Barbuda,2020,3,115000,30000,145000
Antigua und Barbuda,2020,4,4827000,20000,4847000
Antigua und Barbuda,2020,5,97000,9000,106000
Antigua und Barbuda,2020,6,492000,27000,519000
Antigua und Barbuda,2020,7,250000,11000,261000
Antigua und Barbuda,2020,8,109000,37000,146000
Antigua und Barbuda,2020,9,1534000,57000,1591000
Antigua und Barbuda,2020,10,312000,77000,389000
Antigua und Barbuda,2020,11,245000,51000,296000
Antigua und Barbuda,2020,12,455000,70000,525000
Antigua und Barbuda,2021,1,605000,17000,622000
Antigua und Barbuda,2021,2,1856000,55000,1911000
Antigua und Barbuda,2021,3,318000,29000,347000
Antigua und Barbuda,2021,4,413000,62000,475000
Antigua und Barbuda,2021,5,2522000,20000,2542000
Antigua und Barbuda,2021,6,5819000,44000,5863000
Antigua und Barbuda,2021,7,3076000,1708000,4784000
Antigua und Barbuda,2021,8,3141000,9000,3150000
Antigua und Barbuda,2021,9,537000,28000,565000
Antigua und Barbuda,2021,10,261000,30000,291000
Antigua und Barbuda,2021,11,4319000,36000,4355000
Antigua und Barbuda,2021,12,370000,35000,405000
Antigua und Barbuda,2022,1,392000,11000,403000
Antigua und Barbuda,2022,2,716000,6813000,7529000
Antigua und Barbuda,2022,3,14251000,97000,14348000
Antigua und Barbuda,2022,4,1126000,34000,1160000
Antigua und Barbuda,2022,5,741000,132000,873000
Antigua und Barbuda,2022,6,815000,13016000,13831000
Antigua und Barbuda,2022,7,731000,13000,744000
Antigua und Barbuda,2022,8,238000,86000,324000
Antigua und Barbuda,2022,9,448000,69000,517000
Antigua und Barbuda,2022,10,623000,6000,629000
Antigua und Barbuda,2022,11,6315000,50000,6365000
Antigua und Barbuda,2022,12,241000,6275000,6516000
Antigua und Barbuda,2023,1,153000,13000,166000
Antigua und Barbuda,2023,2,134000,32000,166000
Antigua und Barbuda,2023,3,215000,29000,244000
Antigua und Barbuda,2023,4,11740000,76000,11816000
Antigua und Barbuda,2023,5,275000,55000,330000
Antigua und Barbuda,2023,6,301000,32000,333000
Antigua und Barbuda,2023,7,8193000,49000,8242000
Antigua und Barbuda,2023,8,322000,50000,372000
Antigua und Barbuda,2023,9,136000,20000,156000
Antigua und Barbuda,2023,10,6509000,10000,6519000
Antigua und Barbuda,2023,11,356000,57000,413000
Antigua und Barbuda,2023,12,950000,20000,970000
Antigua und Barbuda,2024,1,5452000,65000,5517000
Antigua und Barbuda,2024,2,470000,127000,597000
Antigua und Barbuda,2024,3,423000,191000,614000
Antigua und Barbuda,2024,4,379000,153000,532000
Antigua und Barbuda,2024,5,3990000,126000,4116000
Antigua und Barbuda,2024,6,2513000,139000,2652000
Antigua und Barbuda,2024,7,380000,388000,768000
Antigua und Barbuda,2024,8,471000,350000,821000
Antigua und Barbuda,2024,9,4130000,24190000,28320000
Antigua und Barbuda,2024,10,1210000,2420000,3630000
Antigua und Barbuda,2024,11,279000,187000,466000
Antigua und Barbuda,2024,12,298000,296000,594000
Arabische Republik Syrien,2008,1,55548000,71360000,126908000
Arabische Republik Syrien,2008,2,44642000,14486000,59128000
Arabische Republik Syrien,2008,3,52984000,98142000,151126000
Arabische Republik Syrien,2008,4,53260000,140659000,193919000
Arabische Republik Syrien,2008,5,46303000,134503000,180806000
Arabische Republik Syrien,2008,6,48943000,127920000,176863000
Arabische Republik Syrien,2008,7,66395000,125649000,192044000
Arabische Republik Syrien,2008,8,54352000,103475000,157827000
Arabische Republik Syrien,2008,9,84905000,128677000,213582000
Arabische Republik Syrien,2008,10,54015000,109993000,164008000
Arabische Republik Syrien,2008,11,52138000,116693000,168831000
Arabische Republik Syrien,2008,12,67888000,67350000,135238000
Arabische Republik Syrien,2009,1,46944000,44050000,90994000
Arabische Republik Syrien,2009,2,50602000,19629000,70231000
Arabische Republik Syrien,2009,3,56678000,12715000,69393000
Arabische Republik Syrien,2009,4,48770000,31798000,80568000
Arabische Republik Syrien,2009,5,40023000,83642000,123665000
Arabische Republik Syrien,2009,6,60448000,59689000,120137000
Arabische Republik Syrien,2009,7,61993000,100284000,162277000
Arabische Republik Syrien,2009,8,51013000,93834000,144847000
Arabische Republik Syrien,2009,9,48512000,90200000,138712000
Arabische Republik Syrien,2009,10,55204000,51443000,106647000
Arabische Republik Syrien,2009,11,56549000,101554000,158103000
Arabische Republik Syrien,2009,12,76449000,124920000,201369000
Arabische Republik Syrien,2010,1,40131000,51058000,91189000
Arabische Republik Syrien,2010,2,53812000,15657000,69469000
Arabische Republik Syrien,2010,3,57925000,15999000,73924000
Arabische Republik Syrien,2010,4,48242000,44163000,92405000
Arabische Republik Syrien,2010,5,49068000,128208000,177276000
Arabische Republik Syrien,2010,6,63204000,137274000,200478000
Arabische Republik Syrien,2010,7,52733000,152685000,205418000
Arabische Republik Syrien,2010,8,49595000,113040000,162635000
Arabische Republik Syrien,2010,9,62913000,109631000,172544000
Arabische Republik Syrien,2010,10,58625000,140592000,199217000
Arabische Republik Syrien,2010,11,57604000,175597000,233201000
Arabische Republik Syrien,2010,12,65904000,78401000,144305000
Arabische Republik Syrien,2011,1,47662000,50901000,98563000
Arabische Republik Syrien,2011,2,58334000,97002000,155336000
Arabische Republik Syrien,2011,3,82423000,46935000,129358000
Arabische Republik Syrien,2011,4,54994000,94177000,149171000
Arabische Republik Syrien,2011,5,36279000,25532000,61811000
Arabische Republik Syrien,2011,6,32147000,189226000,221373000
Arabische Republik Syrien,2011,7,42617000,144144000,186761000
Arabische Republik Syrien,2011,8,41872000,188379000,230251000
Arabische Republik Syrien,2011,9,37329000,138700000,176029000
Arabische Republik Syrien,2011,10,35241000,9586000,44827000
Arabische Republik Syrien,2011,11,33098000,7894000,40992000
Arabische Republik Syrien,2011,12,44945000,8591000,53536000
Arabische Republik Syrien,2012,1,24577000,6983000,31560000
Arabische Republik Syrien,2012,2,24384000,7673000,32057000
Arabische Republik Syrien,2012,3,27257000,6849000,34106000
Arabische Republik Syrien,2012,4,18704000,8487000,27191000
Arabische Republik Syrien,2012,5,30919000,13458000,44377000
Arabische Republik Syrien,2012,6,25704000,7772000,33476000
Arabische Republik Syrien,2012,7,16094000,6947000,23041000
Arabische Republik Syrien,2012,8,7607000,6032000,13639000
Arabische Republik Syrien,2012,9,4772000,4845000,9617000
Arabische Republik Syrien,2012,10,7750000,5666000,13416000
Arabische Republik Syrien,2012,11,10599000,2936000,13535000
Arabische Republik Syrien,2012,12,6630000,2138000,8768000
Arabische Republik Syrien,2013,1,4374000,2927000,7301000
Arabische Republik Syrien,2013,2,6692000,2013000,8705000
Arabische Republik Syrien,2013,3,5192000,1608000,6800000
Arabische Republik Syrien,2013,4,6678000,1731000,8409000
Arabische Republik Syrien,2013,5,3209000,1516000,4725000
Arabische Republik Syrien,2013,6,13857000,934000,14791000
Arabische Republik Syrien,2013,7,3063000,1374000,4437000
Arabische Republik Syrien,2013,8,3983000,874000,4857000
Arabische Republik Syrien,2013,9,4754000,1137000,5891000
Arabische Republik Syrien,2013,10,8180000,964000,9144000
Arabische Republik Syrien,2013,11,7491000,695000,8186000
Arabische Republik Syrien,2013,12,5335000,738000,6073000
Arabische Republik Syrien,2014,1,4789000,591000,5380000
Arabische Republik Syrien,2014,2,4560000,850000,5410000
Arabische Republik Syrien,2014,3,5532000,793000,6325000
Arabische Republik Syrien,2014,4,6032000,739000,6771000
Arabische Republik Syrien,2014,5,4342000,739000,5081000
Arabische Republik Syrien,2014,6,3580000,832000,4412000
Arabische Republik Syrien,2014,7,5808000,551000,6359000
Arabische Republik Syrien,2014,8,5412000,462000,5874000
Arabische Republik Syrien,2014,9,5360000,847000,6207000
Arabische Republik Syrien,2014,10,8632000,1371000,10003000
Arabische Republik Syrien,2014,11,5058000,394000,5452000
Arabische Republik Syrien,2014,12,7900000,655000,8555000
Arabische Republik Syrien,2015,1,3349000,685000,4034000
Arabische Republik Syrien,2015,2,9125000,880000,10005000
Arabische Republik Syrien,2015,3,5637000,874000,6511000
Arabische Republik Syrien,2015,4,5849000,810000,6659000
Arabische Republik Syrien,2015,5,4136000,630000,4766000
Arabische Republik Syrien,2015,6,3990000,1260000,5250000
Arabische Republik Syrien,2015,7,4129000,1894000,6023000
Arabische Republik Syrien,2015,8,4067000,532000,4599000
Arabische Republik Syrien,2015,9,5072000,1906000,6978000
Arabische Republik Syrien,2015,10,4173000,814000,4987000
Arabische Republik Syrien,2015,11,5959000,1024000,6983000
Arabische Republik Syrien,2015,12,5751000,1246000,6997000
Arabische Republik Syrien,2016,1,2367000,1137000,3504000
Arabische Republik Syrien,2016,2,2930000,1248000,4178000
Arabische Republik Syrien,2016,3,4526000,1730000,6256000
Arabische Republik Syrien,2016,4,4379000,882000,5261000
Arabische Republik Syrien,2016,5,3849000,1830000,5679000
Arabische Republik Syrien,2016,6,4712000,1838000,6550000
Arabische Republik Syrien,2016,7,4069000,633000,4702000
Arabische Republik Syrien,2016,8,3425000,871000,4296000
Arabische Republik Syrien,2016,9,3322000,1303000,4625000
Arabische Republik Syrien,2016,10,4709000,1122000,5831000
Arabische Republik Syrien,2016,11,5278000,1833000,7111000
Arabische Republik Syrien,2016,12,8252000,1202000,9454000
Arabische Republik Syrien,2017,1,5081000,2027000,7108000
Arabische Republik Syrien,2017,2,6164000,1565000,7729000
Arabische Republik Syrien,2017,3,7197000,2072000,9269000
Arabische Republik Syrien,2017,4,3795000,792000,4587000
Arabische Republik Syrien,2017,5,6767000,1892000,8659000
Arabische Republik Syrien,2017,6,5339000,1247000,6586000
Arabische Republik Syrien,2017,7,6845000,1175000,8020000
Arabische Republik Syrien,2017,8,10286000,1449000,11735000
Arabische Republik Syrien,2017,9,5817000,824000,6641000
Arabische Republik Syrien,2017,10,6262000,1061000,7323000
Arabische Republik Syrien,2017,11,8449000,1508000,9957000
Arabische Republik Syrien,2017,12,7043000,1017000,8060000
Arabische Republik Syrien,2018,1,6859000,1100000,7959000
Arabische Republik Syrien,2018,2,7546000,843000,8389000
Arabische Republik Syrien,2018,3,7318000,1851000,9169000
Arabische Republik Syrien,2018,4,6547000,771000,7318000
Arabische Republik Syrien,2018,5,6522000,2284000,8806000
Arabische Republik Syrien,2018,6,7803000,838000,8641000
Arabische Republik Syrien,2018,7,6171000,1719000,7890000
Arabische Republik Syrien,2018,8,7029000,769000,7798000
Arabische Republik Syrien,2018,9,9112000,1272000,10384000
Arabische Republik Syrien,2018,10,8740000,1205000,9945000
Arabische Republik Syrien,2018,11,8276000,1632000,9908000
Arabische Republik Syrien,2018,12,6103000,962000,7065000
Arabische Republik Syrien,2019,1,10642000,1055000,11697000
Arabische Republik Syrien,2019,2,7823000,1718000,9541000
Arabische Republik Syrien,2019,3,5185000,829000,6014000
Arabische Republik Syrien,2019,4,6449000,1744000,8193000
Arabische Republik Syrien,2019,5,8028000,1063000,9091000
Arabische Republik Syrien,2019,6,8780000,1241000,10021000
Arabische Republik Syrien,2019,7,7775000,1046000,8821000
Arabische Republik Syrien,2019,8,9651000,1036000,10687000
Arabische Republik Syrien,2019,9,6183000,1209000,7392000
Arabische Republik Syrien,2019,10,6116000,1370000,7486000
Arabische Republik Syrien,2019,11,5123000,1731000,6854000
Arabische Republik Syrien,2019,12,5829000,1058000,6887000
Arabische Republik Syrien,2020,1,3723000,1050000,4773000
Arabische Republik Syrien,2020,2,3183000,1205000,4388000
Arabische Republik Syrien,2020,3,5136000,1789000,6925000
Arabische Republik Syrien,2020,4,4395000,1258000,5653000
Arabische Republik Syrien,2020,5,5741000,1160000,6901000
Arabische Republik Syrien,2020,6,8061000,1547000,9608000
Arabische Republik Syrien,2020,7,8617000,1243000,9860000
Arabische Republik Syrien,2020,8,2515000,1354000,3869000
Arabische Republik Syrien,2020,9,3499000,1230000,4729000
Arabische Republik Syrien,2020,10,3779000,1436000,5215000
Arabische Republik Syrien,2020,11,6868000,1312000,8180000
Arabische Republik Syrien,2020,12,3482000,1388000,4870000
Arabische Republik Syrien,2021,1,4074000,1272000,5346000
Arabische Republik Syrien,2021,2,3090000,1112000,4202000
Arabische Republik Syrien,2021,3,5563000,2369000,7932000
Arabische Republik Syrien,2021,4,2794000,1802000,4596000
Arabische Republik Syrien,2021,5,2386000,1627000,4013000
Arabische Republik Syrien,2021,6,3328000,1280000,4608000
Arabische Republik Syrien,2021,7,3827000,1346000,5173000
Arabische Republik Syrien,2021,8,4148000,1219000,5367000
Arabische Republik Syrien,2021,9,3510000,1267000,4777000
Arabische Republik Syrien,2021,10,2291000,1178000,3469000
Arabische Republik Syrien,2021,11,3566000,1592000,5158000
Arabische Republik Syrien,2021,12,5099000,1541000,6640000
Arabische Republik Syrien,2022,1,3228000,490000,3718000
Arabische Republik Syrien,2022,2,3204000,1184000,4388000
Arabische Republik Syrien,2022,3,3368000,1243000,4611000
Arabische Republik Syrien,2022,4,2410000,870000,3280000
Arabische Republik Syrien,2022,5,4432000,993000,5425000
Arabische Republik Syrien,2022,6,4788000,780000,5568000
Arabische Republik Syrien,2022,7,4246000,454000,4700000
Arabische Republik Syrien,2022,8,3972000,794000,4766000
Arabische Republik Syrien,2022,9,3125000,494000,3619000
Arabische Republik Syrien,2022,10,5286000,759000,6045000
Arabische Republik Syrien,2022,11,3184000,859000,4043000
Arabische Republik Syrien,2022,12,3535000,951000,4486000
Arabische Republik Syrien,2023,1,3850000,1003000,4853000
Arabische Republik Syrien,2023,2,3020000,815000,3835000
Arabische Republik Syrien,2023,3,4152000,1023000,5175000
Arabische Republik Syrien,2023,4,4060000,1466000,5526000
Arabische Republik Syrien,2023,5,3152000,727000,3879000
Arabische Republik Syrien,2023,6,4493000,1699000,6192000
Arabische Republik Syrien,2023,7,3991000,787000,4778000
Arabische Republik Syrien,2023,8,3362000,464000,3826000
Arabische Republik Syrien,2023,9,3151000,1146000,4297000
Arabische Republik Syrien,2023,10,2445000,1847000,4292000
Arabische Republik Syrien,2023,11,5112000,1916000,7028000
Arabische Republik Syrien,2023,12,4052000,897000,4949000
Arabische Republik Syrien,2024,1,5302000,1202000,6504000
Arabische Republik Syrien,2024,2,3825000,1054000,4879000
Arabische Republik Syrien,2024,3,2091000,1244000,3335000
Arabische Republik Syrien,2024,4,3853000,1511000,5364000
Arabische Republik Syrien,2024,5,1890000,991000,2881000
Arabische Republik Syrien,2024,6,3176000,608000,3784000
Arabische Republik Syrien,2024,7,6035000,1118000,7153000
Arabische Republik Syrien,2024,8,4465000,1245000,5710000
Arabische Republik Syrien,2024,9,3384000,1863000,5247000
Arabische Republik Syrien,2024,10,2540000,1403000,3943000
Arabische Republik Syrien,2024,11,3642000,1044000,4686000
Arabische Republik Syrien,2024,12,2030000,1685000,3715000
Argentinien,2008,1,164491000,160497000,324988000
Argentinien,2008,2,140993000,130277000,271270000
Argentinien,2008,3,130096000,97177000,227273000
Argentinien,2008,4,154414000,203331000,357745000
Argentinien,2008,5,167668000,145109000,312777000
Argentinien,2008,6,157863000,138006000,295869000
Argentinien,2008,7,177385000,152334000,329719000
Argentinien,2008,8,154634000,127758000,282392000
Argentinien,2008,9,159521000,141746000,301267000
Argentinien,2008,10,173150000,191756000,364906000
Argentinien,2008,11,120074000,115386000,235460000
Argentinien,2008,12,148929000,125862000,274791000
Argentinien,2009,1,117578000,150444000,268022000
Argentinien,2009,2,89767000,125208000,214975000
Argentinien,2009,3,102900000,137154000,240054000
Argentinien,2009,4,93867000,133472000,227339000
Argentinien,2009,5,84381000,115667000,200048000
Argentinien,2009,6,110458000,134249000,244707000
Argentinien,2009,7,125360000,125500000,250860000
Argentinien,2009,8,127908000,99740000,227648000
Argentinien,2009,9,117393000,134897000,252290000
Argentinien,2009,10,133086000,101808000,234894000
Argentinien,2009,11,154895000,106941000,261836000
Argentinien,2009,12,122645000,111640000,234285000
Argentinien,2010,1,124340000,149891000,274231000
Argentinien,2010,2,182456000,98175000,280631000
Argentinien,2010,3,200387000,157426000,357813000
Argentinien,2010,4,189275000,133545000,322820000
Argentinien,2010,5,188284000,128793000,317077000
Argentinien,2010,6,226440000,176486000,402926000
Argentinien,2010,7,243885000,167137000,411022000
Argentinien,2010,8,216380000,120764000,337144000
Argentinien,2010,9,226085000,159985000,386070000
Argentinien,2010,10,207079000,204433000,411512000
Argentinien,2010,11,227136000,169515000,396651000
Argentinien,2010,12,161822000,136375000,298197000
Argentinien,2011,1,185854000,129621000,315475000
Argentinien,2011,2,193403000,157560000,350963000
Argentinien,2011,3,250898000,141666000,392564000
Argentinien,2011,4,185031000,231556000,416587000
Argentinien,2011,5,219199000,133804000,353003000
Argentinien,2011,6,207753000,234232000,441985000
Argentinien,2011,7,212362000,202062000,414424000
Argentinien,2011,8,257681000,184553000,442234000
Argentinien,2011,9,248691000,246056000,494747000
Argentinien,2011,10,223649000,157965000,381614000
Argentinien,2011,11,252076000,221514000,473590000
Argentinien,2011,12,242883000,226883000,469766000
Argentinien,2012,1,246018000,150470000,396488000
Argentinien,2012,2,182207000,150145000,332352000
Argentinien,2012,3,218946000,181815000,400761000
Argentinien,2012,4,216895000,170743000,387638000
Argentinien,2012,5,204093000,181323000,385416000
Argentinien,2012,6,217253000,145263000,362516000
Argentinien,2012,7,258203000,130268000,388471000
Argentinien,2012,8,273483000,198066000,471549000
Argentinien,2012,9,231862000,216628000,448490000
Argentinien,2012,10,261307000,154227000,415534000
Argentinien,2012,11,242886000,150036000,392922000
Argentinien,2012,12,161050000,130368000,291418000
Argentinien,2013,1,212752000,114025000,326777000
Argentinien,2013,2,217268000,87980000,305248000
Argentinien,2013,3,232437000,185650000,418087000
Argentinien,2013,4,260837000,178205000,439042000
Argentinien,2013,5,247548000,141793000,389341000
Argentinien,2013,6,237041000,166975000,404016000
Argentinien,2013,7,267854000,132344000,400198000
Argentinien,2013,8,238965000,101017000,339982000
Argentinien,2013,9,227252000,140729000,367981000
Argentinien,2013,10,223753000,118991000,342744000
Argentinien,2013,11,205817000,176687000,382504000
Argentinien,2013,12,246315000,143411000,389726000
Argentinien,2014,1,185623000,136984000,322607000
Argentinien,2014,2,202212000,149967000,352179000
Argentinien,2014,3,192807000,129636000,322443000
Argentinien,2014,4,214868000,130306000,345174000
Argentinien,2014,5,214335000,128643000,342978000
Argentinien,2014,6,200423000,97760000,298183000
Argentinien,2014,7,250892000,120731000,371623000
Argentinien,2014,8,202806000,94111000,296917000
Argentinien,2014,9,202791000,147991000,350782000
Argentinien,2014,10,218063000,181459000,399522000
Argentinien,2014,11,180571000,137480000,318051000
Argentinien,2014,12,173481000,149955000,323436000
Argentinien,2015,1,211105000,106778000,317883000
Argentinien,2015,2,192433000,152217000,344650000
Argentinien,2015,3,242000000,108107000,350107000
Argentinien,2015,4,230996000,99280000,330276000
Argentinien,2015,5,200285000,103608000,303893000
Argentinien,2015,6,264452000,110719000,375171000
Argentinien,2015,7,266827000,150962000,417789000
Argentinien,2015,8,212421000,143787000,356208000
Argentinien,2015,9,211305000,151121000,362426000
Argentinien,2015,10,223178000,162599000,385777000
Argentinien,2015,11,182697000,129627000,312324000
Argentinien,2015,12,211377000,107208000,318585000
Argentinien,2016,1,206038000,149546000,355584000
Argentinien,2016,2,222483000,134907000,357390000
Argentinien,2016,3,219502000,174828000,394330000
Argentinien,2016,4,205104000,86656000,291760000
Argentinien,2016,5,184543000,105034000,289577000
Argentinien,2016,6,268265000,121023000,389288000
Argentinien,2016,7,226737000,137122000,363859000
Argentinien,2016,8,221884000,116210000,338094000
Argentinien,2016,9,224574000,106453000,331027000
Argentinien,2016,10,203149000,151829000,354978000
Argentinien,2016,11,189039000,114162000,303201000
Argentinien,2016,12,200941000,104107000,305048000
Argentinien,2017,1,245926000,121735000,367661000
Argentinien,2017,2,228555000,137538000,366093000
Argentinien,2017,3,264967000,109170000,374137000
Argentinien,2017,4,203986000,80267000,284253000
Argentinien,2017,5,271846000,118854000,390700000
Argentinien,2017,6,260264000,84692000,344956000
Argentinien,2017,7,263530000,95399000,358929000
Argentinien,2017,8,267014000,102547000,369561000
Argentinien,2017,9,264038000,111176000,375214000
Argentinien,2017,10,225697000,129877000,355574000
Argentinien,2017,11,251017000,100406000,351423000
Argentinien,2017,12,211034000,85120000,296154000
Argentinien,2018,1,234619000,126921000,361540000
Argentinien,2018,2,233271000,127075000,360346000
Argentinien,2018,3,306188000,98140000,404328000
Argentinien,2018,4,267938000,121116000,389054000
Argentinien,2018,5,245646000,80948000,326594000
Argentinien,2018,6,263560000,169667000,433227000
Argentinien,2018,7,268514000,97025000,365539000
Argentinien,2018,8,251041000,95247000,346288000
Argentinien,2018,9,218399000,112602000,331001000
Argentinien,2018,10,227857000,108574000,336431000
Argentinien,2018,11,170226000,102479000,272705000
Argentinien,2018,12,225470000,64755000,290225000
Argentinien,2019,1,224196000,104836000,329032000
Argentinien,2019,2,191414000,73617000,265031000
Argentinien,2019,3,196619000,67428000,264047000
Argentinien,2019,4,219493000,98363000,317856000
Argentinien,2019,5,252074000,91058000,343132000
Argentinien,2019,6,184539000,86528000,271067000
Argentinien,2019,7,209469000,105601000,315070000
Argentinien,2019,8,272754000,77553000,350307000
Argentinien,2019,9,182037000,107073000,289110000
Argentinien,2019,10,183909000,92209000,276118000
Argentinien,2019,11,136659000,103157000,239816000
Argentinien,2019,12,140428000,74465000,214893000
Argentinien,2020,1,170206000,106976000,277182000
Argentinien,2020,2,183632000,79510000,263142000
Argentinien,2020,3,217575000,83621000,301196000
Argentinien,2020,4,120059000,75676000,195735000
Argentinien,2020,5,103281000,63325000,166606000
Argentinien,2020,6,105122000,73126000,178248000
Argentinien,2020,7,143234000,67117000,210351000
Argentinien,2020,8,129278000,69400000,198678000
Argentinien,2020,9,169697000,87393000,257090000
Argentinien,2020,10,187390000,86978000,274368000
Argentinien,2020,11,157136000,68427000,225563000
Argentinien,2020,12,164241000,80899000,245140000
Argentinien,2021,1,166319000,70323000,236642000
Argentinien,2021,2,160389000,43890000,204279000
Argentinien,2021,3,193588000,66610000,260198000
Argentinien,2021,4,166532000,87388000,253920000
Argentinien,2021,5,182531000,68896000,251427000
Argentinien,2021,6,191722000,92348000,284070000
Argentinien,2021,7,194433000,73217000,267650000
Argentinien,2021,8,198317000,91541000,289858000
Argentinien,2021,9,187090000,83036000,270126000
Argentinien,2021,10,206976000,115613000,322589000
Argentinien,2021,11,227372000,110472000,337844000
Argentinien,2021,12,170960000,100046000,271006000
Argentinien,2022,1,181994000,66434000,248428000
Argentinien,2022,2,186596000,70382000,256978000
Argentinien,2022,3,193170000,88504000,281674000
Argentinien,2022,4,258804000,80266000,339070000
Argentinien,2022,5,217914000,85302000,303216000
Argentinien,2022,6,206612000,72291000,278903000
Argentinien,2022,7,209240000,97293000,306533000
Argentinien,2022,8,227598000,98153000,325751000
Argentinien,2022,9,223901000,88024000,311925000
Argentinien,2022,10,180139000,121878000,302017000
Argentinien,2022,11,194007000,116731000,310738000
Argentinien,2022,12,217838000,112124000,329962000
Argentinien,2023,1,214227000,68399000,282626000
Argentinien,2023,2,230742000,86762000,317504000
Argentinien,2023,3,258393000,70105000,328498000
Argentinien,2023,4,183579000,71875000,255454000
Argentinien,2023,5,218160000,74824000,292984000
Argentinien,2023,6,225564000,98884000,324448000
Argentinien,2023,7,228516000,89118000,317634000
Argentinien,2023,8,240770000,94557000,335327000
Argentinien,2023,9,207120000,72200000,279320000
Argentinien,2023,10,194551000,78503000,273054000
Argentinien,2023,11,177634000,69496000,247130000
Argentinien,2023,12,152363000,99781000,252144000
Argentinien,2024,1,175471000,72672000,248143000
Argentinien,2024,2,186280000,72235000,258515000
Argentinien,2024,3,168582000,106630000,275212000
Argentinien,2024,4,172226000,76272000,248498000
Argentinien,2024,5,169683000,88486000,258169000
Argentinien,2024,6,194798000,70858000,265656000
Argentinien,2024,7,230640000,87484000,318124000
Argentinien,2024,8,176939000,83298000,260237000
Argentinien,2024,9,195344000,99148000,294492000
Argentinien,2024,10,213970000,118870000,332840000
Argentinien,2024,11,188337000,116109000,304446000
Argentinien,2024,12,194445000,70414000,264859000
Armenien (ab 05/1992),2008,1,7085000,10134000,17219000
Armenien (ab 05/1992),2008,2,7321000,14674000,21995000
Armenien (ab 05/1992),2008,3,8891000,5791000,14682000
Armenien (ab 05/1992),2008,4,8875000,11232000,20107000
Armenien (ab 05/1992),2008,5,7462000,10705000,18167000
Armenien (ab 05/1992),2008,6,9416000,13818000,23234000
Armenien (ab 05/1992),2008,7,14405000,4778000,19183000
Armenien (ab 05/1992),2008,8,7643000,14126000,21769000
Armenien (ab 05/1992),2008,9,7866000,12080000,19946000
Armenien (ab 05/1992),2008,10,9453000,22633000,32086000
Armenien (ab 05/1992),2008,11,8416000,11503000,19919000
Armenien (ab 05/1992),2008,12,5653000,2861000,8514000
Armenien (ab 05/1992),2009,1,4380000,5602000,9982000
Armenien (ab 05/1992),2009,2,7079000,5458000,12537000
Armenien (ab 05/1992),2009,3,6080000,6986000,13066000
Armenien (ab 05/1992),2009,4,45124000,9019000,54143000
Armenien (ab 05/1992),2009,5,14974000,8379000,23353000
Armenien (ab 05/1992),2009,6,5617000,4843000,10460000
Armenien (ab 05/1992),2009,7,9425000,3614000,13039000
Armenien (ab 05/1992),2009,8,7642000,9276000,16918000
Armenien (ab 05/1992),2009,9,15933000,8232000,24165000
Armenien (ab 05/1992),2009,10,9420000,6466000,15886000
Armenien (ab 05/1992),2009,11,6656000,12209000,18865000
Armenien (ab 05/1992),2009,12,9088000,6361000,15449000
Armenien (ab 05/1992),2010,1,3944000,9632000,13576000
Armenien (ab 05/1992),2010,2,7640000,8597000,16237000
Armenien (ab 05/1992),2010,3,7940000,9566000,17506000
Armenien (ab 05/1992),2010,4,8900000,7675000,16575000
Armenien (ab 05/1992),2010,5,8156000,11918000,20074000
Armenien (ab 05/1992),2010,6,13795000,11009000,24804000
Armenien (ab 05/1992),2010,7,12656000,9414000,22070000
Armenien (ab 05/1992),2010,8,6768000,12247000,19015000
Armenien (ab 05/1992),2010,9,9481000,10857000,20338000
Armenien (ab 05/1992),2010,10,9695000,10482000,20177000
Armenien (ab 05/1992),2010,11,16990000,5656000,22646000
Armenien (ab 05/1992),2010,12,12506000,11627000,24133000
Armenien (ab 05/1992),2011,1,6437000,9511000,15948000
Armenien (ab 05/1992),2011,2,8433000,6041000,14474000
Armenien (ab 05/1992),2011,3,9761000,10318000,20079000
Armenien (ab 05/1992),2011,4,8838000,13813000,22651000
Armenien (ab 05/1992),2011,5,15877000,12064000,27941000
Armenien (ab 05/1992),2011,6,8361000,13119000,21480000
Armenien (ab 05/1992),2011,7,11321000,7738000,19059000
Armenien (ab 05/1992),2011,8,9070000,12592000,21662000
Armenien (ab 05/1992),2011,9,12173000,9545000,21718000
Armenien (ab 05/1992),2011,10,10055000,12236000,22291000
Armenien (ab 05/1992),2011,11,10155000,13348000,23503000
Armenien (ab 05/1992),2011,12,9579000,10510000,20089000
Armenien (ab 05/1992),2012,1,6557000,11444000,18001000
Armenien (ab 05/1992),2012,2,8919000,8240000,17159000
Armenien (ab 05/1992),2012,3,11551000,7593000,19144000
Armenien (ab 05/1992),2012,4,11467000,9988000,21455000
Armenien (ab 05/1992),2012,5,9647000,8493000,18140000
Armenien (ab 05/1992),2012,6,13215000,8640000,21855000
Armenien (ab 05/1992),2012,7,9404000,9119000,18523000
Armenien (ab 05/1992),2012,8,11805000,9665000,21470000
Armenien (ab 05/1992),2012,9,11013000,8938000,19951000
Armenien (ab 05/1992),2012,10,15278000,4032000,19310000
Armenien (ab 05/1992),2012,11,18644000,6786000,25430000
Armenien (ab 05/1992),2012,12,11946000,5554000,17500000
Armenien (ab 05/1992),2013,1,8057000,9038000,17095000
Armenien (ab 05/1992),2013,2,9269000,3920000,13189000
Armenien (ab 05/1992),2013,3,11301000,4413000,15714000
Armenien (ab 05/1992),2013,4,15481000,5463000,20944000
Armenien (ab 05/1992),2013,5,9458000,6793000,16251000
Armenien (ab 05/1992),2013,6,10307000,6658000,16965000
Armenien (ab 05/1992),2013,7,11883000,5044000,16927000
Armenien (ab 05/1992),2013,8,10448000,5661000,16109000
Armenien (ab 05/1992),2013,9,12216000,4772000,16988000
Armenien (ab 05/1992),2013,10,11683000,7206000,18889000
Armenien (ab 05/1992),2013,11,9574000,3480000,13054000
Armenien (ab 05/1992),2013,12,8782000,7043000,15825000
Armenien (ab 05/1992),2014,1,6745000,9548000,16293000
Armenien (ab 05/1992),2014,2,9715000,6450000,16165000
Armenien (ab 05/1992),2014,3,11815000,4352000,16167000
Armenien (ab 05/1992),2014,4,9863000,7202000,17065000
Armenien (ab 05/1992),2014,5,13364000,7384000,20748000
Armenien (ab 05/1992),2014,6,11799000,11569000,23368000
Armenien (ab 05/1992),2014,7,12282000,12506000,24788000
Armenien (ab 05/1992),2014,8,8746000,8150000,16896000
Armenien (ab 05/1992),2014,9,11353000,12553000,23906000
Armenien (ab 05/1992),2014,10,12435000,6007000,18442000
Armenien (ab 05/1992),2014,11,10839000,8774000,19613000
Armenien (ab 05/1992),2014,12,9035000,12108000,21143000
Armenien (ab 05/1992),2015,1,11574000,8044000,19618000
Armenien (ab 05/1992),2015,2,14231000,8111000,22342000
Armenien (ab 05/1992),2015,3,14790000,15476000,30266000
Armenien (ab 05/1992),2015,4,7730000,9167000,16897000
Armenien (ab 05/1992),2015,5,7654000,9276000,16930000
Armenien (ab 05/1992),2015,6,12766000,20598000,33364000
Armenien (ab 05/1992),2015,7,15780000,9191000,24971000
Armenien (ab 05/1992),2015,8,15150000,15032000,30182000
Armenien (ab 05/1992),2015,9,14849000,8308000,23157000
Armenien (ab 05/1992),2015,10,12080000,11802000,23882000
Armenien (ab 05/1992),2015,11,13570000,10953000,24523000
Armenien (ab 05/1992),2015,12,9975000,12369000,22344000
Armenien (ab 05/1992),2016,1,10695000,6617000,17312000
Armenien (ab 05/1992),2016,2,16099000,11592000,27691000
Armenien (ab 05/1992),2016,3,12497000,11749000,24246000
Armenien (ab 05/1992),2016,4,11002000,12554000,23556000
Armenien (ab 05/1992),2016,5,15360000,10620000,25980000
Armenien (ab 05/1992),2016,6,9933000,8650000,18583000
Armenien (ab 05/1992),2016,7,11183000,8661000,19844000
Armenien (ab 05/1992),2016,8,14905000,12980000,27885000
Armenien (ab 05/1992),2016,9,14709000,7960000,22669000
Armenien (ab 05/1992),2016,10,12551000,8415000,20966000
Armenien (ab 05/1992),2016,11,10704000,5431000,16135000
Armenien (ab 05/1992),2016,12,11561000,8308000,19869000
Armenien (ab 05/1992),2017,1,6647000,14239000,20886000
Armenien (ab 05/1992),2017,2,9929000,7563000,17492000
Armenien (ab 05/1992),2017,3,14508000,5553000,20061000
Armenien (ab 05/1992),2017,4,11446000,6683000,18129000
Armenien (ab 05/1992),2017,5,12765000,13046000,25811000
Armenien (ab 05/1992),2017,6,9901000,9268000,19169000
Armenien (ab 05/1992),2017,7,13155000,8674000,21829000
Armenien (ab 05/1992),2017,8,15115000,9563000,24678000
Armenien (ab 05/1992),2017,9,12541000,10638000,23179000
Armenien (ab 05/1992),2017,10,10778000,7333000,18111000
Armenien (ab 05/1992),2017,11,17117000,9599000,26716000
Armenien (ab 05/1992),2017,12,17848000,10629000,28477000
Armenien (ab 05/1992),2018,1,13671000,13144000,26815000
Armenien (ab 05/1992),2018,2,17124000,8833000,25957000
Armenien (ab 05/1992),2018,3,18984000,6762000,25746000
Armenien (ab 05/1992),2018,4,15346000,11528000,26874000
Armenien (ab 05/1992),2018,5,13668000,10054000,23722000
Armenien (ab 05/1992),2018,6,21681000,20868000,42549000
Armenien (ab 05/1992),2018,7,14197000,11653000,25850000
Armenien (ab 05/1992),2018,8,13658000,12046000,25704000
Armenien (ab 05/1992),2018,9,18898000,10345000,29243000
Armenien (ab 05/1992),2018,10,18835000,17310000,36145000
Armenien (ab 05/1992),2018,11,20291000,14028000,34319000
Armenien (ab 05/1992),2018,12,12837000,8281000,21118000
Armenien (ab 05/1992),2019,1,9015000,10453000,19468000
Armenien (ab 05/1992),2019,2,13252000,10726000,23978000
Armenien (ab 05/1992),2019,3,19523000,10369000,29892000
Armenien (ab 05/1992),2019,4,10563000,9690000,20253000
Armenien (ab 05/1992),2019,5,14865000,10017000,24882000
Armenien (ab 05/1992),2019,6,12756000,10508000,23264000
Armenien (ab 05/1992),2019,7,13043000,9709000,22752000
Armenien (ab 05/1992),2019,8,15431000,10263000,25694000
Armenien (ab 05/1992),2019,9,17025000,8328000,25353000
Armenien (ab 05/1992),2019,10,21485000,10185000,31670000
Armenien (ab 05/1992),2019,11,17449000,7899000,25348000
Armenien (ab 05/1992),2019,12,15422000,6595000,22017000
Armenien (ab 05/1992),2020,1,9847000,7431000,17278000
Armenien (ab 05/1992),2020,2,11400000,7051000,18451000
Armenien (ab 05/1992),2020,3,14255000,6024000,20279000
Armenien (ab 05/1992),2020,4,39026000,3542000,42568000
Armenien (ab 05/1992),2020,5,14367000,4537000,18904000
Armenien (ab 05/1992),2020,6,14107000,5287000,19394000
Armenien (ab 05/1992),2020,7,30172000,3433000,33605000
Armenien (ab 05/1992),2020,8,12953000,6654000,19607000
Armenien (ab 05/1992),2020,9,12830000,6086000,18916000
Armenien (ab 05/1992),2020,10,11043000,6459000,17502000
Armenien (ab 05/1992),2020,11,8775000,6002000,14777000
Armenien (ab 05/1992),2020,12,8378000,5594000,13972000
Armenien (ab 05/1992),2021,1,16053000,7320000,23373000
Armenien (ab 05/1992),2021,2,15261000,5742000,21003000
Armenien (ab 05/1992),2021,3,13235000,9371000,22606000
Armenien (ab 05/1992),2021,4,11162000,10369000,21531000
Armenien (ab 05/1992),2021,5,9090000,6528000,15618000
Armenien (ab 05/1992),2021,6,14550000,11906000,26456000
Armenien (ab 05/1992),2021,7,17127000,10687000,27814000
Armenien (ab 05/1992),2021,8,12587000,8105000,20692000
Armenien (ab 05/1992),2021,9,14291000,12320000,26611000
Armenien (ab 05/1992),2021,10,13819000,9569000,23388000
Armenien (ab 05/1992),2021,11,18724000,9806000,28530000
Armenien (ab 05/1992),2021,12,23410000,7693000,31103000
Armenien (ab 05/1992),2022,1,11033000,11362000,22395000
Armenien (ab 05/1992),2022,2,16642000,9267000,25909000
Armenien (ab 05/1992),2022,3,24153000,11527000,35680000
Armenien (ab 05/1992),2022,4,19073000,12856000,31929000
Armenien (ab 05/1992),2022,5,30878000,15699000,46577000
Armenien (ab 05/1992),2022,6,39150000,16418000,55568000
Armenien (ab 05/1992),2022,7,38884000,11106000,49990000
Armenien (ab 05/1992),2022,8,51610000,6562000,58172000
Armenien (ab 05/1992),2022,9,59170000,13882000,73052000
Armenien (ab 05/1992),2022,10,64762000,17725000,82487000
Armenien (ab 05/1992),2022,11,60713000,14113000,74826000
Armenien (ab 05/1992),2022,12,60789000,14983000,75772000
Armenien (ab 05/1992),2023,1,37585000,13381000,50966000
Armenien (ab 05/1992),2023,2,51893000,21127000,73020000
Armenien (ab 05/1992),2023,3,50710000,18938000,69648000
Armenien (ab 05/1992),2023,4,44715000,15036000,59751000
Armenien (ab 05/1992),2023,5,53007000,13297000,66304000
Armenien (ab 05/1992),2023,6,40169000,19620000,59789000
Armenien (ab 05/1992),2023,7,35766000,10839000,46605000
Armenien (ab 05/1992),2023,8,36583000,11670000,48253000
Armenien (ab 05/1992),2023,9,39290000,14212000,53502000
Armenien (ab 05/1992),2023,10,34268000,14019000,48287000
Armenien (ab 05/1992),2023,11,37611000,12590000,50201000
Armenien (ab 05/1992),2023,12,31810000,10592000,42402000
Armenien (ab 05/1992),2024,1,39882000,10458000,50340000
Armenien (ab 05/1992),2024,2,32149000,14312000,46461000
Armenien (ab 05/1992),2024,3,30576000,10397000,40973000
Armenien (ab 05/1992),2024,4,30841000,9433000,40274000
Armenien (ab 05/1992),2024,5,32105000,7189000,39294000
Armenien (ab 05/1992),2024,6,38192000,10440000,48632000
Armenien (ab 05/1992),2024,7,39336000,9856000,49192000
Armenien (ab 05/1992),2024,8,38940000,8431000,47371000
Armenien (ab 05/1992),2024,9,40300000,8985000,49285000
Armenien (ab 05/1992),2024,10,38620000,8437000,47057000
Armenien (ab 05/1992),2024,11,46457000,8795000,55252000
Armenien (ab 05/1992),2024,12,25743000,7639000,33382000
Aruba,2008,1,328000,88000,416000
Aruba,2008,2,482000,0,482000
Aruba,2008,3,220000,19000,239000
Aruba,2008,4,767000,1000,768000
Aruba,2008,5,2111000,184000,2295000
Aruba,2008,6,292000,223000,515000
Aruba,2008,7,1403000,63000,1466000
Aruba,2008,8,459000,47000,506000
Aruba,2008,9,222000,0,222000
Aruba,2008,10,811000,33000,844000
Aruba,2008,11,640000,14000,654000
Aruba,2008,12,194000,9000,203000
Aruba,2009,1,272000,8415000,8687000
Aruba,2009,2,451000,2000,453000
Aruba,2009,3,315000,1000,316000
Aruba,2009,4,514000,0,514000
Aruba,2009,5,170000,10000,180000
Aruba,2009,6,233000,0,233000
Aruba,2009,7,378000,0,378000
Aruba,2009,8,248000,0,248000
Aruba,2009,9,200000,0,200000
Aruba,2009,10,1273000,0,1273000
Aruba,2009,11,1115000,1000,1116000
Aruba,2009,12,738000,3000,741000
Aruba,2010,1,218000,0,218000
Aruba,2010,2,489000,30000,519000
Aruba,2010,3,259000,2000,261000
Aruba,2010,4,260000,1000,261000
Aruba,2010,5,280000,28000,308000
Aruba,2010,6,270000,0,270000
Aruba,2010,7,62000,0,62000
Aruba,2010,8,247000,52000,299000
Aruba,2010,9,260000,14000,274000
Aruba,2010,10,715000,3000,718000
Aruba,2010,11,332000,9000,341000
Aruba,2010,12,531000,1000,532000
Aruba,2011,1,3134000,51000,3185000
Aruba,2011,2,459000,2000,461000
Aruba,2011,3,652000,50000,702000
Aruba,2011,4,230000,102000,332000
Aruba,2011,5,409000,0,409000
Aruba,2011,6,348000,4000,352000
Aruba,2011,7,2160000,0,2160000
Aruba,2011,8,434000,0,434000
Aruba,2011,9,365000,0,365000
Aruba,2011,10,335000,74000,409000
Aruba,2011,11,335000,17000,352000
Aruba,2011,12,225000,15000,240000
Aruba,2012,1,440000,14000,454000
Aruba,2012,2,510000,6000,516000
Aruba,2012,3,817000,89000,906000
Aruba,2012,4,1594000,0,1594000
Aruba,2012,5,545000,0,545000
Aruba,2012,6,730000,0,730000
Aruba,2012,7,273000,0,273000
Aruba,2012,8,364000,0,364000
Aruba,2012,9,830000,0,830000
Aruba,2012,10,470000,131000,601000
Aruba,2012,11,458000,6000,464000
Aruba,2012,12,480000,4000,484000
Aruba,2013,1,748000,1000,749000
Aruba,2013,2,535000,0,535000
Aruba,2013,3,650000,0,650000
Aruba,2013,4,517000,0,517000
Aruba,2013,5,660000,15000,675000
Aruba,2013,6,404000,0,404000
Aruba,2013,7,526000,6000,532000
Aruba,2013,8,638000,1000,639000
Aruba,2013,9,725000,107000,832000
Aruba,2013,10,2161000,4000,2165000
Aruba,2013,11,2110000,0,2110000
Aruba,2013,12,928000,0,928000
Aruba,2014,1,549000,0,549000
Aruba,2014,2,507000,0,507000
Aruba,2014,3,446000,45000,491000
Aruba,2014,4,794000,0,794000
Aruba,2014,5,440000,26000,466000
Aruba,2014,6,410000,12000,422000
Aruba,2014,7,625000,0,625000
Aruba,2014,8,576000,122000,698000
Aruba,2014,9,892000,0,892000
Aruba,2014,10,733000,0,733000
Aruba,2014,11,490000,0,490000
Aruba,2014,12,754000,1000,755000
Aruba,2015,1,1037000,14000,1051000
Aruba,2015,2,619000,94000,713000
Aruba,2015,3,567000,413000,980000
Aruba,2015,4,693000,1000,694000
Aruba,2015,5,2172000,107000,2279000
Aruba,2015,6,1114000,0,1114000
Aruba,2015,7,500000,17000,517000
Aruba,2015,8,332000,82000,414000
Aruba,2015,9,644000,36000,680000
Aruba,2015,10,430000,0,430000
Aruba,2015,11,838000,0,838000
Aruba,2015,12,719000,117000,836000
Aruba,2016,1,408000,8000,416000
Aruba,2016,2,2316000,2000,2318000
Aruba,2016,3,431000,15000,446000
Aruba,2016,4,530000,80000,610000
Aruba,2016,5,497000,5000,502000
Aruba,2016,6,922000,2000,924000
Aruba,2016,7,758000,2000,760000
Aruba,2016,8,504000,0,504000
Aruba,2016,9,1100000,3000,1103000
Aruba,2016,10,1356000,0,1356000
Aruba,2016,11,801000,14000,815000
Aruba,2016,12,673000,5000,678000
Aruba,2017,1,383000,1000,384000
Aruba,2017,2,1018000,0,1018000
Aruba,2017,3,1460000,2000,1462000
Aruba,2017,4,816000,0,816000
Aruba,2017,5,751000,8000,759000
Aruba,2017,6,579000,0,579000
Aruba,2017,7,567000,2000,569000
Aruba,2017,8,617000,9000,626000
Aruba,2017,9,839000,9000,848000
Aruba,2017,10,377000,4000,381000
Aruba,2017,11,661000,13000,674000
Aruba,2017,12,1511000,0,1511000
Aruba,2018,1,1073000,0,1073000
Aruba,2018,2,468000,4000,472000
Aruba,2018,3,637000,31000,668000
Aruba,2018,4,519000,0,519000
Aruba,2018,5,410000,31000,441000
Aruba,2018,6,346000,0,346000
Aruba,2018,7,527000,3000,530000
Aruba,2018,8,409000,1000,410000
Aruba,2018,9,524000,0,524000
Aruba,2018,10,785000,1000,786000
Aruba,2018,11,845000,22000,867000
Aruba,2018,12,536000,1000,537000
Aruba,2019,1,709000,0,709000
Aruba,2019,2,916000,12000,928000
Aruba,2019,3,813000,0,813000
Aruba,2019,4,638000,42000,680000
Aruba,2019,5,583000,31000,614000
Aruba,2019,6,927000,6000,933000
Aruba,2019,7,741000,3000,744000
Aruba,2019,8,752000,3000,755000
Aruba,2019,9,391000,31000,422000
Aruba,2019,10,1044000,2000,1046000
Aruba,2019,11,1056000,2000,1058000
Aruba,2019,12,475000,8000,483000
Aruba,2020,1,784000,4000,788000
Aruba,2020,2,610000,3000,613000
Aruba,2020,3,504000,2000,506000
Aruba,2020,4,299000,0,299000
Aruba,2020,5,56000,1000,57000
Aruba,2020,6,429000,82000,511000
Aruba,2020,7,789000,5000,794000
Aruba,2020,8,418000,22000,440000
Aruba,2020,9,584000,1000,585000
Aruba,2020,10,1113000,46000,1159000
Aruba,2020,11,413000,0,413000
Aruba,2020,12,462000,2000,464000
Aruba,2021,1,360000,0,360000
Aruba,2021,2,502000,1000,503000
Aruba,2021,3,847000,0,847000
Aruba,2021,4,965000,10000,975000
Aruba,2021,5,414000,2000,416000
Aruba,2021,6,610000,7000,617000
Aruba,2021,7,787000,1000,788000
Aruba,2021,8,592000,2000,594000
Aruba,2021,9,652000,7000,659000
Aruba,2021,10,693000,0,693000
Aruba,2021,11,732000,27000,759000
Aruba,2021,12,929000,1000,930000
Aruba,2022,1,678000,2000,680000
Aruba,2022,2,583000,0,583000
Aruba,2022,3,756000,7000,763000
Aruba,2022,4,385000,65000,450000
Aruba,2022,5,438000,6000,444000
Aruba,2022,6,1034000,3000,1037000
Aruba,2022,7,1191000,7000,1198000
Aruba,2022,8,983000,2000,985000
Aruba,2022,9,29767000,48000,29815000
Aruba,2022,10,713000,1000,714000
Aruba,2022,11,591000,2000,593000
Aruba,2022,12,685000,8000,693000
Aruba,2023,1,450000,18000,468000
Aruba,2023,2,370000,1000,371000
Aruba,2023,3,640000,1000,641000
Aruba,2023,4,502000,9000,511000
Aruba,2023,5,545000,1000,546000
Aruba,2023,6,821000,0,821000
Aruba,2023,7,691000,2000,693000
Aruba,2023,8,572000,0,572000
Aruba,2023,9,461000,0,461000
Aruba,2023,10,398000,2000,400000
Aruba,2023,11,585000,1000,586000
Aruba,2023,12,412000,0,412000
Aruba,2024,1,414000,0,414000
Aruba,2024,2,656000,1000,657000
Aruba,2024,3,538000,0,538000
Aruba,2024,4,619000,12000,631000
Aruba,2024,5,385000,3000,388000
Aruba,2024,6,738000,2000,740000
Aruba,2024,7,1451000,2000,1453000
Aruba,2024,8,676000,3000,679000
Aruba,2024,9,833000,9000,842000
Aruba,2024,10,637000,2000,639000
Aruba,2024,11,422000,5000,427000
Aruba,2024,12,724000,13000,737000
Aserbaidschan (ab 05/1992),2008,1,34005000,146601000,180606000
Aserbaidschan (ab 05/1992),2008,2,34480000,122989000,157469000
Aserbaidschan (ab 05/1992),2008,3,41007000,160244000,201251000
Aserbaidschan (ab 05/1992),2008,4,42729000,154657000,197386000
Aserbaidschan (ab 05/1992),2008,5,45557000,95054000,140611000
Aserbaidschan (ab 05/1992),2008,6,42853000,183903000,226756000
Aserbaidschan (ab 05/1992),2008,7,45909000,270047000,315956000
Aserbaidschan (ab 05/1992),2008,8,42082000,169953000,212035000
Aserbaidschan (ab 05/1992),2008,9,50372000,176019000,226391000
Aserbaidschan (ab 05/1992),2008,10,62832000,214690000,277522000
Aserbaidschan (ab 05/1992),2008,11,42559000,104262000,146821000
Aserbaidschan (ab 05/1992),2008,12,45523000,60630000,106153000
Aserbaidschan (ab 05/1992),2009,1,30252000,85499000,115751000
Aserbaidschan (ab 05/1992),2009,2,35902000,59214000,95116000
Aserbaidschan (ab 05/1992),2009,3,32443000,35323000,67766000
Aserbaidschan (ab 05/1992),2009,4,37072000,93833000,130905000
Aserbaidschan (ab 05/1992),2009,5,36645000,72805000,109450000
Aserbaidschan (ab 05/1992),2009,6,33166000,63664000,96830000
Aserbaidschan (ab 05/1992),2009,7,57851000,85115000,142966000
Aserbaidschan (ab 05/1992),2009,8,34794000,141271000,176065000
Aserbaidschan (ab 05/1992),2009,9,31709000,187614000,219323000
Aserbaidschan (ab 05/1992),2009,10,34260000,120824000,155084000
Aserbaidschan (ab 05/1992),2009,11,37607000,74568000,112175000
Aserbaidschan (ab 05/1992),2009,12,29392000,165879000,195271000
Aserbaidschan (ab 05/1992),2010,1,18390000,96227000,114617000
Aserbaidschan (ab 05/1992),2010,2,109547000,107084000,216631000
Aserbaidschan (ab 05/1992),2010,3,52861000,22009000,74870000
Aserbaidschan (ab 05/1992),2010,4,42227000,83801000,126028000
Aserbaidschan (ab 05/1992),2010,5,59213000,157823000,217036000
Aserbaidschan (ab 05/1992),2010,6,54569000,74298000,128867000
Aserbaidschan (ab 05/1992),2010,7,63674000,142333000,206007000
Aserbaidschan (ab 05/1992),2010,8,70936000,136090000,207026000
Aserbaidschan (ab 05/1992),2010,9,54263000,79260000,133523000
Aserbaidschan (ab 05/1992),2010,10,49012000,112520000,161532000
Aserbaidschan (ab 05/1992),2010,11,62814000,190064000,252878000
Aserbaidschan (ab 05/1992),2010,12,97372000,92102000,189474000
Aserbaidschan (ab 05/1992),2011,1,28145000,149470000,177615000
Aserbaidschan (ab 05/1992),2011,2,70013000,101187000,171200000
Aserbaidschan (ab 05/1992),2011,3,45449000,80780000,126229000
Aserbaidschan (ab 05/1992),2011,4,59183000,154291000,213474000
Aserbaidschan (ab 05/1992),2011,5,62992000,124133000,187125000
Aserbaidschan (ab 05/1992),2011,6,44756000,16803000,61559000
Aserbaidschan (ab 05/1992),2011,7,46088000,159603000,205691000
Aserbaidschan (ab 05/1992),2011,8,43550000,56008000,99558000
Aserbaidschan (ab 05/1992),2011,9,62855000,83033000,145888000
Aserbaidschan (ab 05/1992),2011,10,64156000,385640000,449796000
Aserbaidschan (ab 05/1992),2011,11,204361000,112712000,317073000
Aserbaidschan (ab 05/1992),2011,12,115082000,49066000,164148000
Aserbaidschan (ab 05/1992),2012,1,47816000,56692000,104508000
Aserbaidschan (ab 05/1992),2012,2,70343000,201775000,272118000
Aserbaidschan (ab 05/1992),2012,3,68655000,228655000,297310000
Aserbaidschan (ab 05/1992),2012,4,64359000,21695000,86054000
Aserbaidschan (ab 05/1992),2012,5,67424000,51941000,119365000
Aserbaidschan (ab 05/1992),2012,6,52804000,111621000,164425000
Aserbaidschan (ab 05/1992),2012,7,69688000,86201000,155889000
Aserbaidschan (ab 05/1992),2012,8,63687000,158574000,222261000
Aserbaidschan (ab 05/1992),2012,9,81203000,133296000,214499000
Aserbaidschan (ab 05/1992),2012,10,60860000,84360000,145220000
Aserbaidschan (ab 05/1992),2012,11,73684000,92057000,165741000
Aserbaidschan (ab 05/1992),2012,12,63281000,345530000,408811000
Aserbaidschan (ab 05/1992),2013,1,50177000,198541000,248718000
Aserbaidschan (ab 05/1992),2013,2,60020000,324799000,384819000
Aserbaidschan (ab 05/1992),2013,3,67017000,159946000,226963000
Aserbaidschan (ab 05/1992),2013,4,70987000,199199000,270186000
Aserbaidschan (ab 05/1992),2013,5,72865000,178676000,251541000
Aserbaidschan (ab 05/1992),2013,6,63824000,174918000,238742000
Aserbaidschan (ab 05/1992),2013,7,68446000,257754000,326200000
Aserbaidschan (ab 05/1992),2013,8,76525000,224451000,300976000
Aserbaidschan (ab 05/1992),2013,9,72502000,183510000,256012000
Aserbaidschan (ab 05/1992),2013,10,72162000,125259000,197421000
Aserbaidschan (ab 05/1992),2013,11,74741000,159050000,233791000
Aserbaidschan (ab 05/1992),2013,12,75722000,265464000,341186000
Aserbaidschan (ab 05/1992),2014,1,45966000,251322000,297288000
Aserbaidschan (ab 05/1992),2014,2,54440000,253100000,307540000
Aserbaidschan (ab 05/1992),2014,3,56509000,215364000,271873000
Aserbaidschan (ab 05/1992),2014,4,67492000,175276000,242768000
Aserbaidschan (ab 05/1992),2014,5,53476000,141024000,194500000
Aserbaidschan (ab 05/1992),2014,6,76247000,95705000,171952000
Aserbaidschan (ab 05/1992),2014,7,66369000,181104000,247473000
Aserbaidschan (ab 05/1992),2014,8,57512000,133843000,191355000
Aserbaidschan (ab 05/1992),2014,9,80491000,186884000,267375000
Aserbaidschan (ab 05/1992),2014,10,75162000,235926000,311088000
Aserbaidschan (ab 05/1992),2014,11,79391000,299013000,378404000
Aserbaidschan (ab 05/1992),2014,12,65854000,220238000,286092000
Aserbaidschan (ab 05/1992),2015,1,55708000,222618000,278326000
Aserbaidschan (ab 05/1992),2015,2,56832000,224980000,281812000
Aserbaidschan (ab 05/1992),2015,3,67635000,207588000,275223000
Aserbaidschan (ab 05/1992),2015,4,103473000,152994000,256467000
Aserbaidschan (ab 05/1992),2015,5,86312000,194772000,281084000
Aserbaidschan (ab 05/1992),2015,6,48446000,248786000,297232000
Aserbaidschan (ab 05/1992),2015,7,54105000,212458000,266563000
Aserbaidschan (ab 05/1992),2015,8,49590000,156268000,205858000
Aserbaidschan (ab 05/1992),2015,9,45208000,161367000,206575000
Aserbaidschan (ab 05/1992),2015,10,35777000,135185000,170962000
Aserbaidschan (ab 05/1992),2015,11,35132000,118941000,154073000
Aserbaidschan (ab 05/1992),2015,12,36355000,140632000,176987000
Aserbaidschan (ab 05/1992),2016,1,14492000,138014000,152506000
Aserbaidschan (ab 05/1992),2016,2,21772000,147466000,169238000
Aserbaidschan (ab 05/1992),2016,3,27504000,79798000,107302000
Aserbaidschan (ab 05/1992),2016,4,28903000,85310000,114213000
Aserbaidschan (ab 05/1992),2016,5,19706000,168179000,187885000
Aserbaidschan (ab 05/1992),2016,6,32393000,166214000,198607000
Aserbaidschan (ab 05/1992),2016,7,31058000,123793000,154851000
Aserbaidschan (ab 05/1992),2016,8,28249000,150690000,178939000
Aserbaidschan (ab 05/1992),2016,9,32394000,135778000,168172000
Aserbaidschan (ab 05/1992),2016,10,22598000,97807000,120405000
Aserbaidschan (ab 05/1992),2016,11,33185000,151393000,184578000
Aserbaidschan (ab 05/1992),2016,12,24751000,169528000,194279000
Aserbaidschan (ab 05/1992),2017,1,16141000,67223000,83364000
Aserbaidschan (ab 05/1992),2017,2,18853000,131219000,150072000
Aserbaidschan (ab 05/1992),2017,3,25309000,107230000,132539000
Aserbaidschan (ab 05/1992),2017,4,21130000,106205000,127335000
Aserbaidschan (ab 05/1992),2017,5,27120000,103044000,130164000
Aserbaidschan (ab 05/1992),2017,6,28965000,63069000,92034000
Aserbaidschan (ab 05/1992),2017,7,33653000,55130000,88783000
Aserbaidschan (ab 05/1992),2017,8,34246000,76397000,110643000
Aserbaidschan (ab 05/1992),2017,9,44352000,83104000,127456000
Aserbaidschan (ab 05/1992),2017,10,32095000,21173000,53268000
Aserbaidschan (ab 05/1992),2017,11,38257000,94003000,132260000
Aserbaidschan (ab 05/1992),2017,12,31746000,95058000,126804000
Aserbaidschan (ab 05/1992),2018,1,25440000,91655000,117095000
Aserbaidschan (ab 05/1992),2018,2,25470000,128621000,154091000
Aserbaidschan (ab 05/1992),2018,3,31437000,57080000,88517000
Aserbaidschan (ab 05/1992),2018,4,39584000,132044000,171628000
Aserbaidschan (ab 05/1992),2018,5,32409000,134752000,167161000
Aserbaidschan (ab 05/1992),2018,6,30369000,94581000,124950000
Aserbaidschan (ab 05/1992),2018,7,55398000,180626000,236024000
Aserbaidschan (ab 05/1992),2018,8,31424000,158429000,189853000
Aserbaidschan (ab 05/1992),2018,9,32888000,102008000,134896000
Aserbaidschan (ab 05/1992),2018,10,38067000,132999000,171066000
Aserbaidschan (ab 05/1992),2018,11,39835000,95356000,135191000
Aserbaidschan (ab 05/1992),2018,12,51158000,134012000,185170000
Aserbaidschan (ab 05/1992),2019,1,38790000,215633000,254423000
Aserbaidschan (ab 05/1992),2019,2,27701000,127062000,154763000
Aserbaidschan (ab 05/1992),2019,3,35413000,154950000,190363000
Aserbaidschan (ab 05/1992),2019,4,44580000,160609000,205189000
Aserbaidschan (ab 05/1992),2019,5,39531000,59677000,99208000
Aserbaidschan (ab 05/1992),2019,6,38528000,129493000,168021000
Aserbaidschan (ab 05/1992),2019,7,38858000,90507000,129365000
Aserbaidschan (ab 05/1992),2019,8,34708000,60269000,94977000
Aserbaidschan (ab 05/1992),2019,9,46774000,91159000,137933000
Aserbaidschan (ab 05/1992),2019,10,32884000,97892000,130776000
Aserbaidschan (ab 05/1992),2019,11,31772000,99950000,131722000
Aserbaidschan (ab 05/1992),2019,12,33547000,61086000,94633000
Aserbaidschan (ab 05/1992),2020,1,37673000,125556000,163229000
Aserbaidschan (ab 05/1992),2020,2,31696000,82495000,114191000
Aserbaidschan (ab 05/1992),2020,3,31014000,75796000,106810000
Aserbaidschan (ab 05/1992),2020,4,26039000,31048000,57087000
Aserbaidschan (ab 05/1992),2020,5,19614000,47663000,67277000
Aserbaidschan (ab 05/1992),2020,6,21570000,53306000,74876000
Aserbaidschan (ab 05/1992),2020,7,38335000,50570000,88905000
Aserbaidschan (ab 05/1992),2020,8,22215000,74010000,96225000
Aserbaidschan (ab 05/1992),2020,9,38603000,111534000,150137000
Aserbaidschan (ab 05/1992),2020,10,32228000,38565000,70793000
Aserbaidschan (ab 05/1992),2020,11,27488000,20713000,48201000
Aserbaidschan (ab 05/1992),2020,12,32268000,22806000,55074000
Aserbaidschan (ab 05/1992),2021,1,20219000,3037000,23256000
Aserbaidschan (ab 05/1992),2021,2,25933000,55144000,81077000
Aserbaidschan (ab 05/1992),2021,3,27522000,3305000,30827000
Aserbaidschan (ab 05/1992),2021,4,22848000,15265000,38113000
Aserbaidschan (ab 05/1992),2021,5,22048000,46816000,68864000
Aserbaidschan (ab 05/1992),2021,6,24901000,85293000,110194000
Aserbaidschan (ab 05/1992),2021,7,22450000,43481000,65931000
Aserbaidschan (ab 05/1992),2021,8,22745000,17722000,40467000
Aserbaidschan (ab 05/1992),2021,9,41743000,57498000,99241000
Aserbaidschan (ab 05/1992),2021,10,26772000,78378000,105150000
Aserbaidschan (ab 05/1992),2021,11,23294000,159990000,183284000
Aserbaidschan (ab 05/1992),2021,12,23693000,139547000,163240000
Aserbaidschan (ab 05/1992),2022,1,28246000,72428000,100674000
Aserbaidschan (ab 05/1992),2022,2,26559000,105909000,132468000
Aserbaidschan (ab 05/1992),2022,3,33420000,93155000,126575000
Aserbaidschan (ab 05/1992),2022,4,23655000,207405000,231060000
Aserbaidschan (ab 05/1992),2022,5,31656000,236417000,268073000
Aserbaidschan (ab 05/1992),2022,6,42666000,207479000,250145000
Aserbaidschan (ab 05/1992),2022,7,34942000,134956000,169898000
Aserbaidschan (ab 05/1992),2022,8,43488000,16965000,60453000
Aserbaidschan (ab 05/1992),2022,9,43117000,62891000,106008000
Aserbaidschan (ab 05/1992),2022,10,59286000,184872000,244158000
Aserbaidschan (ab 05/1992),2022,11,51219000,231799000,283018000
Aserbaidschan (ab 05/1992),2022,12,51140000,162610000,213750000
Aserbaidschan (ab 05/1992),2023,1,38622000,45309000,83931000
Aserbaidschan (ab 05/1992),2023,2,47386000,87471000,134857000
Aserbaidschan (ab 05/1992),2023,3,51312000,32314000,83626000
Aserbaidschan (ab 05/1992),2023,4,47033000,17695000,64728000
Aserbaidschan (ab 05/1992),2023,5,48899000,40675000,89574000
Aserbaidschan (ab 05/1992),2023,6,48710000,34329000,83039000
Aserbaidschan (ab 05/1992),2023,7,49401000,63518000,112919000
Aserbaidschan (ab 05/1992),2023,8,47092000,62917000,110009000
Aserbaidschan (ab 05/1992),2023,9,49395000,118568000,167963000
Aserbaidschan (ab 05/1992),2023,10,48249000,38138000,86387000
Aserbaidschan (ab 05/1992),2023,11,53779000,146243000,200022000
Aserbaidschan (ab 05/1992),2023,12,40201000,104328000,144529000
Aserbaidschan (ab 05/1992),2024,1,35703000,4341000,40044000
Aserbaidschan (ab 05/1992),2024,2,47682000,71325000,119007000
Aserbaidschan (ab 05/1992),2024,3,42526000,40734000,83260000
Aserbaidschan (ab 05/1992),2024,4,53625000,66010000,119635000
Aserbaidschan (ab 05/1992),2024,5,54900000,63033000,117933000
Aserbaidschan (ab 05/1992),2024,6,54190000,88051000,142241000
Aserbaidschan (ab 05/1992),2024,7,49337000,96136000,145473000
Aserbaidschan (ab 05/1992),2024,8,50986000,205018000,256004000
Aserbaidschan (ab 05/1992),2024,9,56119000,11508000,67627000
Aserbaidschan (ab 05/1992),2024,10,67851000,130281000,198132000
Aserbaidschan (ab 05/1992),2024,11,62027000,138374000,200401000
Aserbaidschan (ab 05/1992),2024,12,47425000,163143000,210568000
Australien,2008,1,511431000,187257000,698688000
Australien,2008,2,547354000,121059000,668413000
Australien,2008,3,525696000,126488000,652184000
Australien,2008,4,566479000,110869000,677348000
Australien,2008,5,524222000,108273000,632495000
Australien,2008,6,560284000,133206000,693490000
Australien,2008,7,663033000,138643000,801676000
Australien,2008,8,519107000,188455000,707562000
Australien,2008,9,570157000,224103000,794260000
Australien,2008,10,589626000,167066000,756692000
Australien,2008,11,516389000,143742000,660131000
Australien,2008,12,519294000,211289000,730583000
Australien,2009,1,435037000,205877000,640914000
Australien,2009,2,445639000,203721000,649360000
Australien,2009,3,475365000,181373000,656738000
Australien,2009,4,456604000,172888000,629492000
Australien,2009,5,479826000,128222000,608048000
Australien,2009,6,586018000,170687000,756705000
Australien,2009,7,593540000,141693000,735233000
Australien,2009,8,522142000,140571000,662713000
Australien,2009,9,621361000,164210000,785571000
Australien,2009,10,534045000,167981000,702026000
Australien,2009,11,653128000,132949000,786077000
Australien,2009,12,525772000,145466000,671238000
Australien,2010,1,480046000,125500000,605546000
Australien,2010,2,657323000,160042000,817365000
Australien,2010,3,719932000,129662000,849594000
Australien,2010,4,630889000,149084000,779973000
Australien,2010,5,626390000,220542000,846932000
Australien,2010,6,641887000,207907000,849794000
Australien,2010,7,735184000,226088000,961272000
Australien,2010,8,582194000,175378000,757572000
Australien,2010,9,745928000,215832000,961760000
Australien,2010,10,645314000,199213000,844527000
Australien,2010,11,711028000,201796000,912824000
Australien,2010,12,672899000,242045000,914944000
Australien,2011,1,587915000,211514000,799429000
Australien,2011,2,621115000,204204000,825319000
Australien,2011,3,748486000,268088000,1016574000
Australien,2011,4,693139000,279340000,972479000
Australien,2011,5,838225000,254989000,1093214000
Australien,2011,6,720874000,245286000,966160000
Australien,2011,7,752688000,194817000,947505000
Australien,2011,8,653033000,312203000,965236000
Australien,2011,9,749773000,306998000,1056771000
Australien,2011,10,651535000,231551000,883086000
Australien,2011,11,681220000,243483000,924703000
Australien,2011,12,649540000,215748000,865288000
Australien,2012,1,732539000,306335000,1038874000
Australien,2012,2,768961000,189717000,958678000
Australien,2012,3,852383000,289011000,1141394000
Australien,2012,4,738298000,240870000,979168000
Australien,2012,5,791841000,300153000,1091994000
Australien,2012,6,825904000,316430000,1142334000
Australien,2012,7,822468000,294774000,1117242000
Australien,2012,8,864237000,239993000,1104230000
Australien,2012,9,747735000,254306000,1002041000
Australien,2012,10,842261000,200143000,1042404000
Australien,2012,11,740201000,236533000,976734000
Australien,2012,12,635192000,156547000,791739000
Australien,2013,1,668980000,223419000,892399000
Australien,2013,2,688041000,289625000,977666000
Australien,2013,3,749589000,185635000,935224000
Australien,2013,4,757216000,298790000,1056006000
Australien,2013,5,690792000,258265000,949057000
Australien,2013,6,772927000,243637000,1016564000
Australien,2013,7,766593000,189844000,956437000
Australien,2013,8,710334000,212859000,923193000
Australien,2013,9,764987000,160918000,925905000
Australien,2013,10,750366000,144998000,895364000
Australien,2013,11,663651000,158863000,822514000
Australien,2013,12,601486000,159853000,761339000
Australien,2014,1,575862000,252455000,828317000
Australien,2014,2,626156000,144494000,770650000
Australien,2014,3,677684000,161432000,839116000
Australien,2014,4,629451000,193277000,822728000
Australien,2014,5,617300000,120759000,738059000
Australien,2014,6,703620000,165553000,869173000
Australien,2014,7,723378000,167867000,891245000
Australien,2014,8,605812000,179085000,784897000
Australien,2014,9,683395000,185147000,868542000
Australien,2014,10,695086000,138429000,833515000
Australien,2014,11,662285000,206571000,868856000
Australien,2014,12,595673000,119881000,715554000
Australien,2015,1,596153000,159940000,756093000
Australien,2015,2,659165000,178321000,837486000
Australien,2015,3,731288000,189497000,920785000
Australien,2015,4,660033000,140917000,800950000
Australien,2015,5,658613000,161635000,820248000
Australien,2015,6,738567000,200608000,939175000
Australien,2015,7,811970000,200169000,1012139000
Australien,2015,8,680116000,144229000,824345000
Australien,2015,9,733351000,185018000,918369000
Australien,2015,10,757912000,137893000,895805000
Australien,2015,11,730844000,134950000,865794000
Australien,2015,12,664287000,214922000,879209000
Australien,2016,1,599233000,211389000,810622000
Australien,2016,2,671917000,162551000,834468000
Australien,2016,3,740878000,193945000,934823000
Australien,2016,4,791789000,202896000,994685000
Australien,2016,5,639025000,222556000,861581000
Australien,2016,6,788215000,157084000,945299000
Australien,2016,7,777206000,157187000,934393000
Australien,2016,8,750861000,163015000,913876000
Australien,2016,9,800914000,179912000,980826000
Australien,2016,10,786584000,141303000,927887000
Australien,2016,11,830322000,186741000,1017063000
Australien,2016,12,807131000,185635000,992766000
Australien,2017,1,689985000,292812000,982797000
Australien,2017,2,714878000,305694000,1020572000
Australien,2017,3,833558000,267591000,1101149000
Australien,2017,4,807638000,378354000,1185992000
Australien,2017,5,793196000,289635000,1082831000
Australien,2017,6,829342000,217909000,1047251000
Australien,2017,7,778749000,257881000,1036630000
Australien,2017,8,814066000,159063000,973129000
Australien,2017,9,808960000,197084000,1006044000
Australien,2017,10,770652000,188792000,959444000
Australien,2017,11,899821000,207901000,1107722000
Australien,2017,12,749678000,161136000,910814000
Australien,2018,1,851824000,214405000,1066229000
Australien,2018,2,847039000,255607000,1102646000
Australien,2018,3,819007000,217414000,1036421000
Australien,2018,4,802988000,185958000,988946000
Australien,2018,5,829113000,296563000,1125676000
Australien,2018,6,937407000,219714000,1157121000
Australien,2018,7,833555000,201276000,1034831000
Australien,2018,8,863788000,215542000,1079330000
Australien,2018,9,818127000,177440000,995567000
Australien,2018,10,845044000,226731000,1071775000
Australien,2018,11,831291000,201695000,1032986000
Australien,2018,12,723880000,194975000,918855000
Australien,2019,1,756019000,204947000,960966000
Australien,2019,2,745319000,174601000,919920000
Australien,2019,3,792807000,345734000,1138541000
Australien,2019,4,790372000,196826000,987198000
Australien,2019,5,834266000,333341000,1167607000
Australien,2019,6,725475000,212879000,938354000
Australien,2019,7,968579000,300039000,1268618000
Australien,2019,8,753861000,279834000,1033695000
Australien,2019,9,711002000,176635000,887637000
Australien,2019,10,735789000,275816000,1011605000
Australien,2019,11,717641000,217989000,935630000
Australien,2019,12,684694000,293039000,977733000
Australien,2020,1,650498000,277445000,927943000
Australien,2020,2,758876000,218855000,977731000
Australien,2020,3,718001000,371537000,1089538000
Australien,2020,4,518820000,216616000,735436000
Australien,2020,5,584102000,291302000,875404000
Australien,2020,6,713702000,231551000,945253000
Australien,2020,7,869014000,250791000,1119805000
Australien,2020,8,700699000,201067000,901766000
Australien,2020,9,767687000,241003000,1008690000
Australien,2020,10,741037000,176596000,917633000
Australien,2020,11,744360000,255293000,999653000
Australien,2020,12,710887000,237905000,948792000
Australien,2021,1,640306000,280377000,920683000
Australien,2021,2,749788000,222441000,972229000
Australien,2021,3,960923000,259949000,1220872000
Australien,2021,4,748196000,192964000,941160000
Australien,2021,5,781070000,278210000,1059280000
Australien,2021,6,851912000,345524000,1197436000
Australien,2021,7,890077000,278283000,1168360000
Australien,2021,8,704988000,227473000,932461000
Australien,2021,9,800283000,216992000,1017275000
Australien,2021,10,832427000,249134000,1081561000
Australien,2021,11,1047650000,185252000,1232902000
Australien,2021,12,874081000,441793000,1315874000
Australien,2022,1,871859000,458700000,1330559000
Australien,2022,2,897114000,293133000,1190247000
Australien,2022,3,1104702000,571403000,1676105000
Australien,2022,4,1025908000,617808000,1643716000
Australien,2022,5,1041780000,700173000,1741953000
Australien,2022,6,875878000,578335000,1454213000
Australien,2022,7,1001439000,715068000,1716507000
Australien,2022,8,927044000,371457000,1298501000
Australien,2022,9,957901000,457833000,1415734000
Australien,2022,10,831041000,617111000,1448152000
Australien,2022,11,1095509000,463289000,1558798000
Australien,2022,12,1151627000,309231000,1460858000
Australien,2023,1,837296000,555072000,1392368000
Australien,2023,2,1130571000,508799000,1639370000
Australien,2023,3,1177545000,534639000,1712184000
Australien,2023,4,808255000,468606000,1276861000
Australien,2023,5,1027303000,510428000,1537731000
Australien,2023,6,1047984000,401349000,1449333000
Australien,2023,7,978971000,454143000,1433114000
Australien,2023,8,902973000,294498000,1197471000
Australien,2023,9,768427000,292001000,1060428000
Australien,2023,10,863214000,346680000,1209894000
Australien,2023,11,1127369000,308153000,1435522000
Australien,2023,12,999780000,513216000,1512996000
Australien,2024,1,830755000,316807000,1147562000
Australien,2024,2,977974000,397575000,1375549000
Australien,2024,3,930600000,340949000,1271549000
Australien,2024,4,991648000,325334000,1316982000
Australien,2024,5,972600000,341835000,1314435000
Australien,2024,6,925837000,369451000,1295288000
Australien,2024,7,1118072000,388133000,1506205000
Australien,2024,8,905193000,311327000,1216520000
Australien,2024,9,921426000,314756000,1236182000
Australien,2024,10,901198000,413457000,1314655000
Australien,2024,11,931100000,314641000,1245741000
Australien,2024,12,818402000,375114000,1193516000
Australisch-Ozeanien (bis 2000),2008,1,0,0,0
Australisch-Ozeanien (bis 2000),2008,2,0,0,0
Australisch-Ozeanien (bis 2000),2008,3,0,0,0
Australisch-Ozeanien (bis 2000),2008,4,0,0,0
Australisch-Ozeanien (bis 2000),2008,5,0,0,0
Australisch-Ozeanien (bis 2000),2008,6,0,0,0
Australisch-Ozeanien (bis 2000),2008,7,0,0,0
Australisch-Ozeanien (bis 2000),2008,8,0,0,0
Australisch-Ozeanien (bis 2000),2008,9,0,0,0
Australisch-Ozeanien (bis 2000),2008,10,0,0,0
Australisch-Ozeanien (bis 2000),2008,11,0,0,0
Australisch-Ozeanien (bis 2000),2008,12,0,0,0
Australisch-Ozeanien (bis 2000),2009,1,0,0,0
Australisch-Ozeanien (bis 2000),2009,2,0,0,0
Australisch-Ozeanien (bis 2000),2009,3,0,0,0
Australisch-Ozeanien (bis 2000),2009,4,0,0,0
Australisch-Ozeanien (bis 2000),2009,5,0,0,0
Australisch-Ozeanien (bis 2000),2009,6,0,0,0
Australisch-Ozeanien (bis 2000),2009,7,0,0,0
Australisch-Ozeanien (bis 2000),2009,8,0,0,0
Australisch-Ozeanien (bis 2000),2009,9,0,0,0
Australisch-Ozeanien (bis 2000),2009,10,0,0,0
Australisch-Ozeanien (bis 2000),2009,11,0,0,0
Australisch-Ozeanien (bis 2000),2009,12,0,0,0
Australisch-Ozeanien (bis 2000),2010,1,0,0,0
Australisch-Ozeanien (bis 2000),2010,2,0,0,0
Australisch-Ozeanien (bis 2000),2010,3,0,0,0
Australisch-Ozeanien (bis 2000),2010,4,0,0,0
Australisch-Ozeanien (bis 2000),2010,5,0,0,0
Australisch-Ozeanien (bis 2000),2010,6,0,0,0
Australisch-Ozeanien (bis 2000),2010,7,0,0,0
Australisch-Ozeanien (bis 2000),2010,8,0,0,0
Australisch-Ozeanien (bis 2000),2010,9,0,0,0
Australisch-Ozeanien (bis 2000),2010,10,0,0,0
Australisch-Ozeanien (bis 2000),2010,11,0,0,0
Australisch-Ozeanien (bis 2000),2010,12,0,0,0
Australisch-Ozeanien (bis 2000),2011,1,0,0,0
Australisch-Ozeanien (bis 2000),2011,2,0,0,0
Australisch-Ozeanien (bis 2000),2011,3,0,0,0
Australisch-Ozeanien (bis 2000),2011,4,0,0,0
Australisch-Ozeanien (bis 2000),2011,5,0,0,0
Australisch-Ozeanien (bis 2000),2011,6,0,0,0
Australisch-Ozeanien (bis 2000),2011,7,0,0,0
Australisch-Ozeanien (bis 2000),2011,8,0,0,0
Australisch-Ozeanien (bis 2000),2011,9,0,0,0
Australisch-Ozeanien (bis 2000),2011,10,0,0,0
Australisch-Ozeanien (bis 2000),2011,11,0,0,0
Australisch-Ozeanien (bis 2000),2011,12,0,0,0
Australisch-Ozeanien (bis 2000),2012,1,0,0,0
Australisch-Ozeanien (bis 2000),2012,2,0,0,0
Australisch-Ozeanien (bis 2000),2012,3,0,0,0
Australisch-Ozeanien (bis 2000),2012,4,0,0,0
Australisch-Ozeanien (bis 2000),2012,5,0,0,0
Australisch-Ozeanien (bis 2000),2012,6,0,0,0
Australisch-Ozeanien (bis 2000),2012,7,0,0,0
Australisch-Ozeanien (bis 2000),2012,8,0,0,0
Australisch-Ozeanien (bis 2000),2012,9,0,0,0
Australisch-Ozeanien (bis 2000),2012,10,0,0,0
Australisch-Ozeanien (bis 2000),2012,11,0,0,0
Australisch-Ozeanien (bis 2000),2012,12,0,0,0
Australisch-Ozeanien (bis 2000),2013,1,0,0,0
Australisch-Ozeanien (bis 2000),2013,2,0,0,0
Australisch-Ozeanien (bis 2000),2013,3,0,0,0
Australisch-Ozeanien (bis 2000),2013,4,0,0,0
Australisch-Ozeanien (bis 2000),2013,5,0,0,0
Australisch-Ozeanien (bis 2000),2013,6,0,0,0
Australisch-Ozeanien (bis 2000),2013,7,0,0,0
Australisch-Ozeanien (bis 2000),2013,8,0,0,0
Australisch-Ozeanien (bis 2000),2013,9,0,0,0
Australisch-Ozeanien (bis 2000),2013,10,0,0,0
Australisch-Ozeanien (bis 2000),2013,11,0,0,0
Australisch-Ozeanien (bis 2000),2013,12,0,0,0
Australisch-Ozeanien (bis 2000),2014,1,0,0,0
Australisch-Ozeanien (bis 2000),2014,2,0,0,0
Australisch-Ozeanien (bis 2000),2014,3,0,0,0
Australisch-Ozeanien (bis 2000),2014,4,0,0,0
Australisch-Ozeanien (bis 2000),2014,5,0,0,0
Australisch-Ozeanien (bis 2000),2014,6,0,0,0
Australisch-Ozeanien (bis 2000),2014,7,0,0,0
Australisch-Ozeanien (bis 2000),2014,8,0,0,0
Australisch-Ozeanien (bis 2000),2014,9,0,0,0
Australisch-Ozeanien (bis 2000),2014,10,0,0,0
Australisch-Ozeanien (bis 2000),2014,11,0,0,0
Australisch-Ozeanien (bis 2000),2014,12,0,0,0
Australisch-Ozeanien (bis 2000),2015,1,0,0,0
Australisch-Ozeanien (bis 2000),2015,2,0,0,0
Australisch-Ozeanien (bis 2000),2015,3,0,0,0
Australisch-Ozeanien (bis 2000),2015,4,0,0,0
Australisch-Ozeanien (bis 2000),2015,5,0,0,0
Australisch-Ozeanien (bis 2000),2015,6,0,0,0
Australisch-Ozeanien (bis 2000),2015,7,0,0,0
Australisch-Ozeanien (bis 2000),2015,8,0,0,0
Australisch-Ozeanien (bis 2000),2015,9,0,0,0
Australisch-Ozeanien (bis 2000),2015,10,0,0,0
Australisch-Ozeanien (bis 2000),2015,11,0,0,0
Australisch-Ozeanien (bis 2000),2015,12,0,0,0
Australisch-Ozeanien (bis 2000),2016,1,0,0,0
Australisch-Ozeanien (bis 2000),2016,2,0,0,0
Australisch-Ozeanien (bis 2000),2016,3,0,0,0
Australisch-Ozeanien (bis 2000),2016,4,0,0,0
Australisch-Ozeanien (bis 2000),2016,5,0,0,0
Australisch-Ozeanien (bis 2000),2016,6,0,0,0
Australisch-Ozeanien (bis 2000),2016,7,0,0,0
Australisch-Ozeanien (bis 2000),2016,8,0,0,0
Australisch-Ozeanien (bis 2000),2016,9,0,0,0
Australisch-Ozeanien (bis 2000),2016,10,0,0,0
Australisch-Ozeanien (bis 2000),2016,11,0,0,0
Australisch-Ozeanien (bis 2000),2016,12,0,0,0
Australisch-Ozeanien (bis 2000),2017,1,0,0,0
Australisch-Ozeanien (bis 2000),2017,2,0,0,0
Australisch-Ozeanien (bis 2000),2017,3,0,0,0
Australisch-Ozeanien (bis 2000),2017,4,0,0,0
Australisch-Ozeanien (bis 2000),2017,5,0,0,0
Australisch-Ozeanien (bis 2000),2017,6,0,0,0
Australisch-Ozeanien (bis 2000),2017,7,0,0,0
Australisch-Ozeanien (bis 2000),2017,8,0,0,0
Australisch-Ozeanien (bis 2000),2017,9,0,0,0
Australisch-Ozeanien (bis 2000),2017,10,0,0,0
Australisch-Ozeanien (bis 2000),2017,11,0,0,0
Australisch-Ozeanien (bis 2000),2017,12,0,0,0
Australisch-Ozeanien (bis 2000),2018,1,0,0,0
Australisch-Ozeanien (bis 2000),2018,2,0,0,0
Australisch-Ozeanien (bis 2000),2018,3,0,0,0
Australisch-Ozeanien (bis 2000),2018,4,0,0,0
Australisch-Ozeanien (bis 2000),2018,5,0,0,0
Australisch-Ozeanien (bis 2000),2018,6,0,0,0
Australisch-Ozeanien (bis 2000),2018,7,0,0,0
Australisch-Ozeanien (bis 2000),2018,8,0,0,0
Australisch-Ozeanien (bis 2000),2018,9,0,0,0
Australisch-Ozeanien (bis 2000),2018,10,0,0,0
Australisch-Ozeanien (bis 2000),2018,11,0,0,0
Australisch-Ozeanien (bis 2000),2018,12,0,0,0
Australisch-Ozeanien (bis 2000),2019,1,0,0,0
Australisch-Ozeanien (bis 2000),2019,2,0,0,0
Australisch-Ozeanien (bis 2000),2019,3,0,0,0
Australisch-Ozeanien (bis 2000),2019,4,0,0,0
Australisch-Ozeanien (bis 2000),2019,5,0,0,0
Australisch-Ozeanien (bis 2000),2019,6,0,0,0
Australisch-Ozeanien (bis 2000),2019,7,0,0,0
Australisch-Ozeanien (bis 2000),2019,8,0,0,0
Australisch-Ozeanien (bis 2000),2019,9,0,0,0
Australisch-Ozeanien (bis 2000),2019,10,0,0,0
Australisch-Ozeanien (bis 2000),2019,11,0,0,0
Australisch-Ozeanien (bis 2000),2019,12,0,0,0
Australisch-Ozeanien (bis 2000),2020,1,0,0,0
Australisch-Ozeanien (bis 2000),2020,2,0,0,0
Australisch-Ozeanien (bis 2000),2020,3,0,0,0
Australisch-Ozeanien (bis 2000),2020,4,0,0,0
Australisch-Ozeanien (bis 2000),2020,5,0,0,0
Australisch-Ozeanien (bis 2000),2020,6,0,0,0
Australisch-Ozeanien (bis 2000),2020,7,0,0,0
Australisch-Ozeanien (bis 2000),2020,8,0,0,0
Australisch-Ozeanien (bis 2000),2020,9,0,0,0
Australisch-Ozeanien (bis 2000),2020,10,0,0,0
Australisch-Ozeanien (bis 2000),2020,11,0,0,0
Australisch-Ozeanien (bis 2000),2020,12,0,0,0
Australisch-Ozeanien (bis 2000),2021,1,0,0,0
Australisch-Ozeanien (bis 2000),2021,2,0,0,0
Australisch-Ozeanien (bis 2000),2021,3,0,0,0
Australisch-Ozeanien (bis 2000),2021,4,0,0,0
Australisch-Ozeanien (bis 2000),2021,5,0,0,0
Australisch-Ozeanien (bis 2000),2021,6,0,0,0
Australisch-Ozeanien (bis 2000),2021,7,0,0,0
Australisch-Ozeanien (bis 2000),2021,8,0,0,0
Australisch-Ozeanien (bis 2000),2021,9,0,0,0
Australisch-Ozeanien (bis 2000),2021,10,0,0,0
Australisch-Ozeanien (bis 2000),2021,11,0,0,0
Australisch-Ozeanien (bis 2000),2021,12,0,0,0
Australisch-Ozeanien (bis 2000),2022,1,0,0,0
Australisch-Ozeanien (bis 2000),2022,2,0,0,0
Australisch-Ozeanien (bis 2000),2022,3,0,0,0
Australisch-Ozeanien (bis 2000),2022,4,0,0,0
Australisch-Ozeanien (bis 2000),2022,5,0,0,0
Australisch-Ozeanien (bis 2000),2022,6,0,0,0
Australisch-Ozeanien (bis 2000),2022,7,0,0,0
Australisch-Ozeanien (bis 2000),2022,8,0,0,0
Australisch-Ozeanien (bis 2000),2022,9,0,0,0
Australisch-Ozeanien (bis 2000),2022,10,0,0,0
Australisch-Ozeanien (bis 2000),2022,11,0,0,0
Australisch-Ozeanien (bis 2000),2022,12,0,0,0
Australisch-Ozeanien (bis 2000),2023,1,0,0,0
Australisch-Ozeanien (bis 2000),2023,2,0,0,0
Australisch-Ozeanien (bis 2000),2023,3,0,0,0
Australisch-Ozeanien (bis 2000),2023,4,0,0,0
Australisch-Ozeanien (bis 2000),2023,5,0,0,0
Australisch-Ozeanien (bis 2000),2023,6,0,0,0
Australisch-Ozeanien (bis 2000),2023,7,0,0,0
Australisch-Ozeanien (bis 2000),2023,8,0,0,0
Australisch-Ozeanien (bis 2000),2023,9,0,0,0
Australisch-Ozeanien (bis 2000),2023,10,0,0,0
Australisch-Ozeanien (bis 2000),2023,11,0,0,0
Australisch-Ozeanien (bis 2000),2023,12,0,0,0
Australisch-Ozeanien (bis 2000),2024,1,0,0,0
Australisch-Ozeanien (bis 2000),2024,2,0,0,0
Australisch-Ozeanien (bis 2000),2024,3,0,0,0
Australisch-Ozeanien (bis 2000),2024,4,0,0,0
Australisch-Ozeanien (bis 2000),2024,5,0,0,0
Australisch-Ozeanien (bis 2000),2024,6,0,0,0
Australisch-Ozeanien (bis 2000),2024,7,0,0,0
Australisch-Ozeanien (bis 2000),2024,8,0,0,0
Australisch-Ozeanien (bis 2000),2024,9,0,0,0
Australisch-Ozeanien (bis 2000),2024,10,0,0,0
Australisch-Ozeanien (bis 2000),2024,11,0,0,0
Australisch-Ozeanien (bis 2000),2024,12,0,0,0
Bahamas,2008,1,1615000,9000,1624000
Bahamas,2008,2,8740000,20152000,28892000
Bahamas,2008,3,6538000,19841000,26379000
Bahamas,2008,4,1315000,17000,1332000
Bahamas,2008,5,931000,12765000,13696000
Bahamas,2008,6,2098000,23671000,25769000
Bahamas,2008,7,755000,12000,767000
Bahamas,2008,8,1969000,18071000,20040000
Bahamas,2008,9,624000,44000,668000
Bahamas,2008,10,2028000,31691000,33719000
Bahamas,2008,11,1576000,5364000,6940000
Bahamas,2008,12,1303000,20969000,22272000
Bahamas,2009,1,1466000,14086000,15552000
Bahamas,2009,2,1596000,10000,1606000
Bahamas,2009,3,1269000,23728000,24997000
Bahamas,2009,4,1510000,14546000,16056000
Bahamas,2009,5,2543000,174000,2717000
Bahamas,2009,6,1168000,13726000,14894000
Bahamas,2009,7,1246000,13580000,14826000
Bahamas,2009,8,599000,1632000,2231000
Bahamas,2009,9,2329000,10360000,12689000
Bahamas,2009,10,14920000,8000,14928000
Bahamas,2009,11,10486000,4015000,14501000
Bahamas,2009,12,1239000,10925000,12164000
Bahamas,2010,1,534000,10000,544000
Bahamas,2010,2,634000,219000,853000
Bahamas,2010,3,1315000,35065000,36380000
Bahamas,2010,4,1678000,30000,1708000
Bahamas,2010,5,839000,83000,922000
Bahamas,2010,6,1750000,3000,1753000
Bahamas,2010,7,1376000,4006000,5382000
Bahamas,2010,8,977000,55000,1032000
Bahamas,2010,9,795000,7000,802000
Bahamas,2010,10,1484000,381000,1865000
Bahamas,2010,11,4318000,220373000,224691000
Bahamas,2010,12,1076000,34000,1110000
Bahamas,2011,1,674000,493000,1167000
Bahamas,2011,2,702000,14000,716000
Bahamas,2011,3,1581000,122000,1703000
Bahamas,2011,4,583000,58000,641000
Bahamas,2011,5,1671000,12000,1683000
Bahamas,2011,6,1199000,36000,1235000
Bahamas,2011,7,40153000,38000,40191000
Bahamas,2011,8,757000,1914000,2671000
Bahamas,2011,9,712000,161000,873000
Bahamas,2011,10,2067000,152000,2219000
Bahamas,2011,11,1715000,1361000,3076000
Bahamas,2011,12,4433000,67000,4500000
Bahamas,2012,1,7917000,5000,7922000
Bahamas,2012,2,33866000,13000,33879000
Bahamas,2012,3,908000,1655000,2563000
Bahamas,2012,4,1196000,3174000,4370000
Bahamas,2012,5,1588000,2340000,3928000
Bahamas,2012,6,28227000,21000,28248000
Bahamas,2012,7,1298000,1740000,3038000
Bahamas,2012,8,46807000,215000,47022000
Bahamas,2012,9,12922000,29000,12951000
Bahamas,2012,10,1985000,1862000,3847000
Bahamas,2012,11,2519000,5000,2524000
Bahamas,2012,12,555000,218000,773000
Bahamas,2013,1,937000,40000,977000
Bahamas,2013,2,15291000,110000,15401000
Bahamas,2013,3,1523000,31520000,33043000
Bahamas,2013,4,52527000,164000,52691000
Bahamas,2013,5,1469000,2222000,3691000
Bahamas,2013,6,1272000,1683000,2955000
Bahamas,2013,7,1336000,1756000,3092000
Bahamas,2013,8,1769000,1000,1770000
Bahamas,2013,9,670000,56000,726000
Bahamas,2013,10,3224000,514000,3738000
Bahamas,2013,11,1214000,2103000,3317000
Bahamas,2013,12,3266000,8000,3274000
Bahamas,2014,1,985000,136000,1121000
Bahamas,2014,2,1076000,28000,1104000
Bahamas,2014,3,11545000,12000,11557000
Bahamas,2014,4,954000,1649000,2603000
Bahamas,2014,5,1415000,8000,1423000
Bahamas,2014,6,871000,536000,1407000
Bahamas,2014,7,1896000,2064000,3960000
Bahamas,2014,8,1743000,9000,1752000
Bahamas,2014,9,1380000,27000,1407000
Bahamas,2014,10,1494000,42000,1536000
Bahamas,2014,11,1958000,402000,2360000
Bahamas,2014,12,978000,571000,1549000
Bahamas,2015,1,16462000,87000,16549000
Bahamas,2015,2,1112000,12000,1124000
Bahamas,2015,3,2350000,279000,2629000
Bahamas,2015,4,2124000,25000,2149000
Bahamas,2015,5,1006000,10000,1016000
Bahamas,2015,6,1526000,53000,1579000
Bahamas,2015,7,863000,2394000,3257000
Bahamas,2015,8,2515000,247000,2762000
Bahamas,2015,9,2728000,427000,3155000
Bahamas,2015,10,2196000,744000,2940000
Bahamas,2015,11,2537000,165000,2702000
Bahamas,2015,12,5337000,136000,5473000
Bahamas,2016,1,3635000,54000,3689000
Bahamas,2016,2,4598000,192000,4790000
Bahamas,2016,3,2960000,256000,3216000
Bahamas,2016,4,4309000,797000,5106000
Bahamas,2016,5,3072000,513000,3585000
Bahamas,2016,6,2812000,134000,2946000
Bahamas,2016,7,4470000,177000,4647000
Bahamas,2016,8,2720000,3068000,5788000
Bahamas,2016,9,3306000,315000,3621000
Bahamas,2016,10,2273000,102000,2375000
Bahamas,2016,11,1320000,255000,1575000
Bahamas,2016,12,9335000,790000,10125000
Bahamas,2017,1,1524000,214000,1738000
Bahamas,2017,2,1565000,187000,1752000
Bahamas,2017,3,3175000,259000,3434000
Bahamas,2017,4,1947000,751000,2698000
Bahamas,2017,5,1764000,141000,1905000
Bahamas,2017,6,1237000,274000,1511000
Bahamas,2017,7,7522000,856000,8378000
Bahamas,2017,8,1715000,331000,2046000
Bahamas,2017,9,4513000,155000,4668000
Bahamas,2017,10,2680000,143000,2823000
Bahamas,2017,11,2340000,198000,2538000
Bahamas,2017,12,1781000,426000,2207000
Bahamas,2018,1,2026000,70000,2096000
Bahamas,2018,2,2540000,41000,2581000
Bahamas,2018,3,3677000,16000,3693000
Bahamas,2018,4,2233000,83000,2316000
Bahamas,2018,5,3213000,247000,3460000
Bahamas,2018,6,3140000,485000,3625000
Bahamas,2018,7,2642000,63000,2705000
Bahamas,2018,8,4401000,81000,4482000
Bahamas,2018,9,7114000,27000,7141000
Bahamas,2018,10,3797000,81000,3878000
Bahamas,2018,11,4080000,88000,4168000
Bahamas,2018,12,4635000,80000,4715000
Bahamas,2019,1,3863000,584000,4447000
Bahamas,2019,2,3422000,7000,3429000
Bahamas,2019,3,2983000,80000,3063000
Bahamas,2019,4,3241000,58000,3299000
Bahamas,2019,5,3076000,203000,3279000
Bahamas,2019,6,1177000,79000,1256000
Bahamas,2019,7,1969000,492000,2461000
Bahamas,2019,8,1327000,393000,1720000
Bahamas,2019,9,1959000,219000,2178000
Bahamas,2019,10,1475000,191000,1666000
Bahamas,2019,11,4811000,161000,4972000
Bahamas,2019,12,3092000,431000,3523000
Bahamas,2020,1,1897000,105000,2002000
Bahamas,2020,2,5112000,48000,5160000
Bahamas,2020,3,4135000,107000,4242000
Bahamas,2020,4,2333000,104000,2437000
Bahamas,2020,5,1366000,111000,1477000
Bahamas,2020,6,2179000,170000,2349000
Bahamas,2020,7,1174000,670000,1844000
Bahamas,2020,8,721000,307000,1028000
Bahamas,2020,9,1894000,56000,1950000
Bahamas,2020,10,1190000,115000,1305000
Bahamas,2020,11,1251000,198000,1449000
Bahamas,2020,12,4578000,128000,4706000
Bahamas,2021,1,644000,280000,924000
Bahamas,2021,2,955000,142000,1097000
Bahamas,2021,3,1233000,248000,1481000
Bahamas,2021,4,1439000,940000,2379000
Bahamas,2021,5,887000,14000,901000
Bahamas,2021,6,1730000,166000,1896000
Bahamas,2021,7,1030000,293000,1323000
Bahamas,2021,8,986000,56000,1042000
Bahamas,2021,9,3182000,241000,3423000
Bahamas,2021,10,1064000,194000,1258000
Bahamas,2021,11,1094000,154000,1248000
Bahamas,2021,12,1204000,164000,1368000
Bahamas,2022,1,2610000,15000,2625000
Bahamas,2022,2,1762000,395000,2157000
Bahamas,2022,3,2623000,185000,2808000
Bahamas,2022,4,4221000,11000,4232000
Bahamas,2022,5,1127000,537000,1664000
Bahamas,2022,6,1597000,75000,1672000
Bahamas,2022,7,1434000,40000,1474000
Bahamas,2022,8,6537000,255000,6792000
Bahamas,2022,9,1304000,234000,1538000
Bahamas,2022,10,2156000,1200000,3356000
Bahamas,2022,11,2653000,142000,2795000
Bahamas,2022,12,1457000,474000,1931000
Bahamas,2023,1,1333000,501000,1834000
Bahamas,2023,2,1356000,49000,1405000
Bahamas,2023,3,2894000,137000,3031000
Bahamas,2023,4,1063000,131000,1194000
Bahamas,2023,5,1235000,6000,1241000
Bahamas,2023,6,931000,549000,1480000
Bahamas,2023,7,1559000,529000,2088000
Bahamas,2023,8,1257000,101000,1358000
Bahamas,2023,9,1246000,29000,1275000
Bahamas,2023,10,1024000,258000,1282000
Bahamas,2023,11,1590000,347000,1937000
Bahamas,2023,12,1054000,259000,1313000
Bahamas,2024,1,10188000,343000,10531000
Bahamas,2024,2,2377000,162000,2539000
Bahamas,2024,3,2563000,137000,2700000
Bahamas,2024,4,3056000,82000,3138000
Bahamas,2024,5,3828000,50000,3878000
Bahamas,2024,6,2731000,93000,2824000
Bahamas,2024,7,1543000,143000,1686000
Bahamas,2024,8,1790000,222000,2012000
Bahamas,2024,9,2429000,168000,2597000
Bahamas,2024,10,2644000,52000,2696000
Bahamas,2024,11,1967000,196000,2163000
Bahamas,2024,12,2699000,195000,2894000
Bahrain,2008,1,27769000,7169000,34938000
Bahrain,2008,2,29435000,10474000,39909000
Bahrain,2008,3,25588000,6174000,31762000
Bahrain,2008,4,26337000,8152000,34489000
Bahrain,2008,5,26207000,7422000,33629000
Bahrain,2008,6,30724000,10143000,40867000
Bahrain,2008,7,26744000,10753000,37497000
Bahrain,2008,8,29542000,13103000,42645000
Bahrain,2008,9,29884000,8328000,38212000
Bahrain,2008,10,33978000,9457000,43435000
Bahrain,2008,11,31563000,6485000,38048000
Bahrain,2008,12,34846000,19684000,54530000
Bahrain,2009,1,20422000,8190000,28612000
Bahrain,2009,2,21501000,5609000,27110000
Bahrain,2009,3,20343000,6553000,26896000
Bahrain,2009,4,15860000,12761000,28621000
Bahrain,2009,5,16929000,7110000,24039000
Bahrain,2009,6,19225000,4336000,23561000
Bahrain,2009,7,31281000,2075000,33356000
Bahrain,2009,8,21619000,3655000,25274000
Bahrain,2009,9,20299000,1928000,22227000
Bahrain,2009,10,24117000,3516000,27633000
Bahrain,2009,11,28972000,8494000,37466000
Bahrain,2009,12,62155000,3062000,65217000
Bahrain,2010,1,17465000,5998000,23463000
Bahrain,2010,2,24696000,3149000,27845000
Bahrain,2010,3,34936000,8619000,43555000
Bahrain,2010,4,24305000,4330000,28635000
Bahrain,2010,5,20197000,3308000,23505000
Bahrain,2010,6,39861000,3893000,43754000
Bahrain,2010,7,25353000,3096000,28449000
Bahrain,2010,8,21797000,3671000,25468000
Bahrain,2010,9,31525000,3847000,35372000
Bahrain,2010,10,22389000,3232000,25621000
Bahrain,2010,11,28857000,11272000,40129000
Bahrain,2010,12,67476000,2740000,70216000
Bahrain,2011,1,24312000,5707000,30019000
Bahrain,2011,2,64650000,3452000,68102000
Bahrain,2011,3,23700000,4914000,28614000
Bahrain,2011,4,25062000,2887000,27949000
Bahrain,2011,5,21464000,4370000,25834000
Bahrain,2011,6,19384000,6917000,26301000
Bahrain,2011,7,24086000,3494000,27580000
Bahrain,2011,8,68389000,5383000,73772000
Bahrain,2011,9,33309000,3817000,37126000
Bahrain,2011,10,39138000,4501000,43639000
Bahrain,2011,11,77106000,2352000,79458000
Bahrain,2011,12,52330000,3705000,56035000
Bahrain,2012,1,27360000,2676000,30036000
Bahrain,2012,2,27637000,3160000,30797000
Bahrain,2012,3,37208000,3559000,40767000
Bahrain,2012,4,33469000,2896000,36365000
Bahrain,2012,5,31942000,3962000,35904000
Bahrain,2012,6,36436000,3608000,40044000
Bahrain,2012,7,35012000,2655000,37667000
Bahrain,2012,8,32716000,2064000,34780000
Bahrain,2012,9,34556000,1870000,36426000
Bahrain,2012,10,37268000,5094000,42362000
Bahrain,2012,11,29722000,2743000,32465000
Bahrain,2012,12,36235000,1420000,37655000
Bahrain,2013,1,32859000,3824000,36683000
Bahrain,2013,2,22326000,4853000,27179000
Bahrain,2013,3,36291000,4152000,40443000
Bahrain,2013,4,26484000,4063000,30547000
Bahrain,2013,5,27490000,4174000,31664000
Bahrain,2013,6,30299000,3179000,33478000
Bahrain,2013,7,40904000,4790000,45694000
Bahrain,2013,8,32620000,3507000,36127000
Bahrain,2013,9,27846000,4255000,32101000
Bahrain,2013,10,22852000,3814000,26666000
Bahrain,2013,11,30469000,11658000,42127000
Bahrain,2013,12,24590000,4049000,28639000
Bahrain,2014,1,26685000,3464000,30149000
Bahrain,2014,2,35438000,3513000,38951000
Bahrain,2014,3,27373000,3951000,31324000
Bahrain,2014,4,29311000,3595000,32906000
Bahrain,2014,5,29751000,5279000,35030000
Bahrain,2014,6,35922000,3321000,39243000
Bahrain,2014,7,34492000,4830000,39322000
Bahrain,2014,8,29285000,2985000,32270000
Bahrain,2014,9,31701000,4810000,36511000
Bahrain,2014,10,33263000,4291000,37554000
Bahrain,2014,11,30984000,11329000,42313000
Bahrain,2014,12,29817000,3466000,33283000
Bahrain,2015,1,27320000,1525000,28845000
Bahrain,2015,2,29774000,2169000,31943000
Bahrain,2015,3,27376000,3078000,30454000
Bahrain,2015,4,79179000,2146000,81325000
Bahrain,2015,5,48196000,1408000,49604000
Bahrain,2015,6,23963000,2049000,26012000
Bahrain,2015,7,33613000,2761000,36374000
Bahrain,2015,8,26429000,1958000,28387000
Bahrain,2015,9,29046000,2452000,31498000
Bahrain,2015,10,33465000,1809000,35274000
Bahrain,2015,11,29977000,2031000,32008000
Bahrain,2015,12,26164000,1419000,27583000
Bahrain,2016,1,26739000,2826000,29565000
Bahrain,2016,2,20516000,3068000,23584000
Bahrain,2016,3,29695000,1890000,31585000
Bahrain,2016,4,35339000,2595000,37934000
Bahrain,2016,5,22470000,2276000,24746000
Bahrain,2016,6,26675000,2971000,29646000
Bahrain,2016,7,23737000,2691000,26428000
Bahrain,2016,8,24231000,2624000,26855000
Bahrain,2016,9,37720000,2259000,39979000
Bahrain,2016,10,28395000,2884000,31279000
Bahrain,2016,11,30202000,2654000,32856000
Bahrain,2016,12,31902000,3199000,35101000
Bahrain,2017,1,34156000,5061000,39217000
Bahrain,2017,2,37319000,4358000,41677000
Bahrain,2017,3,53910000,4923000,58833000
Bahrain,2017,4,33239000,1819000,35058000
Bahrain,2017,5,28029000,4081000,32110000
Bahrain,2017,6,33330000,3452000,36782000
Bahrain,2017,7,33007000,3103000,36110000
Bahrain,2017,8,34574000,2353000,36927000
Bahrain,2017,9,46281000,3455000,49736000
Bahrain,2017,10,33025000,2721000,35746000
Bahrain,2017,11,35119000,3809000,38928000
Bahrain,2017,12,43699000,2226000,45925000
Bahrain,2018,1,29660000,4040000,33700000
Bahrain,2018,2,39837000,4555000,44392000
Bahrain,2018,3,29499000,3675000,33174000
Bahrain,2018,4,30247000,5831000,36078000
Bahrain,2018,5,23191000,6871000,30062000
Bahrain,2018,6,30172000,7113000,37285000
Bahrain,2018,7,33635000,8529000,42164000
Bahrain,2018,8,27945000,4507000,32452000
Bahrain,2018,9,30672000,3868000,34540000
Bahrain,2018,10,31948000,8249000,40197000
Bahrain,2018,11,29324000,7490000,36814000
Bahrain,2018,12,27223000,3241000,30464000
Bahrain,2019,1,26543000,7712000,34255000
Bahrain,2019,2,29136000,10589000,39725000
Bahrain,2019,3,26053000,8217000,34270000
Bahrain,2019,4,23869000,7599000,31468000
Bahrain,2019,5,37059000,6956000,44015000
Bahrain,2019,6,23044000,8961000,32005000
Bahrain,2019,7,41102000,9042000,50144000
Bahrain,2019,8,26388000,6719000,33107000
Bahrain,2019,9,23478000,5817000,29295000
Bahrain,2019,10,44073000,9536000,53609000
Bahrain,2019,11,43284000,6779000,50063000
Bahrain,2019,12,35176000,9156000,44332000
Bahrain,2020,1,26495000,8258000,34753000
Bahrain,2020,2,42270000,8948000,51218000
Bahrain,2020,3,34039000,6887000,40926000
Bahrain,2020,4,36196000,6648000,42844000
Bahrain,2020,5,25818000,3164000,28982000
Bahrain,2020,6,24776000,15073000,39849000
Bahrain,2020,7,26606000,15322000,41928000
Bahrain,2020,8,165232000,13682000,178914000
Bahrain,2020,9,35853000,14047000,49900000
Bahrain,2020,10,30026000,8243000,38269000
Bahrain,2020,11,26367000,10609000,36976000
Bahrain,2020,12,32541000,13979000,46520000
Bahrain,2021,1,39795000,8621000,48416000
Bahrain,2021,2,98710000,9042000,107752000
Bahrain,2021,3,30535000,13140000,43675000
Bahrain,2021,4,19865000,17035000,36900000
Bahrain,2021,5,16462000,9843000,26305000
Bahrain,2021,6,88195000,8864000,97059000
Bahrain,2021,7,18848000,13297000,32145000
Bahrain,2021,8,94073000,7505000,101578000
Bahrain,2021,9,33377000,14999000,48376000
Bahrain,2021,10,22623000,11949000,34572000
Bahrain,2021,11,37369000,8904000,46273000
Bahrain,2021,12,26369000,13778000,40147000
Bahrain,2022,1,24221000,15382000,39603000
Bahrain,2022,2,37434000,17537000,54971000
Bahrain,2022,3,29238000,13610000,42848000
Bahrain,2022,4,26006000,18700000,44706000
Bahrain,2022,5,25310000,26033000,51343000
Bahrain,2022,6,22603000,26620000,49223000
Bahrain,2022,7,28258000,15881000,44139000
Bahrain,2022,8,28556000,31667000,60223000
Bahrain,2022,9,34488000,20612000,55100000
Bahrain,2022,10,122755000,24389000,147144000
Bahrain,2022,11,31382000,22296000,53678000
Bahrain,2022,12,30608000,18645000,49253000
Bahrain,2023,1,28174000,13447000,41621000
Bahrain,2023,2,129803000,15806000,145609000
Bahrain,2023,3,44379000,30902000,75281000
Bahrain,2023,4,26537000,22217000,48754000
Bahrain,2023,5,27367000,22324000,49691000
Bahrain,2023,6,112082000,17373000,129455000
Bahrain,2023,7,29117000,13442000,42559000
Bahrain,2023,8,35191000,22649000,57840000
Bahrain,2023,9,121381000,12899000,134280000
Bahrain,2023,10,116195000,15404000,131599000
Bahrain,2023,11,255775000,28258000,284033000
Bahrain,2023,12,129535000,14335000,143870000
Bahrain,2024,1,22849000,20866000,43715000
Bahrain,2024,2,47861000,12670000,60531000
Bahrain,2024,3,26168000,13541000,39709000
Bahrain,2024,4,30056000,26002000,56058000
Bahrain,2024,5,116095000,24105000,140200000
Bahrain,2024,6,24771000,27762000,52533000
Bahrain,2024,7,34844000,40434000,75278000
Bahrain,2024,8,28563000,15576000,44139000
Bahrain,2024,9,122320000,22415000,144735000
Bahrain,2024,10,31014000,19041000,50055000
Bahrain,2024,11,37246000,52043000,89289000
Bahrain,2024,12,23571000,27263000,50834000
Bangladesch,2008,1,25308000,140350000,165658000
Bangladesch,2008,2,16324000,139657000,155981000
Bangladesch,2008,3,15155000,143106000,158261000
Bangladesch,2008,4,24369000,153986000,178355000
Bangladesch,2008,5,20449000,122926000,143375000
Bangladesch,2008,6,23664000,116406000,140070000
Bangladesch,2008,7,30106000,154773000,184879000
Bangladesch,2008,8,27770000,171173000,198943000
Bangladesch,2008,9,29690000,167308000,196998000
Bangladesch,2008,10,19149000,147902000,167051000
Bangladesch,2008,11,19978000,132382000,152360000
Bangladesch,2008,12,17064000,132709000,149773000
Bangladesch,2009,1,13453000,165696000,179149000
Bangladesch,2009,2,16613000,180406000,197019000
Bangladesch,2009,3,17661000,214985000,232646000
Bangladesch,2009,4,48293000,190742000,239035000
Bangladesch,2009,5,22332000,162777000,185109000
Bangladesch,2009,6,20496000,154674000,175170000
Bangladesch,2009,7,26468000,189462000,215930000
Bangladesch,2009,8,31797000,189935000,221732000
Bangladesch,2009,9,21142000,183363000,204505000
Bangladesch,2009,10,21045000,139521000,160566000
Bangladesch,2009,11,33148000,117931000,151079000
Bangladesch,2009,12,31454000,125410000,156864000
Bangladesch,2010,1,21723000,144815000,166538000
Bangladesch,2010,2,20394000,160345000,180739000
Bangladesch,2010,3,40620000,202424000,243044000
Bangladesch,2010,4,37263000,178913000,216176000
Bangladesch,2010,5,26125000,164592000,190717000
Bangladesch,2010,6,27758000,186791000,214549000
Bangladesch,2010,7,32323000,191542000,223865000
Bangladesch,2010,8,54641000,259657000,314298000
Bangladesch,2010,9,37008000,247152000,284160000
Bangladesch,2010,10,37067000,217009000,254076000
Bangladesch,2010,11,41057000,194596000,235653000
Bangladesch,2010,12,89204000,210266000,299470000
Bangladesch,2011,1,53274000,236027000,289301000
Bangladesch,2011,2,46676000,248189000,294865000
Bangladesch,2011,3,49930000,304873000,354803000
Bangladesch,2011,4,28074000,240795000,268869000
Bangladesch,2011,5,32839000,279670000,312509000
Bangladesch,2011,6,27417000,259331000,286748000
Bangladesch,2011,7,26076000,279726000,305802000
Bangladesch,2011,8,48803000,321181000,369984000
Bangladesch,2011,9,41122000,314365000,355487000
Bangladesch,2011,10,27553000,187570000,215123000
Bangladesch,2011,11,30470000,234006000,264476000
Bangladesch,2011,12,35900000,194719000,230619000
Bangladesch,2012,1,22398000,274170000,296568000
Bangladesch,2012,2,29524000,276903000,306427000
Bangladesch,2012,3,33216000,319137000,352353000
Bangladesch,2012,4,35935000,253410000,289345000
Bangladesch,2012,5,30503000,204264000,234767000
Bangladesch,2012,6,27355000,232056000,259411000
Bangladesch,2012,7,38358000,284330000,322688000
Bangladesch,2012,8,34275000,369157000,403432000
Bangladesch,2012,9,55363000,288910000,344273000
Bangladesch,2012,10,33825000,250798000,284623000
Bangladesch,2012,11,28922000,247218000,276140000
Bangladesch,2012,12,49954000,162882000,212836000
Bangladesch,2013,1,41130000,304409000,345539000
Bangladesch,2013,2,36537000,288153000,324690000
Bangladesch,2013,3,39547000,302229000,341776000
Bangladesch,2013,4,48615000,318523000,367138000
Bangladesch,2013,5,33521000,269317000,302838000
Bangladesch,2013,6,38119000,237588000,275707000
Bangladesch,2013,7,29660000,327048000,356708000
Bangladesch,2013,8,38051000,369766000,407817000
Bangladesch,2013,9,30199000,330512000,360711000
Bangladesch,2013,10,30368000,313154000,343522000
Bangladesch,2013,11,35487000,267180000,302667000
Bangladesch,2013,12,53895000,196051000,249946000
Bangladesch,2014,1,31362000,327456000,358818000
Bangladesch,2014,2,59837000,327479000,387316000
Bangladesch,2014,3,60939000,364081000,425020000
Bangladesch,2014,4,33648000,298105000,331753000
Bangladesch,2014,5,33144000,264657000,297801000
Bangladesch,2014,6,46567000,283936000,330503000
Bangladesch,2014,7,44174000,354371000,398545000
Bangladesch,2014,8,34550000,365887000,400437000
Bangladesch,2014,9,77022000,339495000,416517000
Bangladesch,2014,10,42344000,350857000,393201000
Bangladesch,2014,11,49799000,279286000,329085000
Bangladesch,2014,12,61899000,254841000,316740000
Bangladesch,2015,1,50240000,382815000,433055000
Bangladesch,2015,2,49704000,386130000,435834000
Bangladesch,2015,3,66845000,445651000,512496000
Bangladesch,2015,4,43896000,397119000,441015000
Bangladesch,2015,5,46442000,305552000,351994000
Bangladesch,2015,6,57813000,340516000,398329000
Bangladesch,2015,7,72459000,453763000,526222000
Bangladesch,2015,8,50610000,426344000,476954000
Bangladesch,2015,9,53906000,417549000,471455000
Bangladesch,2015,10,41045000,405228000,446273000
Bangladesch,2015,11,47989000,314040000,362029000
Bangladesch,2015,12,56049000,337786000,393835000
Bangladesch,2016,1,34336000,384446000,418782000
Bangladesch,2016,2,78211000,441499000,519710000
Bangladesch,2016,3,84645000,440087000,524732000
Bangladesch,2016,4,47794000,395542000,443336000
Bangladesch,2016,5,50447000,352815000,403262000
Bangladesch,2016,6,70810000,346849000,417659000
Bangladesch,2016,7,47604000,406964000,454568000
Bangladesch,2016,8,52720000,496587000,549307000
Bangladesch,2016,9,61216000,450750000,511966000
Bangladesch,2016,10,38478000,441659000,480137000
Bangladesch,2016,11,65557000,403209000,468766000
Bangladesch,2016,12,67690000,363243000,430933000
Bangladesch,2017,1,42876000,425093000,467969000
Bangladesch,2017,2,47114000,440504000,487618000
Bangladesch,2017,3,66728000,511524000,578252000
Bangladesch,2017,4,53797000,439981000,493778000
Bangladesch,2017,5,47297000,450215000,497512000
Bangladesch,2017,6,62096000,403299000,465395000
Bangladesch,2017,7,64257000,432217000,496474000
Bangladesch,2017,8,67126000,523009000,590135000
Bangladesch,2017,9,52695000,508381000,561076000
Bangladesch,2017,10,62787000,425245000,488032000
Bangladesch,2017,11,60715000,450013000,510728000
Bangladesch,2017,12,99484000,354350000,453834000
Bangladesch,2018,1,45082000,470043000,515125000
Bangladesch,2018,2,52957000,448434000,501391000
Bangladesch,2018,3,139283000,476348000,615631000
Bangladesch,2018,4,51672000,532195000,583867000
Bangladesch,2018,5,56377000,454386000,510763000
Bangladesch,2018,6,70200000,415000000,485200000
Bangladesch,2018,7,60058000,552956000,613014000
Bangladesch,2018,8,77453000,536442000,613895000
Bangladesch,2018,9,58397000,525672000,584069000
Bangladesch,2018,10,45855000,538651000,584506000
Bangladesch,2018,11,71807000,493312000,565119000
Bangladesch,2018,12,98977000,364824000,463801000
Bangladesch,2019,1,51330000,555000000,606330000
Bangladesch,2019,2,56834000,505573000,562407000
Bangladesch,2019,3,84394000,545186000,629580000
Bangladesch,2019,4,43438000,550065000,593503000
Bangladesch,2019,5,81011000,469444000,550455000
Bangladesch,2019,6,61976000,394084000,456060000
Bangladesch,2019,7,51452000,488152000,539604000
Bangladesch,2019,8,121548000,536813000,658361000
Bangladesch,2019,9,62526000,500724000,563250000
Bangladesch,2019,10,71876000,499022000,570898000
Bangladesch,2019,11,60582000,515183000,575765000
Bangladesch,2019,12,66764000,372783000,439547000
Bangladesch,2020,1,49826000,548788000,598614000
Bangladesch,2020,2,53294000,465449000,518743000
Bangladesch,2020,3,55656000,678509000,734165000
Bangladesch,2020,4,32926000,461827000,494753000
Bangladesch,2020,5,37999000,299026000,337025000
Bangladesch,2020,6,49138000,281751000,330889000
Bangladesch,2020,7,37536000,401315000,438851000
Bangladesch,2020,8,40402000,594301000,634703000
Bangladesch,2020,9,29867000,606580000,636447000
Bangladesch,2020,10,48717000,537092000,585809000
Bangladesch,2020,11,48241000,486997000,535238000
Bangladesch,2020,12,47377000,379180000,426557000
Bangladesch,2021,1,40411000,463263000,503674000
Bangladesch,2021,2,49237000,532452000,581689000
Bangladesch,2021,3,64552000,566948000,631500000
Bangladesch,2021,4,51385000,665826000,717211000
Bangladesch,2021,5,51525000,565754000,617279000
Bangladesch,2021,6,66550000,531019000,597569000
Bangladesch,2021,7,61861000,576671000,638532000
Bangladesch,2021,8,47870000,572491000,620361000
Bangladesch,2021,9,67949000,669562000,737511000
Bangladesch,2021,10,46670000,685511000,732181000
Bangladesch,2021,11,104399000,657744000,762143000
Bangladesch,2021,12,120725000,642048000,762773000
Bangladesch,2022,1,48209000,721212000,769421000
Bangladesch,2022,2,54157000,600253000,654410000
Bangladesch,2022,3,64940000,891166000,956106000
Bangladesch,2022,4,57525000,858021000,915546000
Bangladesch,2022,5,68526000,917282000,985808000
Bangladesch,2022,6,85453000,762913000,848366000
Bangladesch,2022,7,64267000,771144000,835411000
Bangladesch,2022,8,72639000,950686000,1023325000
Bangladesch,2022,9,122976000,1017007000,1139983000
Bangladesch,2022,10,55834000,942559000,998393000
Bangladesch,2022,11,69670000,813417000,883087000
Bangladesch,2022,12,63678000,694317000,757995000
Bangladesch,2023,1,57010000,839030000,896040000
Bangladesch,2023,2,76672000,733962000,810634000
Bangladesch,2023,3,87269000,870033000,957302000
Bangladesch,2023,4,83892000,559305000,643197000
Bangladesch,2023,5,120502000,568830000,689332000
Bangladesch,2023,6,64520000,575687000,640207000
Bangladesch,2023,7,60173000,656803000,716976000
Bangladesch,2023,8,57155000,714299000,771454000
Bangladesch,2023,9,67230000,654354000,721584000
Bangladesch,2023,10,61069000,631552000,692621000
Bangladesch,2023,11,61504000,536317000,597821000
Bangladesch,2023,12,59573000,438738000,498311000
Bangladesch,2024,1,36497000,629025000,665522000
Bangladesch,2024,2,53272000,596136000,649408000
Bangladesch,2024,3,52256000,825168000,877424000
Bangladesch,2024,4,52585000,699504000,752089000
Bangladesch,2024,5,47968000,793077000,841045000
Bangladesch,2024,6,52759000,550435000,603194000
Bangladesch,2024,7,58206000,768760000,826966000
Bangladesch,2024,8,44422000,687530000,731952000
Bangladesch,2024,9,50286000,728600000,778886000
Bangladesch,2024,10,49002000,781495000,830497000
Bangladesch,2024,11,48882000,710463000,759345000
Bangladesch,2024,12,74701000,666850000,741551000
Barbados,2008,1,5206000,323000,5529000
Barbados,2008,2,2070000,378000,2448000
Barbados,2008,3,2809000,486000,3295000
Barbados,2008,4,1488000,220000,1708000
Barbados,2008,5,2009000,338000,2347000
Barbados,2008,6,2401000,321000,2722000
Barbados,2008,7,1003000,604000,1607000
Barbados,2008,8,28465000,496000,28961000
Barbados,2008,9,712000,402000,1114000
Barbados,2008,10,1938000,478000,2416000
Barbados,2008,11,1162000,374000,1536000
Barbados,2008,12,1257000,214000,1471000
Barbados,2009,1,861000,377000,1238000
Barbados,2009,2,1180000,634000,1814000
Barbados,2009,3,947000,416000,1363000
Barbados,2009,4,468000,458000,926000
Barbados,2009,5,433000,539000,972000
Barbados,2009,6,796000,474000,1270000
Barbados,2009,7,549000,532000,1081000
Barbados,2009,8,480000,516000,996000
Barbados,2009,9,2006000,592000,2598000
Barbados,2009,10,1076000,342000,1418000
Barbados,2009,11,1339000,170000,1509000
Barbados,2009,12,1063000,344000,1407000
Barbados,2010,1,783000,245000,1028000
Barbados,2010,2,944000,506000,1450000
Barbados,2010,3,1196000,526000,1722000
Barbados,2010,4,1658000,997000,2655000
Barbados,2010,5,1463000,705000,2168000
Barbados,2010,6,1762000,555000,2317000
Barbados,2010,7,1377000,442000,1819000
Barbados,2010,8,1154000,696000,1850000
Barbados,2010,9,1666000,479000,2145000
Barbados,2010,10,1195000,406000,1601000
Barbados,2010,11,1322000,245000,1567000
Barbados,2010,12,1234000,579000,1813000
Barbados,2011,1,3911000,474000,4385000
Barbados,2011,2,3049000,363000,3412000
Barbados,2011,3,2255000,432000,2687000
Barbados,2011,4,1237000,133000,1370000
Barbados,2011,5,5832000,167000,5999000
Barbados,2011,6,3618000,44000,3662000
Barbados,2011,7,1033000,727000,1760000
Barbados,2011,8,716000,44000,760000
Barbados,2011,9,1173000,184000,1357000
Barbados,2011,10,1166000,94000,1260000
Barbados,2011,11,1685000,102000,1787000
Barbados,2011,12,963000,96000,1059000
Barbados,2012,1,1093000,210000,1303000
Barbados,2012,2,1018000,121000,1139000
Barbados,2012,3,1044000,188000,1232000
Barbados,2012,4,633000,77000,710000
Barbados,2012,5,690000,146000,836000
Barbados,2012,6,1683000,116000,1799000
Barbados,2012,7,840000,118000,958000
Barbados,2012,8,940000,66000,1006000
Barbados,2012,9,1080000,86000,1166000
Barbados,2012,10,1119000,251000,1370000
Barbados,2012,11,907000,123000,1030000
Barbados,2012,12,698000,64000,762000
Barbados,2013,1,1150000,151000,1301000
Barbados,2013,2,887000,130000,1017000
Barbados,2013,3,1837000,82000,1919000
Barbados,2013,4,1073000,230000,1303000
Barbados,2013,5,510000,145000,655000
Barbados,2013,6,701000,455000,1156000
Barbados,2013,7,735000,150000,885000
Barbados,2013,8,883000,58000,941000
Barbados,2013,9,1237000,164000,1401000
Barbados,2013,10,1590000,161000,1751000
Barbados,2013,11,1229000,26000,1255000
Barbados,2013,12,1426000,96000,1522000
Barbados,2014,1,1458000,655000,2113000
Barbados,2014,2,1560000,152000,1712000
Barbados,2014,3,1078000,96000,1174000
Barbados,2014,4,745000,86000,831000
Barbados,2014,5,936000,206000,1142000
Barbados,2014,6,1482000,91000,1573000
Barbados,2014,7,762000,49000,811000
Barbados,2014,8,927000,49000,976000
Barbados,2014,9,1344000,100000,1444000
Barbados,2014,10,1333000,272000,1605000
Barbados,2014,11,1407000,217000,1624000
Barbados,2014,12,1500000,372000,1872000
Barbados,2015,1,2135000,61000,2196000
Barbados,2015,2,2387000,232000,2619000
Barbados,2015,3,794000,150000,944000
Barbados,2015,4,899000,207000,1106000
Barbados,2015,5,1241000,293000,1534000
Barbados,2015,6,2976000,263000,3239000
Barbados,2015,7,581000,194000,775000
Barbados,2015,8,1678000,199000,1877000
Barbados,2015,9,1446000,291000,1737000
Barbados,2015,10,942000,174000,1116000
Barbados,2015,11,1865000,230000,2095000
Barbados,2015,12,1599000,54000,1653000
Barbados,2016,1,1646000,211000,1857000
Barbados,2016,2,952000,76000,1028000
Barbados,2016,3,2155000,239000,2394000
Barbados,2016,4,5567000,213000,5780000
Barbados,2016,5,881000,335000,1216000
Barbados,2016,6,2232000,266000,2498000
Barbados,2016,7,1108000,129000,1237000
Barbados,2016,8,1660000,167000,1827000
Barbados,2016,9,1500000,134000,1634000
Barbados,2016,10,2021000,164000,2185000
Barbados,2016,11,2331000,306000,2637000
Barbados,2016,12,1413000,186000,1599000
Barbados,2017,1,1172000,183000,1355000
Barbados,2017,2,1140000,70000,1210000
Barbados,2017,3,1156000,203000,1359000
Barbados,2017,4,1936000,184000,2120000
Barbados,2017,5,1278000,130000,1408000
Barbados,2017,6,1068000,132000,1200000
Barbados,2017,7,818000,135000,953000
Barbados,2017,8,1004000,169000,1173000
Barbados,2017,9,1175000,153000,1328000
Barbados,2017,10,1900000,127000,2027000
Barbados,2017,11,972000,49000,1021000
Barbados,2017,12,1385000,162000,1547000
Barbados,2018,1,2163000,88000,2251000
Barbados,2018,2,1126000,357000,1483000
Barbados,2018,3,860000,521000,1381000
Barbados,2018,4,826000,487000,1313000
Barbados,2018,5,1438000,212000,1650000
Barbados,2018,6,1083000,222000,1305000
Barbados,2018,7,1000000,124000,1124000
Barbados,2018,8,897000,142000,1039000
Barbados,2018,9,819000,148000,967000
Barbados,2018,10,1233000,105000,1338000
Barbados,2018,11,2882000,358000,3240000
Barbados,2018,12,1623000,172000,1795000
Barbados,2019,1,3366000,234000,3600000
Barbados,2019,2,2351000,128000,2479000
Barbados,2019,3,1189000,198000,1387000
Barbados,2019,4,745000,84000,829000
Barbados,2019,5,1561000,85000,1646000
Barbados,2019,6,773000,142000,915000
Barbados,2019,7,2672000,190000,2862000
Barbados,2019,8,875000,190000,1065000
Barbados,2019,9,1812000,155000,1967000
Barbados,2019,10,2667000,5090000,7757000
Barbados,2019,11,3921000,291000,4212000
Barbados,2019,12,2700000,179000,2879000
Barbados,2020,1,2262000,168000,2430000
Barbados,2020,2,2211000,4413000,6624000
Barbados,2020,3,1784000,108000,1892000
Barbados,2020,4,1228000,89000,1317000
Barbados,2020,5,643000,174000,817000
Barbados,2020,6,702000,147000,849000
Barbados,2020,7,1976000,163000,2139000
Barbados,2020,8,1896000,314000,2210000
Barbados,2020,9,621000,339000,960000
Barbados,2020,10,1182000,187000,1369000
Barbados,2020,11,563000,265000,828000
Barbados,2020,12,430000,290000,720000
Barbados,2021,1,723000,211000,934000
Barbados,2021,2,571000,355000,926000
Barbados,2021,3,1151000,245000,1396000
Barbados,2021,4,828000,198000,1026000
Barbados,2021,5,2475000,175000,2650000
Barbados,2021,6,600000,91000,691000
Barbados,2021,7,619000,154000,773000
Barbados,2021,8,995000,93000,1088000
Barbados,2021,9,739000,69000,808000
Barbados,2021,10,758000,133000,891000
Barbados,2021,11,984000,244000,1228000
Barbados,2021,12,1932000,124000,2056000
Barbados,2022,1,843000,142000,985000
Barbados,2022,2,782000,295000,1077000
Barbados,2022,3,1006000,364000,1370000
Barbados,2022,4,485000,327000,812000
Barbados,2022,5,827000,326000,1153000
Barbados,2022,6,1036000,468000,1504000
Barbados,2022,7,714000,235000,949000
Barbados,2022,8,1900000,313000,2213000
Barbados,2022,9,849000,160000,1009000
Barbados,2022,10,1279000,126000,1405000
Barbados,2022,11,2023000,613000,2636000
Barbados,2022,12,1470000,319000,1789000
Barbados,2023,1,1133000,191000,1324000
Barbados,2023,2,651000,417000,1068000
Barbados,2023,3,1734000,791000,2525000
Barbados,2023,4,3189000,409000,3598000
Barbados,2023,5,2745000,467000,3212000
Barbados,2023,6,1727000,267000,1994000
Barbados,2023,7,1508000,280000,1788000
Barbados,2023,8,1623000,220000,1843000
Barbados,2023,9,986000,324000,1310000
Barbados,2023,10,2083000,425000,2508000
Barbados,2023,11,2401000,299000,2700000
Barbados,2023,12,1546000,324000,1870000
Barbados,2024,1,1449000,293000,1742000
Barbados,2024,2,2985000,579000,3564000
Barbados,2024,3,2502000,392000,2894000
Barbados,2024,4,2212000,558000,2770000
Barbados,2024,5,2799000,393000,3192000
Barbados,2024,6,1520000,653000,2173000
Barbados,2024,7,1440000,351000,1791000
Barbados,2024,8,1925000,495000,2420000
Barbados,2024,9,1048000,397000,1445000
Barbados,2024,10,1486000,466000,1952000
Barbados,2024,11,971000,397000,1368000
Barbados,2024,12,2206000,279000,2485000
Belarus (ab 05/1992),2008,1,135158000,33883000,169041000
Belarus (ab 05/1992),2008,2,135385000,52031000,187416000
Belarus (ab 05/1992),2008,3,143699000,46450000,190149000
Belarus (ab 05/1992),2008,4,160817000,39316000,200133000
Belarus (ab 05/1992),2008,5,143360000,41868000,185228000
Belarus (ab 05/1992),2008,6,161860000,42807000,204667000
Belarus (ab 05/1992),2008,7,191862000,42683000,234545000
Belarus (ab 05/1992),2008,8,171286000,39201000,210487000
Belarus (ab 05/1992),2008,9,187990000,45275000,233265000
Belarus (ab 05/1992),2008,10,224855000,45933000,270788000
Belarus (ab 05/1992),2008,11,183820000,41355000,225175000
Belarus (ab 05/1992),2008,12,171816000,46257000,218073000
Belarus (ab 05/1992),2009,1,113839000,36299000,150138000
Belarus (ab 05/1992),2009,2,132005000,41833000,173838000
Belarus (ab 05/1992),2009,3,142524000,37833000,180357000
Belarus (ab 05/1992),2009,4,156058000,25978000,182036000
Belarus (ab 05/1992),2009,5,112320000,40698000,153018000
Belarus (ab 05/1992),2009,6,126600000,35765000,162365000
Belarus (ab 05/1992),2009,7,161509000,29560000,191069000
Belarus (ab 05/1992),2009,8,119426000,42018000,161444000
Belarus (ab 05/1992),2009,9,138749000,38914000,177663000
Belarus (ab 05/1992),2009,10,137835000,41105000,178940000
Belarus (ab 05/1992),2009,11,132389000,43140000,175529000
Belarus (ab 05/1992),2009,12,169543000,51778000,221321000
Belarus (ab 05/1992),2010,1,83625000,59603000,143228000
Belarus (ab 05/1992),2010,2,120714000,44354000,165068000
Belarus (ab 05/1992),2010,3,182437000,44272000,226709000
Belarus (ab 05/1992),2010,4,163144000,30180000,193324000
Belarus (ab 05/1992),2010,5,166298000,37262000,203560000
Belarus (ab 05/1992),2010,6,177940000,31479000,209419000
Belarus (ab 05/1992),2010,7,186613000,31561000,218174000
Belarus (ab 05/1992),2010,8,163871000,41118000,204989000
Belarus (ab 05/1992),2010,9,190051000,37129000,227180000
Belarus (ab 05/1992),2010,10,174848000,33429000,208277000
Belarus (ab 05/1992),2010,11,207633000,41076000,248709000
Belarus (ab 05/1992),2010,12,234065000,29382000,263447000
Belarus (ab 05/1992),2011,1,150967000,52207000,203174000
Belarus (ab 05/1992),2011,2,183350000,51977000,235327000
Belarus (ab 05/1992),2011,3,246702000,69214000,315916000
Belarus (ab 05/1992),2011,4,225042000,62162000,287204000
Belarus (ab 05/1992),2011,5,202309000,46649000,248958000
Belarus (ab 05/1992),2011,6,215288000,61927000,277215000
Belarus (ab 05/1992),2011,7,138455000,59167000,197622000
Belarus (ab 05/1992),2011,8,161423000,50957000,212380000
Belarus (ab 05/1992),2011,9,158448000,49085000,207533000
Belarus (ab 05/1992),2011,10,143704000,54703000,198407000
Belarus (ab 05/1992),2011,11,153874000,56788000,210662000
Belarus (ab 05/1992),2011,12,169256000,54198000,223454000
Belarus (ab 05/1992),2012,1,119556000,78664000,198220000
Belarus (ab 05/1992),2012,2,146843000,79248000,226091000
Belarus (ab 05/1992),2012,3,186962000,96291000,283253000
Belarus (ab 05/1992),2012,4,163581000,112569000,276150000
Belarus (ab 05/1992),2012,5,181049000,83049000,264098000
Belarus (ab 05/1992),2012,6,200247000,48487000,248734000
Belarus (ab 05/1992),2012,7,230071000,61860000,291931000
Belarus (ab 05/1992),2012,8,234687000,70271000,304958000
Belarus (ab 05/1992),2012,9,195509000,31003000,226512000
Belarus (ab 05/1992),2012,10,224518000,35040000,259558000
Belarus (ab 05/1992),2012,11,209691000,42280000,251971000
Belarus (ab 05/1992),2012,12,216800000,30647000,247447000
Belarus (ab 05/1992),2013,1,162948000,42419000,205367000
Belarus (ab 05/1992),2013,2,181675000,30432000,212107000
Belarus (ab 05/1992),2013,3,179831000,44393000,224224000
Belarus (ab 05/1992),2013,4,226819000,53991000,280810000
Belarus (ab 05/1992),2013,5,201028000,35035000,236063000
Belarus (ab 05/1992),2013,6,197909000,34614000,232523000
Belarus (ab 05/1992),2013,7,212190000,42187000,254377000
Belarus (ab 05/1992),2013,8,203283000,43016000,246299000
Belarus (ab 05/1992),2013,9,186256000,48994000,235250000
Belarus (ab 05/1992),2013,10,190597000,38519000,229116000
Belarus (ab 05/1992),2013,11,177719000,35708000,213427000
Belarus (ab 05/1992),2013,12,165549000,33022000,198571000
Belarus (ab 05/1992),2014,1,114004000,36446000,150450000
Belarus (ab 05/1992),2014,2,146866000,43718000,190584000
Belarus (ab 05/1992),2014,3,174889000,39249000,214138000
Belarus (ab 05/1992),2014,4,169426000,46213000,215639000
Belarus (ab 05/1992),2014,5,141658000,39094000,180752000
Belarus (ab 05/1992),2014,6,148850000,62304000,211154000
Belarus (ab 05/1992),2014,7,172915000,57552000,230467000
Belarus (ab 05/1992),2014,8,159950000,35744000,195694000
Belarus (ab 05/1992),2014,9,166938000,42134000,209072000
Belarus (ab 05/1992),2014,10,161526000,35760000,197286000
Belarus (ab 05/1992),2014,11,121753000,41281000,163034000
Belarus (ab 05/1992),2014,12,116919000,38076000,154995000
Belarus (ab 05/1992),2015,1,77574000,83278000,160852000
Belarus (ab 05/1992),2015,2,91241000,37559000,128800000
Belarus (ab 05/1992),2015,3,121382000,107694000,229076000
Belarus (ab 05/1992),2015,4,112586000,86478000,199064000
Belarus (ab 05/1992),2015,5,109746000,49227000,158973000
Belarus (ab 05/1992),2015,6,122098000,46562000,168660000
Belarus (ab 05/1992),2015,7,128408000,53871000,182279000
Belarus (ab 05/1992),2015,8,100102000,47223000,147325000
Belarus (ab 05/1992),2015,9,118622000,53798000,172420000
Belarus (ab 05/1992),2015,10,93751000,39808000,133559000
Belarus (ab 05/1992),2015,11,92627000,41141000,133768000
Belarus (ab 05/1992),2015,12,103863000,32482000,136345000
Belarus (ab 05/1992),2016,1,66742000,37104000,103846000
Belarus (ab 05/1992),2016,2,71583000,38423000,110006000
Belarus (ab 05/1992),2016,3,103097000,40035000,143132000
Belarus (ab 05/1992),2016,4,104785000,40625000,145410000
Belarus (ab 05/1992),2016,5,89169000,43954000,133123000
Belarus (ab 05/1992),2016,6,96647000,35229000,131876000
Belarus (ab 05/1992),2016,7,89458000,38159000,127617000
Belarus (ab 05/1992),2016,8,103743000,40637000,144380000
Belarus (ab 05/1992),2016,9,95628000,38618000,134246000
Belarus (ab 05/1992),2016,10,90100000,37199000,127299000
Belarus (ab 05/1992),2016,11,124753000,35402000,160155000
Belarus (ab 05/1992),2016,12,103301000,29148000,132449000
Belarus (ab 05/1992),2017,1,67622000,37141000,104763000
Belarus (ab 05/1992),2017,2,84795000,34042000,118837000
Belarus (ab 05/1992),2017,3,132491000,37832000,170323000
Belarus (ab 05/1992),2017,4,113636000,35586000,149222000
Belarus (ab 05/1992),2017,5,127337000,55680000,183017000
Belarus (ab 05/1992),2017,6,132779000,49927000,182706000
Belarus (ab 05/1992),2017,7,132084000,44125000,176209000
Belarus (ab 05/1992),2017,8,132040000,40011000,172051000
Belarus (ab 05/1992),2017,9,138980000,38874000,177854000
Belarus (ab 05/1992),2017,10,120322000,41428000,161750000
Belarus (ab 05/1992),2017,11,146852000,45255000,192107000
Belarus (ab 05/1992),2017,12,120520000,47394000,167914000
Belarus (ab 05/1992),2018,1,98263000,48653000,146916000
Belarus (ab 05/1992),2018,2,117042000,46148000,163190000
Belarus (ab 05/1992),2018,3,142957000,42712000,185669000
Belarus (ab 05/1992),2018,4,133732000,52355000,186087000
Belarus (ab 05/1992),2018,5,123187000,47742000,170929000
Belarus (ab 05/1992),2018,6,122911000,50144000,173055000
Belarus (ab 05/1992),2018,7,132190000,53591000,185781000
Belarus (ab 05/1992),2018,8,136785000,53985000,190770000
Belarus (ab 05/1992),2018,9,105268000,52246000,157514000
Belarus (ab 05/1992),2018,10,117070000,55288000,172358000
Belarus (ab 05/1992),2018,11,123534000,53987000,177521000
Belarus (ab 05/1992),2018,12,134061000,39223000,173284000
Belarus (ab 05/1992),2019,1,98443000,50047000,148490000
Belarus (ab 05/1992),2019,2,112734000,47332000,160066000
Belarus (ab 05/1992),2019,3,130758000,48377000,179135000
Belarus (ab 05/1992),2019,4,135515000,48249000,183764000
Belarus (ab 05/1992),2019,5,118927000,43604000,162531000
Belarus (ab 05/1992),2019,6,119316000,38449000,157765000
Belarus (ab 05/1992),2019,7,149210000,55147000,204357000
Belarus (ab 05/1992),2019,8,126421000,51490000,177911000
Belarus (ab 05/1992),2019,9,121331000,48415000,169746000
Belarus (ab 05/1992),2019,10,127473000,46115000,173588000
Belarus (ab 05/1992),2019,11,121507000,45652000,167159000
Belarus (ab 05/1992),2019,12,99926000,32451000,132377000
Belarus (ab 05/1992),2020,1,101285000,43483000,144768000
Belarus (ab 05/1992),2020,2,123026000,49570000,172596000
Belarus (ab 05/1992),2020,3,176361000,51415000,227776000
Belarus (ab 05/1992),2020,4,107058000,41214000,148272000
Belarus (ab 05/1992),2020,5,88469000,38362000,126831000
Belarus (ab 05/1992),2020,6,108424000,43661000,152085000
Belarus (ab 05/1992),2020,7,113745000,44392000,158137000
Belarus (ab 05/1992),2020,8,95002000,43128000,138130000
Belarus (ab 05/1992),2020,9,115106000,44989000,160095000
Belarus (ab 05/1992),2020,10,120255000,42106000,162361000
Belarus (ab 05/1992),2020,11,123716000,47463000,171179000
Belarus (ab 05/1992),2020,12,107505000,40964000,148469000
Belarus (ab 05/1992),2021,1,74294000,45227000,119521000
Belarus (ab 05/1992),2021,2,102553000,57689000,160242000
Belarus (ab 05/1992),2021,3,135106000,61306000,196412000
Belarus (ab 05/1992),2021,4,127802000,79130000,206932000
Belarus (ab 05/1992),2021,5,121412000,75832000,197244000
Belarus (ab 05/1992),2021,6,149117000,74953000,224070000
Belarus (ab 05/1992),2021,7,135444000,64162000,199606000
Belarus (ab 05/1992),2021,8,114702000,80685000,195387000
Belarus (ab 05/1992),2021,9,132195000,67675000,199870000
Belarus (ab 05/1992),2021,10,134115000,65786000,199901000
Belarus (ab 05/1992),2021,11,130233000,70516000,200749000
Belarus (ab 05/1992),2021,12,144650000,49766000,194416000
Belarus (ab 05/1992),2022,1,91600000,65603000,157203000
Belarus (ab 05/1992),2022,2,111468000,58706000,170174000
Belarus (ab 05/1992),2022,3,72432000,62062000,134494000
Belarus (ab 05/1992),2022,4,50118000,30572000,80690000
Belarus (ab 05/1992),2022,5,73120000,39102000,112222000
Belarus (ab 05/1992),2022,6,79627000,26193000,105820000
Belarus (ab 05/1992),2022,7,105156000,28814000,133970000
Belarus (ab 05/1992),2022,8,142625000,26102000,168727000
Belarus (ab 05/1992),2022,9,189557000,23169000,212726000
Belarus (ab 05/1992),2022,10,167701000,17557000,185258000
Belarus (ab 05/1992),2022,11,182874000,23739000,206613000
Belarus (ab 05/1992),2022,12,198378000,15181000,213559000
Belarus (ab 05/1992),2023,1,125705000,28594000,154299000
Belarus (ab 05/1992),2023,2,183194000,21250000,204444000
Belarus (ab 05/1992),2023,3,182730000,24219000,206949000
Belarus (ab 05/1992),2023,4,127901000,22335000,150236000
Belarus (ab 05/1992),2023,5,144238000,21242000,165480000
Belarus (ab 05/1992),2023,6,165225000,20131000,185356000
Belarus (ab 05/1992),2023,7,145705000,18337000,164042000
Belarus (ab 05/1992),2023,8,142289000,21898000,164187000
Belarus (ab 05/1992),2023,9,146921000,19030000,165951000
Belarus (ab 05/1992),2023,10,164595000,17567000,182162000
Belarus (ab 05/1992),2023,11,200745000,19846000,220591000
Belarus (ab 05/1992),2023,12,168871000,20392000,189263000
Belarus (ab 05/1992),2024,1,152088000,18549000,170637000
Belarus (ab 05/1992),2024,2,230242000,18074000,248316000
Belarus (ab 05/1992),2024,3,241702000,15693000,257395000
Belarus (ab 05/1992),2024,4,159412000,16086000,175498000
Belarus (ab 05/1992),2024,5,161720000,13879000,175599000
Belarus (ab 05/1992),2024,6,116423000,17774000,134197000
Belarus (ab 05/1992),2024,7,104901000,17112000,122013000
Belarus (ab 05/1992),2024,8,102480000,15590000,118070000
Belarus (ab 05/1992),2024,9,93442000,12826000,106268000
Belarus (ab 05/1992),2024,10,55139000,4201000,59340000
Belarus (ab 05/1992),2024,11,45806000,3226000,49032000
Belarus (ab 05/1992),2024,12,40775000,3004000,43779000
Belgien (ab 1999),2008,1,4416464000,2953282000,7369746000
Belgien (ab 1999),2008,2,4353430000,2891797000,7245227000
Belgien (ab 1999),2008,3,4156650000,3067309000,7223959000
Belgien (ab 1999),2008,4,4404625000,3224682000,7629307000
Belgien (ab 1999),2008,5,3975122000,3175326000,7150448000
Belgien (ab 1999),2008,6,4409601000,3289342000,7698943000
Belgien (ab 1999),2008,7,4319265000,3353991000,7673256000
Belgien (ab 1999),2008,8,3967319000,3104848000,7072167000
Belgien (ab 1999),2008,9,4396933000,3318911000,7715844000
Belgien (ab 1999),2008,10,4488940000,3158277000,7647217000
Belgien (ab 1999),2008,11,3753422000,2608694000,6362116000
Belgien (ab 1999),2008,12,3291866000,2476224000,5768090000
Belgien (ab 1999),2009,1,3483872000,2104704000,5588576000
Belgien (ab 1999),2009,2,3507067000,2307434000,5814501000
Belgien (ab 1999),2009,3,3838285000,2519714000,6357999000
Belgien (ab 1999),2009,4,3277995000,2241415000,5519410000
Belgien (ab 1999),2009,5,3131836000,2163265000,5295101000
Belgien (ab 1999),2009,6,3479701000,2386905000,5866606000
Belgien (ab 1999),2009,7,3303882000,2360642000,5664524000
Belgien (ab 1999),2009,8,3139133000,2221317000,5360450000
Belgien (ab 1999),2009,9,3852081000,2499075000,6351156000
Belgien (ab 1999),2009,10,3720830000,2551784000,6272614000
Belgien (ab 1999),2009,11,3617761000,2398116000,6015877000
Belgien (ab 1999),2009,12,3487062000,2286556000,5773618000
Belgien (ab 1999),2010,1,3343508000,2290782000,5634290000
Belgien (ab 1999),2010,2,3575117000,2396717000,5971834000
Belgien (ab 1999),2010,3,4332573000,2893240000,7225813000
Belgien (ab 1999),2010,4,3621174000,2567230000,6188404000
Belgien (ab 1999),2010,5,3715015000,2752847000,6467862000
Belgien (ab 1999),2010,6,4049025000,2981441000,7030466000
Belgien (ab 1999),2010,7,3531027000,2819450000,6350477000
Belgien (ab 1999),2010,8,3684197000,2723330000,6407527000
Belgien (ab 1999),2010,9,3893756000,3092736000,6986492000
Belgien (ab 1999),2010,10,3862009000,3049333000,6911342000
Belgien (ab 1999),2010,11,3733999000,2932834000,6666833000
Belgien (ab 1999),2010,12,3697816000,2804077000,6501893000
Belgien (ab 1999),2011,1,3811320000,2909002000,6720322000
Belgien (ab 1999),2011,2,4098384000,3012139000,7110523000
Belgien (ab 1999),2011,3,4501301000,3457884000,7959185000
Belgien (ab 1999),2011,4,3804711000,3194630000,6999341000
Belgien (ab 1999),2011,5,4222321000,3279682000,7502003000
Belgien (ab 1999),2011,6,3918781000,3347257000,7266038000
Belgien (ab 1999),2011,7,3423925000,3092600000,6516525000
Belgien (ab 1999),2011,8,3861890000,3152200000,7014090000
Belgien (ab 1999),2011,9,4125884000,3361825000,7487709000
Belgien (ab 1999),2011,10,3839832000,3307467000,7147299000
Belgien (ab 1999),2011,11,3950221000,3284184000,7234405000
Belgien (ab 1999),2011,12,3417677000,2928777000,6346454000
Belgien (ab 1999),2012,1,3549869000,2862473000,6412342000
Belgien (ab 1999),2012,2,3622269000,3232674000,6854943000
Belgien (ab 1999),2012,3,3998860000,3547298000,7546158000
Belgien (ab 1999),2012,4,3522005000,3026619000,6548624000
Belgien (ab 1999),2012,5,3719236000,3055009000,6774245000
Belgien (ab 1999),2012,6,3733269000,3335349000,7068618000
Belgien (ab 1999),2012,7,3299934000,3203340000,6503274000
Belgien (ab 1999),2012,8,3572714000,2980011000,6552725000
Belgien (ab 1999),2012,9,3567668000,3129565000,6697233000
Belgien (ab 1999),2012,10,3880200000,3361190000,7241390000
Belgien (ab 1999),2012,11,3913869000,3201643000,7115512000
Belgien (ab 1999),2012,12,3418821000,2735368000,6154189000
Belgien (ab 1999),2013,1,3757133000,3108631000,6865764000
Belgien (ab 1999),2013,2,3661556000,3158635000,6820191000
Belgien (ab 1999),2013,3,4111676000,3290735000,7402411000
Belgien (ab 1999),2013,4,3761918000,3279694000,7041612000
Belgien (ab 1999),2013,5,3421499000,3245658000,6667157000
Belgien (ab 1999),2013,6,3480869000,3413881000,6894750000
Belgien (ab 1999),2013,7,3333381000,3232588000,6565969000
Belgien (ab 1999),2013,8,3100180000,3054277000,6154457000
Belgien (ab 1999),2013,9,3512183000,3286712000,6798895000
Belgien (ab 1999),2013,10,3660200000,3634395000,7294595000
Belgien (ab 1999),2013,11,3449681000,3326736000,6776417000
Belgien (ab 1999),2013,12,3187574000,2946100000,6133674000
Belgien (ab 1999),2014,1,3660336000,3094550000,6754886000
Belgien (ab 1999),2014,2,3453072000,3280947000,6734019000
Belgien (ab 1999),2014,3,3656534000,3377227000,7033761000
Belgien (ab 1999),2014,4,3632348000,3343665000,6976013000
Belgien (ab 1999),2014,5,3420052000,3232644000,6652696000
Belgien (ab 1999),2014,6,3521282000,3406468000,6927750000
Belgien (ab 1999),2014,7,3321732000,3308458000,6630190000
Belgien (ab 1999),2014,8,3187282000,3174205000,6361487000
Belgien (ab 1999),2014,9,3707064000,3581550000,7288614000
Belgien (ab 1999),2014,10,3757970000,3571332000,7329302000
Belgien (ab 1999),2014,11,3357241000,3380623000,6737864000
Belgien (ab 1999),2014,12,3330287000,2755115000,6085402000
Belgien (ab 1999),2015,1,3334141000,2925721000,6259862000
Belgien (ab 1999),2015,2,3387531000,3189007000,6576538000
Belgien (ab 1999),2015,3,3787895000,3203138000,6991033000
Belgien (ab 1999),2015,4,3477902000,3184350000,6662252000
Belgien (ab 1999),2015,5,3359272000,3030794000,6390066000
Belgien (ab 1999),2015,6,3647840000,3153483000,6801323000
Belgien (ab 1999),2015,7,3324887000,3055309000,6380196000
Belgien (ab 1999),2015,8,3009282000,2975559000,5984841000
Belgien (ab 1999),2015,9,3565504000,3276296000,6841800000
Belgien (ab 1999),2015,10,3442756000,3040292000,6483048000
Belgien (ab 1999),2015,11,3431548000,3124286000,6555834000
Belgien (ab 1999),2015,12,3132035000,2706242000,5838277000
Belgien (ab 1999),2016,1,3310867000,2958529000,6269396000
Belgien (ab 1999),2016,2,3437350000,3090960000,6528310000
Belgien (ab 1999),2016,3,3708822000,3162319000,6871141000
Belgien (ab 1999),2016,4,3635821000,3225691000,6861512000
Belgien (ab 1999),2016,5,3440805000,2809152000,6249957000
Belgien (ab 1999),2016,6,3697588000,4040302000,7737890000
Belgien (ab 1999),2016,7,3161628000,2997227000,6158855000
Belgien (ab 1999),2016,8,3245251000,3012979000,6258230000
Belgien (ab 1999),2016,9,3716180000,3046827000,6763007000
Belgien (ab 1999),2016,10,3361832000,3092975000,6454807000
Belgien (ab 1999),2016,11,3600858000,3330454000,6931312000
Belgien (ab 1999),2016,12,3258887000,3084293000,6343180000
Belgien (ab 1999),2017,1,3498330000,3128162000,6626492000
Belgien (ab 1999),2017,2,3677457000,3320459000,6997916000
Belgien (ab 1999),2017,3,4152477000,3745076000,7897553000
Belgien (ab 1999),2017,4,3741880000,3487205000,7229085000
Belgien (ab 1999),2017,5,3849653000,3649257000,7498910000
Belgien (ab 1999),2017,6,3810106000,3430639000,7240745000
Belgien (ab 1999),2017,7,3309074000,3437244000,6746318000
Belgien (ab 1999),2017,8,3531775000,3119562000,6651337000
Belgien (ab 1999),2017,9,3649427000,3251956000,6901383000
Belgien (ab 1999),2017,10,3647551000,3335944000,6983495000
Belgien (ab 1999),2017,11,3935788000,3512501000,7448289000
Belgien (ab 1999),2017,12,3458776000,3036072000,6494848000
Belgien (ab 1999),2018,1,3769629000,3961452000,7731081000
Belgien (ab 1999),2018,2,3761486000,3372814000,7134300000
Belgien (ab 1999),2018,3,3999755000,3998769000,7998524000
Belgien (ab 1999),2018,4,3799059000,4047537000,7846596000
Belgien (ab 1999),2018,5,3729161000,3496784000,7225945000
Belgien (ab 1999),2018,6,3877453000,3680674000,7558127000
Belgien (ab 1999),2018,7,3612842000,4299597000,7912439000
Belgien (ab 1999),2018,8,3334678000,3781242000,7115920000
Belgien (ab 1999),2018,9,3567610000,4055755000,7623365000
Belgien (ab 1999),2018,10,3916865000,3524408000,7441273000
Belgien (ab 1999),2018,11,3769326000,4036648000,7805974000
Belgien (ab 1999),2018,12,3215477000,3603488000,6818965000
Belgien (ab 1999),2019,1,3836015000,4121583000,7957598000
Belgien (ab 1999),2019,2,3796710000,4015673000,7812383000
Belgien (ab 1999),2019,3,4089515000,3588058000,7677573000
Belgien (ab 1999),2019,4,3885941000,3567596000,7453537000
Belgien (ab 1999),2019,5,4167305000,3684361000,7851666000
Belgien (ab 1999),2019,6,3876471000,3871567000,7748038000
Belgien (ab 1999),2019,7,3774440000,3391062000,7165502000
Belgien (ab 1999),2019,8,3447067000,3347574000,6794641000
Belgien (ab 1999),2019,9,4058599000,3549772000,7608371000
Belgien (ab 1999),2019,10,3965005000,3627164000,7592169000
Belgien (ab 1999),2019,11,3877368000,3402898000,7280266000
Belgien (ab 1999),2019,12,3468417000,2881273000,6349690000
Belgien (ab 1999),2020,1,3882633000,3265007000,7147640000
Belgien (ab 1999),2020,2,3884732000,3538232000,7422964000
Belgien (ab 1999),2020,3,3788383000,3413302000,7201685000
Belgien (ab 1999),2020,4,2799835000,2713883000,5513718000
Belgien (ab 1999),2020,5,2781241000,2658000000,5439241000
Belgien (ab 1999),2020,6,3614882000,2904758000,6519640000
Belgien (ab 1999),2020,7,3453958000,2777746000,6231704000
Belgien (ab 1999),2020,8,3179495000,2754307000,5933802000
Belgien (ab 1999),2020,9,4097892000,3031299000,7129191000
Belgien (ab 1999),2020,10,4197614000,3411512000,7609126000
Belgien (ab 1999),2020,11,3961941000,3375841000,7337782000
Belgien (ab 1999),2020,12,3664484000,2943594000,6608078000
Belgien (ab 1999),2021,1,3922306000,3151624000,7073930000
Belgien (ab 1999),2021,2,3963888000,3319852000,7283740000
Belgien (ab 1999),2021,3,4545765000,4314361000,8860126000
Belgien (ab 1999),2021,4,4413167000,4514501000,8927668000
Belgien (ab 1999),2021,5,4204436000,4340506000,8544942000
Belgien (ab 1999),2021,6,4448126000,5204331000,9652457000
Belgien (ab 1999),2021,7,4035489000,4587312000,8622801000
Belgien (ab 1999),2021,8,3931961000,4307973000,8239934000
Belgien (ab 1999),2021,9,4430401000,4478052000,8908453000
Belgien (ab 1999),2021,10,4670209000,4682905000,9353114000
Belgien (ab 1999),2021,11,4481198000,4974840000,9456038000
Belgien (ab 1999),2021,12,4364203000,4426124000,8790327000
Belgien (ab 1999),2022,1,4498555000,4273913000,8772468000
Belgien (ab 1999),2022,2,4809392000,4368442000,9177834000
Belgien (ab 1999),2022,3,5720670000,5498603000,11219273000
Belgien (ab 1999),2022,4,4608728000,4584737000,9193465000
Belgien (ab 1999),2022,5,5636424000,6173350000,11809774000
Belgien (ab 1999),2022,6,5066654000,5399932000,10466586000
Belgien (ab 1999),2022,7,5976698000,5460140000,11436838000
Belgien (ab 1999),2022,8,5220154000,4767353000,9987507000
Belgien (ab 1999),2022,9,5808129000,7323719000,13131848000
Belgien (ab 1999),2022,10,5283656000,5316293000,10599949000
Belgien (ab 1999),2022,11,5480757000,4985576000,10466333000
Belgien (ab 1999),2022,12,4817832000,4962224000,9780056000
Belgien (ab 1999),2023,1,5265538000,4238777000,9504315000
Belgien (ab 1999),2023,2,5221314000,4225002000,9446316000
Belgien (ab 1999),2023,3,5735176000,4734260000,10469436000
Belgien (ab 1999),2023,4,4727411000,3974740000,8702151000
Belgien (ab 1999),2023,5,5163744000,5000556000,10164300000
Belgien (ab 1999),2023,6,5616860000,4609326000,10226186000
Belgien (ab 1999),2023,7,4794523000,4626749000,9421272000
Belgien (ab 1999),2023,8,4893290000,4176330000,9069620000
Belgien (ab 1999),2023,9,4967913000,4371417000,9339330000
Belgien (ab 1999),2023,10,5056988000,4472489000,9529477000
Belgien (ab 1999),2023,11,5012535000,4546020000,9558555000
Belgien (ab 1999),2023,12,4294058000,3531359000,7825417000
Belgien (ab 1999),2024,1,5050231000,3897801000,8948032000
Belgien (ab 1999),2024,2,5050586000,3830469000,8881055000
Belgien (ab 1999),2024,3,5207031000,4191886000,9398917000
Belgien (ab 1999),2024,4,5271364000,4297555000,9568919000
Belgien (ab 1999),2024,5,4895796000,3836877000,8732673000
Belgien (ab 1999),2024,6,5212334000,3981963000,9194297000
Belgien (ab 1999),2024,7,4966672000,4328809000,9295481000
Belgien (ab 1999),2024,8,4576752000,3786043000,8362795000
Belgien (ab 1999),2024,9,4692574000,4250117000,8942691000
Belgien (ab 1999),2024,10,4930900000,4523595000,9454495000
Belgien (ab 1999),2024,11,4585600000,3775887000,8361487000
Belgien (ab 1999),2024,12,4418590000,3398700000,7817290000
Belgien und Luxemburg (bis 1998),2008,1,0,0,0
Belgien und Luxemburg (bis 1998),2008,2,0,0,0
Belgien und Luxemburg (bis 1998),2008,3,0,0,0
Belgien und Luxemburg (bis 1998),2008,4,0,0,0
Belgien und Luxemburg (bis 1998),2008,5,0,0,0
Belgien und Luxemburg (bis 1998),2008,6,0,0,0
Belgien und Luxemburg (bis 1998),2008,7,0,0,0
Belgien und Luxemburg (bis 1998),2008,8,0,0,0
Belgien und Luxemburg (bis 1998),2008,9,0,0,0
Belgien und Luxemburg (bis 1998),2008,10,0,0,0
Belgien und Luxemburg (bis 1998),2008,11,0,0,0
Belgien und Luxemburg (bis 1998),2008,12,0,0,0
Belgien und Luxemburg (bis 1998),2009,1,0,0,0
Belgien und Luxemburg (bis 1998),2009,2,0,0,0
Belgien und Luxemburg (bis 1998),2009,3,0,0,0
Belgien und Luxemburg (bis 1998),2009,4,0,0,0
Belgien und Luxemburg (bis 1998),2009,5,0,0,0
Belgien und Luxemburg (bis 1998),2009,6,0,0,0
Belgien und Luxemburg (bis 1998),2009,7,0,0,0
Belgien und Luxemburg (bis 1998),2009,8,0,0,0
Belgien und Luxemburg (bis 1998),2009,9,0,0,0
Belgien und Luxemburg (bis 1998),2009,10,0,0,0
Belgien und Luxemburg (bis 1998),2009,11,0,0,0
Belgien und Luxemburg (bis 1998),2009,12,0,0,0
Belgien und Luxemburg (bis 1998),2010,1,0,0,0
Belgien und Luxemburg (bis 1998),2010,2,0,0,0
Belgien und Luxemburg (bis 1998),2010,3,0,0,0
Belgien und Luxemburg (bis 1998),2010,4,0,0,0
Belgien und Luxemburg (bis 1998),2010,5,0,0,0
Belgien und Luxemburg (bis 1998),2010,6,0,0,0
Belgien und Luxemburg (bis 1998),2010,7,0,0,0
Belgien und Luxemburg (bis 1998),2010,8,0,0,0
Belgien und Luxemburg (bis 1998),2010,9,0,0,0
Belgien und Luxemburg (bis 1998),2010,10,0,0,0
Belgien und Luxemburg (bis 1998),2010,11,0,0,0
Belgien und Luxemburg (bis 1998),2010,12,0,0,0
Belgien und Luxemburg (bis 1998),2011,1,0,0,0
Belgien und Luxemburg (bis 1998),2011,2,0,0,0
Belgien und Luxemburg (bis 1998),2011,3,0,0,0
Belgien und Luxemburg (bis 1998),2011,4,0,0,0
Belgien und Luxemburg (bis 1998),2011,5,0,0,0
Belgien und Luxemburg (bis 1998),2011,6,0,0,0
Belgien und Luxemburg (bis 1998),2011,7,0,0,0
Belgien und Luxemburg (bis 1998),2011,8,0,0,0
Belgien und Luxemburg (bis 1998),2011,9,0,0,0
Belgien und Luxemburg (bis 1998),2011,10,0,0,0
Belgien und Luxemburg (bis 1998),2011,11,0,0,0
Belgien und Luxemburg (bis 1998),2011,12,0,0,0
Belgien und Luxemburg (bis 1998),2012,1,0,0,0
Belgien und Luxemburg (bis 1998),2012,2,0,0,0
Belgien und Luxemburg (bis 1998),2012,3,0,0,0
Belgien und Luxemburg (bis 1998),2012,4,0,0,0
Belgien und Luxemburg (bis 1998),2012,5,0,0,0
Belgien und Luxemburg (bis 1998),2012,6,0,0,0
Belgien und Luxemburg (bis 1998),2012,7,0,0,0
Belgien und Luxemburg (bis 1998),2012,8,0,0,0
Belgien und Luxemburg (bis 1998),2012,9,0,0,0
Belgien und Luxemburg (bis 1998),2012,10,0,0,0
Belgien und Luxemburg (bis 1998),2012,11,0,0,0
Belgien und Luxemburg (bis 1998),2012,12,0,0,0
Belgien und Luxemburg (bis 1998),2013,1,0,0,0
Belgien und Luxemburg (bis 1998),2013,2,0,0,0
Belgien und Luxemburg (bis 1998),2013,3,0,0,0
Belgien und Luxemburg (bis 1998),2013,4,0,0,0
Belgien und Luxemburg (bis 1998),2013,5,0,0,0
Belgien und Luxemburg (bis 1998),2013,6,0,0,0
Belgien und Luxemburg (bis 1998),2013,7,0,0,0
Belgien und Luxemburg (bis 1998),2013,8,0,0,0
Belgien und Luxemburg (bis 1998),2013,9,0,0,0
Belgien und Luxemburg (bis 1998),2013,10,0,0,0
Belgien und Luxemburg (bis 1998),2013,11,0,0,0
Belgien und Luxemburg (bis 1998),2013,12,0,0,0
Belgien und Luxemburg (bis 1998),2014,1,0,0,0
Belgien und Luxemburg (bis 1998),2014,2,0,0,0
Belgien und Luxemburg (bis 1998),2014,3,0,0,0
Belgien und Luxemburg (bis 1998),2014,4,0,0,0
Belgien und Luxemburg (bis 1998),2014,5,0,0,0
Belgien und Luxemburg (bis 1998),2014,6,0,0,0
Belgien und Luxemburg (bis 1998),2014,7,0,0,0
Belgien und Luxemburg (bis 1998),2014,8,0,0,0
Belgien und Luxemburg (bis 1998),2014,9,0,0,0
Belgien und Luxemburg (bis 1998),2014,10,0,0,0
Belgien und Luxemburg (bis 1998),2014,11,0,0,0
Belgien und Luxemburg (bis 1998),2014,12,0,0,0
Belgien und Luxemburg (bis 1998),2015,1,0,0,0
Belgien und Luxemburg (bis 1998),2015,2,0,0,0
Belgien und Luxemburg (bis 1998),2015,3,0,0,0
Belgien und Luxemburg (bis 1998),2015,4,0,0,0
Belgien und Luxemburg (bis 1998),2015,5,0,0,0
Belgien und Luxemburg (bis 1998),2015,6,0,0,0
Belgien und Luxemburg (bis 1998),2015,7,0,0,0
Belgien und Luxemburg (bis 1998),2015,8,0,0,0
Belgien und Luxemburg (bis 1998),2015,9,0,0,0
Belgien und Luxemburg (bis 1998),2015,10,0,0,0
Belgien und Luxemburg (bis 1998),2015,11,0,0,0
Belgien und Luxemburg (bis 1998),2015,12,0,0,0
Belgien und Luxemburg (bis 1998),2016,1,0,0,0
Belgien und Luxemburg (bis 1998),2016,2,0,0,0
Belgien und Luxemburg (bis 1998),2016,3,0,0,0
Belgien und Luxemburg (bis 1998),2016,4,0,0,0
Belgien und Luxemburg (bis 1998),2016,5,0,0,0
Belgien und Luxemburg (bis 1998),2016,6,0,0,0
Belgien und Luxemburg (bis 1998),2016,7,0,0,0
Belgien und Luxemburg (bis 1998),2016,8,0,0,0
Belgien und Luxemburg (bis 1998),2016,9,0,0,0
Belgien und Luxemburg (bis 1998),2016,10,0,0,0
Belgien und Luxemburg (bis 1998),2016,11,0,0,0
Belgien und Luxemburg (bis 1998),2016,12,0,0,0
Belgien und Luxemburg (bis 1998),2017,1,0,0,0
Belgien und Luxemburg (bis 1998),2017,2,0,0,0
Belgien und Luxemburg (bis 1998),2017,3,0,0,0
Belgien und Luxemburg (bis 1998),2017,4,0,0,0
Belgien und Luxemburg (bis 1998),2017,5,0,0,0
Belgien und Luxemburg (bis 1998),2017,6,0,0,0
Belgien und Luxemburg (bis 1998),2017,7,0,0,0
Belgien und Luxemburg (bis 1998),2017,8,0,0,0
Belgien und Luxemburg (bis 1998),2017,9,0,0,0
Belgien und Luxemburg (bis 1998),2017,10,0,0,0
Belgien und Luxemburg (bis 1998),2017,11,0,0,0
Belgien und Luxemburg (bis 1998),2017,12,0,0,0
Belgien und Luxemburg (bis 1998),2018,1,0,0,0
Belgien und Luxemburg (bis 1998),2018,2,0,0,0
Belgien und Luxemburg (bis 1998),2018,3,0,0,0
Belgien und Luxemburg (bis 1998),2018,4,0,0,0
Belgien und Luxemburg (bis 1998),2018,5,0,0,0
Belgien und Luxemburg (bis 1998),2018,6,0,0,0
Belgien und Luxemburg (bis 1998),2018,7,0,0,0
Belgien und Luxemburg (bis 1998),2018,8,0,0,0
Belgien und Luxemburg (bis 1998),2018,9,0,0,0
Belgien und Luxemburg (bis 1998),2018,10,0,0,0
Belgien und Luxemburg (bis 1998),2018,11,0,0,0
Belgien und Luxemburg (bis 1998),2018,12,0,0,0
Belgien und Luxemburg (bis 1998),2019,1,0,0,0
Belgien und Luxemburg (bis 1998),2019,2,0,0,0
Belgien und Luxemburg (bis 1998),2019,3,0,0,0
Belgien und Luxemburg (bis 1998),2019,4,0,0,0
Belgien und Luxemburg (bis 1998),2019,5,0,0,0
Belgien und Luxemburg (bis 1998),2019,6,0,0,0
Belgien und Luxemburg (bis 1998),2019,7,0,0,0
Belgien und Luxemburg (bis 1998),2019,8,0,0,0
Belgien und Luxemburg (bis 1998),2019,9,0,0,0
Belgien und Luxemburg (bis 1998),2019,10,0,0,0
Belgien und Luxemburg (bis 1998),2019,11,0,0,0
Belgien und Luxemburg (bis 1998),2019,12,0,0,0
Belgien und Luxemburg (bis 1998),2020,1,0,0,0
Belgien und Luxemburg (bis 1998),2020,2,0,0,0
Belgien und Luxemburg (bis 1998),2020,3,0,0,0
Belgien und Luxemburg (bis 1998),2020,4,0,0,0
Belgien und Luxemburg (bis 1998),2020,5,0,0,0
Belgien und Luxemburg (bis 1998),2020,6,0,0,0
Belgien und Luxemburg (bis 1998),2020,7,0,0,0
Belgien und Luxemburg (bis 1998),2020,8,0,0,0
Belgien und Luxemburg (bis 1998),2020,9,0,0,0
Belgien und Luxemburg (bis 1998),2020,10,0,0,0
Belgien und Luxemburg (bis 1998),2020,11,0,0,0
Belgien und Luxemburg (bis 1998),2020,12,0,0,0
Belgien und Luxemburg (bis 1998),2021,1,0,0,0
Belgien und Luxemburg (bis 1998),2021,2,0,0,0
Belgien und Luxemburg (bis 1998),2021,3,0,0,0
Belgien und Luxemburg (bis 1998),2021,4,0,0,0
Belgien und Luxemburg (bis 1998),2021,5,0,0,0
Belgien und Luxemburg (bis 1998),2021,6,0,0,0
Belgien und Luxemburg (bis 1998),2021,7,0,0,0
Belgien und Luxemburg (bis 1998),2021,8,0,0,0
Belgien und Luxemburg (bis 1998),2021,9,0,0,0
Belgien und Luxemburg (bis 1998),2021,10,0,0,0
Belgien und Luxemburg (bis 1998),2021,11,0,0,0
Belgien und Luxemburg (bis 1998),2021,12,0,0,0
Belgien und Luxemburg (bis 1998),2022,1,0,0,0
Belgien und Luxemburg (bis 1998),2022,2,0,0,0
Belgien und Luxemburg (bis 1998),2022,3,0,0,0
Belgien und Luxemburg (bis 1998),2022,4,0,0,0
Belgien und Luxemburg (bis 1998),2022,5,0,0,0
Belgien und Luxemburg (bis 1998),2022,6,0,0,0
Belgien und Luxemburg (bis 1998),2022,7,0,0,0
Belgien und Luxemburg (bis 1998),2022,8,0,0,0
Belgien und Luxemburg (bis 1998),2022,9,0,0,0
Belgien und Luxemburg (bis 1998),2022,10,0,0,0
Belgien und Luxemburg (bis 1998),2022,11,0,0,0
Belgien und Luxemburg (bis 1998),2022,12,0,0,0
Belgien und Luxemburg (bis 1998),2023,1,0,0,0
Belgien und Luxemburg (bis 1998),2023,2,0,0,0
Belgien und Luxemburg (bis 1998),2023,3,0,0,0
Belgien und Luxemburg (bis 1998),2023,4,0,0,0
Belgien und Luxemburg (bis 1998),2023,5,0,0,0
Belgien und Luxemburg (bis 1998),2023,6,0,0,0
Belgien und Luxemburg (bis 1998),2023,7,0,0,0
Belgien und Luxemburg (bis 1998),2023,8,0,0,0
Belgien und Luxemburg (bis 1998),2023,9,0,0,0
Belgien und Luxemburg (bis 1998),2023,10,0,0,0
Belgien und Luxemburg (bis 1998),2023,11,0,0,0
Belgien und Luxemburg (bis 1998),2023,12,0,0,0
Belgien und Luxemburg (bis 1998),2024,1,0,0,0
Belgien und Luxemburg (bis 1998),2024,2,0,0,0
Belgien und Luxemburg (bis 1998),2024,3,0,0,0
Belgien und Luxemburg (bis 1998),2024,4,0,0,0
Belgien und Luxemburg (bis 1998),2024,5,0,0,0
Belgien und Luxemburg (bis 1998),2024,6,0,0,0
Belgien und Luxemburg (bis 1998),2024,7,0,0,0
Belgien und Luxemburg (bis 1998),2024,8,0,0,0
Belgien und Luxemburg (bis 1998),2024,9,0,0,0
Belgien und Luxemburg (bis 1998),2024,10,0,0,0
Belgien und Luxemburg (bis 1998),2024,11,0,0,0
Belgien und Luxemburg (bis 1998),2024,12,0,0,0
Belize,2008,1,739000,4000,743000
Belize,2008,2,217000,34000,251000
Belize,2008,3,274000,833000,1107000
Belize,2008,4,693000,0,693000
Belize,2008,5,647000,4000,651000
Belize,2008,6,1553000,0,1553000
Belize,2008,7,499000,10000,509000
Belize,2008,8,583000,116000,699000
Belize,2008,9,1209000,78000,1287000
Belize,2008,10,733000,69000,802000
Belize,2008,11,433000,1000,434000
Belize,2008,12,412000,66000,478000
Belize,2009,1,264000,40000,304000
Belize,2009,2,329000,12000,341000
Belize,2009,3,703000,170000,873000
Belize,2009,4,1188000,36000,1224000
Belize,2009,5,864000,118000,982000
Belize,2009,6,443000,85000,528000
Belize,2009,7,308000,274000,582000
Belize,2009,8,357000,42000,399000
Belize,2009,9,287000,101000,388000
Belize,2009,10,1004000,1115000,2119000
Belize,2009,11,875000,102000,977000
Belize,2009,12,425000,64000,489000
Belize,2010,1,777000,28000,805000
Belize,2010,2,238000,7000,245000
Belize,2010,3,604000,50000,654000
Belize,2010,4,517000,26000,543000
Belize,2010,5,578000,38000,616000
Belize,2010,6,922000,107000,1029000
Belize,2010,7,1719000,74000,1793000
Belize,2010,8,753000,7000,760000
Belize,2010,9,698000,0,698000
Belize,2010,10,748000,11000,759000
Belize,2010,11,1103000,0,1103000
Belize,2010,12,1026000,0,1026000
Belize,2011,1,775000,0,775000
Belize,2011,2,482000,39000,521000
Belize,2011,3,3133000,132000,3265000
Belize,2011,4,506000,4000,510000
Belize,2011,5,3035000,9000,3044000
Belize,2011,6,2678000,10000,2688000
Belize,2011,7,692000,3000,695000
Belize,2011,8,1250000,15000,1265000
Belize,2011,9,2887000,80000,2967000
Belize,2011,10,2686000,37000,2723000
Belize,2011,11,346000,0,346000
Belize,2011,12,870000,0,870000
Belize,2012,1,1680000,0,1680000
Belize,2012,2,913000,167000,1080000
Belize,2012,3,4978000,0,4978000
Belize,2012,4,1035000,4000,1039000
Belize,2012,5,1298000,60000,1358000
Belize,2012,6,116646000,135000,116781000
Belize,2012,7,681000,237000,918000
Belize,2012,8,1218000,59000,1277000
Belize,2012,9,1056000,187000,1243000
Belize,2012,10,1337000,970000,2307000
Belize,2012,11,1147000,436000,1583000
Belize,2012,12,1680000,81000,1761000
Belize,2013,1,777000,99000,876000
Belize,2013,2,4824000,18000,4842000
Belize,2013,3,710000,32000,742000
Belize,2013,4,2878000,6000,2884000
Belize,2013,5,1436000,137000,1573000
Belize,2013,6,1045000,267000,1312000
Belize,2013,7,1012000,29000,1041000
Belize,2013,8,1799000,50000,1849000
Belize,2013,9,1230000,168000,1398000
Belize,2013,10,1054000,29000,1083000
Belize,2013,11,926000,172000,1098000
Belize,2013,12,1892000,17000,1909000
Belize,2014,1,750000,200000,950000
Belize,2014,2,1133000,47000,1180000
Belize,2014,3,12881000,15000,12896000
Belize,2014,4,2331000,30000,2361000
Belize,2014,5,1140000,151000,1291000
Belize,2014,6,1944000,61000,2005000
Belize,2014,7,1109000,127000,1236000
Belize,2014,8,1097000,177000,1274000
Belize,2014,9,1215000,159000,1374000
Belize,2014,10,1404000,165000,1569000
Belize,2014,11,514000,200000,714000
Belize,2014,12,469000,71000,540000
Belize,2015,1,5387000,45000,5432000
Belize,2015,2,360000,216000,576000
Belize,2015,3,1173000,14000,1187000
Belize,2015,4,993000,213000,1206000
Belize,2015,5,845000,70000,915000
Belize,2015,6,1582000,157000,1739000
Belize,2015,7,607000,114000,721000
Belize,2015,8,693000,199000,892000
Belize,2015,9,427000,59000,486000
Belize,2015,10,584000,146000,730000
Belize,2015,11,995000,29000,1024000
Belize,2015,12,218000,77000,295000
Belize,2016,1,463000,79000,542000
Belize,2016,2,290000,200000,490000
Belize,2016,3,289000,301000,590000
Belize,2016,4,2010000,256000,2266000
Belize,2016,5,93000,164000,257000
Belize,2016,6,491000,39000,530000
Belize,2016,7,703000,192000,895000
Belize,2016,8,169000,182000,351000
Belize,2016,9,351000,396000,747000
Belize,2016,10,131000,267000,398000
Belize,2016,11,850000,536000,1386000
Belize,2016,12,633000,480000,1113000
Belize,2017,1,166000,426000,592000
Belize,2017,2,430000,471000,901000
Belize,2017,3,193000,555000,748000
Belize,2017,4,247000,373000,620000
Belize,2017,5,211000,230000,441000
Belize,2017,6,345000,453000,798000
Belize,2017,7,288000,285000,573000
Belize,2017,8,200000,375000,575000
Belize,2017,9,164000,150000,314000
Belize,2017,10,655000,415000,1070000
Belize,2017,11,778000,144000,922000
Belize,2017,12,805000,443000,1248000
Belize,2018,1,297000,341000,638000
Belize,2018,2,528000,172000,700000
Belize,2018,3,143000,131000,274000
Belize,2018,4,180000,147000,327000
Belize,2018,5,153000,199000,352000
Belize,2018,6,191000,29000,220000
Belize,2018,7,239000,402000,641000
Belize,2018,8,157000,139000,296000
Belize,2018,9,162000,256000,418000
Belize,2018,10,481000,159000,640000
Belize,2018,11,200000,560000,760000
Belize,2018,12,137000,57000,194000
Belize,2019,1,117000,186000,303000
Belize,2019,2,249000,351000,600000
Belize,2019,3,149000,2309000,2458000
Belize,2019,4,204000,127000,331000
Belize,2019,5,180000,356000,536000
Belize,2019,6,189000,293000,482000
Belize,2019,7,193000,323000,516000
Belize,2019,8,266000,200000,466000
Belize,2019,9,582000,209000,791000
Belize,2019,10,237000,206000,443000
Belize,2019,11,332000,141000,473000
Belize,2019,12,427000,276000,703000
Belize,2020,1,158000,174000,332000
Belize,2020,2,301000,94000,395000
Belize,2020,3,272000,114000,386000
Belize,2020,4,70000,112000,182000
Belize,2020,5,105000,42000,147000
Belize,2020,6,307000,163000,470000
Belize,2020,7,349000,169000,518000
Belize,2020,8,1143000,288000,1431000
Belize,2020,9,286000,111000,397000
Belize,2020,10,154000,172000,326000
Belize,2020,11,196000,76000,272000
Belize,2020,12,251000,50000,301000
Belize,2021,1,147000,6000,153000
Belize,2021,2,122000,113000,235000
Belize,2021,3,319000,25000,344000
Belize,2021,4,306000,19000,325000
Belize,2021,5,180000,196000,376000
Belize,2021,6,314000,314000,628000
Belize,2021,7,2752000,111000,2863000
Belize,2021,8,661000,94000,755000
Belize,2021,9,525000,64000,589000
Belize,2021,10,371000,303000,674000
Belize,2021,11,161000,372000,533000
Belize,2021,12,327000,170000,497000
Belize,2022,1,161000,202000,363000
Belize,2022,2,2901000,42000,2943000
Belize,2022,3,239000,292000,531000
Belize,2022,4,211000,512000,723000
Belize,2022,5,230000,786000,1016000
Belize,2022,6,317000,335000,652000
Belize,2022,7,175000,477000,652000
Belize,2022,8,657000,227000,884000
Belize,2022,9,740000,281000,1021000
Belize,2022,10,473000,364000,837000
Belize,2022,11,413000,355000,768000
Belize,2022,12,246000,130000,376000
Belize,2023,1,242000,192000,434000
Belize,2023,2,457000,170000,627000
Belize,2023,3,348000,209000,557000
Belize,2023,4,269000,157000,426000
Belize,2023,5,427000,308000,735000
Belize,2023,6,405000,311000,716000
Belize,2023,7,436000,320000,756000
Belize,2023,8,15836000,432000,16268000
Belize,2023,9,383000,216000,599000
Belize,2023,10,481000,708000,1189000
Belize,2023,11,281000,371000,652000
Belize,2023,12,355000,547000,902000
Belize,2024,1,312000,368000,680000
Belize,2024,2,350000,231000,581000
Belize,2024,3,792000,460000,1252000
Belize,2024,4,835000,448000,1283000
Belize,2024,5,332000,913000,1245000
Belize,2024,6,731000,988000,1719000
Belize,2024,7,461000,730000,1191000
Belize,2024,8,475000,462000,937000
Belize,2024,9,978000,509000,1487000
Belize,2024,10,493000,546000,1039000
Belize,2024,11,857000,312000,1169000
Belize,2024,12,336000,383000,719000
Benin,2008,1,3543000,346000,3889000
Benin,2008,2,4690000,27000,4717000
Benin,2008,3,3324000,21000,3345000
Benin,2008,4,5770000,65000,5835000
Benin,2008,5,4840000,434000,5274000
Benin,2008,6,5188000,428000,5616000
Benin,2008,7,4584000,496000,5080000
Benin,2008,8,3947000,254000,4201000
Benin,2008,9,4833000,592000,5425000
Benin,2008,10,5392000,350000,5742000
Benin,2008,11,5267000,384000,5651000
Benin,2008,12,4060000,49000,4109000
Benin,2009,1,4134000,132000,4266000
Benin,2009,2,3346000,125000,3471000
Benin,2009,3,4082000,246000,4328000
Benin,2009,4,3604000,561000,4165000
Benin,2009,5,3822000,304000,4126000
Benin,2009,6,3740000,417000,4157000
Benin,2009,7,5712000,207000,5919000
Benin,2009,8,19668000,143000,19811000
Benin,2009,9,3773000,293000,4066000
Benin,2009,10,4902000,48000,4950000
Benin,2009,11,5170000,109000,5279000
Benin,2009,12,4581000,26000,4607000
Benin,2010,1,2446000,79000,2525000
Benin,2010,2,3708000,80000,3788000
Benin,2010,3,5771000,51000,5822000
Benin,2010,4,5812000,153000,5965000
Benin,2010,5,4807000,1090000,5897000
Benin,2010,6,6185000,72000,6257000
Benin,2010,7,9161000,452000,9613000
Benin,2010,8,6762000,154000,6916000
Benin,2010,9,6440000,64000,6504000
Benin,2010,10,6446000,42000,6488000
Benin,2010,11,5800000,77000,5877000
Benin,2010,12,6479000,326000,6805000
Benin,2011,1,6432000,442000,6874000
Benin,2011,2,6803000,983000,7786000
Benin,2011,3,8337000,2686000,11023000
Benin,2011,4,7211000,1654000,8865000
Benin,2011,5,8072000,1137000,9209000
Benin,2011,6,6645000,210000,6855000
Benin,2011,7,9999000,54000,10053000
Benin,2011,8,6817000,56000,6873000
Benin,2011,9,6530000,100000,6630000
Benin,2011,10,6070000,109000,6179000
Benin,2011,11,5582000,27000,5609000
Benin,2011,12,4922000,51000,4973000
Benin,2012,1,5468000,34000,5502000
Benin,2012,2,6446000,49000,6495000
Benin,2012,3,5836000,48000,5884000
Benin,2012,4,5274000,47000,5321000
Benin,2012,5,8119000,809000,8928000
Benin,2012,6,7034000,34000,7068000
Benin,2012,7,7910000,11000,7921000
Benin,2012,8,6919000,527000,7446000
Benin,2012,9,5997000,15000,6012000
Benin,2012,10,6367000,539000,6906000
Benin,2012,11,8014000,359000,8373000
Benin,2012,12,5313000,384000,5697000
Benin,2013,1,5235000,70000,5305000
Benin,2013,2,8087000,312000,8399000
Benin,2013,3,10609000,180000,10789000
Benin,2013,4,13037000,5000,13042000
Benin,2013,5,8563000,29000,8592000
Benin,2013,6,7630000,49000,7679000
Benin,2013,7,9577000,4000,9581000
Benin,2013,8,5456000,49000,5505000
Benin,2013,9,7118000,13000,7131000
Benin,2013,10,5995000,44000,6039000
Benin,2013,11,6416000,4000,6420000
Benin,2013,12,4887000,1000,4888000
Benin,2014,1,6935000,7121000,14056000
Benin,2014,2,8718000,15000,8733000
Benin,2014,3,6393000,8000,6401000
Benin,2014,4,5007000,21000,5028000
Benin,2014,5,5220000,2000,5222000
Benin,2014,6,6134000,6000,6140000
Benin,2014,7,6759000,143000,6902000
Benin,2014,8,5785000,37000,5822000
Benin,2014,9,6412000,93000,6505000
Benin,2014,10,8779000,754000,9533000
Benin,2014,11,6896000,72000,6968000
Benin,2014,12,4170000,136000,4306000
Benin,2015,1,4889000,135000,5024000
Benin,2015,2,8739000,0,8739000
Benin,2015,3,5901000,1000,5902000
Benin,2015,4,5834000,2000,5836000
Benin,2015,5,5522000,0,5522000
Benin,2015,6,5480000,352000,5832000
Benin,2015,7,7253000,61000,7314000
Benin,2015,8,5654000,313000,5967000
Benin,2015,9,3980000,138000,4118000
Benin,2015,10,4793000,6000,4799000
Benin,2015,11,4805000,0,4805000
Benin,2015,12,4520000,1000,4521000
Benin,2016,1,2286000,1000,2287000
Benin,2016,2,4760000,0,4760000
Benin,2016,3,3882000,3000,3885000
Benin,2016,4,3090000,333000,3423000
Benin,2016,5,10861000,6000,10867000
Benin,2016,6,3971000,58000,4029000
Benin,2016,7,3506000,0,3506000
Benin,2016,8,2268000,3000,2271000
Benin,2016,9,2187000,5000,2192000
Benin,2016,10,3119000,577000,3696000
Benin,2016,11,1662000,5000,1667000
Benin,2016,12,2208000,54000,2262000
Benin,2017,1,1878000,71000,1949000
Benin,2017,2,2145000,6000,2151000
Benin,2017,3,2461000,375000,2836000
Benin,2017,4,2373000,105000,2478000
Benin,2017,5,2599000,28000,2627000
Benin,2017,6,3480000,6000,3486000
Benin,2017,7,2897000,10000,2907000
Benin,2017,8,2168000,75000,2243000
Benin,2017,9,2265000,3000,2268000
Benin,2017,10,2355000,66000,2421000
Benin,2017,11,4082000,13000,4095000
Benin,2017,12,3636000,129000,3765000
Benin,2018,1,2305000,64000,2369000
Benin,2018,2,2526000,184000,2710000
Benin,2018,3,2718000,17000,2735000
Benin,2018,4,2665000,22000,2687000
Benin,2018,5,2574000,116000,2690000
Benin,2018,6,4644000,14000,4658000
Benin,2018,7,3117000,2000,3119000
Benin,2018,8,3175000,16000,3191000
Benin,2018,9,2765000,83000,2848000
Benin,2018,10,3534000,10000,3544000
Benin,2018,11,7830000,127000,7957000
Benin,2018,12,1737000,133000,1870000
Benin,2019,1,3235000,864000,4099000
Benin,2019,2,4269000,61000,4330000
Benin,2019,3,3463000,8000,3471000
Benin,2019,4,3113000,357000,3470000
Benin,2019,5,3554000,95000,3649000
Benin,2019,6,2754000,628000,3382000
Benin,2019,7,2957000,296000,3253000
Benin,2019,8,3505000,293000,3798000
Benin,2019,9,1944000,48000,1992000
Benin,2019,10,2394000,21000,2415000
Benin,2019,11,2264000,62000,2326000
Benin,2019,12,2554000,42000,2596000
Benin,2020,1,3071000,20000,3091000
Benin,2020,2,2073000,138000,2211000
Benin,2020,3,3231000,18000,3249000
Benin,2020,4,4815000,8000,4823000
Benin,2020,5,3234000,5000,3239000
Benin,2020,6,3776000,30000,3806000
Benin,2020,7,2062000,159000,2221000
Benin,2020,8,2531000,143000,2674000
Benin,2020,9,3251000,32000,3283000
Benin,2020,10,3057000,177000,3234000
Benin,2020,11,3601000,16000,3617000
Benin,2020,12,2282000,32000,2314000
Benin,2021,1,2430000,20000,2450000
Benin,2021,2,2750000,19000,2769000
Benin,2021,3,3659000,272000,3931000
Benin,2021,4,3763000,149000,3912000
Benin,2021,5,3227000,31000,3258000
Benin,2021,6,4602000,20000,4622000
Benin,2021,7,5030000,16000,5046000
Benin,2021,8,4519000,290000,4809000
Benin,2021,9,5161000,93000,5254000
Benin,2021,10,3831000,50000,3881000
Benin,2021,11,5365000,20000,5385000
Benin,2021,12,4285000,8000,4293000
Benin,2022,1,3495000,65000,3560000
Benin,2022,2,3089000,259000,3348000
Benin,2022,3,4222000,14000,4236000
Benin,2022,4,2597000,14000,2611000
Benin,2022,5,3552000,264000,3816000
Benin,2022,6,4833000,113000,4946000
Benin,2022,7,3289000,78000,3367000
Benin,2022,8,8904000,377000,9281000
Benin,2022,9,5789000,135000,5924000
Benin,2022,10,5072000,69000,5141000
Benin,2022,11,5953000,86000,6039000
Benin,2022,12,6346000,24000,6370000
Benin,2023,1,5795000,11000,5806000
Benin,2023,2,4096000,1407000,5503000
Benin,2023,3,5100000,31000,5131000
Benin,2023,4,5490000,406000,5896000
Benin,2023,5,9269000,67000,9336000
Benin,2023,6,9980000,244000,10224000
Benin,2023,7,7999000,126000,8125000
Benin,2023,8,5078000,33000,5111000
Benin,2023,9,11025000,44000,11069000
Benin,2023,10,7418000,117000,7535000
Benin,2023,11,4206000,242000,4448000
Benin,2023,12,7807000,15000,7822000
Benin,2024,1,5163000,122000,5285000
Benin,2024,2,10793000,144000,10937000
Benin,2024,3,4473000,1030000,5503000
Benin,2024,4,10799000,358000,11157000
Benin,2024,5,6060000,676000,6736000
Benin,2024,6,3927000,25000,3952000
Benin,2024,7,6799000,738000,7537000
Benin,2024,8,5074000,249000,5323000
Benin,2024,9,5927000,227000,6154000
Benin,2024,10,7329000,254000,7583000
Benin,2024,11,5536000,261000,5797000
Benin,2024,12,5357000,206000,5563000
Bermuda,2008,1,1239000,0,1239000
Bermuda,2008,2,315000,28000,343000
Bermuda,2008,3,608000,65034000,65642000
Bermuda,2008,4,1004000,1000,1005000
Bermuda,2008,5,1033000,139000,1172000
Bermuda,2008,6,1972000,72000,2044000
Bermuda,2008,7,906000,4000,910000
Bermuda,2008,8,511000,948000,1459000
Bermuda,2008,9,659000,10000,669000
Bermuda,2008,10,541000,22000,563000
Bermuda,2008,11,852000,166000,1018000
Bermuda,2008,12,334000,2080000,2414000
Bermuda,2009,1,768000,0,768000
Bermuda,2009,2,1448000,0,1448000
Bermuda,2009,3,2786000,0,2786000
Bermuda,2009,4,1679000,64000,1743000
Bermuda,2009,5,910000,18000,928000
Bermuda,2009,6,406000,3849000,4255000
Bermuda,2009,7,718000,17000,735000
Bermuda,2009,8,1234000,5000,1239000
Bermuda,2009,9,428000,8864000,9292000
Bermuda,2009,10,815000,37000,852000
Bermuda,2009,11,642000,9503000,10145000
Bermuda,2009,12,191000,8000,199000
Bermuda,2010,1,233000,0,233000
Bermuda,2010,2,581000,1000,582000
Bermuda,2010,3,332000,4000,336000
Bermuda,2010,4,292097000,51809000,343906000
Bermuda,2010,5,251000,54000,305000
Bermuda,2010,6,489000,330000,819000
Bermuda,2010,7,878000,9000,887000
Bermuda,2010,8,2178000,496000,2674000
Bermuda,2010,9,557000,475000,1032000
Bermuda,2010,10,371035000,18000,371053000
Bermuda,2010,11,695000,36000,731000
Bermuda,2010,12,286000,145000,431000
Bermuda,2011,1,427000,62000,489000
Bermuda,2011,2,849000,17000,866000
Bermuda,2011,3,315000,57000,372000
Bermuda,2011,4,304000,5000,309000
Bermuda,2011,5,56541000,50000000,106541000
Bermuda,2011,6,512000,19000,531000
Bermuda,2011,7,976000,37000,1013000
Bermuda,2011,8,1351000,32000,1383000
Bermuda,2011,9,443000,55000,498000
Bermuda,2011,10,32942000,53000,32995000
Bermuda,2011,11,409000,217000,626000
Bermuda,2011,12,476000,4000,480000
Bermuda,2012,1,141000,35000,176000
Bermuda,2012,2,191000,93000,284000
Bermuda,2012,3,990000,21000,1011000
Bermuda,2012,4,125000,106000,231000
Bermuda,2012,5,286000,21000,307000
Bermuda,2012,6,224000,174000,398000
Bermuda,2012,7,481000,6000,487000
Bermuda,2012,8,499000,13000,512000
Bermuda,2012,9,372000,4000,376000
Bermuda,2012,10,396000,1000,397000
Bermuda,2012,11,343000,43000,386000
Bermuda,2012,12,474000,8000,482000
Bermuda,2013,1,362000,21000,383000
Bermuda,2013,2,389000,13000,402000
Bermuda,2013,3,485000,0,485000
Bermuda,2013,4,282000,11000,293000
Bermuda,2013,5,1526000,25000,1551000
Bermuda,2013,6,387000,19000,406000
Bermuda,2013,7,526000,4000,530000
Bermuda,2013,8,278000,11000,289000
Bermuda,2013,9,509000,34000,543000
Bermuda,2013,10,150000,38000,188000
Bermuda,2013,11,619000,24000,643000
Bermuda,2013,12,1204000,45000,1249000
Bermuda,2014,1,264000,1000,265000
Bermuda,2014,2,149000,2000,151000
Bermuda,2014,3,1322000,22000,1344000
Bermuda,2014,4,271000,38000,309000
Bermuda,2014,5,221000,12000,233000
Bermuda,2014,6,465000,35000,500000
Bermuda,2014,7,286000,16000,302000
Bermuda,2014,8,490000,55000,545000
Bermuda,2014,9,151000,23000,174000
Bermuda,2014,10,280000,29000,309000
Bermuda,2014,11,414000,18000,432000
Bermuda,2014,12,247000,71000,318000
Bermuda,2015,1,194000,13000,207000
Bermuda,2015,2,269000,39000,308000
Bermuda,2015,3,350000,39000,389000
Bermuda,2015,4,266000,18000,284000
Bermuda,2015,5,287000,13000,300000
Bermuda,2015,6,295000,77000,372000
Bermuda,2015,7,314000,68000,382000
Bermuda,2015,8,432000,15000,447000
Bermuda,2015,9,287000,77000,364000
Bermuda,2015,10,341782000,14000,341796000
Bermuda,2015,11,181000,12000,193000
Bermuda,2015,12,73544000,42000,73586000
Bermuda,2016,1,272000,55000,327000
Bermuda,2016,2,605000,21000,626000
Bermuda,2016,3,700000,29000,729000
Bermuda,2016,4,456000,23000,479000
Bermuda,2016,5,541000,49000,590000
Bermuda,2016,6,1132000,26060000,27192000
Bermuda,2016,7,1223000,56698000,57921000
Bermuda,2016,8,1224000,54426000,55650000
Bermuda,2016,9,890000,18000,908000
Bermuda,2016,10,442000,66000,508000
Bermuda,2016,11,556000,100887000,101443000
Bermuda,2016,12,430000,51000,481000
Bermuda,2017,1,2052000,14000,2066000
Bermuda,2017,2,5004000,47000,5051000
Bermuda,2017,3,418000,208000,626000
Bermuda,2017,4,803000,116000,919000
Bermuda,2017,5,650000,78000,728000
Bermuda,2017,6,510000,86000,596000
Bermuda,2017,7,590000,91000,681000
Bermuda,2017,8,1440000,40000,1480000
Bermuda,2017,9,1024000,50000,1074000
Bermuda,2017,10,614000,21000,635000
Bermuda,2017,11,430000,55000,485000
Bermuda,2017,12,206000,27000,233000
Bermuda,2018,1,381000,12000,393000
Bermuda,2018,2,495000,8000,503000
Bermuda,2018,3,382000,45000,427000
Bermuda,2018,4,591000,14000,605000
Bermuda,2018,5,995000,32000,1027000
Bermuda,2018,6,245000,62000,307000
Bermuda,2018,7,615000,45000,660000
Bermuda,2018,8,699000,26000,725000
Bermuda,2018,9,1578000,42000,1620000
Bermuda,2018,10,391000,56000,447000
Bermuda,2018,11,759000,285000,1044000
Bermuda,2018,12,881000,29000,910000
Bermuda,2019,1,1163000,68000,1231000
Bermuda,2019,2,795000,0,795000
Bermuda,2019,3,2613000,36000,2649000
Bermuda,2019,4,18843000,57000,18900000
Bermuda,2019,5,979000,166000,1145000
Bermuda,2019,6,40457000,44000,40501000
Bermuda,2019,7,809000,38000,847000
Bermuda,2019,8,20391000,76000,20467000
Bermuda,2019,9,325000,271000,596000
Bermuda,2019,10,32783000,88000,32871000
Bermuda,2019,11,1026000,46000,1072000
Bermuda,2019,12,230000,30000,260000
Bermuda,2020,1,279000,102000,381000
Bermuda,2020,2,901000,29000,930000
Bermuda,2020,3,263000,11000,274000
Bermuda,2020,4,2024000,0,2024000
Bermuda,2020,5,302000,17000,319000
Bermuda,2020,6,377000,4000,381000
Bermuda,2020,7,307000,3000,310000
Bermuda,2020,8,1148000,8000,1156000
Bermuda,2020,9,434000,19000,453000
Bermuda,2020,10,3953000,13000,3966000
Bermuda,2020,11,538000,9000,547000
Bermuda,2020,12,995000,10000,1005000
Bermuda,2021,1,944000,2000,946000
Bermuda,2021,2,817000,6000,823000
Bermuda,2021,3,2175000,45000,2220000
Bermuda,2021,4,2832000,4000,2836000
Bermuda,2021,5,584000,17000,601000
Bermuda,2021,6,1092000,58000,1150000
Bermuda,2021,7,682000,149000,831000
Bermuda,2021,8,1386000,40000,1426000
Bermuda,2021,9,1171000,57000,1228000
Bermuda,2021,10,1940000,15000,1955000
Bermuda,2021,11,4430000,92000,4522000
Bermuda,2021,12,3903000,74000,3977000
Bermuda,2022,1,1350000,64000,1414000
Bermuda,2022,2,1021000,51000,1072000
Bermuda,2022,3,1462000,60000,1522000
Bermuda,2022,4,1840000,64000,1904000
Bermuda,2022,5,771000,58000,829000
Bermuda,2022,6,803000,70000,873000
Bermuda,2022,7,1074000,41000,1115000
Bermuda,2022,8,3586000,62000,3648000
Bermuda,2022,9,794000,39000,833000
Bermuda,2022,10,4540000,191000,4731000
Bermuda,2022,11,1023000,34000,1057000
Bermuda,2022,12,629000,29000,658000
Bermuda,2023,1,716000,181000,897000
Bermuda,2023,2,548000,31000,579000
Bermuda,2023,3,836000,30000,866000
Bermuda,2023,4,550000,75000,625000
Bermuda,2023,5,507000,19624000,20131000
Bermuda,2023,6,430000,56326000,56756000
Bermuda,2023,7,39864000,63000,39927000
Bermuda,2023,8,916000,16756000,17672000
Bermuda,2023,9,545000,8000,553000
Bermuda,2023,10,344000,9000,353000
Bermuda,2023,11,218000,26000,244000
Bermuda,2023,12,1286000,22000,1308000
Bermuda,2024,1,463000,65000,528000
Bermuda,2024,2,480000,32000,512000
Bermuda,2024,3,1908000,11000,1919000
Bermuda,2024,4,4103000,68000,4171000
Bermuda,2024,5,165000,151000,316000
Bermuda,2024,6,2962000,19000,2981000
Bermuda,2024,7,456000,114000,570000
Bermuda,2024,8,609000,25000,634000
Bermuda,2024,9,1096000,25000,1121000
Bermuda,2024,10,618000,35000,653000
Bermuda,2024,11,527000,36000,563000
Bermuda,2024,12,3392000,23000,3415000
Besetzte palästinensische Gebiete (ab 1995),2008,1,2409000,198000,2607000
Besetzte palästinensische Gebiete (ab 1995),2008,2,1541000,23000,1564000
Besetzte palästinensische Gebiete (ab 1995),2008,3,2682000,7000,2689000
Besetzte palästinensische Gebiete (ab 1995),2008,4,2234000,1000,2235000
Besetzte palästinensische Gebiete (ab 1995),2008,5,1365000,4000,1369000
Besetzte palästinensische Gebiete (ab 1995),2008,6,2822000,13000,2835000
Besetzte palästinensische Gebiete (ab 1995),2008,7,3039000,1000,3040000
Besetzte palästinensische Gebiete (ab 1995),2008,8,1099000,6000,1105000
Besetzte palästinensische Gebiete (ab 1995),2008,9,4084000,3000,4087000
Besetzte palästinensische Gebiete (ab 1995),2008,10,2488000,9000,2497000
Besetzte palästinensische Gebiete (ab 1995),2008,11,2013000,39000,2052000
Besetzte palästinensische Gebiete (ab 1995),2008,12,4125000,0,4125000
Besetzte palästinensische Gebiete (ab 1995),2009,1,978000,1000,979000
Besetzte palästinensische Gebiete (ab 1995),2009,2,3506000,193000,3699000
Besetzte palästinensische Gebiete (ab 1995),2009,3,2788000,6000,2794000
Besetzte palästinensische Gebiete (ab 1995),2009,4,3685000,3000,3688000
Besetzte palästinensische Gebiete (ab 1995),2009,5,2561000,9000,2570000
Besetzte palästinensische Gebiete (ab 1995),2009,6,1917000,44000,1961000
Besetzte palästinensische Gebiete (ab 1995),2009,7,1066000,1000,1067000
Besetzte palästinensische Gebiete (ab 1995),2009,8,3214000,5000,3219000
Besetzte palästinensische Gebiete (ab 1995),2009,9,1711000,55000,1766000
Besetzte palästinensische Gebiete (ab 1995),2009,10,1785000,28000,1813000
Besetzte palästinensische Gebiete (ab 1995),2009,11,2432000,25000,2457000
Besetzte palästinensische Gebiete (ab 1995),2009,12,2142000,22000,2164000
Besetzte palästinensische Gebiete (ab 1995),2010,1,3062000,2000,3064000
Besetzte palästinensische Gebiete (ab 1995),2010,2,2670000,39000,2709000
Besetzte palästinensische Gebiete (ab 1995),2010,3,2810000,9000,2819000
Besetzte palästinensische Gebiete (ab 1995),2010,4,1734000,43000,1777000
Besetzte palästinensische Gebiete (ab 1995),2010,5,3147000,16000,3163000
Besetzte palästinensische Gebiete (ab 1995),2010,6,3764000,10000,3774000
Besetzte palästinensische Gebiete (ab 1995),2010,7,2957000,0,2957000
Besetzte palästinensische Gebiete (ab 1995),2010,8,2350000,5000,2355000
Besetzte palästinensische Gebiete (ab 1995),2010,9,2153000,13000,2166000
Besetzte palästinensische Gebiete (ab 1995),2010,10,2166000,16000,2182000
Besetzte palästinensische Gebiete (ab 1995),2010,11,2170000,9000,2179000
Besetzte palästinensische Gebiete (ab 1995),2010,12,3992000,14000,4006000
Besetzte palästinensische Gebiete (ab 1995),2011,1,2379000,29000,2408000
Besetzte palästinensische Gebiete (ab 1995),2011,2,3095000,17000,3112000
Besetzte palästinensische Gebiete (ab 1995),2011,3,2693000,19000,2712000
Besetzte palästinensische Gebiete (ab 1995),2011,4,3421000,39000,3460000
Besetzte palästinensische Gebiete (ab 1995),2011,5,5100000,17000,5117000
Besetzte palästinensische Gebiete (ab 1995),2011,6,3973000,24000,3997000
Besetzte palästinensische Gebiete (ab 1995),2011,7,3764000,6000,3770000
Besetzte palästinensische Gebiete (ab 1995),2011,8,2956000,6000,2962000
Besetzte palästinensische Gebiete (ab 1995),2011,9,1348000,9000,1357000
Besetzte palästinensische Gebiete (ab 1995),2011,10,3516000,8000,3524000
Besetzte palästinensische Gebiete (ab 1995),2011,11,2244000,30000,2274000
Besetzte palästinensische Gebiete (ab 1995),2011,12,2795000,2000,2797000
Besetzte palästinensische Gebiete (ab 1995),2012,1,1892000,53000,1945000
Besetzte palästinensische Gebiete (ab 1995),2012,2,4078000,28000,4106000
Besetzte palästinensische Gebiete (ab 1995),2012,3,3672000,28000,3700000
Besetzte palästinensische Gebiete (ab 1995),2012,4,3935000,14000,3949000
Besetzte palästinensische Gebiete (ab 1995),2012,5,3004000,19000,3023000
Besetzte palästinensische Gebiete (ab 1995),2012,6,6662000,10000,6672000
Besetzte palästinensische Gebiete (ab 1995),2012,7,7073000,82000,7155000
Besetzte palästinensische Gebiete (ab 1995),2012,8,3195000,8000,3203000
Besetzte palästinensische Gebiete (ab 1995),2012,9,5392000,6000,5398000
Besetzte palästinensische Gebiete (ab 1995),2012,10,3502000,31000,3533000
Besetzte palästinensische Gebiete (ab 1995),2012,11,4836000,17000,4853000
Besetzte palästinensische Gebiete (ab 1995),2012,12,2722000,170000,2892000
Besetzte palästinensische Gebiete (ab 1995),2013,1,4977000,38000,5015000
Besetzte palästinensische Gebiete (ab 1995),2013,2,4063000,26000,4089000
Besetzte palästinensische Gebiete (ab 1995),2013,3,3508000,87000,3595000
Besetzte palästinensische Gebiete (ab 1995),2013,4,4862000,34000,4896000
Besetzte palästinensische Gebiete (ab 1995),2013,5,4556000,65000,4621000
Besetzte palästinensische Gebiete (ab 1995),2013,6,4519000,10000,4529000
Besetzte palästinensische Gebiete (ab 1995),2013,7,5356000,14000,5370000
Besetzte palästinensische Gebiete (ab 1995),2013,8,2761000,104000,2865000
Besetzte palästinensische Gebiete (ab 1995),2013,9,3770000,74000,3844000
Besetzte palästinensische Gebiete (ab 1995),2013,10,4696000,26000,4722000
Besetzte palästinensische Gebiete (ab 1995),2013,11,5039000,24000,5063000
Besetzte palästinensische Gebiete (ab 1995),2013,12,4810000,23000,4833000
Besetzte palästinensische Gebiete (ab 1995),2014,1,3316000,162000,3478000
Besetzte palästinensische Gebiete (ab 1995),2014,2,5466000,102000,5568000
Besetzte palästinensische Gebiete (ab 1995),2014,3,3915000,107000,4022000
Besetzte palästinensische Gebiete (ab 1995),2014,4,4046000,82000,4128000
Besetzte palästinensische Gebiete (ab 1995),2014,5,4132000,25000,4157000
Besetzte palästinensische Gebiete (ab 1995),2014,6,8738000,55000,8793000
Besetzte palästinensische Gebiete (ab 1995),2014,7,4132000,45000,4177000
Besetzte palästinensische Gebiete (ab 1995),2014,8,2206000,109000,2315000
Besetzte palästinensische Gebiete (ab 1995),2014,9,3669000,62000,3731000
Besetzte palästinensische Gebiete (ab 1995),2014,10,4328000,35000,4363000
Besetzte palästinensische Gebiete (ab 1995),2014,11,4707000,85000,4792000
Besetzte palästinensische Gebiete (ab 1995),2014,12,3434000,90000,3524000
Besetzte palästinensische Gebiete (ab 1995),2015,1,4054000,83000,4137000
Besetzte palästinensische Gebiete (ab 1995),2015,2,4285000,121000,4406000
Besetzte palästinensische Gebiete (ab 1995),2015,3,5179000,27000,5206000
Besetzte palästinensische Gebiete (ab 1995),2015,4,5643000,77000,5720000
Besetzte palästinensische Gebiete (ab 1995),2015,5,4416000,7000,4423000
Besetzte palästinensische Gebiete (ab 1995),2015,6,6358000,36000,6394000
Besetzte palästinensische Gebiete (ab 1995),2015,7,6717000,59000,6776000
Besetzte palästinensische Gebiete (ab 1995),2015,8,5744000,65000,5809000
Besetzte palästinensische Gebiete (ab 1995),2015,9,4636000,63000,4699000
Besetzte palästinensische Gebiete (ab 1995),2015,10,5225000,30000,5255000
Besetzte palästinensische Gebiete (ab 1995),2015,11,5410000,60000,5470000
Besetzte palästinensische Gebiete (ab 1995),2015,12,3831000,147000,3978000
Besetzte palästinensische Gebiete (ab 1995),2016,1,5320000,157000,5477000
Besetzte palästinensische Gebiete (ab 1995),2016,2,7586000,111000,7697000
Besetzte palästinensische Gebiete (ab 1995),2016,3,8151000,56000,8207000
Besetzte palästinensische Gebiete (ab 1995),2016,4,7565000,82000,7647000
Besetzte palästinensische Gebiete (ab 1995),2016,5,5059000,38000,5097000
Besetzte palästinensische Gebiete (ab 1995),2016,6,11101000,33000,11134000
Besetzte palästinensische Gebiete (ab 1995),2016,7,5200000,62000,5262000
Besetzte palästinensische Gebiete (ab 1995),2016,8,7930000,28000,7958000
Besetzte palästinensische Gebiete (ab 1995),2016,9,9056000,31000,9087000
Besetzte palästinensische Gebiete (ab 1995),2016,10,5427000,97000,5524000
Besetzte palästinensische Gebiete (ab 1995),2016,11,5506000,125000,5631000
Besetzte palästinensische Gebiete (ab 1995),2016,12,6396000,18000,6414000
Besetzte palästinensische Gebiete (ab 1995),2017,1,7051000,47000,7098000
Besetzte palästinensische Gebiete (ab 1995),2017,2,7791000,90000,7881000
Besetzte palästinensische Gebiete (ab 1995),2017,3,10690000,40000,10730000
Besetzte palästinensische Gebiete (ab 1995),2017,4,7033000,20000,7053000
Besetzte palästinensische Gebiete (ab 1995),2017,5,7876000,105000,7981000
Besetzte palästinensische Gebiete (ab 1995),2017,6,9443000,29000,9472000
Besetzte palästinensische Gebiete (ab 1995),2017,7,6030000,85000,6115000
Besetzte palästinensische Gebiete (ab 1995),2017,8,8009000,66000,8075000
Besetzte palästinensische Gebiete (ab 1995),2017,9,7350000,40000,7390000
Besetzte palästinensische Gebiete (ab 1995),2017,10,5142000,82000,5224000
Besetzte palästinensische Gebiete (ab 1995),2017,11,6222000,226000,6448000
Besetzte palästinensische Gebiete (ab 1995),2017,12,5078000,128000,5206000
Besetzte palästinensische Gebiete (ab 1995),2018,1,5766000,146000,5912000
Besetzte palästinensische Gebiete (ab 1995),2018,2,7369000,114000,7483000
Besetzte palästinensische Gebiete (ab 1995),2018,3,9967000,165000,10132000
Besetzte palästinensische Gebiete (ab 1995),2018,4,7243000,157000,7400000
Besetzte palästinensische Gebiete (ab 1995),2018,5,8856000,54000,8910000
Besetzte palästinensische Gebiete (ab 1995),2018,6,8053000,78000,8131000
Besetzte palästinensische Gebiete (ab 1995),2018,7,10085000,15000,10100000
Besetzte palästinensische Gebiete (ab 1995),2018,8,6351000,20000,6371000
Besetzte palästinensische Gebiete (ab 1995),2018,9,6337000,164000,6501000
Besetzte palästinensische Gebiete (ab 1995),2018,10,7201000,67000,7268000
Besetzte palästinensische Gebiete (ab 1995),2018,11,6181000,252000,6433000
Besetzte palästinensische Gebiete (ab 1995),2018,12,5925000,27000,5952000
Besetzte palästinensische Gebiete (ab 1995),2019,1,4396000,277000,4673000
Besetzte palästinensische Gebiete (ab 1995),2019,2,6013000,18000,6031000
Besetzte palästinensische Gebiete (ab 1995),2019,3,7395000,291000,7686000
Besetzte palästinensische Gebiete (ab 1995),2019,4,5566000,79000,5645000
Besetzte palästinensische Gebiete (ab 1995),2019,5,8035000,176000,8211000
Besetzte palästinensische Gebiete (ab 1995),2019,6,5617000,123000,5740000
Besetzte palästinensische Gebiete (ab 1995),2019,7,7852000,39000,7891000
Besetzte palästinensische Gebiete (ab 1995),2019,8,6114000,60000,6174000
Besetzte palästinensische Gebiete (ab 1995),2019,9,7759000,139000,7898000
Besetzte palästinensische Gebiete (ab 1995),2019,10,6111000,378000,6489000
Besetzte palästinensische Gebiete (ab 1995),2019,11,8378000,569000,8947000
Besetzte palästinensische Gebiete (ab 1995),2019,12,6477000,371000,6848000
Besetzte palästinensische Gebiete (ab 1995),2020,1,5968000,427000,6395000
Besetzte palästinensische Gebiete (ab 1995),2020,2,7222000,207000,7429000
Besetzte palästinensische Gebiete (ab 1995),2020,3,9229000,474000,9703000
Besetzte palästinensische Gebiete (ab 1995),2020,4,4983000,452000,5435000
Besetzte palästinensische Gebiete (ab 1995),2020,5,4588000,228000,4816000
Besetzte palästinensische Gebiete (ab 1995),2020,6,6670000,231000,6901000
Besetzte palästinensische Gebiete (ab 1995),2020,7,6859000,325000,7184000
Besetzte palästinensische Gebiete (ab 1995),2020,8,5386000,68000,5454000
Besetzte palästinensische Gebiete (ab 1995),2020,9,7205000,234000,7439000
Besetzte palästinensische Gebiete (ab 1995),2020,10,9723000,625000,10348000
Besetzte palästinensische Gebiete (ab 1995),2020,11,7531000,563000,8094000
Besetzte palästinensische Gebiete (ab 1995),2020,12,7067000,367000,7434000
Besetzte palästinensische Gebiete (ab 1995),2021,1,6773000,765000,7538000
Besetzte palästinensische Gebiete (ab 1995),2021,2,8888000,725000,9613000
Besetzte palästinensische Gebiete (ab 1995),2021,3,8907000,1177000,10084000
Besetzte palästinensische Gebiete (ab 1995),2021,4,6923000,714000,7637000
Besetzte palästinensische Gebiete (ab 1995),2021,5,7399000,375000,7774000
Besetzte palästinensische Gebiete (ab 1995),2021,6,8281000,232000,8513000
Besetzte palästinensische Gebiete (ab 1995),2021,7,6915000,133000,7048000
Besetzte palästinensische Gebiete (ab 1995),2021,8,7505000,172000,7677000
Besetzte palästinensische Gebiete (ab 1995),2021,9,8478000,269000,8747000
Besetzte palästinensische Gebiete (ab 1995),2021,10,9148000,624000,9772000
Besetzte palästinensische Gebiete (ab 1995),2021,11,9644000,508000,10152000
Besetzte palästinensische Gebiete (ab 1995),2021,12,8928000,436000,9364000
Besetzte palästinensische Gebiete (ab 1995),2022,1,8541000,26000,8567000
Besetzte palästinensische Gebiete (ab 1995),2022,2,8880000,332000,9212000
Besetzte palästinensische Gebiete (ab 1995),2022,3,10561000,862000,11423000
Besetzte palästinensische Gebiete (ab 1995),2022,4,9401000,681000,10082000
Besetzte palästinensische Gebiete (ab 1995),2022,5,8560000,177000,8737000
Besetzte palästinensische Gebiete (ab 1995),2022,6,10905000,37000,10942000
Besetzte palästinensische Gebiete (ab 1995),2022,7,13009000,104000,13113000
Besetzte palästinensische Gebiete (ab 1995),2022,8,14080000,87000,14167000
Besetzte palästinensische Gebiete (ab 1995),2022,9,13603000,37000,13640000
Besetzte palästinensische Gebiete (ab 1995),2022,10,12799000,535000,13334000
Besetzte palästinensische Gebiete (ab 1995),2022,11,11127000,527000,11654000
Besetzte palästinensische Gebiete (ab 1995),2022,12,8821000,216000,9037000
Besetzte palästinensische Gebiete (ab 1995),2023,1,9885000,388000,10273000
Besetzte palästinensische Gebiete (ab 1995),2023,2,13542000,582000,14124000
Besetzte palästinensische Gebiete (ab 1995),2023,3,11015000,608000,11623000
Besetzte palästinensische Gebiete (ab 1995),2023,4,9240000,373000,9613000
Besetzte palästinensische Gebiete (ab 1995),2023,5,10363000,147000,10510000
Besetzte palästinensische Gebiete (ab 1995),2023,6,14507000,123000,14630000
Besetzte palästinensische Gebiete (ab 1995),2023,7,10736000,197000,10933000
Besetzte palästinensische Gebiete (ab 1995),2023,8,13115000,135000,13250000
Besetzte palästinensische Gebiete (ab 1995),2023,9,11559000,21000,11580000
Besetzte palästinensische Gebiete (ab 1995),2023,10,7810000,321000,8131000
Besetzte palästinensische Gebiete (ab 1995),2023,11,8733000,478000,9211000
Besetzte palästinensische Gebiete (ab 1995),2023,12,7226000,825000,8051000
Besetzte palästinensische Gebiete (ab 1995),2024,1,8182000,561000,8743000
Besetzte palästinensische Gebiete (ab 1995),2024,2,8225000,806000,9031000
Besetzte palästinensische Gebiete (ab 1995),2024,3,9597000,1270000,10867000
Besetzte palästinensische Gebiete (ab 1995),2024,4,7603000,486000,8089000
Besetzte palästinensische Gebiete (ab 1995),2024,5,8761000,80000,8841000
Besetzte palästinensische Gebiete (ab 1995),2024,6,7314000,81000,7395000
Besetzte palästinensische Gebiete (ab 1995),2024,7,7528000,96000,7624000
Besetzte palästinensische Gebiete (ab 1995),2024,8,8280000,8000,8288000
Besetzte palästinensische Gebiete (ab 1995),2024,9,8500000,184000,8684000
Besetzte palästinensische Gebiete (ab 1995),2024,10,6628000,1193000,7821000
Besetzte palästinensische Gebiete (ab 1995),2024,11,7966000,925000,8891000
Besetzte palästinensische Gebiete (ab 1995),2024,12,6485000,982000,7467000
Bhutan,2008,1,30000,11000,41000
Bhutan,2008,2,28000,195000,223000
Bhutan,2008,3,84000,44000,128000
Bhutan,2008,4,555000,25000,580000
Bhutan,2008,5,84000,35000,119000
Bhutan,2008,6,1785000,1000,1786000
Bhutan,2008,7,260000,8000,268000
Bhutan,2008,8,134000,0,134000
Bhutan,2008,9,170000,72000,242000
Bhutan,2008,10,191000,14000,205000
Bhutan,2008,11,87000,151000,238000
Bhutan,2008,12,32000,1000,33000
Bhutan,2009,1,167000,170000,337000
Bhutan,2009,2,164000,3000,167000
Bhutan,2009,3,56000,28000,84000
Bhutan,2009,4,53000,5000,58000
Bhutan,2009,5,75000,6000,81000
Bhutan,2009,6,337000,44000,381000
Bhutan,2009,7,778000,0,778000
Bhutan,2009,8,34000,1000,35000
Bhutan,2009,9,138000,1000,139000
Bhutan,2009,10,133000,0,133000
Bhutan,2009,11,215000,22000,237000
Bhutan,2009,12,786000,7000,793000
Bhutan,2010,1,137000,0,137000
Bhutan,2010,2,181000,0,181000
Bhutan,2010,3,58000,0,58000
Bhutan,2010,4,112000,0,112000
Bhutan,2010,5,75000,1000,76000
Bhutan,2010,6,136000,1000,137000
Bhutan,2010,7,157000,0,157000
Bhutan,2010,8,149000,0,149000
Bhutan,2010,9,280000,0,280000
Bhutan,2010,10,1639000,4000,1643000
Bhutan,2010,11,1327000,0,1327000
Bhutan,2010,12,416000,0,416000
Bhutan,2011,1,92000,0,92000
Bhutan,2011,2,1915000,0,1915000
Bhutan,2011,3,877000,0,877000
Bhutan,2011,4,2061000,0,2061000
Bhutan,2011,5,136000,0,136000
Bhutan,2011,6,194000,0,194000
Bhutan,2011,7,41000,0,41000
Bhutan,2011,8,32000,485000,517000
Bhutan,2011,9,172000,0,172000
Bhutan,2011,10,37000,452000,489000
Bhutan,2011,11,787000,232000,1019000
Bhutan,2011,12,273000,117000,390000
Bhutan,2012,1,105000,0,105000
Bhutan,2012,2,190000,0,190000
Bhutan,2012,3,175000,0,175000
Bhutan,2012,4,23000,0,23000
Bhutan,2012,5,120000,347000,467000
Bhutan,2012,6,260000,502000,762000
Bhutan,2012,7,212000,117000,329000
Bhutan,2012,8,304000,104000,408000
Bhutan,2012,9,187000,0,187000
Bhutan,2012,10,173000,4000,177000
Bhutan,2012,11,203000,0,203000
Bhutan,2012,12,994000,1000,995000
Bhutan,2013,1,83000,104000,187000
Bhutan,2013,2,167000,0,167000
Bhutan,2013,3,9000,283000,292000
Bhutan,2013,4,101000,1085000,1186000
Bhutan,2013,5,360000,335000,695000
Bhutan,2013,6,79000,769000,848000
Bhutan,2013,7,288000,530000,818000
Bhutan,2013,8,112000,659000,771000
Bhutan,2013,9,300000,0,300000
Bhutan,2013,10,200000,442000,642000
Bhutan,2013,11,359000,409000,768000
Bhutan,2013,12,68000,463000,531000
Bhutan,2014,1,64000,153000,217000
Bhutan,2014,2,108000,616000,724000
Bhutan,2014,3,75000,0,75000
Bhutan,2014,4,103000,686000,789000
Bhutan,2014,5,301000,831000,1132000
Bhutan,2014,6,518000,868000,1386000
Bhutan,2014,7,1154000,680000,1834000
Bhutan,2014,8,174000,870000,1044000
Bhutan,2014,9,194000,933000,1127000
Bhutan,2014,10,186000,848000,1034000
Bhutan,2014,11,308000,1137000,1445000
Bhutan,2014,12,355000,225000,580000
Bhutan,2015,1,255000,976000,1231000
Bhutan,2015,2,1933000,1794000,3727000
Bhutan,2015,3,48157000,173000,48330000
Bhutan,2015,4,227000,282000,509000
Bhutan,2015,5,418000,444000,862000
Bhutan,2015,6,948000,920000,1868000
Bhutan,2015,7,631000,562000,1193000
Bhutan,2015,8,284000,1026000,1310000
Bhutan,2015,9,820000,1605000,2425000
Bhutan,2015,10,260000,1408000,1668000
Bhutan,2015,11,147000,570000,717000
Bhutan,2015,12,266000,873000,1139000
Bhutan,2016,1,186000,21000,207000
Bhutan,2016,2,75000,54000,129000
Bhutan,2016,3,669000,17000,686000
Bhutan,2016,4,433000,171000,604000
Bhutan,2016,5,700000,414000,1114000
Bhutan,2016,6,322000,504000,826000
Bhutan,2016,7,768000,106000,874000
Bhutan,2016,8,81000,149000,230000
Bhutan,2016,9,811000,4000,815000
Bhutan,2016,10,181000,4000,185000
Bhutan,2016,11,221000,54000,275000
Bhutan,2016,12,193000,71000,264000
Bhutan,2017,1,613000,0,613000
Bhutan,2017,2,275000,271000,546000
Bhutan,2017,3,224000,334000,558000
Bhutan,2017,4,145000,223000,368000
Bhutan,2017,5,74000,583000,657000
Bhutan,2017,6,76000,138000,214000
Bhutan,2017,7,84000,57000,141000
Bhutan,2017,8,38000,223000,261000
Bhutan,2017,9,395000,346000,741000
Bhutan,2017,10,58000,1140000,1198000
Bhutan,2017,11,167000,595000,762000
Bhutan,2017,12,47000,532000,579000
Bhutan,2018,1,209000,755000,964000
Bhutan,2018,2,231000,48000,279000
Bhutan,2018,3,203000,671000,874000
Bhutan,2018,4,114000,452000,566000
Bhutan,2018,5,126000,726000,852000
Bhutan,2018,6,286000,1258000,1544000
Bhutan,2018,7,36000,859000,895000
Bhutan,2018,8,133000,692000,825000
Bhutan,2018,9,48000,735000,783000
Bhutan,2018,10,189000,769000,958000
Bhutan,2018,11,138000,164000,302000
Bhutan,2018,12,41000,206000,247000
Bhutan,2019,1,680000,207000,887000
Bhutan,2019,2,697000,508000,1205000
Bhutan,2019,3,245000,76000,321000
Bhutan,2019,4,277000,187000,464000
Bhutan,2019,5,12000,131000,143000
Bhutan,2019,6,181000,9000,190000
Bhutan,2019,7,174000,0,174000
Bhutan,2019,8,165000,0,165000
Bhutan,2019,9,49000,0,49000
Bhutan,2019,10,628000,86000,714000
Bhutan,2019,11,1045000,3000,1048000
Bhutan,2019,12,895000,1000,896000
Bhutan,2020,1,499000,163000,662000
Bhutan,2020,2,526000,0,526000
Bhutan,2020,3,973000,14000,987000
Bhutan,2020,4,654000,0,654000
Bhutan,2020,5,513000,3000,516000
Bhutan,2020,6,1065000,1000,1066000
Bhutan,2020,7,891000,40000,931000
Bhutan,2020,8,510000,0,510000
Bhutan,2020,9,590000,3000,593000
Bhutan,2020,10,320000,1000,321000
Bhutan,2020,11,481000,1000,482000
Bhutan,2020,12,137000,1000,138000
Bhutan,2021,1,93000,0,93000
Bhutan,2021,2,98000,0,98000
Bhutan,2021,3,319000,35000,354000
Bhutan,2021,4,462000,0,462000
Bhutan,2021,5,115000,281000,396000
Bhutan,2021,6,162000,354000,516000
Bhutan,2021,7,82000,2000,84000
Bhutan,2021,8,250000,0,250000
Bhutan,2021,9,335000,194000,529000
Bhutan,2021,10,2652000,194000,2846000
Bhutan,2021,11,275000,48000,323000
Bhutan,2021,12,179000,91000,270000
Bhutan,2022,1,66000,20000,86000
Bhutan,2022,2,739000,55000,794000
Bhutan,2022,3,219000,7000,226000
Bhutan,2022,4,101000,23000,124000
Bhutan,2022,5,55000,45000,100000
Bhutan,2022,6,268000,21000,289000
Bhutan,2022,7,1027000,8000,1035000
Bhutan,2022,8,358000,28000,386000
Bhutan,2022,9,55000,334000,389000
Bhutan,2022,10,37000,67000,104000
Bhutan,2022,11,698000,66000,764000
Bhutan,2022,12,952000,34000,986000
Bhutan,2023,1,340000,29000,369000
Bhutan,2023,2,519000,0,519000
Bhutan,2023,3,492000,221000,713000
Bhutan,2023,4,237000,8000,245000
Bhutan,2023,5,290000,177000,467000
Bhutan,2023,6,149000,185000,334000
Bhutan,2023,7,220000,3000,223000
Bhutan,2023,8,38000,2000,40000
Bhutan,2023,9,416000,3000,419000
Bhutan,2023,10,275000,109000,384000
Bhutan,2023,11,466000,38000,504000
Bhutan,2023,12,886000,6000,892000
Bhutan,2024,1,187000,4000,191000
Bhutan,2024,2,142000,45000,187000
Bhutan,2024,3,71000,67000,138000
Bhutan,2024,4,81000,20000,101000
Bhutan,2024,5,59000,26000,85000
Bhutan,2024,6,180000,9000,189000
Bhutan,2024,7,117000,16000,133000
Bhutan,2024,8,99000,5000,104000
Bhutan,2024,9,33000,67000,100000
Bhutan,2024,10,27000,4000,31000
Bhutan,2024,11,159000,3000,162000
Bhutan,2024,12,163000,3000,166000
Bolivarische Republik Venezuela,2008,1,82476000,95225000,177701000
Bolivarische Republik Venezuela,2008,2,66119000,38794000,104913000
Bolivarische Republik Venezuela,2008,3,62033000,42540000,104573000
Bolivarische Republik Venezuela,2008,4,90910000,57938000,148848000
Bolivarische Republik Venezuela,2008,5,88054000,73242000,161296000
Bolivarische Republik Venezuela,2008,6,98920000,37954000,136874000
Bolivarische Republik Venezuela,2008,7,87898000,85692000,173590000
Bolivarische Republik Venezuela,2008,8,76908000,35066000,111974000
Bolivarische Republik Venezuela,2008,9,75665000,153463000,229128000
Bolivarische Republik Venezuela,2008,10,98356000,140133000,238489000
Bolivarische Republik Venezuela,2008,11,70845000,90268000,161113000
Bolivarische Republik Venezuela,2008,12,70004000,72940000,142944000
Bolivarische Republik Venezuela,2009,1,69531000,52025000,121556000
Bolivarische Republik Venezuela,2009,2,68808000,54838000,123646000
Bolivarische Republik Venezuela,2009,3,75465000,17587000,93052000
Bolivarische Republik Venezuela,2009,4,47500000,38398000,85898000
Bolivarische Republik Venezuela,2009,5,38007000,83784000,121791000
Bolivarische Republik Venezuela,2009,6,64384000,100600000,164984000
Bolivarische Republik Venezuela,2009,7,47808000,76071000,123879000
Bolivarische Republik Venezuela,2009,8,100984000,97483000,198467000
Bolivarische Republik Venezuela,2009,9,46405000,82877000,129282000
Bolivarische Republik Venezuela,2009,10,67575000,74559000,142134000
Bolivarische Republik Venezuela,2009,11,71767000,98680000,170447000
Bolivarische Republik Venezuela,2009,12,63194000,23559000,86753000
Bolivarische Republik Venezuela,2010,1,51810000,36446000,88256000
Bolivarische Republik Venezuela,2010,2,40519000,85699000,126218000
Bolivarische Republik Venezuela,2010,3,64809000,37016000,101825000
Bolivarische Republik Venezuela,2010,4,67246000,14773000,82019000
Bolivarische Republik Venezuela,2010,5,53479000,23294000,76773000
Bolivarische Republik Venezuela,2010,6,57788000,78707000,136495000
Bolivarische Republik Venezuela,2010,7,55088000,80819000,135907000
Bolivarische Republik Venezuela,2010,8,54649000,82279000,136928000
Bolivarische Republik Venezuela,2010,9,58278000,88621000,146899000
Bolivarische Republik Venezuela,2010,10,81599000,46321000,127920000
Bolivarische Republik Venezuela,2010,11,60309000,95266000,155575000
Bolivarische Republik Venezuela,2010,12,60912000,41658000,102570000
Bolivarische Republik Venezuela,2011,1,47903000,4939000,52842000
Bolivarische Republik Venezuela,2011,2,64663000,41716000,106379000
Bolivarische Republik Venezuela,2011,3,54932000,49862000,104794000
Bolivarische Republik Venezuela,2011,4,47140000,82436000,129576000
Bolivarische Republik Venezuela,2011,5,55396000,67953000,123349000
Bolivarische Republik Venezuela,2011,6,69028000,53225000,122253000
Bolivarische Republik Venezuela,2011,7,66022000,51793000,117815000
Bolivarische Republik Venezuela,2011,8,63618000,60022000,123640000
Bolivarische Republik Venezuela,2011,9,55203000,101919000,157122000
Bolivarische Republik Venezuela,2011,10,53949000,113318000,167267000
Bolivarische Republik Venezuela,2011,11,58980000,102798000,161778000
Bolivarische Republik Venezuela,2011,12,65452000,19207000,84659000
Bolivarische Republik Venezuela,2012,1,71181000,51904000,123085000
Bolivarische Republik Venezuela,2012,2,52215000,6891000,59106000
Bolivarische Republik Venezuela,2012,3,84904000,51296000,136200000
Bolivarische Republik Venezuela,2012,4,69354000,54567000,123921000
Bolivarische Republik Venezuela,2012,5,77019000,20933000,97952000
Bolivarische Republik Venezuela,2012,6,84707000,42217000,126924000
Bolivarische Republik Venezuela,2012,7,88052000,97225000,185277000
Bolivarische Republik Venezuela,2012,8,102503000,39471000,141974000
Bolivarische Republik Venezuela,2012,9,66863000,4174000,71037000
Bolivarische Republik Venezuela,2012,10,76001000,43240000,119241000
Bolivarische Republik Venezuela,2012,11,82450000,74347000,156797000
Bolivarische Republik Venezuela,2012,12,63975000,53621000,117596000
Bolivarische Republik Venezuela,2013,1,59416000,33147000,92563000
Bolivarische Republik Venezuela,2013,2,44653000,185079000,229732000
Bolivarische Republik Venezuela,2013,3,50639000,22890000,73529000
Bolivarische Republik Venezuela,2013,4,48394000,4119000,52513000
Bolivarische Republik Venezuela,2013,5,62566000,3928000,66494000
Bolivarische Republik Venezuela,2013,6,60926000,29166000,90092000
Bolivarische Republik Venezuela,2013,7,92501000,5354000,97855000
Bolivarische Republik Venezuela,2013,8,85167000,7193000,92360000
Bolivarische Republik Venezuela,2013,9,77001000,6263000,83264000
Bolivarische Republik Venezuela,2013,10,56345000,9202000,65547000
Bolivarische Republik Venezuela,2013,11,55242000,5803000,61045000
Bolivarische Republik Venezuela,2013,12,45610000,7538000,53148000
Bolivarische Republik Venezuela,2014,1,54880000,12332000,67212000
Bolivarische Republik Venezuela,2014,2,80393000,4669000,85062000
Bolivarische Republik Venezuela,2014,3,56447000,8767000,65214000
Bolivarische Republik Venezuela,2014,4,34671000,11063000,45734000
Bolivarische Republik Venezuela,2014,5,34320000,9317000,43637000
Bolivarische Republik Venezuela,2014,6,55292000,20632000,75924000
Bolivarische Republik Venezuela,2014,7,60757000,5699000,66456000
Bolivarische Republik Venezuela,2014,8,54382000,30146000,84528000
Bolivarische Republik Venezuela,2014,9,63872000,4106000,67978000
Bolivarische Republik Venezuela,2014,10,59012000,3438000,62450000
Bolivarische Republik Venezuela,2014,11,66987000,6288000,73275000
Bolivarische Republik Venezuela,2014,12,70819000,4433000,75252000
Bolivarische Republik Venezuela,2015,1,34197000,4164000,38361000
Bolivarische Republik Venezuela,2015,2,36597000,7193000,43790000
Bolivarische Republik Venezuela,2015,3,42397000,3927000,46324000
Bolivarische Republik Venezuela,2015,4,26067000,10026000,36093000
Bolivarische Republik Venezuela,2015,5,42050000,6550000,48600000
Bolivarische Republik Venezuela,2015,6,40474000,9494000,49968000
Bolivarische Republik Venezuela,2015,7,39364000,36920000,76284000
Bolivarische Republik Venezuela,2015,8,72093000,2397000,74490000
Bolivarische Republik Venezuela,2015,9,63689000,20096000,83785000
Bolivarische Republik Venezuela,2015,10,40199000,3291000,43490000
Bolivarische Republik Venezuela,2015,11,49342000,32552000,81894000
Bolivarische Republik Venezuela,2015,12,27569000,3931000,31500000
Bolivarische Republik Venezuela,2016,1,31575000,4836000,36411000
Bolivarische Republik Venezuela,2016,2,16069000,4775000,20844000
Bolivarische Republik Venezuela,2016,3,32647000,5171000,37818000
Bolivarische Republik Venezuela,2016,4,20589000,5799000,26388000
Bolivarische Republik Venezuela,2016,5,16054000,14721000,30775000
Bolivarische Republik Venezuela,2016,6,16305000,3632000,19937000
Bolivarische Republik Venezuela,2016,7,23091000,10968000,34059000
Bolivarische Republik Venezuela,2016,8,22721000,20319000,43040000
Bolivarische Republik Venezuela,2016,9,13349000,10558000,23907000
Bolivarische Republik Venezuela,2016,10,18998000,13619000,32617000
Bolivarische Republik Venezuela,2016,11,20775000,33975000,54750000
Bolivarische Republik Venezuela,2016,12,18146000,14986000,33132000
Bolivarische Republik Venezuela,2017,1,7814000,19496000,27310000
Bolivarische Republik Venezuela,2017,2,13884000,19402000,33286000
Bolivarische Republik Venezuela,2017,3,31883000,23195000,55078000
Bolivarische Republik Venezuela,2017,4,25871000,5619000,31490000
Bolivarische Republik Venezuela,2017,5,17930000,34385000,52315000
Bolivarische Republik Venezuela,2017,6,16135000,19742000,35877000
Bolivarische Republik Venezuela,2017,7,14100000,29913000,44013000
Bolivarische Republik Venezuela,2017,8,8979000,27107000,36086000
Bolivarische Republik Venezuela,2017,9,9449000,31446000,40895000
Bolivarische Republik Venezuela,2017,10,9668000,10664000,20332000
Bolivarische Republik Venezuela,2017,11,10712000,11414000,22126000
Bolivarische Republik Venezuela,2017,12,6063000,24768000,30831000
Bolivarische Republik Venezuela,2018,1,8502000,23852000,32354000
Bolivarische Republik Venezuela,2018,2,9536000,24151000,33687000
Bolivarische Republik Venezuela,2018,3,5577000,21174000,26751000
Bolivarische Republik Venezuela,2018,4,2613000,25990000,28603000
Bolivarische Republik Venezuela,2018,5,4450000,27516000,31966000
Bolivarische Republik Venezuela,2018,6,8693000,24691000,33384000
Bolivarische Republik Venezuela,2018,7,23168000,50934000,74102000
Bolivarische Republik Venezuela,2018,8,15284000,33789000,49073000
Bolivarische Republik Venezuela,2018,9,12865000,24291000,37156000
Bolivarische Republik Venezuela,2018,10,12980000,28834000,41814000
Bolivarische Republik Venezuela,2018,11,16015000,4902000,20917000
Bolivarische Republik Venezuela,2018,12,8103000,22790000,30893000
Bolivarische Republik Venezuela,2019,1,4913000,32269000,37182000
Bolivarische Republik Venezuela,2019,2,4860000,6649000,11509000
Bolivarische Republik Venezuela,2019,3,3958000,45131000,49089000
Bolivarische Republik Venezuela,2019,4,5402000,19653000,25055000
Bolivarische Republik Venezuela,2019,5,6252000,33586000,39838000
Bolivarische Republik Venezuela,2019,6,4172000,3085000,7257000
Bolivarische Republik Venezuela,2019,7,4164000,36665000,40829000
Bolivarische Republik Venezuela,2019,8,3955000,34682000,38637000
Bolivarische Republik Venezuela,2019,9,4467000,20180000,24647000
Bolivarische Republik Venezuela,2019,10,2528000,16664000,19192000
Bolivarische Republik Venezuela,2019,11,4937000,12131000,17068000
Bolivarische Republik Venezuela,2019,12,2363000,2779000,5142000
Bolivarische Republik Venezuela,2020,1,3378000,2599000,5977000
Bolivarische Republik Venezuela,2020,2,2628000,1363000,3991000
Bolivarische Republik Venezuela,2020,3,2048000,1501000,3549000
Bolivarische Republik Venezuela,2020,4,1477000,5838000,7315000
Bolivarische Republik Venezuela,2020,5,1632000,1086000,2718000
Bolivarische Republik Venezuela,2020,6,4146000,2287000,6433000
Bolivarische Republik Venezuela,2020,7,3073000,1523000,4596000
Bolivarische Republik Venezuela,2020,8,2925000,1410000,4335000
Bolivarische Republik Venezuela,2020,9,3435000,1955000,5390000
Bolivarische Republik Venezuela,2020,10,2653000,4306000,6959000
Bolivarische Republik Venezuela,2020,11,3319000,3901000,7220000
Bolivarische Republik Venezuela,2020,12,2888000,2267000,5155000
Bolivarische Republik Venezuela,2021,1,3442000,2375000,5817000
Bolivarische Republik Venezuela,2021,2,3263000,9420000,12683000
Bolivarische Republik Venezuela,2021,3,2606000,8846000,11452000
Bolivarische Republik Venezuela,2021,4,3638000,2573000,6211000
Bolivarische Republik Venezuela,2021,5,2760000,2577000,5337000
Bolivarische Republik Venezuela,2021,6,5979000,2969000,8948000
Bolivarische Republik Venezuela,2021,7,3313000,3598000,6911000
Bolivarische Republik Venezuela,2021,8,4526000,3022000,7548000
Bolivarische Republik Venezuela,2021,9,3312000,2728000,6040000
Bolivarische Republik Venezuela,2021,10,4272000,1688000,5960000
Bolivarische Republik Venezuela,2021,11,3671000,1270000,4941000
Bolivarische Republik Venezuela,2021,12,10159000,1257000,11416000
Bolivarische Republik Venezuela,2022,1,6869000,696000,7565000
Bolivarische Republik Venezuela,2022,2,4600000,1407000,6007000
Bolivarische Republik Venezuela,2022,3,6637000,2536000,9173000
Bolivarische Republik Venezuela,2022,4,6105000,1805000,7910000
Bolivarische Republik Venezuela,2022,5,5371000,1260000,6631000
Bolivarische Republik Venezuela,2022,6,6205000,12698000,18903000
Bolivarische Republik Venezuela,2022,7,7038000,1343000,8381000
Bolivarische Republik Venezuela,2022,8,6177000,727000,6904000
Bolivarische Republik Venezuela,2022,9,9189000,995000,10184000
Bolivarische Republik Venezuela,2022,10,5165000,6908000,12073000
Bolivarische Republik Venezuela,2022,11,12199000,4696000,16895000
Bolivarische Republik Venezuela,2022,12,8125000,1592000,9717000
Bolivarische Republik Venezuela,2023,1,3971000,562000,4533000
Bolivarische Republik Venezuela,2023,2,7655000,1956000,9611000
Bolivarische Republik Venezuela,2023,3,7829000,1229000,9058000
Bolivarische Republik Venezuela,2023,4,4781000,871000,5652000
Bolivarische Republik Venezuela,2023,5,8386000,3400000,11786000
Bolivarische Republik Venezuela,2023,6,11408000,3094000,14502000
Bolivarische Republik Venezuela,2023,7,6026000,2954000,8980000
Bolivarische Republik Venezuela,2023,8,6391000,1122000,7513000
Bolivarische Republik Venezuela,2023,9,5692000,329000,6021000
Bolivarische Republik Venezuela,2023,10,7970000,1223000,9193000
Bolivarische Republik Venezuela,2023,11,5172000,674000,5846000
Bolivarische Republik Venezuela,2023,12,7803000,1859000,9662000
Bolivarische Republik Venezuela,2024,1,16892000,1276000,18168000
Bolivarische Republik Venezuela,2024,2,15837000,1511000,17348000
Bolivarische Republik Venezuela,2024,3,7363000,872000,8235000
Bolivarische Republik Venezuela,2024,4,7800000,3355000,11155000
Bolivarische Republik Venezuela,2024,5,7894000,773000,8667000
Bolivarische Republik Venezuela,2024,6,9041000,6144000,15185000
Bolivarische Republik Venezuela,2024,7,9128000,2866000,11994000
Bolivarische Republik Venezuela,2024,8,9593000,2683000,12276000
Bolivarische Republik Venezuela,2024,9,7586000,4349000,11935000
Bolivarische Republik Venezuela,2024,10,9497000,5563000,15060000
Bolivarische Republik Venezuela,2024,11,7098000,2380000,9478000
Bolivarische Republik Venezuela,2024,12,7994000,1481000,9475000
"Bonaire, Sint Eustatius und Saba (ab 2013)",2008,1,0,0,0
"Bonaire, Sint Eustatius und Saba (ab 2013)",2008,2,0,0,0
"Bonaire, Sint Eustatius und Saba (ab 2013)",2008,3,0,0,0
"Bonaire, Sint Eustatius und Saba (ab 2013)",2008,4,0,0,0
"Bonaire, Sint Eustatius und Saba (ab 2013)",2008,5,0,0,0
"Bonaire, Sint Eustatius und Saba (ab 2013)",2008,6,0,0,0
"Bonaire, Sint Eustatius und Saba (ab 2013)",2008,7,0,0,0
"Bonaire, Sint Eustatius und Saba (ab 2013)",2008,8,0,0,0
"Bonaire, Sint Eustatius und Saba (ab 2013)",2008,9,0,0,0
"Bonaire, Sint Eustatius und Saba (ab 2013)",2008,10,0,0,0
"Bonaire, Sint Eustatius und Saba (ab 2013)",2008,11,0,0,0
"Bonaire, Sint Eustatius und Saba (ab 2013)",2008,12,0,0,0
"Bonaire, Sint Eustatius und Saba (ab 2013)",2009,1,0,0,0
"Bonaire, Sint Eustatius und Saba (ab 2013)",2009,2,0,0,0
"Bonaire, Sint Eustatius und Saba (ab 2013)",2009,3,0,0,0
"Bonaire, Sint Eustatius und Saba (ab 2013)",2009,4,0,0,0
"Bonaire, Sint Eustatius und Saba (ab 2013)",2009,5,0,0,0
"Bonaire, Sint Eustatius und Saba (ab 2013)",2009,6,0,0,0
"Bonaire, Sint Eustatius und Saba (ab 2013)",2009,7,0,0,0
"Bonaire, Sint Eustatius und Saba (ab 2013)",2009,8,0,0,0
"Bonaire, Sint Eustatius und Saba (ab 2013)",2009,9,0,0,0
"Bonaire, Sint Eustatius und Saba (ab 2013)",2009,10,0,0,0
"Bonaire, Sint Eustatius und Saba (ab 2013)",2009,11,0,0,0
"Bonaire, Sint Eustatius und Saba (ab 2013)",2009,12,0,0,0
"Bonaire, Sint Eustatius und Saba (ab 2013)",2010,1,0,0,0
"Bonaire, Sint Eustatius und Saba (ab 2013)",2010,2,0,0,0
"Bonaire, Sint Eustatius und Saba (ab 2013)",2010,3,0,0,0
"Bonaire, Sint Eustatius und Saba (ab 2013)",2010,4,0,0,0
"Bonaire, Sint Eustatius und Saba (ab 2013)",2010,5,0,0,0
"Bonaire, Sint Eustatius und Saba (ab 2013)",2010,6,0,0,0
"Bonaire, Sint Eustatius und Saba (ab 2013)",2010,7,0,0,0
"Bonaire, Sint Eustatius und Saba (ab 2013)",2010,8,0,0,0
"Bonaire, Sint Eustatius und Saba (ab 2013)",2010,9,0,0,0
"Bonaire, Sint Eustatius und Saba (ab 2013)",2010,10,0,0,0
"Bonaire, Sint Eustatius und Saba (ab 2013)",2010,11,0,0,0
"Bonaire, Sint Eustatius und Saba (ab 2013)",2010,12,0,0,0
"Bonaire, Sint Eustatius und Saba (ab 2013)",2011,1,0,0,0
"Bonaire, Sint Eustatius und Saba (ab 2013)",2011,2,0,0,0
"Bonaire, Sint Eustatius und Saba (ab 2013)",2011,3,0,0,0
"Bonaire, Sint Eustatius und Saba (ab 2013)",2011,4,0,0,0
"Bonaire, Sint Eustatius und Saba (ab 2013)",2011,5,0,0,0
"Bonaire, Sint Eustatius und Saba (ab 2013)",2011,6,0,0,0
"Bonaire, Sint Eustatius und Saba (ab 2013)",2011,7,0,0,0
"Bonaire, Sint Eustatius und Saba (ab 2013)",2011,8,0,0,0
"Bonaire, Sint Eustatius und Saba (ab 2013)",2011,9,0,0,0
"Bonaire, Sint Eustatius und Saba (ab 2013)",2011,10,0,0,0
"Bonaire, Sint Eustatius und Saba (ab 2013)",2011,11,0,0,0
"Bonaire, Sint Eustatius und Saba (ab 2013)",2011,12,0,0,0
"Bonaire, Sint Eustatius und Saba (ab 2013)",2012,1,0,0,0
"Bonaire, Sint Eustatius und Saba (ab 2013)",2012,2,0,0,0
"Bonaire, Sint Eustatius und Saba (ab 2013)",2012,3,0,0,0
"Bonaire, Sint Eustatius und Saba (ab 2013)",2012,4,0,0,0
"Bonaire, Sint Eustatius und Saba (ab 2013)",2012,5,0,0,0
"Bonaire, Sint Eustatius und Saba (ab 2013)",2012,6,0,0,0
"Bonaire, Sint Eustatius und Saba (ab 2013)",2012,7,0,0,0
"Bonaire, Sint Eustatius und Saba (ab 2013)",2012,8,0,0,0
"Bonaire, Sint Eustatius und Saba (ab 2013)",2012,9,0,0,0
"Bonaire, Sint Eustatius und Saba (ab 2013)",2012,10,0,0,0
"Bonaire, Sint Eustatius und Saba (ab 2013)",2012,11,0,0,0
"Bonaire, Sint Eustatius und Saba (ab 2013)",2012,12,0,0,0
"Bonaire, Sint Eustatius und Saba (ab 2013)",2013,1,39000,32000,71000
"Bonaire, Sint Eustatius und Saba (ab 2013)",2013,2,6000,6000,12000
"Bonaire, Sint Eustatius und Saba (ab 2013)",2013,3,30000,0,30000
"Bonaire, Sint Eustatius und Saba (ab 2013)",2013,4,96000,0,96000
"Bonaire, Sint Eustatius und Saba (ab 2013)",2013,5,69000,0,69000
"Bonaire, Sint Eustatius und Saba (ab 2013)",2013,6,34000,0,34000
"Bonaire, Sint Eustatius und Saba (ab 2013)",2013,7,5000,0,5000
"Bonaire, Sint Eustatius und Saba (ab 2013)",2013,8,11000,261000,272000
"Bonaire, Sint Eustatius und Saba (ab 2013)",2013,9,25000,0,25000
"Bonaire, Sint Eustatius und Saba (ab 2013)",2013,10,30000,0,30000
"Bonaire, Sint Eustatius und Saba (ab 2013)",2013,11,55000,0,55000
"Bonaire, Sint Eustatius und Saba (ab 2013)",2013,12,14000,0,14000
"Bonaire, Sint Eustatius und Saba (ab 2013)",2014,1,45000,0,45000
"Bonaire, Sint Eustatius und Saba (ab 2013)",2014,2,15000,0,15000
"Bonaire, Sint Eustatius und Saba (ab 2013)",2014,3,139000,0,139000
"Bonaire, Sint Eustatius und Saba (ab 2013)",2014,4,39000,0,39000
"Bonaire, Sint Eustatius und Saba (ab 2013)",2014,5,68000,0,68000
"Bonaire, Sint Eustatius und Saba (ab 2013)",2014,6,42000,0,42000
"Bonaire, Sint Eustatius und Saba (ab 2013)",2014,7,15000,0,15000
"Bonaire, Sint Eustatius und Saba (ab 2013)",2014,8,72000,0,72000
"Bonaire, Sint Eustatius und Saba (ab 2013)",2014,9,173000,0,173000
"Bonaire, Sint Eustatius und Saba (ab 2013)",2014,10,32000,0,32000
"Bonaire, Sint Eustatius und Saba (ab 2013)",2014,11,191000,0,191000
"Bonaire, Sint Eustatius und Saba (ab 2013)",2014,12,77000,115000,192000
"Bonaire, Sint Eustatius und Saba (ab 2013)",2015,1,27000,0,27000
"Bonaire, Sint Eustatius und Saba (ab 2013)",2015,2,106000,0,106000
"Bonaire, Sint Eustatius und Saba (ab 2013)",2015,3,86000,21000,107000
"Bonaire, Sint Eustatius und Saba (ab 2013)",2015,4,26000,0,26000
"Bonaire, Sint Eustatius und Saba (ab 2013)",2015,5,28000,0,28000
"Bonaire, Sint Eustatius und Saba (ab 2013)",2015,6,236000,0,236000
"Bonaire, Sint Eustatius und Saba (ab 2013)",2015,7,92000,0,92000
"Bonaire, Sint Eustatius und Saba (ab 2013)",2015,8,54000,0,54000
"Bonaire, Sint Eustatius und Saba (ab 2013)",2015,9,438000,0,438000
"Bonaire, Sint Eustatius und Saba (ab 2013)",2015,10,226000,0,226000
"Bonaire, Sint Eustatius und Saba (ab 2013)",2015,11,39000,1000,40000
"Bonaire, Sint Eustatius und Saba (ab 2013)",2015,12,146000,0,146000
"Bonaire, Sint Eustatius und Saba (ab 2013)",2016,1,90000,18000,108000
"Bonaire, Sint Eustatius und Saba (ab 2013)",2016,2,47000,0,47000
"Bonaire, Sint Eustatius und Saba (ab 2013)",2016,3,33000,38000,71000
"Bonaire, Sint Eustatius und Saba (ab 2013)",2016,4,153000,0,153000
"Bonaire, Sint Eustatius und Saba (ab 2013)",2016,5,43000,0,43000
"Bonaire, Sint Eustatius und Saba (ab 2013)",2016,6,27000,0,27000
"Bonaire, Sint Eustatius und Saba (ab 2013)",2016,7,165000,7000,172000
"Bonaire, Sint Eustatius und Saba (ab 2013)",2016,8,81000,0,81000
"Bonaire, Sint Eustatius und Saba (ab 2013)",2016,9,112000,0,112000
"Bonaire, Sint Eustatius und Saba (ab 2013)",2016,10,65000,0,65000
"Bonaire, Sint Eustatius und Saba (ab 2013)",2016,11,33000,3000,36000
"Bonaire, Sint Eustatius und Saba (ab 2013)",2016,12,69000,0,69000
"Bonaire, Sint Eustatius und Saba (ab 2013)",2017,1,19000,25000,44000
"Bonaire, Sint Eustatius und Saba (ab 2013)",2017,2,64000,0,64000
"Bonaire, Sint Eustatius und Saba (ab 2013)",2017,3,60000,1000,61000
"Bonaire, Sint Eustatius und Saba (ab 2013)",2017,4,76000,0,76000
"Bonaire, Sint Eustatius und Saba (ab 2013)",2017,5,27000,0,27000
"Bonaire, Sint Eustatius und Saba (ab 2013)",2017,6,90000,11000,101000
"Bonaire, Sint Eustatius und Saba (ab 2013)",2017,7,11000,4000,15000
"Bonaire, Sint Eustatius und Saba (ab 2013)",2017,8,96000,0,96000
"Bonaire, Sint Eustatius und Saba (ab 2013)",2017,9,174000,3000,177000
"Bonaire, Sint Eustatius und Saba (ab 2013)",2017,10,74000,0,74000
"Bonaire, Sint Eustatius und Saba (ab 2013)",2017,11,22000,0,22000
"Bonaire, Sint Eustatius und Saba (ab 2013)",2017,12,99000,0,99000
"Bonaire, Sint Eustatius und Saba (ab 2013)",2018,1,274000,0,274000
"Bonaire, Sint Eustatius und Saba (ab 2013)",2018,2,143000,0,143000
"Bonaire, Sint Eustatius und Saba (ab 2013)",2018,3,55000,0,55000
"Bonaire, Sint Eustatius und Saba (ab 2013)",2018,4,61000,0,61000
"Bonaire, Sint Eustatius und Saba (ab 2013)",2018,5,56000,11000,67000
"Bonaire, Sint Eustatius und Saba (ab 2013)",2018,6,26000,0,26000
"Bonaire, Sint Eustatius und Saba (ab 2013)",2018,7,51000,0,51000
"Bonaire, Sint Eustatius und Saba (ab 2013)",2018,8,66000,0,66000
"Bonaire, Sint Eustatius und Saba (ab 2013)",2018,9,136000,0,136000
"Bonaire, Sint Eustatius und Saba (ab 2013)",2018,10,32000,0,32000
"Bonaire, Sint Eustatius und Saba (ab 2013)",2018,11,116000,0,116000
"Bonaire, Sint Eustatius und Saba (ab 2013)",2018,12,220000,17000,237000
"Bonaire, Sint Eustatius und Saba (ab 2013)",2019,1,102000,0,102000
"Bonaire, Sint Eustatius und Saba (ab 2013)",2019,2,89000,18000,107000
"Bonaire, Sint Eustatius und Saba (ab 2013)",2019,3,103000,1000,104000
"Bonaire, Sint Eustatius und Saba (ab 2013)",2019,4,35000,16000,51000
"Bonaire, Sint Eustatius und Saba (ab 2013)",2019,5,315000,0,315000
"Bonaire, Sint Eustatius und Saba (ab 2013)",2019,6,52000,1000,53000
"Bonaire, Sint Eustatius und Saba (ab 2013)",2019,7,570000,2000,572000
"Bonaire, Sint Eustatius und Saba (ab 2013)",2019,8,92000,0,92000
"Bonaire, Sint Eustatius und Saba (ab 2013)",2019,9,183000,0,183000
"Bonaire, Sint Eustatius und Saba (ab 2013)",2019,10,193000,0,193000
"Bonaire, Sint Eustatius und Saba (ab 2013)",2019,11,93000,0,93000
"Bonaire, Sint Eustatius und Saba (ab 2013)",2019,12,208000,0,208000
"Bonaire, Sint Eustatius und Saba (ab 2013)",2020,1,494000,0,494000
"Bonaire, Sint Eustatius und Saba (ab 2013)",2020,2,121000,0,121000
"Bonaire, Sint Eustatius und Saba (ab 2013)",2020,3,581000,0,581000
"Bonaire, Sint Eustatius und Saba (ab 2013)",2020,4,51000,0,51000
"Bonaire, Sint Eustatius und Saba (ab 2013)",2020,5,121000,0,121000
"Bonaire, Sint Eustatius und Saba (ab 2013)",2020,6,229000,0,229000
"Bonaire, Sint Eustatius und Saba (ab 2013)",2020,7,62000,0,62000
"Bonaire, Sint Eustatius und Saba (ab 2013)",2020,8,55000,0,55000
"Bonaire, Sint Eustatius und Saba (ab 2013)",2020,9,198000,0,198000
"Bonaire, Sint Eustatius und Saba (ab 2013)",2020,10,148000,0,148000
"Bonaire, Sint Eustatius und Saba (ab 2013)",2020,11,281000,15000,296000
"Bonaire, Sint Eustatius und Saba (ab 2013)",2020,12,53000,7000,60000
"Bonaire, Sint Eustatius und Saba (ab 2013)",2021,1,108000,0,108000
"Bonaire, Sint Eustatius und Saba (ab 2013)",2021,2,30000,0,30000
"Bonaire, Sint Eustatius und Saba (ab 2013)",2021,3,148000,2000,150000
"Bonaire, Sint Eustatius und Saba (ab 2013)",2021,4,25000,0,25000
"Bonaire, Sint Eustatius und Saba (ab 2013)",2021,5,108000,1000,109000
"Bonaire, Sint Eustatius und Saba (ab 2013)",2021,6,356000,0,356000
"Bonaire, Sint Eustatius und Saba (ab 2013)",2021,7,75000,0,75000
"Bonaire, Sint Eustatius und Saba (ab 2013)",2021,8,86000,2000,88000
"Bonaire, Sint Eustatius und Saba (ab 2013)",2021,9,121000,36000,157000
"Bonaire, Sint Eustatius und Saba (ab 2013)",2021,10,130000,74000,204000
"Bonaire, Sint Eustatius und Saba (ab 2013)",2021,11,41000,72000,113000
"Bonaire, Sint Eustatius und Saba (ab 2013)",2021,12,64000,0,64000
"Bonaire, Sint Eustatius und Saba (ab 2013)",2022,1,115000,18000,133000
"Bonaire, Sint Eustatius und Saba (ab 2013)",2022,2,32000,0,32000
"Bonaire, Sint Eustatius und Saba (ab 2013)",2022,3,1032000,9000,1041000
"Bonaire, Sint Eustatius und Saba (ab 2013)",2022,4,22000,0,22000
"Bonaire, Sint Eustatius und Saba (ab 2013)",2022,5,162000,0,162000
"Bonaire, Sint Eustatius und Saba (ab 2013)",2022,6,143000,1000,144000
"Bonaire, Sint Eustatius und Saba (ab 2013)",2022,7,42000,2000,44000
"Bonaire, Sint Eustatius und Saba (ab 2013)",2022,8,291000,1000,292000
"Bonaire, Sint Eustatius und Saba (ab 2013)",2022,9,90000,0,90000
"Bonaire, Sint Eustatius und Saba (ab 2013)",2022,10,200000,2000,202000
"Bonaire, Sint Eustatius und Saba (ab 2013)",2022,11,96000,0,96000
"Bonaire, Sint Eustatius und Saba (ab 2013)",2022,12,135000,0,135000
"Bonaire, Sint Eustatius und Saba (ab 2013)",2023,1,92000,0,92000
"Bonaire, Sint Eustatius und Saba (ab 2013)",2023,2,111000,0,111000
"Bonaire, Sint Eustatius und Saba (ab 2013)",2023,3,581000,0,581000
"Bonaire, Sint Eustatius und Saba (ab 2013)",2023,4,48000,1000,49000
"Bonaire, Sint Eustatius und Saba (ab 2013)",2023,5,143000,0,143000
"Bonaire, Sint Eustatius und Saba (ab 2013)",2023,6,83000,3000,86000
"Bonaire, Sint Eustatius und Saba (ab 2013)",2023,7,65000,0,65000
"Bonaire, Sint Eustatius und Saba (ab 2013)",2023,8,55000,0,55000
"Bonaire, Sint Eustatius und Saba (ab 2013)",2023,9,41000,3000,44000
"Bonaire, Sint Eustatius und Saba (ab 2013)",2023,10,321000,3000,324000
"Bonaire, Sint Eustatius und Saba (ab 2013)",2023,11,489000,9000,498000
"Bonaire, Sint Eustatius und Saba (ab 2013)",2023,12,125000,0,125000
"Bonaire, Sint Eustatius und Saba (ab 2013)",2024,1,134000,0,134000
"Bonaire, Sint Eustatius und Saba (ab 2013)",2024,2,231000,1000,232000
"Bonaire, Sint Eustatius und Saba (ab 2013)",2024,3,272000,0,272000
"Bonaire, Sint Eustatius und Saba (ab 2013)",2024,4,280000,0,280000
"Bonaire, Sint Eustatius und Saba (ab 2013)",2024,5,113000,0,113000
"Bonaire, Sint Eustatius und Saba (ab 2013)",2024,6,183000,3000,186000
"Bonaire, Sint Eustatius und Saba (ab 2013)",2024,7,239000,2000,241000
"Bonaire, Sint Eustatius und Saba (ab 2013)",2024,8,116000,1000,117000
"Bonaire, Sint Eustatius und Saba (ab 2013)",2024,9,86000,0,86000
"Bonaire, Sint Eustatius und Saba (ab 2013)",2024,10,881000,0,881000
"Bonaire, Sint Eustatius und Saba (ab 2013)",2024,11,46412000,3000,46415000
"Bonaire, Sint Eustatius und Saba (ab 2013)",2024,12,57000,0,57000
Bosnien und Herzegowina (ab 1993),2008,1,55345000,31990000,87335000
Bosnien und Herzegowina (ab 1993),2008,2,61847000,33594000,95441000
Bosnien und Herzegowina (ab 1993),2008,3,55662000,30414000,86076000
Bosnien und Herzegowina (ab 1993),2008,4,68357000,31010000,99367000
Bosnien und Herzegowina (ab 1993),2008,5,60382000,32114000,92496000
Bosnien und Herzegowina (ab 1993),2008,6,64040000,32606000,96646000
Bosnien und Herzegowina (ab 1993),2008,7,71486000,34934000,106420000
Bosnien und Herzegowina (ab 1993),2008,8,57772000,26903000,84675000
Bosnien und Herzegowina (ab 1993),2008,9,69318000,40052000,109370000
Bosnien und Herzegowina (ab 1993),2008,10,68719000,31991000,100710000
Bosnien und Herzegowina (ab 1993),2008,11,52836000,30105000,82941000
Bosnien und Herzegowina (ab 1993),2008,12,49393000,22196000,71589000
Bosnien und Herzegowina (ab 1993),2009,1,44223000,26864000,71087000
Bosnien und Herzegowina (ab 1993),2009,2,52017000,25746000,77763000
Bosnien und Herzegowina (ab 1993),2009,3,54083000,24008000,78091000
Bosnien und Herzegowina (ab 1993),2009,4,47515000,23531000,71046000
Bosnien und Herzegowina (ab 1993),2009,5,48129000,21880000,70009000
Bosnien und Herzegowina (ab 1993),2009,6,60247000,25139000,85386000
Bosnien und Herzegowina (ab 1993),2009,7,60822000,26748000,87570000
Bosnien und Herzegowina (ab 1993),2009,8,42099000,24620000,66719000
Bosnien und Herzegowina (ab 1993),2009,9,51513000,28218000,79731000
Bosnien und Herzegowina (ab 1993),2009,10,54285000,26273000,80558000
Bosnien und Herzegowina (ab 1993),2009,11,52245000,28029000,80274000
Bosnien und Herzegowina (ab 1993),2009,12,46985000,24707000,71692000
Bosnien und Herzegowina (ab 1993),2010,1,39870000,24245000,64115000
Bosnien und Herzegowina (ab 1993),2010,2,49029000,30567000,79596000
Bosnien und Herzegowina (ab 1993),2010,3,54959000,45107000,100066000
Bosnien und Herzegowina (ab 1993),2010,4,55160000,28095000,83255000
Bosnien und Herzegowina (ab 1993),2010,5,52213000,33589000,85802000
Bosnien und Herzegowina (ab 1993),2010,6,56918000,31972000,88890000
Bosnien und Herzegowina (ab 1993),2010,7,53280000,33760000,87040000
Bosnien und Herzegowina (ab 1993),2010,8,55727000,30744000,86471000
Bosnien und Herzegowina (ab 1993),2010,9,58667000,35286000,93953000
Bosnien und Herzegowina (ab 1993),2010,10,55970000,33573000,89543000
Bosnien und Herzegowina (ab 1993),2010,11,57640000,40715000,98355000
Bosnien und Herzegowina (ab 1993),2010,12,54420000,37065000,91485000
Bosnien und Herzegowina (ab 1993),2011,1,48936000,38534000,87470000
Bosnien und Herzegowina (ab 1993),2011,2,55456000,37591000,93047000
Bosnien und Herzegowina (ab 1993),2011,3,65932000,42367000,108299000
Bosnien und Herzegowina (ab 1993),2011,4,59513000,41246000,100759000
Bosnien und Herzegowina (ab 1993),2011,5,71424000,44305000,115729000
Bosnien und Herzegowina (ab 1993),2011,6,62030000,42744000,104774000
Bosnien und Herzegowina (ab 1993),2011,7,61546000,43187000,104733000
Bosnien und Herzegowina (ab 1993),2011,8,61896000,44079000,105975000
Bosnien und Herzegowina (ab 1993),2011,9,70341000,43921000,114262000
Bosnien und Herzegowina (ab 1993),2011,10,67173000,41526000,108699000
Bosnien und Herzegowina (ab 1993),2011,11,63197000,43433000,106630000
Bosnien und Herzegowina (ab 1993),2011,12,55041000,34724000,89765000
Bosnien und Herzegowina (ab 1993),2012,1,53246000,40669000,93915000
Bosnien und Herzegowina (ab 1993),2012,2,57708000,38612000,96320000
Bosnien und Herzegowina (ab 1993),2012,3,68676000,38552000,107228000
Bosnien und Herzegowina (ab 1993),2012,4,65108000,39340000,104448000
Bosnien und Herzegowina (ab 1993),2012,5,64183000,43544000,107727000
Bosnien und Herzegowina (ab 1993),2012,6,68167000,42714000,110881000
Bosnien und Herzegowina (ab 1993),2012,7,64497000,40053000,104550000
Bosnien und Herzegowina (ab 1993),2012,8,62808000,40189000,102997000
Bosnien und Herzegowina (ab 1993),2012,9,62124000,38353000,100477000
Bosnien und Herzegowina (ab 1993),2012,10,71623000,42917000,114540000
Bosnien und Herzegowina (ab 1993),2012,11,64809000,40274000,105083000
Bosnien und Herzegowina (ab 1993),2012,12,51812000,31766000,83578000
Bosnien und Herzegowina (ab 1993),2013,1,55386000,43555000,98941000
Bosnien und Herzegowina (ab 1993),2013,2,55006000,40937000,95943000
Bosnien und Herzegowina (ab 1993),2013,3,61440000,42075000,103515000
Bosnien und Herzegowina (ab 1993),2013,4,70320000,45875000,116195000
Bosnien und Herzegowina (ab 1993),2013,5,64521000,43499000,108020000
Bosnien und Herzegowina (ab 1993),2013,6,64215000,42630000,106845000
Bosnien und Herzegowina (ab 1993),2013,7,68614000,50836000,119450000
Bosnien und Herzegowina (ab 1993),2013,8,57186000,42965000,100151000
Bosnien und Herzegowina (ab 1993),2013,9,67492000,44925000,112417000
Bosnien und Herzegowina (ab 1993),2013,10,65402000,44109000,109511000
Bosnien und Herzegowina (ab 1993),2013,11,63126000,43912000,107038000
Bosnien und Herzegowina (ab 1993),2013,12,56806000,37873000,94679000
Bosnien und Herzegowina (ab 1993),2014,1,60019000,48227000,108246000
Bosnien und Herzegowina (ab 1993),2014,2,61886000,46151000,108037000
Bosnien und Herzegowina (ab 1993),2014,3,67560000,45258000,112818000
Bosnien und Herzegowina (ab 1993),2014,4,67130000,47524000,114654000
Bosnien und Herzegowina (ab 1993),2014,5,63841000,39183000,103024000
Bosnien und Herzegowina (ab 1993),2014,6,61970000,47180000,109150000
Bosnien und Herzegowina (ab 1993),2014,7,76394000,51239000,127633000
Bosnien und Herzegowina (ab 1993),2014,8,56656000,39145000,95801000
Bosnien und Herzegowina (ab 1993),2014,9,73499000,50524000,124023000
Bosnien und Herzegowina (ab 1993),2014,10,70450000,46473000,116923000
Bosnien und Herzegowina (ab 1993),2014,11,64806000,47077000,111883000
Bosnien und Herzegowina (ab 1993),2014,12,61247000,40308000,101555000
Bosnien und Herzegowina (ab 1993),2015,1,58297000,45744000,104041000
Bosnien und Herzegowina (ab 1993),2015,2,64712000,45706000,110418000
Bosnien und Herzegowina (ab 1993),2015,3,78899000,51200000,130099000
Bosnien und Herzegowina (ab 1993),2015,4,70844000,47923000,118767000
Bosnien und Herzegowina (ab 1993),2015,5,63670000,46924000,110594000
Bosnien und Herzegowina (ab 1993),2015,6,72340000,49843000,122183000
Bosnien und Herzegowina (ab 1993),2015,7,75621000,53781000,129402000
Bosnien und Herzegowina (ab 1993),2015,8,59840000,46302000,106142000
Bosnien und Herzegowina (ab 1993),2015,9,78274000,52382000,130656000
Bosnien und Herzegowina (ab 1993),2015,10,73832000,51529000,125361000
Bosnien und Herzegowina (ab 1993),2015,11,64194000,53403000,117597000
Bosnien und Herzegowina (ab 1993),2015,12,55044000,44931000,99975000
Bosnien und Herzegowina (ab 1993),2016,1,54350000,44135000,98485000
Bosnien und Herzegowina (ab 1993),2016,2,73782000,52869000,126651000
Bosnien und Herzegowina (ab 1993),2016,3,69736000,55779000,125515000
Bosnien und Herzegowina (ab 1993),2016,4,72892000,51016000,123908000
Bosnien und Herzegowina (ab 1993),2016,5,66497000,52902000,119399000
Bosnien und Herzegowina (ab 1993),2016,6,73351000,54979000,128330000
Bosnien und Herzegowina (ab 1993),2016,7,64365000,52119000,116484000
Bosnien und Herzegowina (ab 1993),2016,8,68796000,51356000,120152000
Bosnien und Herzegowina (ab 1993),2016,9,78485000,53701000,132186000
Bosnien und Herzegowina (ab 1993),2016,10,68523000,52926000,121449000
Bosnien und Herzegowina (ab 1993),2016,11,70122000,55267000,125389000
Bosnien und Herzegowina (ab 1993),2016,12,63901000,47754000,111655000
Bosnien und Herzegowina (ab 1993),2017,1,61105000,54360000,115465000
Bosnien und Herzegowina (ab 1993),2017,2,66986000,59245000,126231000
Bosnien und Herzegowina (ab 1993),2017,3,76546000,59945000,136491000
Bosnien und Herzegowina (ab 1993),2017,4,64744000,53739000,118483000
Bosnien und Herzegowina (ab 1993),2017,5,72576000,62159000,134735000
Bosnien und Herzegowina (ab 1993),2017,6,78742000,59602000,138344000
Bosnien und Herzegowina (ab 1993),2017,7,71113000,64161000,135274000
Bosnien und Herzegowina (ab 1993),2017,8,74464000,61854000,136318000
Bosnien und Herzegowina (ab 1993),2017,9,73946000,62439000,136385000
Bosnien und Herzegowina (ab 1993),2017,10,72229000,63799000,136028000
Bosnien und Herzegowina (ab 1993),2017,11,82806000,69492000,152298000
Bosnien und Herzegowina (ab 1993),2017,12,58490000,52738000,111228000
Bosnien und Herzegowina (ab 1993),2018,1,69920000,66917000,136837000
Bosnien und Herzegowina (ab 1993),2018,2,76219000,64001000,140220000
Bosnien und Herzegowina (ab 1993),2018,3,77744000,64701000,142445000
Bosnien und Herzegowina (ab 1993),2018,4,72902000,67194000,140096000
Bosnien und Herzegowina (ab 1993),2018,5,81341000,70306000,151647000
Bosnien und Herzegowina (ab 1993),2018,6,83141000,65372000,148513000
Bosnien und Herzegowina (ab 1993),2018,7,77546000,73201000,150747000
Bosnien und Herzegowina (ab 1993),2018,8,74647000,61189000,135836000
Bosnien und Herzegowina (ab 1993),2018,9,77907000,69122000,147029000
Bosnien und Herzegowina (ab 1993),2018,10,77086000,79031000,156117000
Bosnien und Herzegowina (ab 1993),2018,11,74312000,74773000,149085000
Bosnien und Herzegowina (ab 1993),2018,12,60605000,53055000,113660000
Bosnien und Herzegowina (ab 1993),2019,1,66716000,71097000,137813000
Bosnien und Herzegowina (ab 1993),2019,2,73528000,65433000,138961000
Bosnien und Herzegowina (ab 1993),2019,3,79413000,68845000,148258000
Bosnien und Herzegowina (ab 1993),2019,4,78552000,69810000,148362000
Bosnien und Herzegowina (ab 1993),2019,5,79010000,64418000,143428000
Bosnien und Herzegowina (ab 1993),2019,6,68446000,61182000,129628000
Bosnien und Herzegowina (ab 1993),2019,7,81443000,71691000,153134000
Bosnien und Herzegowina (ab 1993),2019,8,68102000,57187000,125289000
Bosnien und Herzegowina (ab 1993),2019,9,69210000,67511000,136721000
Bosnien und Herzegowina (ab 1993),2019,10,83682000,69571000,153253000
Bosnien und Herzegowina (ab 1993),2019,11,68246000,64027000,132273000
Bosnien und Herzegowina (ab 1993),2019,12,58951000,54788000,113739000
Bosnien und Herzegowina (ab 1993),2020,1,67523000,68393000,135916000
Bosnien und Herzegowina (ab 1993),2020,2,76170000,68127000,144297000
Bosnien und Herzegowina (ab 1993),2020,3,75093000,65902000,140995000
Bosnien und Herzegowina (ab 1993),2020,4,48879000,55999000,104878000
Bosnien und Herzegowina (ab 1993),2020,5,54080000,53873000,107953000
Bosnien und Herzegowina (ab 1993),2020,6,62556000,59699000,122255000
Bosnien und Herzegowina (ab 1993),2020,7,68023000,68565000,136588000
Bosnien und Herzegowina (ab 1993),2020,8,57452000,56980000,114432000
Bosnien und Herzegowina (ab 1993),2020,9,66430000,70370000,136800000
Bosnien und Herzegowina (ab 1993),2020,10,72783000,71950000,144733000
Bosnien und Herzegowina (ab 1993),2020,11,72169000,71280000,143449000
Bosnien und Herzegowina (ab 1993),2020,12,63288000,62544000,125832000
Bosnien und Herzegowina (ab 1993),2021,1,61343000,67433000,128776000
Bosnien und Herzegowina (ab 1993),2021,2,72509000,71183000,143692000
Bosnien und Herzegowina (ab 1993),2021,3,87387000,82955000,170342000
Bosnien und Herzegowina (ab 1993),2021,4,78478000,73460000,151938000
Bosnien und Herzegowina (ab 1993),2021,5,78540000,69859000,148399000
Bosnien und Herzegowina (ab 1993),2021,6,81608000,85067000,166675000
Bosnien und Herzegowina (ab 1993),2021,7,84307000,79672000,163979000
Bosnien und Herzegowina (ab 1993),2021,8,76207000,74865000,151072000
Bosnien und Herzegowina (ab 1993),2021,9,84486000,88925000,173411000
Bosnien und Herzegowina (ab 1993),2021,10,85879000,89503000,175382000
Bosnien und Herzegowina (ab 1993),2021,11,86903000,94529000,181432000
Bosnien und Herzegowina (ab 1993),2021,12,77501000,88273000,165774000
Bosnien und Herzegowina (ab 1993),2022,1,75764000,99122000,174886000
Bosnien und Herzegowina (ab 1993),2022,2,90205000,106804000,197009000
Bosnien und Herzegowina (ab 1993),2022,3,99481000,126007000,225488000
Bosnien und Herzegowina (ab 1993),2022,4,90213000,99293000,189506000
Bosnien und Herzegowina (ab 1993),2022,5,95085000,113203000,208288000
Bosnien und Herzegowina (ab 1993),2022,6,100614000,117237000,217851000
Bosnien und Herzegowina (ab 1993),2022,7,97087000,111892000,208979000
Bosnien und Herzegowina (ab 1993),2022,8,93471000,102457000,195928000
Bosnien und Herzegowina (ab 1993),2022,9,102651000,109103000,211754000
Bosnien und Herzegowina (ab 1993),2022,10,101266000,118886000,220152000
Bosnien und Herzegowina (ab 1993),2022,11,110267000,119702000,229969000
Bosnien und Herzegowina (ab 1993),2022,12,94344000,91477000,185821000
Bosnien und Herzegowina (ab 1993),2023,1,92546000,109929000,202475000
Bosnien und Herzegowina (ab 1993),2023,2,108703000,109045000,217748000
Bosnien und Herzegowina (ab 1993),2023,3,120693000,124445000,245138000
Bosnien und Herzegowina (ab 1993),2023,4,90784000,103157000,193941000
Bosnien und Herzegowina (ab 1993),2023,5,100847000,119715000,220562000
Bosnien und Herzegowina (ab 1993),2023,6,118342000,115723000,234065000
Bosnien und Herzegowina (ab 1993),2023,7,107006000,110958000,217964000
Bosnien und Herzegowina (ab 1993),2023,8,113729000,98209000,211938000
Bosnien und Herzegowina (ab 1993),2023,9,110265000,111241000,221506000
Bosnien und Herzegowina (ab 1993),2023,10,107126000,111884000,219010000
Bosnien und Herzegowina (ab 1993),2023,11,119347000,114360000,233707000
Bosnien und Herzegowina (ab 1993),2023,12,93289000,82950000,176239000
Bosnien und Herzegowina (ab 1993),2024,1,104857000,104999000,209856000
Bosnien und Herzegowina (ab 1993),2024,2,119460000,109547000,229007000
Bosnien und Herzegowina (ab 1993),2024,3,110175000,96950000,207125000
Bosnien und Herzegowina (ab 1993),2024,4,123700000,108219000,231919000
Bosnien und Herzegowina (ab 1993),2024,5,108045000,96538000,204583000
Bosnien und Herzegowina (ab 1993),2024,6,111718000,95248000,206966000
Bosnien und Herzegowina (ab 1993),2024,7,115014000,105312000,220326000
Bosnien und Herzegowina (ab 1993),2024,8,100286000,78627000,178913000
Bosnien und Herzegowina (ab 1993),2024,9,111260000,98965000,210225000
Bosnien und Herzegowina (ab 1993),2024,10,109364000,110597000,219961000
Bosnien und Herzegowina (ab 1993),2024,11,111741000,98094000,209835000
Bosnien und Herzegowina (ab 1993),2024,12,93470000,83971000,177441000
Botsuana,2008,1,341000,202000,543000
Botsuana,2008,2,614000,1029000,1643000
Botsuana,2008,3,1342000,207000,1549000
Botsuana,2008,4,825000,834000,1659000
Botsuana,2008,5,253000,1570000,1823000
Botsuana,2008,6,1533000,2592000,4125000
Botsuana,2008,7,1686000,2482000,4168000
Botsuana,2008,8,1398000,1591000,2989000
Botsuana,2008,9,578000,1036000,1614000
Botsuana,2008,10,1698000,951000,2649000
Botsuana,2008,11,1120000,584000,1704000
Botsuana,2008,12,1234000,104000,1338000
Botsuana,2009,1,1827000,1084000,2911000
Botsuana,2009,2,1891000,149000,2040000
Botsuana,2009,3,1329000,287000,1616000
Botsuana,2009,4,3474000,1912000,5386000
Botsuana,2009,5,831000,1611000,2442000
Botsuana,2009,6,805000,3880000,4685000
Botsuana,2009,7,2722000,1668000,4390000
Botsuana,2009,8,864000,536000,1400000
Botsuana,2009,9,5836000,588000,6424000
Botsuana,2009,10,3941000,440000,4381000
Botsuana,2009,11,2817000,315000,3132000
Botsuana,2009,12,3376000,2131000,5507000
Botsuana,2010,1,758000,1344000,2102000
Botsuana,2010,2,1943000,1394000,3337000
Botsuana,2010,3,1752000,778000,2530000
Botsuana,2010,4,506000,2372000,2878000
Botsuana,2010,5,3450000,1545000,4995000
Botsuana,2010,6,3463000,930000,4393000
Botsuana,2010,7,1107000,2184000,3291000
Botsuana,2010,8,2886000,2432000,5318000
Botsuana,2010,9,7759000,1070000,8829000
Botsuana,2010,10,2525000,1493000,4018000
Botsuana,2010,11,3302000,1120000,4422000
Botsuana,2010,12,8193000,705000,8898000
Botsuana,2011,1,1860000,851000,2711000
Botsuana,2011,2,1388000,105000,1493000
Botsuana,2011,3,2144000,108000,2252000
Botsuana,2011,4,1336000,12000,1348000
Botsuana,2011,5,2087000,66000,2153000
Botsuana,2011,6,1808000,28000,1836000
Botsuana,2011,7,1998000,0,1998000
Botsuana,2011,8,1322000,16000,1338000
Botsuana,2011,9,1608000,59000,1667000
Botsuana,2011,10,1378000,352000,1730000
Botsuana,2011,11,4513000,48000,4561000
Botsuana,2011,12,1723000,39000,1762000
Botsuana,2012,1,1739000,38000,1777000
Botsuana,2012,2,4638000,0,4638000
Botsuana,2012,3,2827000,73000,2900000
Botsuana,2012,4,2890000,27000,2917000
Botsuana,2012,5,1711000,46000,1757000
Botsuana,2012,6,3542000,135000,3677000
Botsuana,2012,7,6316000,3000,6319000
Botsuana,2012,8,6331000,42000,6373000
Botsuana,2012,9,3660000,24000,3684000
Botsuana,2012,10,9063000,54000,9117000
Botsuana,2012,11,1465000,14000,1479000
Botsuana,2012,12,2088000,15000,2103000
Botsuana,2013,1,2681000,72000,2753000
Botsuana,2013,2,2138000,1000,2139000
Botsuana,2013,3,2293000,7000,2300000
Botsuana,2013,4,1876000,4000,1880000
Botsuana,2013,5,2472000,136000,2608000
Botsuana,2013,6,5625000,253000,5878000
Botsuana,2013,7,2550000,1398000,3948000
Botsuana,2013,8,6122000,1837000,7959000
Botsuana,2013,9,1394000,154000,1548000
Botsuana,2013,10,1946000,113000,2059000
Botsuana,2013,11,1533000,126000,1659000
Botsuana,2013,12,2254000,176000,2430000
Botsuana,2014,1,1940000,135000,2075000
Botsuana,2014,2,5033000,36000,5069000
Botsuana,2014,3,2924000,92000,3016000
Botsuana,2014,4,3325000,7000,3332000
Botsuana,2014,5,3977000,82000,4059000
Botsuana,2014,6,7963000,157000,8120000
Botsuana,2014,7,5786000,73000,5859000
Botsuana,2014,8,6772000,9000,6781000
Botsuana,2014,9,5347000,117000,5464000
Botsuana,2014,10,4597000,146000,4743000
Botsuana,2014,11,3586000,78000,3664000
Botsuana,2014,12,5665000,130000,5795000
Botsuana,2015,1,5469000,85000,5554000
Botsuana,2015,2,9844000,172000,10016000
Botsuana,2015,3,5773000,50000,5823000
Botsuana,2015,4,5437000,92000,5529000
Botsuana,2015,5,4775000,289000,5064000
Botsuana,2015,6,6122000,173000,6295000
Botsuana,2015,7,5621000,345000,5966000
Botsuana,2015,8,5268000,272000,5540000
Botsuana,2015,9,12942000,125000,13067000
Botsuana,2015,10,5460000,356000,5816000
Botsuana,2015,11,2564000,363000,2927000
Botsuana,2015,12,5259000,313000,5572000
Botsuana,2016,1,4273000,42000,4315000
Botsuana,2016,2,4184000,109000,4293000
Botsuana,2016,3,9982000,82000,10064000
Botsuana,2016,4,6184000,357000,6541000
Botsuana,2016,5,5900000,404000,6304000
Botsuana,2016,6,5842000,82000,5924000
Botsuana,2016,7,5753000,67000,5820000
Botsuana,2016,8,6965000,159000,7124000
Botsuana,2016,9,7781000,244000,8025000
Botsuana,2016,10,5817000,196000,6013000
Botsuana,2016,11,4593000,277000,4870000
Botsuana,2016,12,5040000,171000,5211000
Botsuana,2017,1,5660000,298000,5958000
Botsuana,2017,2,5141000,143000,5284000
Botsuana,2017,3,8667000,98000,8765000
Botsuana,2017,4,4718000,80000,4798000
Botsuana,2017,5,6146000,142000,6288000
Botsuana,2017,6,5257000,50000,5307000
Botsuana,2017,7,6075000,241000,6316000
Botsuana,2017,8,6204000,266000,6470000
Botsuana,2017,9,4602000,178000,4780000
Botsuana,2017,10,5078000,144000,5222000
Botsuana,2017,11,2265000,3522000,5787000
Botsuana,2017,12,5089000,66000,5155000
Botsuana,2018,1,8085000,222000,8307000
Botsuana,2018,2,5492000,370000,5862000
Botsuana,2018,3,5443000,320000,5763000
Botsuana,2018,4,9708000,319000,10027000
Botsuana,2018,5,6000000,238000,6238000
Botsuana,2018,6,4700000,228000,4928000
Botsuana,2018,7,5167000,190000,5357000
Botsuana,2018,8,7366000,203000,7569000
Botsuana,2018,9,7751000,51000,7802000
Botsuana,2018,10,6877000,383000,7260000
Botsuana,2018,11,2626000,265000,2891000
Botsuana,2018,12,4725000,215000,4940000
Botsuana,2019,1,6465000,65000,6530000
Botsuana,2019,2,4013000,451000,4464000
Botsuana,2019,3,4728000,338000,5066000
Botsuana,2019,4,6954000,180000,7134000
Botsuana,2019,5,8204000,454000,8658000
Botsuana,2019,6,5521000,91000,5612000
Botsuana,2019,7,5410000,248000,5658000
Botsuana,2019,8,6224000,377000,6601000
Botsuana,2019,9,5557000,110000,5667000
Botsuana,2019,10,4966000,119000,5085000
Botsuana,2019,11,1643000,518000,2161000
Botsuana,2019,12,6464000,37000,6501000
Botsuana,2020,1,5294000,524000,5818000
Botsuana,2020,2,4563000,118000,4681000
Botsuana,2020,3,4999000,110000,5109000
Botsuana,2020,4,1244000,8000,1252000
Botsuana,2020,5,1367000,64000,1431000
Botsuana,2020,6,1496000,74000,1570000
Botsuana,2020,7,2770000,86000,2856000
Botsuana,2020,8,2872000,59000,2931000
Botsuana,2020,9,4256000,89000,4345000
Botsuana,2020,10,2990000,212000,3202000
Botsuana,2020,11,2415000,58000,2473000
Botsuana,2020,12,5202000,44000,5246000
Botsuana,2021,1,8275000,27000,8302000
Botsuana,2021,2,4883000,30000,4913000
Botsuana,2021,3,5237000,378000,5615000
Botsuana,2021,4,4008000,1082000,5090000
Botsuana,2021,5,4854000,221000,5075000
Botsuana,2021,6,5519000,250000,5769000
Botsuana,2021,7,6139000,47000,6186000
Botsuana,2021,8,6870000,109000,6979000
Botsuana,2021,9,5132000,49000,5181000
Botsuana,2021,10,1797000,22000,1819000
Botsuana,2021,11,3332000,59000,3391000
Botsuana,2021,12,3905000,80000,3985000
Botsuana,2022,1,5202000,198000,5400000
Botsuana,2022,2,4285000,39000,4324000
Botsuana,2022,3,8406000,56000,8462000
Botsuana,2022,4,7114000,196000,7310000
Botsuana,2022,5,8336000,212000,8548000
Botsuana,2022,6,6256000,110000,6366000
Botsuana,2022,7,8457000,68000,8525000
Botsuana,2022,8,5298000,237000,5535000
Botsuana,2022,9,5423000,73000,5496000
Botsuana,2022,10,3966000,46000,4012000
Botsuana,2022,11,9324000,2800000,12124000
Botsuana,2022,12,6871000,928000,7799000
Botsuana,2023,1,6881000,2619000,9500000
Botsuana,2023,2,7869000,417000,8286000
Botsuana,2023,3,6731000,679000,7410000
Botsuana,2023,4,6574000,2351000,8925000
Botsuana,2023,5,7917000,999000,8916000
Botsuana,2023,6,9097000,1038000,10135000
Botsuana,2023,7,6686000,23000,6709000
Botsuana,2023,8,7857000,56000,7913000
Botsuana,2023,9,5207000,218000,5425000
Botsuana,2023,10,6457000,28000,6485000
Botsuana,2023,11,6061000,58000,6119000
Botsuana,2023,12,6961000,74000,7035000
Botsuana,2024,1,6691000,49000,6740000
Botsuana,2024,2,7057000,68000,7125000
Botsuana,2024,3,6391000,1684000,8075000
Botsuana,2024,4,5785000,204000,5989000
Botsuana,2024,5,5942000,355000,6297000
Botsuana,2024,6,4945000,49000,4994000
Botsuana,2024,7,4602000,240000,4842000
Botsuana,2024,8,3687000,128000,3815000
Botsuana,2024,9,6058000,137000,6195000
Botsuana,2024,10,7855000,166000,8021000
Botsuana,2024,11,2242000,139000,2381000
Botsuana,2024,12,3484000,157000,3641000
Bouvetinsel (ab 2001),2008,1,16000,0,16000
Bouvetinsel (ab 2001),2008,2,46000,0,46000
Bouvetinsel (ab 2001),2008,3,1000,0,1000
Bouvetinsel (ab 2001),2008,4,1000,0,1000
Bouvetinsel (ab 2001),2008,5,0,0,0
Bouvetinsel (ab 2001),2008,6,4000,0,4000
Bouvetinsel (ab 2001),2008,7,13000,0,13000
Bouvetinsel (ab 2001),2008,8,0,0,0
Bouvetinsel (ab 2001),2008,9,0,0,0
Bouvetinsel (ab 2001),2008,10,0,0,0
Bouvetinsel (ab 2001),2008,11,12000,0,12000
Bouvetinsel (ab 2001),2008,12,37000,0,37000
Bouvetinsel (ab 2001),2009,1,0,0,0
Bouvetinsel (ab 2001),2009,2,3000,0,3000
Bouvetinsel (ab 2001),2009,3,143000,0,143000
Bouvetinsel (ab 2001),2009,4,20000,0,20000
Bouvetinsel (ab 2001),2009,5,0,0,0
Bouvetinsel (ab 2001),2009,6,0,0,0
Bouvetinsel (ab 2001),2009,7,0,0,0
Bouvetinsel (ab 2001),2009,8,0,0,0
Bouvetinsel (ab 2001),2009,9,0,0,0
Bouvetinsel (ab 2001),2009,10,0,0,0
Bouvetinsel (ab 2001),2009,11,0,0,0
Bouvetinsel (ab 2001),2009,12,0,0,0
Bouvetinsel (ab 2001),2010,1,0,0,0
Bouvetinsel (ab 2001),2010,2,0,0,0
Bouvetinsel (ab 2001),2010,3,0,0,0
Bouvetinsel (ab 2001),2010,4,0,0,0
Bouvetinsel (ab 2001),2010,5,0,0,0
Bouvetinsel (ab 2001),2010,6,0,0,0
Bouvetinsel (ab 2001),2010,7,0,0,0
Bouvetinsel (ab 2001),2010,8,0,0,0
Bouvetinsel (ab 2001),2010,9,0,0,0
Bouvetinsel (ab 2001),2010,10,13000,0,13000
Bouvetinsel (ab 2001),2010,11,0,0,0
Bouvetinsel (ab 2001),2010,12,0,0,0
Bouvetinsel (ab 2001),2011,1,0,0,0
Bouvetinsel (ab 2001),2011,2,0,0,0
Bouvetinsel (ab 2001),2011,3,0,0,0
Bouvetinsel (ab 2001),2011,4,0,0,0
Bouvetinsel (ab 2001),2011,5,0,0,0
Bouvetinsel (ab 2001),2011,6,0,0,0
Bouvetinsel (ab 2001),2011,7,0,0,0
Bouvetinsel (ab 2001),2011,8,0,0,0
Bouvetinsel (ab 2001),2011,9,0,0,0
Bouvetinsel (ab 2001),2011,10,0,0,0
Bouvetinsel (ab 2001),2011,11,0,0,0
Bouvetinsel (ab 2001),2011,12,0,0,0
Bouvetinsel (ab 2001),2012,1,0,0,0
Bouvetinsel (ab 2001),2012,2,0,0,0
Bouvetinsel (ab 2001),2012,3,0,0,0
Bouvetinsel (ab 2001),2012,4,0,0,0
Bouvetinsel (ab 2001),2012,5,0,0,0
Bouvetinsel (ab 2001),2012,6,0,0,0
Bouvetinsel (ab 2001),2012,7,0,0,0
Bouvetinsel (ab 2001),2012,8,0,0,0
Bouvetinsel (ab 2001),2012,9,0,0,0
Bouvetinsel (ab 2001),2012,10,0,0,0
Bouvetinsel (ab 2001),2012,11,0,0,0
Bouvetinsel (ab 2001),2012,12,0,0,0
Bouvetinsel (ab 2001),2013,1,0,0,0
Bouvetinsel (ab 2001),2013,2,7000,0,7000
Bouvetinsel (ab 2001),2013,3,0,0,0
Bouvetinsel (ab 2001),2013,4,0,0,0
Bouvetinsel (ab 2001),2013,5,0,0,0
Bouvetinsel (ab 2001),2013,6,0,4000,4000
Bouvetinsel (ab 2001),2013,7,0,0,0
Bouvetinsel (ab 2001),2013,8,0,0,0
Bouvetinsel (ab 2001),2013,9,0,0,0
Bouvetinsel (ab 2001),2013,10,0,0,0
Bouvetinsel (ab 2001),2013,11,0,0,0
Bouvetinsel (ab 2001),2013,12,0,0,0
Bouvetinsel (ab 2001),2014,1,0,0,0
Bouvetinsel (ab 2001),2014,2,0,0,0
Bouvetinsel (ab 2001),2014,3,0,0,0
Bouvetinsel (ab 2001),2014,4,0,0,0
Bouvetinsel (ab 2001),2014,5,0,0,0
Bouvetinsel (ab 2001),2014,6,0,0,0
Bouvetinsel (ab 2001),2014,7,0,0,0
Bouvetinsel (ab 2001),2014,8,0,0,0
Bouvetinsel (ab 2001),2014,9,0,0,0
Bouvetinsel (ab 2001),2014,10,0,0,0
Bouvetinsel (ab 2001),2014,11,0,0,0
Bouvetinsel (ab 2001),2014,12,0,0,0
Bouvetinsel (ab 2001),2015,1,0,0,0
Bouvetinsel (ab 2001),2015,2,0,0,0
Bouvetinsel (ab 2001),2015,3,0,0,0
Bouvetinsel (ab 2001),2015,4,0,0,0
Bouvetinsel (ab 2001),2015,5,0,0,0
Bouvetinsel (ab 2001),2015,6,0,0,0
Bouvetinsel (ab 2001),2015,7,0,0,0
Bouvetinsel (ab 2001),2015,8,0,0,0
Bouvetinsel (ab 2001),2015,9,0,0,0
Bouvetinsel (ab 2001),2015,10,0,0,0
Bouvetinsel (ab 2001),2015,11,0,0,0
Bouvetinsel (ab 2001),2015,12,0,0,0
Bouvetinsel (ab 2001),2016,1,0,0,0
Bouvetinsel (ab 2001),2016,2,0,0,0
Bouvetinsel (ab 2001),2016,3,0,0,0
Bouvetinsel (ab 2001),2016,4,0,0,0
Bouvetinsel (ab 2001),2016,5,0,0,0
Bouvetinsel (ab 2001),2016,6,0,0,0
Bouvetinsel (ab 2001),2016,7,0,0,0
Bouvetinsel (ab 2001),2016,8,2000,0,2000
Bouvetinsel (ab 2001),2016,9,0,0,0
Bouvetinsel (ab 2001),2016,10,0,0,0
Bouvetinsel (ab 2001),2016,11,0,0,0
Bouvetinsel (ab 2001),2016,12,0,0,0
Bouvetinsel (ab 2001),2017,1,0,0,0
Bouvetinsel (ab 2001),2017,2,0,0,0
Bouvetinsel (ab 2001),2017,3,0,0,0
Bouvetinsel (ab 2001),2017,4,0,0,0
Bouvetinsel (ab 2001),2017,5,0,0,0
Bouvetinsel (ab 2001),2017,6,0,0,0
Bouvetinsel (ab 2001),2017,7,0,0,0
Bouvetinsel (ab 2001),2017,8,0,0,0
Bouvetinsel (ab 2001),2017,9,0,0,0
Bouvetinsel (ab 2001),2017,10,0,0,0
Bouvetinsel (ab 2001),2017,11,0,0,0
Bouvetinsel (ab 2001),2017,12,0,0,0
Bouvetinsel (ab 2001),2018,1,0,0,0
Bouvetinsel (ab 2001),2018,2,0,0,0
Bouvetinsel (ab 2001),2018,3,0,0,0
Bouvetinsel (ab 2001),2018,4,0,0,0
Bouvetinsel (ab 2001),2018,5,0,0,0
Bouvetinsel (ab 2001),2018,6,0,0,0
Bouvetinsel (ab 2001),2018,7,0,0,0
Bouvetinsel (ab 2001),2018,8,0,0,0
Bouvetinsel (ab 2001),2018,9,0,0,0
Bouvetinsel (ab 2001),2018,10,0,0,0
Bouvetinsel (ab 2001),2018,11,15000,0,15000
Bouvetinsel (ab 2001),2018,12,0,0,0
Bouvetinsel (ab 2001),2019,1,0,0,0
Bouvetinsel (ab 2001),2019,2,0,0,0
Bouvetinsel (ab 2001),2019,3,0,0,0
Bouvetinsel (ab 2001),2019,4,0,0,0
Bouvetinsel (ab 2001),2019,5,0,0,0
Bouvetinsel (ab 2001),2019,6,0,0,0
Bouvetinsel (ab 2001),2019,7,0,0,0
Bouvetinsel (ab 2001),2019,8,0,0,0
Bouvetinsel (ab 2001),2019,9,0,0,0
Bouvetinsel (ab 2001),2019,10,0,0,0
Bouvetinsel (ab 2001),2019,11,0,0,0
Bouvetinsel (ab 2001),2019,12,0,0,0
Bouvetinsel (ab 2001),2020,1,0,0,0
Bouvetinsel (ab 2001),2020,2,0,0,0
Bouvetinsel (ab 2001),2020,3,0,0,0
Bouvetinsel (ab 2001),2020,4,0,0,0
Bouvetinsel (ab 2001),2020,5,0,0,0
Bouvetinsel (ab 2001),2020,6,0,0,0
Bouvetinsel (ab 2001),2020,7,0,0,0
Bouvetinsel (ab 2001),2020,8,0,0,0
Bouvetinsel (ab 2001),2020,9,0,0,0
Bouvetinsel (ab 2001),2020,10,0,0,0
Bouvetinsel (ab 2001),2020,11,0,0,0
Bouvetinsel (ab 2001),2020,12,0,0,0
Bouvetinsel (ab 2001),2021,1,0,0,0
Bouvetinsel (ab 2001),2021,2,0,0,0
Bouvetinsel (ab 2001),2021,3,0,0,0
Bouvetinsel (ab 2001),2021,4,0,0,0
Bouvetinsel (ab 2001),2021,5,0,0,0
Bouvetinsel (ab 2001),2021,6,0,0,0
Bouvetinsel (ab 2001),2021,7,0,0,0
Bouvetinsel (ab 2001),2021,8,0,0,0
Bouvetinsel (ab 2001),2021,9,0,0,0
Bouvetinsel (ab 2001),2021,10,0,0,0
Bouvetinsel (ab 2001),2021,11,0,6000,6000
Bouvetinsel (ab 2001),2021,12,0,7000,7000
Bouvetinsel (ab 2001),2022,1,0,2000,2000
Bouvetinsel (ab 2001),2022,2,0,0,0
Bouvetinsel (ab 2001),2022,3,0,1000,1000
Bouvetinsel (ab 2001),2022,4,0,0,0
Bouvetinsel (ab 2001),2022,5,0,0,0
Bouvetinsel (ab 2001),2022,6,0,0,0
Bouvetinsel (ab 2001),2022,7,0,0,0
Bouvetinsel (ab 2001),2022,8,0,0,0
Bouvetinsel (ab 2001),2022,9,0,0,0
Bouvetinsel (ab 2001),2022,10,0,0,0
Bouvetinsel (ab 2001),2022,11,0,0,0
Bouvetinsel (ab 2001),2022,12,0,0,0
Bouvetinsel (ab 2001),2023,1,0,0,0
Bouvetinsel (ab 2001),2023,2,0,0,0
Bouvetinsel (ab 2001),2023,3,0,0,0
Bouvetinsel (ab 2001),2023,4,0,0,0
Bouvetinsel (ab 2001),2023,5,0,0,0
Bouvetinsel (ab 2001),2023,6,0,0,0
Bouvetinsel (ab 2001),2023,7,0,0,0
Bouvetinsel (ab 2001),2023,8,0,0,0
Bouvetinsel (ab 2001),2023,9,0,0,0
Bouvetinsel (ab 2001),2023,10,0,0,0
Bouvetinsel (ab 2001),2023,11,0,0,0
Bouvetinsel (ab 2001),2023,12,0,0,0
Bouvetinsel (ab 2001),2024,1,0,0,0
Bouvetinsel (ab 2001),2024,2,0,0,0
Bouvetinsel (ab 2001),2024,3,0,0,0
Bouvetinsel (ab 2001),2024,4,0,0,0
Bouvetinsel (ab 2001),2024,5,0,0,0
Bouvetinsel (ab 2001),2024,6,0,0,0
Bouvetinsel (ab 2001),2024,7,21000,0,21000
Bouvetinsel (ab 2001),2024,8,0,0,0
Bouvetinsel (ab 2001),2024,9,0,0,0
Bouvetinsel (ab 2001),2024,10,0,0,0
Bouvetinsel (ab 2001),2024,11,0,49000,49000
Bouvetinsel (ab 2001),2024,12,0,19000,19000
Brasilien,2008,1,656058000,710919000,1366977000
Brasilien,2008,2,619112000,606327000,1225439000
Brasilien,2008,3,661950000,781947000,1443897000
Brasilien,2008,4,658447000,817778000,1476225000
Brasilien,2008,5,657614000,706230000,1363844000
Brasilien,2008,6,817433000,808999000,1626432000
Brasilien,2008,7,916698000,873761000,1790459000
Brasilien,2008,8,759960000,825329000,1585289000
Brasilien,2008,9,857592000,962026000,1819618000
Brasilien,2008,10,825936000,867865000,1693801000
Brasilien,2008,11,628437000,712023000,1340460000
Brasilien,2008,12,594004000,824136000,1418140000
Brasilien,2009,1,511635000,694629000,1206264000
Brasilien,2009,2,453295000,546252000,999547000
Brasilien,2009,3,549598000,610933000,1160531000
Brasilien,2009,4,513903000,618881000,1132784000
Brasilien,2009,5,522800000,495968000,1018768000
Brasilien,2009,6,590444000,670262000,1260706000
Brasilien,2009,7,709313000,574114000,1283427000
Brasilien,2009,8,686890000,563169000,1250059000
Brasilien,2009,9,585624000,628968000,1214592000
Brasilien,2009,10,782999000,607427000,1390426000
Brasilien,2009,11,661102000,645494000,1306596000
Brasilien,2009,12,695092000,522383000,1217475000
Brasilien,2010,1,580906000,699438000,1280344000
Brasilien,2010,2,687419000,549303000,1236722000
Brasilien,2010,3,869427000,671174000,1540601000
Brasilien,2010,4,839701000,740396000,1580097000
Brasilien,2010,5,842152000,769637000,1611789000
Brasilien,2010,6,1159541000,803658000,1963199000
Brasilien,2010,7,1033889000,924006000,1957895000
Brasilien,2010,8,898254000,789441000,1687695000
Brasilien,2010,9,900986000,860440000,1761426000
Brasilien,2010,10,886271000,928664000,1814935000
Brasilien,2010,11,848122000,867966000,1716088000
Brasilien,2010,12,839232000,840694000,1679926000
Brasilien,2011,1,752751000,797719000,1550470000
Brasilien,2011,2,860290000,854948000,1715238000
Brasilien,2011,3,990215000,991105000,1981320000
Brasilien,2011,4,931235000,983276000,1914511000
Brasilien,2011,5,957301000,1160814000,2118115000
Brasilien,2011,6,957585000,1028330000,1985915000
Brasilien,2011,7,1005867000,1051922000,2057789000
Brasilien,2011,8,997866000,907770000,1905636000
Brasilien,2011,9,922285000,933941000,1856226000
Brasilien,2011,10,908041000,877305000,1785346000
Brasilien,2011,11,940374000,935254000,1875628000
Brasilien,2011,12,939251000,737525000,1676776000
Brasilien,2012,1,890875000,849185000,1740060000
Brasilien,2012,2,969589000,808092000,1777681000
Brasilien,2012,3,1155059000,1090502000,2245561000
Brasilien,2012,4,1051825000,887726000,1939551000
Brasilien,2012,5,956787000,990543000,1947330000
Brasilien,2012,6,1062835000,825593000,1888428000
Brasilien,2012,7,1039283000,1031659000,2070942000
Brasilien,2012,8,935577000,870302000,1805879000
Brasilien,2012,9,926313000,728845000,1655158000
Brasilien,2012,10,1038481000,908815000,1947296000
Brasilien,2012,11,942069000,806968000,1749037000
Brasilien,2012,12,758796000,816433000,1575229000
Brasilien,2013,1,862793000,884321000,1747114000
Brasilien,2013,2,828943000,529312000,1358255000
Brasilien,2013,3,1051973000,701721000,1753694000
Brasilien,2013,4,986709000,789553000,1776262000
Brasilien,2013,5,969492000,701461000,1670953000
Brasilien,2013,6,937594000,765605000,1703199000
Brasilien,2013,7,1056890000,775635000,1832525000
Brasilien,2013,8,951891000,564591000,1516482000
Brasilien,2013,9,981638000,737190000,1718828000
Brasilien,2013,10,999965000,888443000,1888408000
Brasilien,2013,11,911392000,767304000,1678696000
Brasilien,2013,12,747960000,780153000,1528113000
Brasilien,2014,1,855167000,790694000,1645861000
Brasilien,2014,2,891082000,606817000,1497899000
Brasilien,2014,3,878753000,706582000,1585335000
Brasilien,2014,4,884080000,720887000,1604967000
Brasilien,2014,5,984055000,760059000,1744114000
Brasilien,2014,6,941717000,810122000,1751839000
Brasilien,2014,7,976917000,870541000,1847458000
Brasilien,2014,8,780481000,783727000,1564208000
Brasilien,2014,9,780140000,827397000,1607537000
Brasilien,2014,10,836830000,746656000,1583486000
Brasilien,2014,11,723017000,749115000,1472132000
Brasilien,2014,12,852205000,694774000,1546979000
Brasilien,2015,1,782136000,715273000,1497409000
Brasilien,2015,2,775066000,605228000,1380294000
Brasilien,2015,3,1020689000,772461000,1793150000
Brasilien,2015,4,845211000,739343000,1584554000
Brasilien,2015,5,886816000,784688000,1671504000
Brasilien,2015,6,980322000,774426000,1754748000
Brasilien,2015,7,959479000,756273000,1715752000
Brasilien,2015,8,840220000,666313000,1506533000
Brasilien,2015,9,759161000,641232000,1400393000
Brasilien,2015,10,759396000,638282000,1397678000
Brasilien,2015,11,609681000,729866000,1339547000
Brasilien,2015,12,646501000,595084000,1241585000
Brasilien,2016,1,509708000,643401000,1153109000
Brasilien,2016,2,777606000,546373000,1323979000
Brasilien,2016,3,710916000,648709000,1359625000
Brasilien,2016,4,812953000,712900000,1525853000
Brasilien,2016,5,753468000,635574000,1389042000
Brasilien,2016,6,768852000,739521000,1508373000
Brasilien,2016,7,694189000,625635000,1319824000
Brasilien,2016,8,769101000,675952000,1445053000
Brasilien,2016,9,708646000,719276000,1427922000
Brasilien,2016,10,614756000,728241000,1342997000
Brasilien,2016,11,655560000,673909000,1329469000
Brasilien,2016,12,749510000,620282000,1369792000
Brasilien,2017,1,602395000,679251000,1281646000
Brasilien,2017,2,593974000,594499000,1188473000
Brasilien,2017,3,738900000,739180000,1478080000
Brasilien,2017,4,653307000,556655000,1209962000
Brasilien,2017,5,754748000,789383000,1544131000
Brasilien,2017,6,668744000,617815000,1286559000
Brasilien,2017,7,823703000,707115000,1530818000
Brasilien,2017,8,767787000,553494000,1321281000
Brasilien,2017,9,733852000,729972000,1463824000
Brasilien,2017,10,757203000,586983000,1344186000
Brasilien,2017,11,715062000,657961000,1373023000
Brasilien,2017,12,661353000,566242000,1227595000
Brasilien,2018,1,721699000,655962000,1377661000
Brasilien,2018,2,712249000,599226000,1311475000
Brasilien,2018,3,777965000,591226000,1369191000
Brasilien,2018,4,793438000,681235000,1474673000
Brasilien,2018,5,807808000,756782000,1564590000
Brasilien,2018,6,858764000,623238000,1482002000
Brasilien,2018,7,843606000,638525000,1482131000
Brasilien,2018,8,891029000,609592000,1500621000
Brasilien,2018,9,762863000,582264000,1345127000
Brasilien,2018,10,823873000,570808000,1394681000
Brasilien,2018,11,788897000,632401000,1421298000
Brasilien,2018,12,675993000,546946000,1222939000
Brasilien,2019,1,735005000,680938000,1415943000
Brasilien,2019,2,735293000,713119000,1448412000
Brasilien,2019,3,911679000,597570000,1509249000
Brasilien,2019,4,885273000,558551000,1443824000
Brasilien,2019,5,928198000,599319000,1527517000
Brasilien,2019,6,793420000,609020000,1402440000
Brasilien,2019,7,1027001000,555820000,1582821000
Brasilien,2019,8,906815000,597344000,1504159000
Brasilien,2019,9,799877000,523727000,1323604000
Brasilien,2019,10,797919000,530044000,1327963000
Brasilien,2019,11,888871000,557034000,1445905000
Brasilien,2019,12,748269000,510339000,1258608000
Brasilien,2020,1,735274000,552364000,1287638000
Brasilien,2020,2,859243000,510534000,1369777000
Brasilien,2020,3,803650000,583604000,1387254000
Brasilien,2020,4,558849000,575345000,1134194000
Brasilien,2020,5,525248000,612123000,1137371000
Brasilien,2020,6,590440000,503073000,1093513000
Brasilien,2020,7,682634000,475454000,1158088000
Brasilien,2020,8,649280000,437803000,1087083000
Brasilien,2020,9,807271000,452348000,1259619000
Brasilien,2020,10,739243000,476763000,1216006000
Brasilien,2020,11,774164000,506197000,1280361000
Brasilien,2020,12,725411000,432834000,1158245000
Brasilien,2021,1,741871000,532792000,1274663000
Brasilien,2021,2,740047000,477489000,1217536000
Brasilien,2021,3,999340000,595795000,1595135000
Brasilien,2021,4,838136000,677030000,1515166000
Brasilien,2021,5,854644000,638113000,1492757000
Brasilien,2021,6,919754000,804206000,1723960000
Brasilien,2021,7,923010000,605087000,1528097000
Brasilien,2021,8,871688000,696377000,1568065000
Brasilien,2021,9,897094000,651550000,1548644000
Brasilien,2021,10,901341000,649875000,1551216000
Brasilien,2021,11,864097000,566591000,1430688000
Brasilien,2021,12,933304000,647880000,1581184000
Brasilien,2022,1,883054000,691530000,1574584000
Brasilien,2022,2,914586000,711996000,1626582000
Brasilien,2022,3,1012688000,809965000,1822653000
Brasilien,2022,4,1025407000,850504000,1875911000
Brasilien,2022,5,1132800000,1030044000,2162844000
Brasilien,2022,6,1185974000,867894000,2053868000
Brasilien,2022,7,1139611000,760691000,1900302000
Brasilien,2022,8,1181603000,906779000,2088382000
Brasilien,2022,9,1204253000,691840000,1896093000
Brasilien,2022,10,1047687000,751710000,1799397000
Brasilien,2022,11,1179737000,839716000,2019453000
Brasilien,2022,12,996639000,601239000,1597878000
Brasilien,2023,1,1131839000,793584000,1925423000
Brasilien,2023,2,1209719000,686524000,1896243000
Brasilien,2023,3,1341083000,734809000,2075892000
Brasilien,2023,4,1016632000,664547000,1681179000
Brasilien,2023,5,1001332000,717031000,1718363000
Brasilien,2023,6,1102294000,621792000,1724086000
Brasilien,2023,7,1080632000,741850000,1822482000
Brasilien,2023,8,992477000,667280000,1659757000
Brasilien,2023,9,994751000,574795000,1569546000
Brasilien,2023,10,947350000,657648000,1604998000
Brasilien,2023,11,1089632000,762011000,1851643000
Brasilien,2023,12,891825000,616835000,1508660000
Brasilien,2024,1,956092000,754129000,1710221000
Brasilien,2024,2,1085996000,641686000,1727682000
Brasilien,2024,3,1222382000,700061000,1922443000
Brasilien,2024,4,1160320000,763807000,1924127000
Brasilien,2024,5,1174685000,773216000,1947901000
Brasilien,2024,6,1114315000,740619000,1854934000
Brasilien,2024,7,1268899000,833585000,2102484000
Brasilien,2024,8,1111255000,622556000,1733811000
Brasilien,2024,9,1088103000,627953000,1716056000
Brasilien,2024,10,1100484000,863158000,1963642000
Brasilien,2024,11,960962000,980427000,1941389000
Brasilien,2024,12,932545000,783989000,1716534000
Britische Jungferninseln,2008,1,2809000,5000,2814000
Britische Jungferninseln,2008,2,3478000,12000,3490000
Britische Jungferninseln,2008,3,2044000,16000,2060000
Britische Jungferninseln,2008,4,1685000,20000,1705000
Britische Jungferninseln,2008,5,3416000,10000,3426000
Britische Jungferninseln,2008,6,3995000,1964000,5959000
Britische Jungferninseln,2008,7,2370000,19000,2389000
Britische Jungferninseln,2008,8,2488000,14000,2502000
Britische Jungferninseln,2008,9,3670000,16000,3686000
Britische Jungferninseln,2008,10,3154000,10000,3164000
Britische Jungferninseln,2008,11,3624000,140000,3764000
Britische Jungferninseln,2008,12,1220000,85000,1305000
Britische Jungferninseln,2009,1,474000,501000,975000
Britische Jungferninseln,2009,2,538000,18606000,19144000
Britische Jungferninseln,2009,3,1421000,1000,1422000
Britische Jungferninseln,2009,4,852000,0,852000
Britische Jungferninseln,2009,5,621000,20000,641000
Britische Jungferninseln,2009,6,11550000,0,11550000
Britische Jungferninseln,2009,7,910000,74000,984000
Britische Jungferninseln,2009,8,972000,3000,975000
Britische Jungferninseln,2009,9,1151000,0,1151000
Britische Jungferninseln,2009,10,1720000,8000,1728000
Britische Jungferninseln,2009,11,1667000,23000,1690000
Britische Jungferninseln,2009,12,416000,62000,478000
Britische Jungferninseln,2010,1,343000,0,343000
Britische Jungferninseln,2010,2,1410000,0,1410000
Britische Jungferninseln,2010,3,1733000,15000,1748000
Britische Jungferninseln,2010,4,949000,2301000,3250000
Britische Jungferninseln,2010,5,5644000,0,5644000
Britische Jungferninseln,2010,6,1025000,1000,1026000
Britische Jungferninseln,2010,7,706000,2000,708000
Britische Jungferninseln,2010,8,3287000,3000,3290000
Britische Jungferninseln,2010,9,3922000,0,3922000
Britische Jungferninseln,2010,10,1038000,25000,1063000
Britische Jungferninseln,2010,11,2048000,56000,2104000
Britische Jungferninseln,2010,12,817000,77000,894000
Britische Jungferninseln,2011,1,336000,0,336000
Britische Jungferninseln,2011,2,801000,11000,812000
Britische Jungferninseln,2011,3,1046000,0,1046000
Britische Jungferninseln,2011,4,48928000,44000,48972000
Britische Jungferninseln,2011,5,3049000,118000,3167000
Britische Jungferninseln,2011,6,111238000,173000,111411000
Britische Jungferninseln,2011,7,7556000,356000,7912000
Britische Jungferninseln,2011,8,1454000,128000,1582000
Britische Jungferninseln,2011,9,2332000,0,2332000
Britische Jungferninseln,2011,10,1342000,0,1342000
Britische Jungferninseln,2011,11,1665000,12000,1677000
Britische Jungferninseln,2011,12,703000,0,703000
Britische Jungferninseln,2012,1,880000,0,880000
Britische Jungferninseln,2012,2,305000,0,305000
Britische Jungferninseln,2012,3,1293000,0,1293000
Britische Jungferninseln,2012,4,3462000,0,3462000
Britische Jungferninseln,2012,5,3300000,9000,3309000
Britische Jungferninseln,2012,6,897000,4000,901000
Britische Jungferninseln,2012,7,59094000,5000,59099000
Britische Jungferninseln,2012,8,1459000,244000,1703000
Britische Jungferninseln,2012,9,1040000,323000,1363000
Britische Jungferninseln,2012,10,1897000,3000,1900000
Britische Jungferninseln,2012,11,1073000,166000,1239000
Britische Jungferninseln,2012,12,110406000,171000,110577000
Britische Jungferninseln,2013,1,618000,116000,734000
Britische Jungferninseln,2013,2,5401000,28000,5429000
Britische Jungferninseln,2013,3,1795000,1000,1796000
Britische Jungferninseln,2013,4,910000,31000,941000
Britische Jungferninseln,2013,5,8085000,3000,8088000
Britische Jungferninseln,2013,6,5181000,23000,5204000
Britische Jungferninseln,2013,7,1508000,11000,1519000
Britische Jungferninseln,2013,8,7750000,2000,7752000
Britische Jungferninseln,2013,9,1347000,74000,1421000
Britische Jungferninseln,2013,10,1399000,833000,2232000
Britische Jungferninseln,2013,11,778000,160010000,160788000
Britische Jungferninseln,2013,12,2446000,0,2446000
Britische Jungferninseln,2014,1,259000,35000,294000
Britische Jungferninseln,2014,2,646000,0,646000
Britische Jungferninseln,2014,3,1575000,0,1575000
Britische Jungferninseln,2014,4,4705000,0,4705000
Britische Jungferninseln,2014,5,4056000,0,4056000
Britische Jungferninseln,2014,6,897000,0,897000
Britische Jungferninseln,2014,7,1860000,0,1860000
Britische Jungferninseln,2014,8,444000,0,444000
Britische Jungferninseln,2014,9,1060000,0,1060000
Britische Jungferninseln,2014,10,747000,0,747000
Britische Jungferninseln,2014,11,95420000,0,95420000
Britische Jungferninseln,2014,12,271000,0,271000
Britische Jungferninseln,2015,1,354000,140000,494000
Britische Jungferninseln,2015,2,4133000,170000,4303000
Britische Jungferninseln,2015,3,708000,96000,804000
Britische Jungferninseln,2015,4,2572000,117000,2689000
Britische Jungferninseln,2015,5,215160000,161000,215321000
Britische Jungferninseln,2015,6,165460000,160000,165620000
Britische Jungferninseln,2015,7,1356000,31000,1387000
Britische Jungferninseln,2015,8,537000,63000,600000
Britische Jungferninseln,2015,9,6577000,113000,6690000
Britische Jungferninseln,2015,10,538000,104000,642000
Britische Jungferninseln,2015,11,143034000,145128000,288162000
Britische Jungferninseln,2015,12,673000,0,673000
Britische Jungferninseln,2016,1,106000,9000,115000
Britische Jungferninseln,2016,2,1091000,0,1091000
Britische Jungferninseln,2016,3,5412000,5000,5417000
Britische Jungferninseln,2016,4,93333000,75000,93408000
Britische Jungferninseln,2016,5,80914000,160000,81074000
Britische Jungferninseln,2016,6,20222000,0,20222000
Britische Jungferninseln,2016,7,797000,35000,832000
Britische Jungferninseln,2016,8,13142000,357000,13499000
Britische Jungferninseln,2016,9,663000,5158000,5821000
Britische Jungferninseln,2016,10,725000,26000,751000
Britische Jungferninseln,2016,11,1276000,115000,1391000
Britische Jungferninseln,2016,12,6028000,0,6028000
Britische Jungferninseln,2017,1,13086000,0,13086000
Britische Jungferninseln,2017,2,7816000,0,7816000
Britische Jungferninseln,2017,3,9592000,1409000,11001000
Britische Jungferninseln,2017,4,4478000,22000,4500000
Britische Jungferninseln,2017,5,579000,0,579000
Britische Jungferninseln,2017,6,7045000,0,7045000
Britische Jungferninseln,2017,7,241000,0,241000
Britische Jungferninseln,2017,8,314000,0,314000
Britische Jungferninseln,2017,9,563000,0,563000
Britische Jungferninseln,2017,10,639000,0,639000
Britische Jungferninseln,2017,11,29305000,0,29305000
Britische Jungferninseln,2017,12,12254000,1000,12255000
Britische Jungferninseln,2018,1,122000,59000,181000
Britische Jungferninseln,2018,2,629000,0,629000
Britische Jungferninseln,2018,3,1071000,27000,1098000
Britische Jungferninseln,2018,4,257000,0,257000
Britische Jungferninseln,2018,5,21266000,0,21266000
Britische Jungferninseln,2018,6,29561000,654000,30215000
Britische Jungferninseln,2018,7,2170000,859000,3029000
Britische Jungferninseln,2018,8,457000,11000,468000
Britische Jungferninseln,2018,9,25756000,4000,25760000
Britische Jungferninseln,2018,10,14630000,17000,14647000
Britische Jungferninseln,2018,11,907000,533000,1440000
Britische Jungferninseln,2018,12,252000,4000,256000
Britische Jungferninseln,2019,1,430000,21000,451000
Britische Jungferninseln,2019,2,994000,0,994000
Britische Jungferninseln,2019,3,426742000,23000,426765000
Britische Jungferninseln,2019,4,283000,29000,312000
Britische Jungferninseln,2019,5,489000,7000,496000
Britische Jungferninseln,2019,6,141000,2090000,2231000
Britische Jungferninseln,2019,7,15175000,3000,15178000
Britische Jungferninseln,2019,8,94000,16000,110000
Britische Jungferninseln,2019,9,372000,17000,389000
Britische Jungferninseln,2019,10,108000,41000,149000
Britische Jungferninseln,2019,11,286000,0,286000
Britische Jungferninseln,2019,12,198000,1000,199000
Britische Jungferninseln,2020,1,156000,1000,157000
Britische Jungferninseln,2020,2,31000,0,31000
Britische Jungferninseln,2020,3,97000,6000,103000
Britische Jungferninseln,2020,4,310000,4000,314000
Britische Jungferninseln,2020,5,68565000,0,68565000
Britische Jungferninseln,2020,6,312000,3000,315000
Britische Jungferninseln,2020,7,94000,1000,95000
Britische Jungferninseln,2020,8,135000,0,135000
Britische Jungferninseln,2020,9,123000,5000,128000
Britische Jungferninseln,2020,10,52000,10000,62000
Britische Jungferninseln,2020,11,289000,4000,293000
Britische Jungferninseln,2020,12,85000,2000,87000
Britische Jungferninseln,2021,1,46000,0,46000
Britische Jungferninseln,2021,2,412554000,0,412554000
Britische Jungferninseln,2021,3,3514000,11299000,14813000
Britische Jungferninseln,2021,4,14599000,0,14599000
Britische Jungferninseln,2021,5,3023000,47000,3070000
Britische Jungferninseln,2021,6,401905000,28000,401933000
Britische Jungferninseln,2021,7,2368000,34000,2402000
Britische Jungferninseln,2021,8,698000,37000,735000
Britische Jungferninseln,2021,9,142000,1476000,1618000
Britische Jungferninseln,2021,10,192000,8000,200000
Britische Jungferninseln,2021,11,8265000,44000,8309000
Britische Jungferninseln,2021,12,1961000,24000,1985000
Britische Jungferninseln,2022,1,163000,63000,226000
Britische Jungferninseln,2022,2,196000,48000,244000
Britische Jungferninseln,2022,3,164000,30000,194000
Britische Jungferninseln,2022,4,167000,1000,168000
Britische Jungferninseln,2022,5,268000,0,268000
Britische Jungferninseln,2022,6,114000,1760000,1874000
Britische Jungferninseln,2022,7,119000,3000,122000
Britische Jungferninseln,2022,8,482000,3000,485000
Britische Jungferninseln,2022,9,115000,4000,119000
Britische Jungferninseln,2022,10,495000,0,495000
Britische Jungferninseln,2022,11,555000,16000,571000
Britische Jungferninseln,2022,12,78000,0,78000
Britische Jungferninseln,2023,1,67000,1000,68000
Britische Jungferninseln,2023,2,93000,84000,177000
Britische Jungferninseln,2023,3,295000,0,295000
Britische Jungferninseln,2023,4,216000,20000,236000
Britische Jungferninseln,2023,5,512000,0,512000
Britische Jungferninseln,2023,6,138000,2000,140000
Britische Jungferninseln,2023,7,107000,0,107000
Britische Jungferninseln,2023,8,156000,0,156000
Britische Jungferninseln,2023,9,196000,17300000,17496000
Britische Jungferninseln,2023,10,87000,3000,90000
Britische Jungferninseln,2023,11,288000,2000,290000
Britische Jungferninseln,2023,12,199000,50000,249000
Britische Jungferninseln,2024,1,112000,0,112000
Britische Jungferninseln,2024,2,136000,0,136000
Britische Jungferninseln,2024,3,276000,46940000,47216000
Britische Jungferninseln,2024,4,532000,2000,534000
Britische Jungferninseln,2024,5,149000,0,149000
Britische Jungferninseln,2024,6,177000,0,177000
Britische Jungferninseln,2024,7,82203000,0,82203000
Britische Jungferninseln,2024,8,89000,2000,91000
Britische Jungferninseln,2024,9,294000,0,294000
Britische Jungferninseln,2024,10,231000,1000,232000
Britische Jungferninseln,2024,11,319000,0,319000
Britische Jungferninseln,2024,12,471000,0,471000
Britisches Territorium im Indischen Ozean,2008,1,77000,0,77000
Britisches Territorium im Indischen Ozean,2008,2,134000,0,134000
Britisches Territorium im Indischen Ozean,2008,3,254000,0,254000
Britisches Territorium im Indischen Ozean,2008,4,21000,0,21000
Britisches Territorium im Indischen Ozean,2008,5,9000,0,9000
Britisches Territorium im Indischen Ozean,2008,6,2653000,0,2653000
Britisches Territorium im Indischen Ozean,2008,7,0,0,0
Britisches Territorium im Indischen Ozean,2008,8,11000,0,11000
Britisches Territorium im Indischen Ozean,2008,9,9000,0,9000
Britisches Territorium im Indischen Ozean,2008,10,1000,0,1000
Britisches Territorium im Indischen Ozean,2008,11,52000,0,52000
Britisches Territorium im Indischen Ozean,2008,12,259000,1000,260000
Britisches Territorium im Indischen Ozean,2009,1,926000,0,926000
Britisches Territorium im Indischen Ozean,2009,2,631000,0,631000
Britisches Territorium im Indischen Ozean,2009,3,551000,0,551000
Britisches Territorium im Indischen Ozean,2009,4,152000,0,152000
Britisches Territorium im Indischen Ozean,2009,5,123000,0,123000
Britisches Territorium im Indischen Ozean,2009,6,66000,0,66000
Britisches Territorium im Indischen Ozean,2009,7,61000,0,61000
Britisches Territorium im Indischen Ozean,2009,8,0,0,0
Britisches Territorium im Indischen Ozean,2009,9,0,29000,29000
Britisches Territorium im Indischen Ozean,2009,10,0,0,0
Britisches Territorium im Indischen Ozean,2009,11,7000,0,7000
Britisches Territorium im Indischen Ozean,2009,12,15000,0,15000
Britisches Territorium im Indischen Ozean,2010,1,4000,0,4000
Britisches Territorium im Indischen Ozean,2010,2,0,0,0
Britisches Territorium im Indischen Ozean,2010,3,0,0,0
Britisches Territorium im Indischen Ozean,2010,4,2000,0,2000
Britisches Territorium im Indischen Ozean,2010,5,0,0,0
Britisches Territorium im Indischen Ozean,2010,6,0,0,0
Britisches Territorium im Indischen Ozean,2010,7,90000,0,90000
Britisches Territorium im Indischen Ozean,2010,8,0,0,0
Britisches Territorium im Indischen Ozean,2010,9,0,0,0
Britisches Territorium im Indischen Ozean,2010,10,0,0,0
Britisches Territorium im Indischen Ozean,2010,11,0,0,0
Britisches Territorium im Indischen Ozean,2010,12,0,0,0
Britisches Territorium im Indischen Ozean,2011,1,0,0,0
Britisches Territorium im Indischen Ozean,2011,2,0,0,0
Britisches Territorium im Indischen Ozean,2011,3,0,0,0
Britisches Territorium im Indischen Ozean,2011,4,0,0,0
Britisches Territorium im Indischen Ozean,2011,5,0,0,0
Britisches Territorium im Indischen Ozean,2011,6,0,0,0
Britisches Territorium im Indischen Ozean,2011,7,0,0,0
Britisches Territorium im Indischen Ozean,2011,8,0,0,0
Britisches Territorium im Indischen Ozean,2011,9,0,0,0
Britisches Territorium im Indischen Ozean,2011,10,0,0,0
Britisches Territorium im Indischen Ozean,2011,11,0,0,0
Britisches Territorium im Indischen Ozean,2011,12,0,0,0
Britisches Territorium im Indischen Ozean,2012,1,0,0,0
Britisches Territorium im Indischen Ozean,2012,2,0,0,0
Britisches Territorium im Indischen Ozean,2012,3,1172000,0,1172000
Britisches Territorium im Indischen Ozean,2012,4,11000,0,11000
Britisches Territorium im Indischen Ozean,2012,5,0,0,0
Britisches Territorium im Indischen Ozean,2012,6,97000,13000,110000
Britisches Territorium im Indischen Ozean,2012,7,0,0,0
Britisches Territorium im Indischen Ozean,2012,8,0,0,0
Britisches Territorium im Indischen Ozean,2012,9,0,0,0
Britisches Territorium im Indischen Ozean,2012,10,0,0,0
Britisches Territorium im Indischen Ozean,2012,11,0,0,0
Britisches Territorium im Indischen Ozean,2012,12,0,0,0
Britisches Territorium im Indischen Ozean,2013,1,0,0,0
Britisches Territorium im Indischen Ozean,2013,2,0,0,0
Britisches Territorium im Indischen Ozean,2013,3,0,0,0
Britisches Territorium im Indischen Ozean,2013,4,0,0,0
Britisches Territorium im Indischen Ozean,2013,5,0,0,0
Britisches Territorium im Indischen Ozean,2013,6,0,0,0
Britisches Territorium im Indischen Ozean,2013,7,0,0,0
Britisches Territorium im Indischen Ozean,2013,8,0,0,0
Britisches Territorium im Indischen Ozean,2013,9,4000,0,4000
Britisches Territorium im Indischen Ozean,2013,10,0,0,0
Britisches Territorium im Indischen Ozean,2013,11,0,0,0
Britisches Territorium im Indischen Ozean,2013,12,2000,0,2000
Britisches Territorium im Indischen Ozean,2014,1,0,0,0
Britisches Territorium im Indischen Ozean,2014,2,0,0,0
Britisches Territorium im Indischen Ozean,2014,3,0,0,0
Britisches Territorium im Indischen Ozean,2014,4,0,0,0
Britisches Territorium im Indischen Ozean,2014,5,0,0,0
Britisches Territorium im Indischen Ozean,2014,6,0,2000,2000
Britisches Territorium im Indischen Ozean,2014,7,0,0,0
Britisches Territorium im Indischen Ozean,2014,8,0,0,0
Britisches Territorium im Indischen Ozean,2014,9,0,0,0
Britisches Territorium im Indischen Ozean,2014,10,4000,0,4000
Britisches Territorium im Indischen Ozean,2014,11,0,0,0
Britisches Territorium im Indischen Ozean,2014,12,0,0,0
Britisches Territorium im Indischen Ozean,2015,1,0,0,0
Britisches Territorium im Indischen Ozean,2015,2,0,0,0
Britisches Territorium im Indischen Ozean,2015,3,0,0,0
Britisches Territorium im Indischen Ozean,2015,4,1000,0,1000
Britisches Territorium im Indischen Ozean,2015,5,1000,0,1000
Britisches Territorium im Indischen Ozean,2015,6,0,0,0
Britisches Territorium im Indischen Ozean,2015,7,0,0,0
Britisches Territorium im Indischen Ozean,2015,8,0,0,0
Britisches Territorium im Indischen Ozean,2015,9,0,0,0
Britisches Territorium im Indischen Ozean,2015,10,0,0,0
Britisches Territorium im Indischen Ozean,2015,11,0,0,0
Britisches Territorium im Indischen Ozean,2015,12,0,0,0
Britisches Territorium im Indischen Ozean,2016,1,4000,0,4000
Britisches Territorium im Indischen Ozean,2016,2,0,0,0
Britisches Territorium im Indischen Ozean,2016,3,0,0,0
Britisches Territorium im Indischen Ozean,2016,4,0,0,0
Britisches Territorium im Indischen Ozean,2016,5,0,0,0
Britisches Territorium im Indischen Ozean,2016,6,0,0,0
Britisches Territorium im Indischen Ozean,2016,7,0,5000,5000
Britisches Territorium im Indischen Ozean,2016,8,0,0,0
Britisches Territorium im Indischen Ozean,2016,9,0,0,0
Britisches Territorium im Indischen Ozean,2016,10,0,0,0
Britisches Territorium im Indischen Ozean,2016,11,0,0,0
Britisches Territorium im Indischen Ozean,2016,12,0,0,0
Britisches Territorium im Indischen Ozean,2017,1,0,0,0
Britisches Territorium im Indischen Ozean,2017,2,0,0,0
Britisches Territorium im Indischen Ozean,2017,3,0,0,0
Britisches Territorium im Indischen Ozean,2017,4,0,0,0
Britisches Territorium im Indischen Ozean,2017,5,0,0,0
Britisches Territorium im Indischen Ozean,2017,6,0,0,0
Britisches Territorium im Indischen Ozean,2017,7,0,0,0
Britisches Territorium im Indischen Ozean,2017,8,0,0,0
Britisches Territorium im Indischen Ozean,2017,9,0,0,0
Britisches Territorium im Indischen Ozean,2017,10,0,0,0
Britisches Territorium im Indischen Ozean,2017,11,0,0,0
Britisches Territorium im Indischen Ozean,2017,12,0,0,0
Britisches Territorium im Indischen Ozean,2018,1,0,0,0
Britisches Territorium im Indischen Ozean,2018,2,0,7000,7000
Britisches Territorium im Indischen Ozean,2018,3,0,0,0
Britisches Territorium im Indischen Ozean,2018,4,0,0,0
Britisches Territorium im Indischen Ozean,2018,5,0,0,0
Britisches Territorium im Indischen Ozean,2018,6,0,0,0
Britisches Territorium im Indischen Ozean,2018,7,0,0,0
Britisches Territorium im Indischen Ozean,2018,8,0,2000,2000
Britisches Territorium im Indischen Ozean,2018,9,0,0,0
Britisches Territorium im Indischen Ozean,2018,10,0,2000,2000
Britisches Territorium im Indischen Ozean,2018,11,0,0,0
Britisches Territorium im Indischen Ozean,2018,12,0,0,0
Britisches Territorium im Indischen Ozean,2019,1,0,4000,4000
Britisches Territorium im Indischen Ozean,2019,2,0,1000,1000
Britisches Territorium im Indischen Ozean,2019,3,0,0,0
Britisches Territorium im Indischen Ozean,2019,4,0,2000,2000
Britisches Territorium im Indischen Ozean,2019,5,17000,0,17000
Britisches Territorium im Indischen Ozean,2019,6,0,0,0
Britisches Territorium im Indischen Ozean,2019,7,0,0,0
Britisches Territorium im Indischen Ozean,2019,8,0,0,0
Britisches Territorium im Indischen Ozean,2019,9,0,0,0
Britisches Territorium im Indischen Ozean,2019,10,0,35000,35000
Britisches Territorium im Indischen Ozean,2019,11,0,0,0
Britisches Territorium im Indischen Ozean,2019,12,0,0,0
Britisches Territorium im Indischen Ozean,2020,1,0,4000,4000
Britisches Territorium im Indischen Ozean,2020,2,0,0,0
Britisches Territorium im Indischen Ozean,2020,3,0,19000,19000
Britisches Territorium im Indischen Ozean,2020,4,0,0,0
Britisches Territorium im Indischen Ozean,2020,5,0,0,0
Britisches Territorium im Indischen Ozean,2020,6,1000,0,1000
Britisches Territorium im Indischen Ozean,2020,7,0,0,0
Britisches Territorium im Indischen Ozean,2020,8,0,0,0
Britisches Territorium im Indischen Ozean,2020,9,18000,0,18000
Britisches Territorium im Indischen Ozean,2020,10,0,0,0
Britisches Territorium im Indischen Ozean,2020,11,18000,0,18000
Britisches Territorium im Indischen Ozean,2020,12,0,0,0
Britisches Territorium im Indischen Ozean,2021,1,0,0,0
Britisches Territorium im Indischen Ozean,2021,2,0,0,0
Britisches Territorium im Indischen Ozean,2021,3,6000,0,6000
Britisches Territorium im Indischen Ozean,2021,4,44000,0,44000
Britisches Territorium im Indischen Ozean,2021,5,0,0,0
Britisches Territorium im Indischen Ozean,2021,6,0,0,0
Britisches Territorium im Indischen Ozean,2021,7,0,0,0
Britisches Territorium im Indischen Ozean,2021,8,0,0,0
Britisches Territorium im Indischen Ozean,2021,9,0,0,0
Britisches Territorium im Indischen Ozean,2021,10,0,0,0
Britisches Territorium im Indischen Ozean,2021,11,0,0,0
Britisches Territorium im Indischen Ozean,2021,12,0,0,0
Britisches Territorium im Indischen Ozean,2022,1,0,1000,1000
Britisches Territorium im Indischen Ozean,2022,2,0,0,0
Britisches Territorium im Indischen Ozean,2022,3,2000,0,2000
Britisches Territorium im Indischen Ozean,2022,4,0,0,0
Britisches Territorium im Indischen Ozean,2022,5,0,0,0
Britisches Territorium im Indischen Ozean,2022,6,0,0,0
Britisches Territorium im Indischen Ozean,2022,7,0,0,0
Britisches Territorium im Indischen Ozean,2022,8,0,0,0
Britisches Territorium im Indischen Ozean,2022,9,0,0,0
Britisches Territorium im Indischen Ozean,2022,10,3000,0,3000
Britisches Territorium im Indischen Ozean,2022,11,0,0,0
Britisches Territorium im Indischen Ozean,2022,12,19000,0,19000
Britisches Territorium im Indischen Ozean,2023,1,0,0,0
Britisches Territorium im Indischen Ozean,2023,2,0,0,0
Britisches Territorium im Indischen Ozean,2023,3,0,3000,3000
Britisches Territorium im Indischen Ozean,2023,4,0,0,0
Britisches Territorium im Indischen Ozean,2023,5,0,0,0
Britisches Territorium im Indischen Ozean,2023,6,0,1000,1000
Britisches Territorium im Indischen Ozean,2023,7,0,0,0
Britisches Territorium im Indischen Ozean,2023,8,16000,0,16000
Britisches Territorium im Indischen Ozean,2023,9,0,0,0
Britisches Territorium im Indischen Ozean,2023,10,50000,0,50000
Britisches Territorium im Indischen Ozean,2023,11,0,0,0
Britisches Territorium im Indischen Ozean,2023,12,0,0,0
Britisches Territorium im Indischen Ozean,2024,1,0,0,0
Britisches Territorium im Indischen Ozean,2024,2,0,0,0
Britisches Territorium im Indischen Ozean,2024,3,0,0,0
Britisches Territorium im Indischen Ozean,2024,4,0,0,0
Britisches Territorium im Indischen Ozean,2024,5,0,0,0
Britisches Territorium im Indischen Ozean,2024,6,0,212000,212000
Britisches Territorium im Indischen Ozean,2024,7,0,0,0
Britisches Territorium im Indischen Ozean,2024,8,0,4000,4000
Britisches Territorium im Indischen Ozean,2024,9,0,97000,97000
Britisches Territorium im Indischen Ozean,2024,10,0,0,0
Britisches Territorium im Indischen Ozean,2024,11,0,0,0
Britisches Territorium im Indischen Ozean,2024,12,0,0,0
Brunei Darussalam,2008,1,2078000,195000,2273000
Brunei Darussalam,2008,2,2050000,79000,2129000
Brunei Darussalam,2008,3,1571000,168000,1739000
Brunei Darussalam,2008,4,1939000,369000,2308000
Brunei Darussalam,2008,5,3675000,19000,3694000
Brunei Darussalam,2008,6,2028000,59000,2087000
Brunei Darussalam,2008,7,5111000,229000,5340000
Brunei Darussalam,2008,8,3643000,265000,3908000
Brunei Darussalam,2008,9,2092000,394000,2486000
Brunei Darussalam,2008,10,2963000,58000,3021000
Brunei Darussalam,2008,11,1706000,43000,1749000
Brunei Darussalam,2008,12,2611000,136000,2747000
Brunei Darussalam,2009,1,3932000,141000,4073000
Brunei Darussalam,2009,2,2230000,4000,2234000
Brunei Darussalam,2009,3,1454000,144000,1598000
Brunei Darussalam,2009,4,1452000,120000,1572000
Brunei Darussalam,2009,5,3812000,12000,3824000
Brunei Darussalam,2009,6,2654000,289000,2943000
Brunei Darussalam,2009,7,4340000,27000,4367000
Brunei Darussalam,2009,8,1837000,326000,2163000
Brunei Darussalam,2009,9,1419000,66000,1485000
Brunei Darussalam,2009,10,6453000,1202000,7655000
Brunei Darussalam,2009,11,4545000,83000,4628000
Brunei Darussalam,2009,12,2045000,34000,2079000
Brunei Darussalam,2010,1,47395000,11000,47406000
Brunei Darussalam,2010,2,4122000,107000,4229000
Brunei Darussalam,2010,3,3347000,45000,3392000
Brunei Darussalam,2010,4,5416000,18000,5434000
Brunei Darussalam,2010,5,1912000,61000,1973000
Brunei Darussalam,2010,6,2931000,18000,2949000
Brunei Darussalam,2010,7,47531000,9000,47540000
Brunei Darussalam,2010,8,1719000,12000,1731000
Brunei Darussalam,2010,9,1958000,328000,2286000
Brunei Darussalam,2010,10,3831000,34000,3865000
Brunei Darussalam,2010,11,5864000,69000,5933000
Brunei Darussalam,2010,12,1498000,61000,1559000
Brunei Darussalam,2011,1,4850000,34000,4884000
Brunei Darussalam,2011,2,1490000,177000,1667000
Brunei Darussalam,2011,3,206819000,76000,206895000
Brunei Darussalam,2011,4,5452000,92000,5544000
Brunei Darussalam,2011,5,3130000,130000,3260000
Brunei Darussalam,2011,6,3395000,230000,3625000
Brunei Darussalam,2011,7,4443000,86000,4529000
Brunei Darussalam,2011,8,1837000,62000,1899000
Brunei Darussalam,2011,9,2749000,845000,3594000
Brunei Darussalam,2011,10,105553000,221000,105774000
Brunei Darussalam,2011,11,2907000,205000,3112000
Brunei Darussalam,2011,12,3684000,90000,3774000
Brunei Darussalam,2012,1,2851000,72000,2923000
Brunei Darussalam,2012,2,2131000,207000,2338000
Brunei Darussalam,2012,3,4977000,509000,5486000
Brunei Darussalam,2012,4,3892000,199000,4091000
Brunei Darussalam,2012,5,4242000,387000,4629000
Brunei Darussalam,2012,6,4495000,25000,4520000
Brunei Darussalam,2012,7,4050000,358000,4408000
Brunei Darussalam,2012,8,4473000,583000,5056000
Brunei Darussalam,2012,9,3866000,58000,3924000
Brunei Darussalam,2012,10,3332000,250000,3582000
Brunei Darussalam,2012,11,5299000,366000,5665000
Brunei Darussalam,2012,12,7811000,76000,7887000
Brunei Darussalam,2013,1,3142000,49000,3191000
Brunei Darussalam,2013,2,5745000,270000,6015000
Brunei Darussalam,2013,3,3941000,45000,3986000
Brunei Darussalam,2013,4,12494000,483000,12977000
Brunei Darussalam,2013,5,3062000,183000,3245000
Brunei Darussalam,2013,6,5728000,12000,5740000
Brunei Darussalam,2013,7,3868000,45000,3913000
Brunei Darussalam,2013,8,4085000,104000,4189000
Brunei Darussalam,2013,9,3965000,28000,3993000
Brunei Darussalam,2013,10,3583000,95000,3678000
Brunei Darussalam,2013,11,3889000,59000,3948000
Brunei Darussalam,2013,12,2099000,97000,2196000
Brunei Darussalam,2014,1,3241000,2611000,5852000
Brunei Darussalam,2014,2,2505000,51000,2556000
Brunei Darussalam,2014,3,1995000,46000,2041000
Brunei Darussalam,2014,4,3318000,100000,3418000
Brunei Darussalam,2014,5,5022000,41000,5063000
Brunei Darussalam,2014,6,7362000,179000,7541000
Brunei Darussalam,2014,7,89393000,92000,89485000
Brunei Darussalam,2014,8,2418000,162000,2580000
Brunei Darussalam,2014,9,5496000,73000,5569000
Brunei Darussalam,2014,10,3036000,22000,3058000
Brunei Darussalam,2014,11,7022000,406000,7428000
Brunei Darussalam,2014,12,2705000,209000,2914000
Brunei Darussalam,2015,1,3911000,10000,3921000
Brunei Darussalam,2015,2,4773000,23000,4796000
Brunei Darussalam,2015,3,3752000,524000,4276000
Brunei Darussalam,2015,4,11941000,140000,12081000
Brunei Darussalam,2015,5,4260000,57000,4317000
Brunei Darussalam,2015,6,2646000,165000,2811000
Brunei Darussalam,2015,7,3301000,254000,3555000
Brunei Darussalam,2015,8,34027000,79000,34106000
Brunei Darussalam,2015,9,60928000,25000,60953000
Brunei Darussalam,2015,10,7555000,31000,7586000
Brunei Darussalam,2015,11,7953000,39000,7992000
Brunei Darussalam,2015,12,5082000,8000,5090000
Brunei Darussalam,2016,1,2772000,122000,2894000
Brunei Darussalam,2016,2,5455000,18000,5473000
Brunei Darussalam,2016,3,5117000,488000,5605000
Brunei Darussalam,2016,4,17477000,35000,17512000
Brunei Darussalam,2016,5,2364000,20000,2384000
Brunei Darussalam,2016,6,3117000,42000,3159000
Brunei Darussalam,2016,7,3886000,21000,3907000
Brunei Darussalam,2016,8,4296000,13000,4309000
Brunei Darussalam,2016,9,3213000,53000,3266000
Brunei Darussalam,2016,10,6242000,31000,6273000
Brunei Darussalam,2016,11,4226000,92000,4318000
Brunei Darussalam,2016,12,8515000,24000,8539000
Brunei Darussalam,2017,1,6214000,13000,6227000
Brunei Darussalam,2017,2,4634000,92000,4726000
Brunei Darussalam,2017,3,3624000,37000,3661000
Brunei Darussalam,2017,4,2603000,56000,2659000
Brunei Darussalam,2017,5,3632000,28000,3660000
Brunei Darussalam,2017,6,3762000,83000,3845000
Brunei Darussalam,2017,7,6973000,52000,7025000
Brunei Darussalam,2017,8,5065000,32000,5097000
Brunei Darussalam,2017,9,4033000,207000,4240000
Brunei Darussalam,2017,10,4395000,21000,4416000
Brunei Darussalam,2017,11,4151000,51000,4202000
Brunei Darussalam,2017,12,2425000,30000,2455000
Brunei Darussalam,2018,1,2833000,42000,2875000
Brunei Darussalam,2018,2,2576000,23000,2599000
Brunei Darussalam,2018,3,5376000,45000,5421000
Brunei Darussalam,2018,4,4562000,342000,4904000
Brunei Darussalam,2018,5,4254000,59000,4313000
Brunei Darussalam,2018,6,3710000,65000,3775000
Brunei Darussalam,2018,7,2826000,34000,2860000
Brunei Darussalam,2018,8,3327000,66000,3393000
Brunei Darussalam,2018,9,5689000,45000,5734000
Brunei Darussalam,2018,10,3958000,62000,4020000
Brunei Darussalam,2018,11,68688000,29000,68717000
Brunei Darussalam,2018,12,4699000,509000,5208000
Brunei Darussalam,2019,1,4289000,357000,4646000
Brunei Darussalam,2019,2,4545000,38000,4583000
Brunei Darussalam,2019,3,4515000,114000,4629000
Brunei Darussalam,2019,4,5244000,18000,5262000
Brunei Darussalam,2019,5,6410000,15000,6425000
Brunei Darussalam,2019,6,4479000,124000,4603000
Brunei Darussalam,2019,7,8684000,22000,8706000
Brunei Darussalam,2019,8,6872000,16000,6888000
Brunei Darussalam,2019,9,6197000,67000,6264000
Brunei Darussalam,2019,10,5688000,127000,5815000
Brunei Darussalam,2019,11,5673000,43000,5716000
Brunei Darussalam,2019,12,5799000,17000,5816000
Brunei Darussalam,2020,1,3411000,33000,3444000
Brunei Darussalam,2020,2,8780000,63000,8843000
Brunei Darussalam,2020,3,3950000,203000,4153000
Brunei Darussalam,2020,4,2389000,153000,2542000
Brunei Darussalam,2020,5,2814000,40000,2854000
Brunei Darussalam,2020,6,9246000,41000,9287000
Brunei Darussalam,2020,7,7554000,104000,7658000
Brunei Darussalam,2020,8,2635000,80000,2715000
Brunei Darussalam,2020,9,4094000,23000,4117000
Brunei Darussalam,2020,10,2845000,333000,3178000
Brunei Darussalam,2020,11,11217000,562000,11779000
Brunei Darussalam,2020,12,3897000,71000,3968000
Brunei Darussalam,2021,1,2031000,13000,2044000
Brunei Darussalam,2021,2,2867000,32000,2899000
Brunei Darussalam,2021,3,3142000,61000,3203000
Brunei Darussalam,2021,4,4416000,409000,4825000
Brunei Darussalam,2021,5,3511000,97000,3608000
Brunei Darussalam,2021,6,4954000,155000,5109000
Brunei Darussalam,2021,7,3590000,19000,3609000
Brunei Darussalam,2021,8,6435000,140000,6575000
Brunei Darussalam,2021,9,3256000,76000,3332000
Brunei Darussalam,2021,10,3373000,61000,3434000
Brunei Darussalam,2021,11,7427000,39000,7466000
Brunei Darussalam,2021,12,2585000,15000,2600000
Brunei Darussalam,2022,1,4008000,58000,4066000
Brunei Darussalam,2022,2,2233000,197000,2430000
Brunei Darussalam,2022,3,6012000,304000,6316000
Brunei Darussalam,2022,4,5560000,208000,5768000
Brunei Darussalam,2022,5,1917000,564000,2481000
Brunei Darussalam,2022,6,2145000,366000,2511000
Brunei Darussalam,2022,7,3611000,335000,3946000
Brunei Darussalam,2022,8,2360000,348000,2708000
Brunei Darussalam,2022,9,2733000,400000,3133000
Brunei Darussalam,2022,10,2267000,295000,2562000
Brunei Darussalam,2022,11,3037000,330000,3367000
Brunei Darussalam,2022,12,3274000,195000,3469000
Brunei Darussalam,2023,1,3534000,175000,3709000
Brunei Darussalam,2023,2,4680000,231000,4911000
Brunei Darussalam,2023,3,6351000,357000,6708000
Brunei Darussalam,2023,4,5442000,654000,6096000
Brunei Darussalam,2023,5,4203000,295000,4498000
Brunei Darussalam,2023,6,5743000,416000,6159000
Brunei Darussalam,2023,7,2847000,260000,3107000
Brunei Darussalam,2023,8,5787000,422000,6209000
Brunei Darussalam,2023,9,2612000,193000,2805000
Brunei Darussalam,2023,10,2987000,188000,3175000
Brunei Darussalam,2023,11,4180000,537000,4717000
Brunei Darussalam,2023,12,2271000,204000,2475000
Brunei Darussalam,2024,1,4424000,329000,4753000
Brunei Darussalam,2024,2,3471000,445000,3916000
Brunei Darussalam,2024,3,3079000,314000,3393000
Brunei Darussalam,2024,4,2313000,436000,2749000
Brunei Darussalam,2024,5,3589000,346000,3935000
Brunei Darussalam,2024,6,2210000,444000,2654000
Brunei Darussalam,2024,7,4527000,374000,4901000
Brunei Darussalam,2024,8,1880000,342000,2222000
Brunei Darussalam,2024,9,3171000,474000,3645000
Brunei Darussalam,2024,10,1955000,441000,2396000
Brunei Darussalam,2024,11,2857000,400000,3257000
Brunei Darussalam,2024,12,2865000,241000,3106000
Bulgarien,2008,1,199815000,113438000,313253000
Bulgarien,2008,2,208024000,116612000,324636000
Bulgarien,2008,3,224620000,116205000,340825000
Bulgarien,2008,4,248238000,108506000,356744000
Bulgarien,2008,5,216429000,113484000,329913000
Bulgarien,2008,6,321853000,117427000,439280000
Bulgarien,2008,7,273064000,135405000,408469000
Bulgarien,2008,8,215312000,117284000,332596000
Bulgarien,2008,9,235660000,114209000,349869000
Bulgarien,2008,10,238722000,136653000,375375000
Bulgarien,2008,11,197163000,127745000,324908000
Bulgarien,2008,12,183139000,99350000,282489000
Bulgarien,2009,1,173163000,97039000,270202000
Bulgarien,2009,2,180634000,110467000,291101000
Bulgarien,2009,3,188672000,98154000,286826000
Bulgarien,2009,4,159180000,92437000,251617000
Bulgarien,2009,5,145494000,86959000,232453000
Bulgarien,2009,6,151254000,118932000,270186000
Bulgarien,2009,7,159104000,112361000,271465000
Bulgarien,2009,8,136863000,120130000,256993000
Bulgarien,2009,9,166275000,112018000,278293000
Bulgarien,2009,10,153685000,133400000,287085000
Bulgarien,2009,11,149035000,116276000,265311000
Bulgarien,2009,12,145091000,105698000,250789000
Bulgarien,2010,1,130207000,109933000,240140000
Bulgarien,2010,2,141185000,111666000,252851000
Bulgarien,2010,3,195126000,138574000,333700000
Bulgarien,2010,4,157203000,118860000,276063000
Bulgarien,2010,5,190626000,122849000,313475000
Bulgarien,2010,6,232197000,139544000,371741000
Bulgarien,2010,7,218987000,150781000,369768000
Bulgarien,2010,8,162451000,159727000,322178000
Bulgarien,2010,9,192880000,143506000,336386000
Bulgarien,2010,10,188902000,147522000,336424000
Bulgarien,2010,11,187523000,152538000,340061000
Bulgarien,2010,12,177884000,150260000,328144000
Bulgarien,2011,1,173680000,161287000,334967000
Bulgarien,2011,2,179742000,153758000,333500000
Bulgarien,2011,3,210284000,190167000,400451000
Bulgarien,2011,4,180898000,154549000,335447000
Bulgarien,2011,5,200800000,154203000,355003000
Bulgarien,2011,6,195227000,163915000,359142000
Bulgarien,2011,7,199941000,173082000,373023000
Bulgarien,2011,8,223008000,213687000,436695000
Bulgarien,2011,9,201193000,160772000,361965000
Bulgarien,2011,10,189702000,170231000,359933000
Bulgarien,2011,11,207905000,207092000,414997000
Bulgarien,2011,12,207921000,184485000,392406000
Bulgarien,2012,1,193813000,205254000,399067000
Bulgarien,2012,2,220891000,170226000,391117000
Bulgarien,2012,3,233197000,202170000,435367000
Bulgarien,2012,4,250322000,171144000,421466000
Bulgarien,2012,5,299968000,203124000,503092000
Bulgarien,2012,6,276833000,172007000,448840000
Bulgarien,2012,7,214006000,176085000,390091000
Bulgarien,2012,8,206296000,177186000,383482000
Bulgarien,2012,9,193408000,185782000,379190000
Bulgarien,2012,10,210878000,187891000,398769000
Bulgarien,2012,11,207268000,237498000,444766000
Bulgarien,2012,12,180662000,138571000,319233000
Bulgarien,2013,1,191135000,237547000,428682000
Bulgarien,2013,2,190722000,246230000,436952000
Bulgarien,2013,3,224123000,242415000,466538000
Bulgarien,2013,4,219039000,210137000,429176000
Bulgarien,2013,5,217633000,189472000,407105000
Bulgarien,2013,6,240098000,208460000,448558000
Bulgarien,2013,7,229574000,203651000,433225000
Bulgarien,2013,8,212671000,221526000,434197000
Bulgarien,2013,9,240967000,254633000,495600000
Bulgarien,2013,10,248839000,311972000,560811000
Bulgarien,2013,11,234128000,218286000,452414000
Bulgarien,2013,12,197437000,182562000,379999000
Bulgarien,2014,1,232925000,199189000,432114000
Bulgarien,2014,2,248491000,194991000,443482000
Bulgarien,2014,3,264300000,187993000,452293000
Bulgarien,2014,4,238714000,242020000,480734000
Bulgarien,2014,5,245651000,177158000,422809000
Bulgarien,2014,6,274555000,227201000,501756000
Bulgarien,2014,7,275167000,224418000,499585000
Bulgarien,2014,8,247011000,250926000,497937000
Bulgarien,2014,9,327766000,209858000,537624000
Bulgarien,2014,10,313333000,247828000,561161000
Bulgarien,2014,11,309906000,226505000,536411000
Bulgarien,2014,12,304757000,201238000,505995000
Bulgarien,2015,1,302524000,215968000,518492000
Bulgarien,2015,2,315155000,225648000,540803000
Bulgarien,2015,3,305481000,236803000,542284000
Bulgarien,2015,4,282714000,239560000,522274000
Bulgarien,2015,5,275314000,274282000,549596000
Bulgarien,2015,6,286560000,283688000,570248000
Bulgarien,2015,7,301608000,247136000,548744000
Bulgarien,2015,8,245192000,214856000,460048000
Bulgarien,2015,9,280561000,248815000,529376000
Bulgarien,2015,10,298164000,226843000,525007000
Bulgarien,2015,11,309062000,282345000,591407000
Bulgarien,2015,12,249381000,208560000,457941000
Bulgarien,2016,1,258671000,239177000,497848000
Bulgarien,2016,2,282797000,264951000,547748000
Bulgarien,2016,3,303134000,269293000,572427000
Bulgarien,2016,4,289302000,262316000,551618000
Bulgarien,2016,5,256809000,220981000,477790000
Bulgarien,2016,6,327696000,265454000,593150000
Bulgarien,2016,7,346884000,266997000,613881000
Bulgarien,2016,8,280203000,265270000,545473000
Bulgarien,2016,9,291664000,279178000,570842000
Bulgarien,2016,10,287738000,278456000,566194000
Bulgarien,2016,11,309844000,269147000,578991000
Bulgarien,2016,12,263203000,330798000,594001000
Bulgarien,2017,1,276442000,340306000,616748000
Bulgarien,2017,2,294581000,317196000,611777000
Bulgarien,2017,3,326612000,292146000,618758000
Bulgarien,2017,4,289979000,338405000,628384000
Bulgarien,2017,5,313993000,356995000,670988000
Bulgarien,2017,6,339495000,365570000,705065000
Bulgarien,2017,7,313172000,328434000,641606000
Bulgarien,2017,8,308150000,304808000,612958000
Bulgarien,2017,9,307588000,285749000,593337000
Bulgarien,2017,10,344916000,362472000,707388000
Bulgarien,2017,11,333086000,359752000,692838000
Bulgarien,2017,12,297693000,243830000,541523000
Bulgarien,2018,1,324745000,417034000,741779000
Bulgarien,2018,2,339132000,305184000,644316000
Bulgarien,2018,3,371591000,360076000,731667000
Bulgarien,2018,4,318854000,404594000,723448000
Bulgarien,2018,5,326774000,349414000,676188000
Bulgarien,2018,6,338558000,359964000,698522000
Bulgarien,2018,7,335459000,351184000,686643000
Bulgarien,2018,8,312913000,377070000,689983000
Bulgarien,2018,9,313988000,389364000,703352000
Bulgarien,2018,10,366097000,371428000,737525000
Bulgarien,2018,11,345495000,330707000,676202000
Bulgarien,2018,12,293627000,298991000,592618000
Bulgarien,2019,1,321041000,391854000,712895000
Bulgarien,2019,2,333390000,377469000,710859000
Bulgarien,2019,3,364944000,375087000,740031000
Bulgarien,2019,4,353874000,395915000,749789000
Bulgarien,2019,5,330286000,327584000,657870000
Bulgarien,2019,6,309528000,356760000,666288000
Bulgarien,2019,7,319962000,364176000,684138000
Bulgarien,2019,8,294915000,401757000,696672000
Bulgarien,2019,9,338694000,395805000,734499000
Bulgarien,2019,10,352530000,434991000,787521000
Bulgarien,2019,11,341422000,472057000,813479000
Bulgarien,2019,12,273105000,352291000,625396000
Bulgarien,2020,1,325682000,407356000,733038000
Bulgarien,2020,2,346252000,359743000,705995000
Bulgarien,2020,3,330576000,407077000,737653000
Bulgarien,2020,4,237974000,319431000,557405000
Bulgarien,2020,5,234566000,326820000,561386000
Bulgarien,2020,6,283227000,353753000,636980000
Bulgarien,2020,7,291580000,391463000,683043000
Bulgarien,2020,8,295865000,393058000,688923000
Bulgarien,2020,9,327197000,450350000,777547000
Bulgarien,2020,10,341494000,443163000,784657000
Bulgarien,2020,11,348145000,412865000,761010000
Bulgarien,2020,12,283499000,344875000,628374000
Bulgarien,2021,1,313830000,404593000,718423000
Bulgarien,2021,2,357968000,413253000,771221000
Bulgarien,2021,3,429145000,533084000,962229000
Bulgarien,2021,4,368594000,417885000,786479000
Bulgarien,2021,5,377243000,467317000,844560000
Bulgarien,2021,6,381744000,426692000,808436000
Bulgarien,2021,7,377455000,436622000,814077000
Bulgarien,2021,8,380284000,408786000,789070000
Bulgarien,2021,9,412615000,492238000,904853000
Bulgarien,2021,10,410970000,408029000,818999000
Bulgarien,2021,11,429299000,462898000,892197000
Bulgarien,2021,12,357150000,394441000,751591000
Bulgarien,2022,1,402335000,492082000,894417000
Bulgarien,2022,2,405994000,526207000,932201000
Bulgarien,2022,3,483858000,673945000,1157803000
Bulgarien,2022,4,429982000,568092000,998074000
Bulgarien,2022,5,437303000,665013000,1102316000
Bulgarien,2022,6,476006000,642110000,1118116000
Bulgarien,2022,7,458524000,518610000,977134000
Bulgarien,2022,8,472485000,438708000,911193000
Bulgarien,2022,9,501418000,626225000,1127643000
Bulgarien,2022,10,481831000,592574000,1074405000
Bulgarien,2022,11,561113000,604809000,1165922000
Bulgarien,2022,12,458542000,455181000,913723000
Bulgarien,2023,1,494363000,533918000,1028281000
Bulgarien,2023,2,491351000,501774000,993125000
Bulgarien,2023,3,562133000,559363000,1121496000
Bulgarien,2023,4,442040000,465963000,908003000
Bulgarien,2023,5,516082000,513037000,1029119000
Bulgarien,2023,6,534640000,530631000,1065271000
Bulgarien,2023,7,532978000,502731000,1035709000
Bulgarien,2023,8,479425000,471223000,950648000
Bulgarien,2023,9,476417000,497380000,973797000
Bulgarien,2023,10,498743000,490510000,989253000
Bulgarien,2023,11,512538000,510885000,1023423000
Bulgarien,2023,12,397510000,397953000,795463000
Bulgarien,2024,1,510259000,546337000,1056596000
Bulgarien,2024,2,509219000,420156000,929375000
Bulgarien,2024,3,520149000,633853000,1154002000
Bulgarien,2024,4,511096000,625829000,1136925000
Bulgarien,2024,5,469826000,548081000,1017907000
Bulgarien,2024,6,491947000,629139000,1121086000
Bulgarien,2024,7,497642000,477601000,975243000
Bulgarien,2024,8,468611000,532785000,1001396000
Bulgarien,2024,9,491283000,589374000,1080657000
Bulgarien,2024,10,524333000,627441000,1151774000
Bulgarien,2024,11,517282000,587045000,1104327000
Bulgarien,2024,12,431868000,402348000,834216000
Burkina Faso,2008,1,2334000,229000,2563000
Burkina Faso,2008,2,978000,34000,1012000
Burkina Faso,2008,3,943000,165000,1108000
Burkina Faso,2008,4,1509000,572000,2081000
Burkina Faso,2008,5,2591000,507000,3098000
Burkina Faso,2008,6,1468000,325000,1793000
Burkina Faso,2008,7,1459000,239000,1698000
Burkina Faso,2008,8,1052000,165000,1217000
Burkina Faso,2008,9,1015000,316000,1331000
Burkina Faso,2008,10,930000,360000,1290000
Burkina Faso,2008,11,1737000,152000,1889000
Burkina Faso,2008,12,1664000,207000,1871000
Burkina Faso,2009,1,730000,257000,987000
Burkina Faso,2009,2,1048000,464000,1512000
Burkina Faso,2009,3,1119000,900000,2019000
Burkina Faso,2009,4,2120000,826000,2946000
Burkina Faso,2009,5,1292000,452000,1744000
Burkina Faso,2009,6,1295000,543000,1838000
Burkina Faso,2009,7,3096000,257000,3353000
Burkina Faso,2009,8,2039000,293000,2332000
Burkina Faso,2009,9,741000,328000,1069000
Burkina Faso,2009,10,2971000,339000,3310000
Burkina Faso,2009,11,2408000,182000,2590000
Burkina Faso,2009,12,2682000,213000,2895000
Burkina Faso,2010,1,1421000,263000,1684000
Burkina Faso,2010,2,2005000,381000,2386000
Burkina Faso,2010,3,2427000,553000,2980000
Burkina Faso,2010,4,1587000,1641000,3228000
Burkina Faso,2010,5,1283000,999000,2282000
Burkina Faso,2010,6,2933000,960000,3893000
Burkina Faso,2010,7,2663000,481000,3144000
Burkina Faso,2010,8,2975000,248000,3223000
Burkina Faso,2010,9,2387000,280000,2667000
Burkina Faso,2010,10,2862000,312000,3174000
Burkina Faso,2010,11,2235000,128000,2363000
Burkina Faso,2010,12,3844000,142000,3986000
Burkina Faso,2011,1,1699000,830000,2529000
Burkina Faso,2011,2,1407000,501000,1908000
Burkina Faso,2011,3,2672000,623000,3295000
Burkina Faso,2011,4,1887000,1337000,3224000
Burkina Faso,2011,5,1724000,1169000,2893000
Burkina Faso,2011,6,4440000,1738000,6178000
Burkina Faso,2011,7,10413000,1465000,11878000
Burkina Faso,2011,8,2763000,738000,3501000
Burkina Faso,2011,9,1972000,713000,2685000
Burkina Faso,2011,10,4430000,511000,4941000
Burkina Faso,2011,11,3078000,463000,3541000
Burkina Faso,2011,12,2798000,284000,3082000
Burkina Faso,2012,1,3983000,355000,4338000
Burkina Faso,2012,2,5141000,693000,5834000
Burkina Faso,2012,3,4269000,787000,5056000
Burkina Faso,2012,4,3818000,360000,4178000
Burkina Faso,2012,5,5718000,508000,6226000
Burkina Faso,2012,6,2095000,390000,2485000
Burkina Faso,2012,7,10095000,980000,11075000
Burkina Faso,2012,8,5242000,499000,5741000
Burkina Faso,2012,9,4875000,292000,5167000
Burkina Faso,2012,10,6037000,431000,6468000
Burkina Faso,2012,11,3490000,1381000,4871000
Burkina Faso,2012,12,6488000,160000,6648000
Burkina Faso,2013,1,3449000,276000,3725000
Burkina Faso,2013,2,2308000,170000,2478000
Burkina Faso,2013,3,6093000,814000,6907000
Burkina Faso,2013,4,5673000,739000,6412000
Burkina Faso,2013,5,2621000,1977000,4598000
Burkina Faso,2013,6,2928000,847000,3775000
Burkina Faso,2013,7,5249000,964000,6213000
Burkina Faso,2013,8,4959000,1345000,6304000
Burkina Faso,2013,9,2213000,1237000,3450000
Burkina Faso,2013,10,4345000,941000,5286000
Burkina Faso,2013,11,2306000,783000,3089000
Burkina Faso,2013,12,4491000,712000,5203000
Burkina Faso,2014,1,2681000,972000,3653000
Burkina Faso,2014,2,2718000,317000,3035000
Burkina Faso,2014,3,4390000,495000,4885000
Burkina Faso,2014,4,4812000,958000,5770000
Burkina Faso,2014,5,6940000,517000,7457000
Burkina Faso,2014,6,2282000,891000,3173000
Burkina Faso,2014,7,7276000,1533000,8809000
Burkina Faso,2014,8,5684000,1111000,6795000
Burkina Faso,2014,9,6878000,6248000,13126000
Burkina Faso,2014,10,3714000,891000,4605000
Burkina Faso,2014,11,3639000,575000,4214000
Burkina Faso,2014,12,3414000,584000,3998000
Burkina Faso,2015,1,2186000,410000,2596000
Burkina Faso,2015,2,2311000,1142000,3453000
Burkina Faso,2015,3,5222000,534000,5756000
Burkina Faso,2015,4,3820000,1420000,5240000
Burkina Faso,2015,5,4430000,1194000,5624000
Burkina Faso,2015,6,4670000,1699000,6369000
Burkina Faso,2015,7,4689000,548000,5237000
Burkina Faso,2015,8,3317000,1736000,5053000
Burkina Faso,2015,9,3148000,1039000,4187000
Burkina Faso,2015,10,3661000,826000,4487000
Burkina Faso,2015,11,4877000,5582000,10459000
Burkina Faso,2015,12,3959000,1524000,5483000
Burkina Faso,2016,1,4018000,415000,4433000
Burkina Faso,2016,2,5160000,4921000,10081000
Burkina Faso,2016,3,4353000,582000,4935000
Burkina Faso,2016,4,3721000,1872000,5593000
Burkina Faso,2016,5,5631000,1537000,7168000
Burkina Faso,2016,6,3963000,7852000,11815000
Burkina Faso,2016,7,3174000,8723000,11897000
Burkina Faso,2016,8,4787000,827000,5614000
Burkina Faso,2016,9,3803000,1097000,4900000
Burkina Faso,2016,10,4070000,476000,4546000
Burkina Faso,2016,11,7260000,9017000,16277000
Burkina Faso,2016,12,4306000,776000,5082000
Burkina Faso,2017,1,8160000,9754000,17914000
Burkina Faso,2017,2,10957000,426000,11383000
Burkina Faso,2017,3,13070000,11845000,24915000
Burkina Faso,2017,4,4190000,1149000,5339000
Burkina Faso,2017,5,7499000,910000,8409000
Burkina Faso,2017,6,4942000,1245000,6187000
Burkina Faso,2017,7,8374000,1266000,9640000
Burkina Faso,2017,8,6978000,12599000,19577000
Burkina Faso,2017,9,11853000,1152000,13005000
Burkina Faso,2017,10,4613000,545000,5158000
Burkina Faso,2017,11,5697000,12742000,18439000
Burkina Faso,2017,12,3992000,464000,4456000
Burkina Faso,2018,1,4445000,12469000,16914000
Burkina Faso,2018,2,5049000,528000,5577000
Burkina Faso,2018,3,6613000,782000,7395000
Burkina Faso,2018,4,4773000,12364000,17137000
Burkina Faso,2018,5,7454000,970000,8424000
Burkina Faso,2018,6,7610000,1286000,8896000
Burkina Faso,2018,7,6257000,14093000,20350000
Burkina Faso,2018,8,4068000,1437000,5505000
Burkina Faso,2018,9,5431000,10172000,15603000
Burkina Faso,2018,10,10141000,1000000,11141000
Burkina Faso,2018,11,11213000,638000,11851000
Burkina Faso,2018,12,4378000,569000,4947000
Burkina Faso,2019,1,3789000,9117000,12906000
Burkina Faso,2019,2,4704000,8157000,12861000
Burkina Faso,2019,3,4399000,1419000,5818000
Burkina Faso,2019,4,6420000,1636000,8056000
Burkina Faso,2019,5,4732000,7848000,12580000
Burkina Faso,2019,6,3555000,8729000,12284000
Burkina Faso,2019,7,3724000,11087000,14811000
Burkina Faso,2019,8,5162000,2084000,7246000
Burkina Faso,2019,9,4482000,1970000,6452000
Burkina Faso,2019,10,9325000,829000,10154000
Burkina Faso,2019,11,6168000,6623000,12791000
Burkina Faso,2019,12,4876000,706000,5582000
Burkina Faso,2020,1,10279000,7769000,18048000
Burkina Faso,2020,2,8859000,170000,9029000
Burkina Faso,2020,3,5495000,807000,6302000
Burkina Faso,2020,4,4136000,1208000,5344000
Burkina Faso,2020,5,4339000,1478000,5817000
Burkina Faso,2020,6,5560000,1920000,7480000
Burkina Faso,2020,7,4431000,2527000,6958000
Burkina Faso,2020,8,3583000,2764000,6347000
Burkina Faso,2020,9,5084000,1951000,7035000
Burkina Faso,2020,10,7480000,935000,8415000
Burkina Faso,2020,11,5714000,1341000,7055000
Burkina Faso,2020,12,7240000,924000,8164000
Burkina Faso,2021,1,7334000,798000,8132000
Burkina Faso,2021,2,3867000,15461000,19328000
Burkina Faso,2021,3,6503000,1191000,7694000
Burkina Faso,2021,4,6301000,6919000,13220000
Burkina Faso,2021,5,4846000,1046000,5892000
Burkina Faso,2021,6,10288000,7866000,18154000
Burkina Faso,2021,7,11851000,2862000,14713000
Burkina Faso,2021,8,6756000,3076000,9832000
Burkina Faso,2021,9,7779000,9201000,16980000
Burkina Faso,2021,10,11697000,1822000,13519000
Burkina Faso,2021,11,12377000,1400000,13777000
Burkina Faso,2021,12,7567000,917000,8484000
Burkina Faso,2022,1,7813000,23589000,31402000
Burkina Faso,2022,2,6181000,504000,6685000
Burkina Faso,2022,3,17828000,2311000,20139000
Burkina Faso,2022,4,6520000,2300000,8820000
Burkina Faso,2022,5,6425000,18409000,24834000
Burkina Faso,2022,6,15282000,1705000,16987000
Burkina Faso,2022,7,16227000,2932000,19159000
Burkina Faso,2022,8,7531000,4004000,11535000
Burkina Faso,2022,9,6539000,2772000,9311000
Burkina Faso,2022,10,8358000,1742000,10100000
Burkina Faso,2022,11,8281000,1877000,10158000
Burkina Faso,2022,12,5562000,1416000,6978000
Burkina Faso,2023,1,5200000,760000,5960000
Burkina Faso,2023,2,7345000,1368000,8713000
Burkina Faso,2023,3,5273000,1105000,6378000
Burkina Faso,2023,4,5619000,1918000,7537000
Burkina Faso,2023,5,6395000,1938000,8333000
Burkina Faso,2023,6,5986000,3033000,9019000
Burkina Faso,2023,7,4581000,3991000,8572000
Burkina Faso,2023,8,7096000,3964000,11060000
Burkina Faso,2023,9,5825000,2014000,7839000
Burkina Faso,2023,10,4450000,2268000,6718000
Burkina Faso,2023,11,4708000,1492000,6200000
Burkina Faso,2023,12,12779000,945000,13724000
Burkina Faso,2024,1,3821000,1917000,5738000
Burkina Faso,2024,2,4387000,677000,5064000
Burkina Faso,2024,3,5439000,1233000,6672000
Burkina Faso,2024,4,6602000,1045000,7647000
Burkina Faso,2024,5,4622000,1824000,6446000
Burkina Faso,2024,6,5017000,1731000,6748000
Burkina Faso,2024,7,5065000,4251000,9316000
Burkina Faso,2024,8,6531000,3580000,10111000
Burkina Faso,2024,9,5490000,3272000,8762000
Burkina Faso,2024,10,4677000,1612000,6289000
Burkina Faso,2024,11,4928000,1073000,6001000
Burkina Faso,2024,12,6678000,1040000,7718000
Burundi,2008,1,834000,803000,1637000
Burundi,2008,2,849000,884000,1733000
Burundi,2008,3,1013000,873000,1886000
Burundi,2008,4,1311000,1112000,2423000
Burundi,2008,5,1390000,881000,2271000
Burundi,2008,6,508000,1625000,2133000
Burundi,2008,7,734000,1017000,1751000
Burundi,2008,8,727000,342000,1069000
Burundi,2008,9,674000,894000,1568000
Burundi,2008,10,2294000,682000,2976000
Burundi,2008,11,586000,268000,854000
Burundi,2008,12,1879000,756000,2635000
Burundi,2009,1,503000,2276000,2779000
Burundi,2009,2,642000,1731000,2373000
Burundi,2009,3,1542000,1403000,2945000
Burundi,2009,4,493000,2466000,2959000
Burundi,2009,5,964000,1609000,2573000
Burundi,2009,6,1819000,1808000,3627000
Burundi,2009,7,448000,876000,1324000
Burundi,2009,8,1198000,983000,2181000
Burundi,2009,9,659000,974000,1633000
Burundi,2009,10,470000,876000,1346000
Burundi,2009,11,791000,1745000,2536000
Burundi,2009,12,581000,1269000,1850000
Burundi,2010,1,404000,2002000,2406000
Burundi,2010,2,611000,1535000,2146000
Burundi,2010,3,304000,1182000,1486000
Burundi,2010,4,472000,1925000,2397000
Burundi,2010,5,699000,715000,1414000
Burundi,2010,6,490000,1358000,1848000
Burundi,2010,7,551000,1696000,2247000
Burundi,2010,8,349000,1074000,1423000
Burundi,2010,9,528000,1015000,1543000
Burundi,2010,10,1131000,1605000,2736000
Burundi,2010,11,7000000,1681000,8681000
Burundi,2010,12,1519000,1472000,2991000
Burundi,2011,1,532000,3060000,3592000
Burundi,2011,2,1046000,1797000,2843000
Burundi,2011,3,638000,1552000,2190000
Burundi,2011,4,504000,212000,716000
Burundi,2011,5,906000,1275000,2181000
Burundi,2011,6,356000,427000,783000
Burundi,2011,7,374000,521000,895000
Burundi,2011,8,781000,895000,1676000
Burundi,2011,9,771000,527000,1298000
Burundi,2011,10,779000,1906000,2685000
Burundi,2011,11,561000,948000,1509000
Burundi,2011,12,784000,2456000,3240000
Burundi,2012,1,573000,2252000,2825000
Burundi,2012,2,1458000,1504000,2962000
Burundi,2012,3,2018000,1069000,3087000
Burundi,2012,4,391000,1444000,1835000
Burundi,2012,5,1080000,662000,1742000
Burundi,2012,6,1871000,631000,2502000
Burundi,2012,7,803000,335000,1138000
Burundi,2012,8,599000,901000,1500000
Burundi,2012,9,553000,1376000,1929000
Burundi,2012,10,1143000,1884000,3027000
Burundi,2012,11,1572000,995000,2567000
Burundi,2012,12,3384000,1821000,5205000
Burundi,2013,1,1760000,1984000,3744000
Burundi,2013,2,979000,892000,1871000
Burundi,2013,3,1610000,1477000,3087000
Burundi,2013,4,1869000,1954000,3823000
Burundi,2013,5,826000,697000,1523000
Burundi,2013,6,1395000,459000,1854000
Burundi,2013,7,1563000,734000,2297000
Burundi,2013,8,1236000,893000,2129000
Burundi,2013,9,1001000,288000,1289000
Burundi,2013,10,1382000,307000,1689000
Burundi,2013,11,1313000,429000,1742000
Burundi,2013,12,1792000,738000,2530000
Burundi,2014,1,726000,646000,1372000
Burundi,2014,2,899000,200000,1099000
Burundi,2014,3,891000,528000,1419000
Burundi,2014,4,619000,481000,1100000
Burundi,2014,5,277000,303000,580000
Burundi,2014,6,470000,354000,824000
Burundi,2014,7,898000,355000,1253000
Burundi,2014,8,647000,296000,943000
Burundi,2014,9,819000,453000,1272000
Burundi,2014,10,509000,271000,780000
Burundi,2014,11,1734000,229000,1963000
Burundi,2014,12,6099000,600000,6699000
Burundi,2015,1,482000,764000,1246000
Burundi,2015,2,565000,903000,1468000
Burundi,2015,3,774000,733000,1507000
Burundi,2015,4,1051000,1317000,2368000
Burundi,2015,5,321000,2567000,2888000
Burundi,2015,6,605000,540000,1145000
Burundi,2015,7,320000,833000,1153000
Burundi,2015,8,472000,983000,1455000
Burundi,2015,9,1027000,1267000,2294000
Burundi,2015,10,516000,2522000,3038000
Burundi,2015,11,401000,193000,594000
Burundi,2015,12,730000,718000,1448000
Burundi,2016,1,525000,868000,1393000
Burundi,2016,2,1012000,375000,1387000
Burundi,2016,3,1082000,867000,1949000
Burundi,2016,4,1625000,910000,2535000
Burundi,2016,5,705000,974000,1679000
Burundi,2016,6,2771000,100000,2871000
Burundi,2016,7,1589000,72000,1661000
Burundi,2016,8,479000,492000,971000
Burundi,2016,9,305000,267000,572000
Burundi,2016,10,682000,2065000,2747000
Burundi,2016,11,1118000,1790000,2908000
Burundi,2016,12,426000,3231000,3657000
Burundi,2017,1,496000,743000,1239000
Burundi,2017,2,1563000,1533000,3096000
Burundi,2017,3,1172000,91000,1263000
Burundi,2017,4,799000,788000,1587000
Burundi,2017,5,597000,236000,833000
Burundi,2017,6,1477000,369000,1846000
Burundi,2017,7,297000,47000,344000
Burundi,2017,8,875000,216000,1091000
Burundi,2017,9,296000,460000,756000
Burundi,2017,10,650000,444000,1094000
Burundi,2017,11,1559000,1772000,3331000
Burundi,2017,12,610000,335000,945000
Burundi,2018,1,255000,3232000,3487000
Burundi,2018,2,295000,381000,676000
Burundi,2018,3,2060000,1166000,3226000
Burundi,2018,4,333000,669000,1002000
Burundi,2018,5,505000,853000,1358000
Burundi,2018,6,1069000,921000,1990000
Burundi,2018,7,970000,462000,1432000
Burundi,2018,8,272000,369000,641000
Burundi,2018,9,288000,183000,471000
Burundi,2018,10,1560000,209000,1769000
Burundi,2018,11,693000,430000,1123000
Burundi,2018,12,1286000,586000,1872000
Burundi,2019,1,306000,979000,1285000
Burundi,2019,2,1512000,1306000,2818000
Burundi,2019,3,1490000,1038000,2528000
Burundi,2019,4,1937000,1595000,3532000
Burundi,2019,5,4161000,3936000,8097000
Burundi,2019,6,1161000,1851000,3012000
Burundi,2019,7,538000,394000,932000
Burundi,2019,8,320000,369000,689000
Burundi,2019,9,478000,500000,978000
Burundi,2019,10,511000,428000,939000
Burundi,2019,11,532000,242000,774000
Burundi,2019,12,416000,1352000,1768000
Burundi,2020,1,762000,713000,1475000
Burundi,2020,2,579000,906000,1485000
Burundi,2020,3,624000,2098000,2722000
Burundi,2020,4,354000,41000,395000
Burundi,2020,5,367000,840000,1207000
Burundi,2020,6,1712000,805000,2517000
Burundi,2020,7,543000,110000,653000
Burundi,2020,8,740000,59000,799000
Burundi,2020,9,1085000,136000,1221000
Burundi,2020,10,525000,95000,620000
Burundi,2020,11,459000,15000,474000
Burundi,2020,12,811000,831000,1642000
Burundi,2021,1,738000,1116000,1854000
Burundi,2021,2,778000,2813000,3591000
Burundi,2021,3,490000,2068000,2558000
Burundi,2021,4,751000,720000,1471000
Burundi,2021,5,280000,2564000,2844000
Burundi,2021,6,222000,1374000,1596000
Burundi,2021,7,1013000,1403000,2416000
Burundi,2021,8,2516000,551000,3067000
Burundi,2021,9,527000,936000,1463000
Burundi,2021,10,809000,1009000,1818000
Burundi,2021,11,548000,1731000,2279000
Burundi,2021,12,980000,851000,1831000
Burundi,2022,1,1268000,769000,2037000
Burundi,2022,2,2385000,320000,2705000
Burundi,2022,3,354000,592000,946000
Burundi,2022,4,1101000,521000,1622000
Burundi,2022,5,921000,1124000,2045000
Burundi,2022,6,673000,1855000,2528000
Burundi,2022,7,593000,2255000,2848000
Burundi,2022,8,2736000,1319000,4055000
Burundi,2022,9,834000,731000,1565000
Burundi,2022,10,340000,1610000,1950000
Burundi,2022,11,1111000,644000,1755000
Burundi,2022,12,768000,1112000,1880000
Burundi,2023,1,1543000,1103000,2646000
Burundi,2023,2,2299000,1535000,3834000
Burundi,2023,3,1326000,1640000,2966000
Burundi,2023,4,247000,1087000,1334000
Burundi,2023,5,969000,1740000,2709000
Burundi,2023,6,420000,889000,1309000
Burundi,2023,7,110000,582000,692000
Burundi,2023,8,614000,2128000,2742000
Burundi,2023,9,307000,298000,605000
Burundi,2023,10,1133000,514000,1647000
Burundi,2023,11,394000,483000,877000
Burundi,2023,12,925000,257000,1182000
Burundi,2024,1,465000,3000,468000
Burundi,2024,2,1805000,97000,1902000
Burundi,2024,3,995000,1017000,2012000
Burundi,2024,4,1629000,384000,2013000
Burundi,2024,5,313000,450000,763000
Burundi,2024,6,1992000,369000,2361000
Burundi,2024,7,1608000,549000,2157000
Burundi,2024,8,474000,432000,906000
Burundi,2024,9,1756000,134000,1890000
Burundi,2024,10,691000,474000,1165000
Burundi,2024,11,1262000,437000,1699000
Burundi,2024,12,430000,13000,443000
Cabo Verde,2008,1,1536000,69000,1605000
Cabo Verde,2008,2,858000,242000,1100000
Cabo Verde,2008,3,408000,402000,810000
Cabo Verde,2008,4,781000,1000,782000
Cabo Verde,2008,5,311000,10000,321000
Cabo Verde,2008,6,680000,5000,685000
Cabo Verde,2008,7,259000,5000,264000
Cabo Verde,2008,8,379000,18000,397000
Cabo Verde,2008,9,5318000,2000,5320000
Cabo Verde,2008,10,4550000,578000,5128000
Cabo Verde,2008,11,361000,113000,474000
Cabo Verde,2008,12,351000,98000,449000
Cabo Verde,2009,1,1852000,3000,1855000
Cabo Verde,2009,2,514000,44000,558000
Cabo Verde,2009,3,379000,339000,718000
Cabo Verde,2009,4,267000,14000,281000
Cabo Verde,2009,5,1065000,10000,1075000
Cabo Verde,2009,6,945000,6000,951000
Cabo Verde,2009,7,344000,32000,376000
Cabo Verde,2009,8,547000,8000,555000
Cabo Verde,2009,9,1327000,6000,1333000
Cabo Verde,2009,10,595000,1000,596000
Cabo Verde,2009,11,720000,719000,1439000
Cabo Verde,2009,12,633000,7000,640000
Cabo Verde,2010,1,1084000,19000,1103000
Cabo Verde,2010,2,762000,15000,777000
Cabo Verde,2010,3,2010000,11000,2021000
Cabo Verde,2010,4,849000,9000,858000
Cabo Verde,2010,5,352000,5000,357000
Cabo Verde,2010,6,1004000,6000,1010000
Cabo Verde,2010,7,193000,6000,199000
Cabo Verde,2010,8,2362000,15000,2377000
Cabo Verde,2010,9,1050000,0,1050000
Cabo Verde,2010,10,1087000,5000,1092000
Cabo Verde,2010,11,634000,2000,636000
Cabo Verde,2010,12,1429000,11000,1440000
Cabo Verde,2011,1,492000,2000,494000
Cabo Verde,2011,2,295000,1000,296000
Cabo Verde,2011,3,449000,4000,453000
Cabo Verde,2011,4,673000,16000,689000
Cabo Verde,2011,5,821000,1000,822000
Cabo Verde,2011,6,6953000,348000,7301000
Cabo Verde,2011,7,442000,5000,447000
Cabo Verde,2011,8,1203000,156000,1359000
Cabo Verde,2011,9,458000,7000,465000
Cabo Verde,2011,10,601000,103000,704000
Cabo Verde,2011,11,698000,37000,735000
Cabo Verde,2011,12,857000,49000,906000
Cabo Verde,2012,1,501000,35000,536000
Cabo Verde,2012,2,415000,108000,523000
Cabo Verde,2012,3,230000,48000,278000
Cabo Verde,2012,4,403000,1000,404000
Cabo Verde,2012,5,78000,11000,89000
Cabo Verde,2012,6,1030000,0,1030000
Cabo Verde,2012,7,1286000,43000,1329000
Cabo Verde,2012,8,474000,19000,493000
Cabo Verde,2012,9,634000,8000,642000
Cabo Verde,2012,10,1070000,28000,1098000
Cabo Verde,2012,11,756000,219000,975000
Cabo Verde,2012,12,445000,12000,457000
Cabo Verde,2013,1,1722000,173000,1895000
Cabo Verde,2013,2,353000,115000,468000
Cabo Verde,2013,3,1748000,87000,1835000
Cabo Verde,2013,4,986000,32000,1018000
Cabo Verde,2013,5,1494000,27000,1521000
Cabo Verde,2013,6,338000,3000,341000
Cabo Verde,2013,7,1008000,9000,1017000
Cabo Verde,2013,8,356000,24000,380000
Cabo Verde,2013,9,343000,19000,362000
Cabo Verde,2013,10,1158000,4000,1162000
Cabo Verde,2013,11,336000,45000,381000
Cabo Verde,2013,12,482000,1000,483000
Cabo Verde,2014,1,731000,15000,746000
Cabo Verde,2014,2,789000,3000,792000
Cabo Verde,2014,3,810000,4000,814000
Cabo Verde,2014,4,328000,14000,342000
Cabo Verde,2014,5,602000,7000,609000
Cabo Verde,2014,6,1043000,58000,1101000
Cabo Verde,2014,7,994000,9000,1003000
Cabo Verde,2014,8,374000,9000,383000
Cabo Verde,2014,9,611000,7000,618000
Cabo Verde,2014,10,606000,0,606000
Cabo Verde,2014,11,518000,7000,525000
Cabo Verde,2014,12,344000,20000,364000
Cabo Verde,2015,1,498000,144000,642000
Cabo Verde,2015,2,666000,142000,808000
Cabo Verde,2015,3,292000,199000,491000
Cabo Verde,2015,4,322000,2000,324000
Cabo Verde,2015,5,405000,0,405000
Cabo Verde,2015,6,817000,8000,825000
Cabo Verde,2015,7,534000,0,534000
Cabo Verde,2015,8,510000,90000,600000
Cabo Verde,2015,9,477000,64000,541000
Cabo Verde,2015,10,425000,0,425000
Cabo Verde,2015,11,382000,136000,518000
Cabo Verde,2015,12,824000,201000,1025000
Cabo Verde,2016,1,260000,1000,261000
Cabo Verde,2016,2,609000,52000,661000
Cabo Verde,2016,3,475000,36000,511000
Cabo Verde,2016,4,555000,0,555000
Cabo Verde,2016,5,409000,11000,420000
Cabo Verde,2016,6,577000,0,577000
Cabo Verde,2016,7,1820000,2000,1822000
Cabo Verde,2016,8,527000,0,527000
Cabo Verde,2016,9,563000,0,563000
Cabo Verde,2016,10,349000,1000,350000
Cabo Verde,2016,11,438000,0,438000
Cabo Verde,2016,12,969000,2000,971000
Cabo Verde,2017,1,419000,0,419000
Cabo Verde,2017,2,452000,0,452000
Cabo Verde,2017,3,672000,1000,673000
Cabo Verde,2017,4,758000,3000,761000
Cabo Verde,2017,5,633000,8000,641000
Cabo Verde,2017,6,848000,1000,849000
Cabo Verde,2017,7,465000,0,465000
Cabo Verde,2017,8,596000,0,596000
Cabo Verde,2017,9,271000,11000,282000
Cabo Verde,2017,10,2860000,2000,2862000
Cabo Verde,2017,11,828000,19000,847000
Cabo Verde,2017,12,2741000,25000,2766000
Cabo Verde,2018,1,364000,216000,580000
Cabo Verde,2018,2,618000,0,618000
Cabo Verde,2018,3,845000,1000,846000
Cabo Verde,2018,4,570000,314000,884000
Cabo Verde,2018,5,704000,75000,779000
Cabo Verde,2018,6,520000,192000,712000
Cabo Verde,2018,7,1162000,0,1162000
Cabo Verde,2018,8,653000,0,653000
Cabo Verde,2018,9,1415000,138000,1553000
Cabo Verde,2018,10,805000,5000,810000
Cabo Verde,2018,11,778000,7000,785000
Cabo Verde,2018,12,1240000,5000,1245000
Cabo Verde,2019,1,656000,0,656000
Cabo Verde,2019,2,486000,0,486000
Cabo Verde,2019,3,683000,3000,686000
Cabo Verde,2019,4,719000,0,719000
Cabo Verde,2019,5,1230000,5000,1235000
Cabo Verde,2019,6,1723000,1000,1724000
Cabo Verde,2019,7,1680000,121000,1801000
Cabo Verde,2019,8,2782000,96000,2878000
Cabo Verde,2019,9,1388000,166000,1554000
Cabo Verde,2019,10,1385000,199000,1584000
Cabo Verde,2019,11,754000,8000,762000
Cabo Verde,2019,12,523000,28000,551000
Cabo Verde,2020,1,1000000,61000,1061000
Cabo Verde,2020,2,799000,30000,829000
Cabo Verde,2020,3,350000,51000,401000
Cabo Verde,2020,4,347000,7000,354000
Cabo Verde,2020,5,185000,2000,187000
Cabo Verde,2020,6,322000,0,322000
Cabo Verde,2020,7,2128000,18000,2146000
Cabo Verde,2020,8,1086000,3000,1089000
Cabo Verde,2020,9,191000,1000,192000
Cabo Verde,2020,10,388000,83000,471000
Cabo Verde,2020,11,526000,251000,777000
Cabo Verde,2020,12,393000,3000,396000
Cabo Verde,2021,1,156000,0,156000
Cabo Verde,2021,2,732000,12000,744000
Cabo Verde,2021,3,563000,5000,568000
Cabo Verde,2021,4,573000,2000,575000
Cabo Verde,2021,5,410000,0,410000
Cabo Verde,2021,6,513000,39000,552000
Cabo Verde,2021,7,387000,141000,528000
Cabo Verde,2021,8,203000,15000,218000
Cabo Verde,2021,9,481000,2000,483000
Cabo Verde,2021,10,450000,16000,466000
Cabo Verde,2021,11,788000,0,788000
Cabo Verde,2021,12,399000,2000,401000
Cabo Verde,2022,1,116000,31000,147000
Cabo Verde,2022,2,593000,1000,594000
Cabo Verde,2022,3,614000,88000,702000
Cabo Verde,2022,4,522000,37000,559000
Cabo Verde,2022,5,1023000,15000,1038000
Cabo Verde,2022,6,353000,0,353000
Cabo Verde,2022,7,333000,0,333000
Cabo Verde,2022,8,446000,0,446000
Cabo Verde,2022,9,637000,0,637000
Cabo Verde,2022,10,377000,1000,378000
Cabo Verde,2022,11,994000,4000,998000
Cabo Verde,2022,12,412000,67000,479000
Cabo Verde,2023,1,224000,12000,236000
Cabo Verde,2023,2,768000,0,768000
Cabo Verde,2023,3,738000,9000,747000
Cabo Verde,2023,4,317000,0,317000
Cabo Verde,2023,5,1226000,11000,1237000
Cabo Verde,2023,6,481000,0,481000
Cabo Verde,2023,7,348000,1000,349000
Cabo Verde,2023,8,521000,0,521000
Cabo Verde,2023,9,686000,0,686000
Cabo Verde,2023,10,202000,29000,231000
Cabo Verde,2023,11,436000,10000,446000
Cabo Verde,2023,12,424000,0,424000
Cabo Verde,2024,1,563000,0,563000
Cabo Verde,2024,2,211000,0,211000
Cabo Verde,2024,3,732000,15000,747000
Cabo Verde,2024,4,321000,10000,331000
Cabo Verde,2024,5,703000,1000,704000
Cabo Verde,2024,6,1052000,4000,1056000
Cabo Verde,2024,7,633000,20000,653000
Cabo Verde,2024,8,656000,2000,658000
Cabo Verde,2024,9,1172000,13000,1185000
Cabo Verde,2024,10,622000,171000,793000
Cabo Verde,2024,11,189000,38000,227000
Cabo Verde,2024,12,991000,7000,998000
Ceuta (ab 1999),2008,1,656000,208000,864000
Ceuta (ab 1999),2008,2,1281000,202000,1483000
Ceuta (ab 1999),2008,3,1211000,254000,1465000
Ceuta (ab 1999),2008,4,607000,35000,642000
Ceuta (ab 1999),2008,5,594000,83000,677000
Ceuta (ab 1999),2008,6,934000,23000,957000
Ceuta (ab 1999),2008,7,559000,14000,573000
Ceuta (ab 1999),2008,8,476000,2000,478000
Ceuta (ab 1999),2008,9,855000,8000,863000
Ceuta (ab 1999),2008,10,829000,0,829000
Ceuta (ab 1999),2008,11,779000,8000,787000
Ceuta (ab 1999),2008,12,765000,74000,839000
Ceuta (ab 1999),2009,1,1012000,176000,1188000
Ceuta (ab 1999),2009,2,1110000,250000,1360000
Ceuta (ab 1999),2009,3,6498000,109000,6607000
Ceuta (ab 1999),2009,4,834000,86000,920000
Ceuta (ab 1999),2009,5,578000,61000,639000
Ceuta (ab 1999),2009,6,1335000,24000,1359000
Ceuta (ab 1999),2009,7,1402000,168000,1570000
Ceuta (ab 1999),2009,8,945000,1000,946000
Ceuta (ab 1999),2009,9,806000,0,806000
Ceuta (ab 1999),2009,10,433000,9000,442000
Ceuta (ab 1999),2009,11,998000,11000,1009000
Ceuta (ab 1999),2009,12,360000,77000,437000
Ceuta (ab 1999),2010,1,523000,101000,624000
Ceuta (ab 1999),2010,2,357000,60000,417000
Ceuta (ab 1999),2010,3,690000,48000,738000
Ceuta (ab 1999),2010,4,521000,19000,540000
Ceuta (ab 1999),2010,5,513000,11000,524000
Ceuta (ab 1999),2010,6,493000,50000,543000
Ceuta (ab 1999),2010,7,684000,70000,754000
Ceuta (ab 1999),2010,8,1258000,17000,1275000
Ceuta (ab 1999),2010,9,565000,7000,572000
Ceuta (ab 1999),2010,10,700000,42000,742000
Ceuta (ab 1999),2010,11,480000,13000,493000
Ceuta (ab 1999),2010,12,560000,67000,627000
Ceuta (ab 1999),2011,1,449000,38000,487000
Ceuta (ab 1999),2011,2,548000,80000,628000
Ceuta (ab 1999),2011,3,768000,21000,789000
Ceuta (ab 1999),2011,4,683000,30000,713000
Ceuta (ab 1999),2011,5,741000,4000,745000
Ceuta (ab 1999),2011,6,1176000,6000,1182000
Ceuta (ab 1999),2011,7,616000,0,616000
Ceuta (ab 1999),2011,8,582000,0,582000
Ceuta (ab 1999),2011,9,672000,0,672000
Ceuta (ab 1999),2011,10,223000,565000,788000
Ceuta (ab 1999),2011,11,486000,1000,487000
Ceuta (ab 1999),2011,12,327000,7000,334000
Ceuta (ab 1999),2012,1,931000,25000,956000
Ceuta (ab 1999),2012,2,556000,53000,609000
Ceuta (ab 1999),2012,3,811000,26000,837000
Ceuta (ab 1999),2012,4,462000,6000,468000
Ceuta (ab 1999),2012,5,463000,3000,466000
Ceuta (ab 1999),2012,6,406000,136000,542000
Ceuta (ab 1999),2012,7,769000,2000,771000
Ceuta (ab 1999),2012,8,524000,145000,669000
Ceuta (ab 1999),2012,9,343000,3000,346000
Ceuta (ab 1999),2012,10,545000,7000,552000
Ceuta (ab 1999),2012,11,868000,28000,896000
Ceuta (ab 1999),2012,12,445000,123000,568000
Ceuta (ab 1999),2013,1,486000,16000,502000
Ceuta (ab 1999),2013,2,398000,16000,414000
Ceuta (ab 1999),2013,3,765000,7000,772000
Ceuta (ab 1999),2013,4,633000,17000,650000
Ceuta (ab 1999),2013,5,458000,12000,470000
Ceuta (ab 1999),2013,6,748000,14000,762000
Ceuta (ab 1999),2013,7,449000,0,449000
Ceuta (ab 1999),2013,8,355000,11000,366000
Ceuta (ab 1999),2013,9,590000,0,590000
Ceuta (ab 1999),2013,10,605000,1000,606000
Ceuta (ab 1999),2013,11,321000,0,321000
Ceuta (ab 1999),2013,12,623000,7000,630000
Ceuta (ab 1999),2014,1,423000,24000,447000
Ceuta (ab 1999),2014,2,564000,16000,580000
Ceuta (ab 1999),2014,3,708000,37000,745000
Ceuta (ab 1999),2014,4,199000,26000,225000
Ceuta (ab 1999),2014,5,881000,8000,889000
Ceuta (ab 1999),2014,6,795000,1000,796000
Ceuta (ab 1999),2014,7,655000,0,655000
Ceuta (ab 1999),2014,8,504000,0,504000
Ceuta (ab 1999),2014,9,561000,6000,567000
Ceuta (ab 1999),2014,10,640000,2000,642000
Ceuta (ab 1999),2014,11,513000,1000,514000
Ceuta (ab 1999),2014,12,650000,0,650000
Ceuta (ab 1999),2015,1,489000,2000,491000
Ceuta (ab 1999),2015,2,670000,0,670000
Ceuta (ab 1999),2015,3,487000,1000,488000
Ceuta (ab 1999),2015,4,820000,1000,821000
Ceuta (ab 1999),2015,5,1114000,2000,1116000
Ceuta (ab 1999),2015,6,730000,0,730000
Ceuta (ab 1999),2015,7,1741000,0,1741000
Ceuta (ab 1999),2015,8,670000,0,670000
Ceuta (ab 1999),2015,9,767000,0,767000
Ceuta (ab 1999),2015,10,539000,19000,558000
Ceuta (ab 1999),2015,11,538000,2000,540000
Ceuta (ab 1999),2015,12,778000,11000,789000
Ceuta (ab 1999),2016,1,532000,8000,540000
Ceuta (ab 1999),2016,2,979000,5000,984000
Ceuta (ab 1999),2016,3,776000,8000,784000
Ceuta (ab 1999),2016,4,1313000,0,1313000
Ceuta (ab 1999),2016,5,526000,0,526000
Ceuta (ab 1999),2016,6,462000,0,462000
Ceuta (ab 1999),2016,7,1120000,4000,1124000
Ceuta (ab 1999),2016,8,523000,0,523000
Ceuta (ab 1999),2016,9,483000,6000,489000
Ceuta (ab 1999),2016,10,610000,4000,614000
Ceuta (ab 1999),2016,11,545000,3000,548000
Ceuta (ab 1999),2016,12,852000,3000,855000
Ceuta (ab 1999),2017,1,477000,5000,482000
Ceuta (ab 1999),2017,2,755000,9000,764000
Ceuta (ab 1999),2017,3,697000,4000,701000
Ceuta (ab 1999),2017,4,830000,9000,839000
Ceuta (ab 1999),2017,5,640000,3000,643000
Ceuta (ab 1999),2017,6,415000,2000,417000
Ceuta (ab 1999),2017,7,492000,2000,494000
Ceuta (ab 1999),2017,8,417000,2000,419000
Ceuta (ab 1999),2017,9,303000,3000,306000
Ceuta (ab 1999),2017,10,475000,3000,478000
Ceuta (ab 1999),2017,11,491000,1000,492000
Ceuta (ab 1999),2017,12,583000,3000,586000
Ceuta (ab 1999),2018,1,674000,1000,675000
Ceuta (ab 1999),2018,2,475000,2000,477000
Ceuta (ab 1999),2018,3,694000,1000,695000
Ceuta (ab 1999),2018,4,587000,1000,588000
Ceuta (ab 1999),2018,5,1268000,2000,1270000
Ceuta (ab 1999),2018,6,583000,9000,592000
Ceuta (ab 1999),2018,7,379000,4000,383000
Ceuta (ab 1999),2018,8,388000,1000,389000
Ceuta (ab 1999),2018,9,624000,0,624000
Ceuta (ab 1999),2018,10,662000,0,662000
Ceuta (ab 1999),2018,11,826000,0,826000
Ceuta (ab 1999),2018,12,427000,0,427000
Ceuta (ab 1999),2019,1,1000000,0,1000000
Ceuta (ab 1999),2019,2,542000,1000,543000
Ceuta (ab 1999),2019,3,891000,4000,895000
Ceuta (ab 1999),2019,4,657000,7000,664000
Ceuta (ab 1999),2019,5,544000,22000,566000
Ceuta (ab 1999),2019,6,453000,5000,458000
Ceuta (ab 1999),2019,7,1507000,7000,1514000
Ceuta (ab 1999),2019,8,780000,7000,787000
Ceuta (ab 1999),2019,9,1039000,1000,1040000
Ceuta (ab 1999),2019,10,623000,1000,624000
Ceuta (ab 1999),2019,11,424000,2000,426000
Ceuta (ab 1999),2019,12,228000,24000,252000
Ceuta (ab 1999),2020,1,373000,17000,390000
Ceuta (ab 1999),2020,2,231000,8000,239000
Ceuta (ab 1999),2020,3,94000,11000,105000
Ceuta (ab 1999),2020,4,25000,2000,27000
Ceuta (ab 1999),2020,5,100000,2000,102000
Ceuta (ab 1999),2020,6,81000,3000,84000
Ceuta (ab 1999),2020,7,330000,1000,331000
Ceuta (ab 1999),2020,8,386000,3000,389000
Ceuta (ab 1999),2020,9,218000,1000,219000
Ceuta (ab 1999),2020,10,294000,192000,486000
Ceuta (ab 1999),2020,11,184000,10000,194000
Ceuta (ab 1999),2020,12,705000,4000,709000
Ceuta (ab 1999),2021,1,168000,13000,181000
Ceuta (ab 1999),2021,2,651000,16000,667000
Ceuta (ab 1999),2021,3,162000,7000,169000
Ceuta (ab 1999),2021,4,296000,11000,307000
Ceuta (ab 1999),2021,5,225000,5000,230000
Ceuta (ab 1999),2021,6,373000,2000,375000
Ceuta (ab 1999),2021,7,144000,18000,162000
Ceuta (ab 1999),2021,8,117000,1000,118000
Ceuta (ab 1999),2021,9,245000,4000,249000
Ceuta (ab 1999),2021,10,58000,7000,65000
Ceuta (ab 1999),2021,11,460000,11000,471000
Ceuta (ab 1999),2021,12,209000,27000,236000
Ceuta (ab 1999),2022,1,95000,28000,123000
Ceuta (ab 1999),2022,2,345000,40000,385000
Ceuta (ab 1999),2022,3,156000,19000,175000
Ceuta (ab 1999),2022,4,204000,27000,231000
Ceuta (ab 1999),2022,5,242000,8000,250000
Ceuta (ab 1999),2022,6,324000,2000,326000
Ceuta (ab 1999),2022,7,451000,9000,460000
Ceuta (ab 1999),2022,8,572000,2000,574000
Ceuta (ab 1999),2022,9,585000,35000,620000
Ceuta (ab 1999),2022,10,260000,2000,262000
Ceuta (ab 1999),2022,11,91000,3000,94000
Ceuta (ab 1999),2022,12,157000,6000,163000
Ceuta (ab 1999),2023,1,131000,29000,160000
Ceuta (ab 1999),2023,2,148000,11000,159000
Ceuta (ab 1999),2023,3,407000,10000,417000
Ceuta (ab 1999),2023,4,188000,0,188000
Ceuta (ab 1999),2023,5,248000,0,248000
Ceuta (ab 1999),2023,6,446000,14000,460000
Ceuta (ab 1999),2023,7,112000,0,112000
Ceuta (ab 1999),2023,8,101000,0,101000
Ceuta (ab 1999),2023,9,148000,35000,183000
Ceuta (ab 1999),2023,10,190000,1000,191000
Ceuta (ab 1999),2023,11,216000,26000,242000
Ceuta (ab 1999),2023,12,166000,4000,170000
Ceuta (ab 1999),2024,1,135000,20000,155000
Ceuta (ab 1999),2024,2,296000,11000,307000
Ceuta (ab 1999),2024,3,171000,0,171000
Ceuta (ab 1999),2024,4,815000,3000,818000
Ceuta (ab 1999),2024,5,57000,0,57000
Ceuta (ab 1999),2024,6,164000,1000,165000
Ceuta (ab 1999),2024,7,306000,0,306000
Ceuta (ab 1999),2024,8,231000,3000,234000
Ceuta (ab 1999),2024,9,140000,5000,145000
Ceuta (ab 1999),2024,10,403000,7000,410000
Ceuta (ab 1999),2024,11,262000,3000,265000
Ceuta (ab 1999),2024,12,476000,12000,488000
Ceuta und Melilla (bis 1998),2008,1,0,0,0
Ceuta und Melilla (bis 1998),2008,2,0,0,0
Ceuta und Melilla (bis 1998),2008,3,0,0,0
Ceuta und Melilla (bis 1998),2008,4,0,0,0
Ceuta und Melilla (bis 1998),2008,5,0,0,0
Ceuta und Melilla (bis 1998),2008,6,0,0,0
Ceuta und Melilla (bis 1998),2008,7,0,0,0
Ceuta und Melilla (bis 1998),2008,8,0,0,0
Ceuta und Melilla (bis 1998),2008,9,0,0,0
Ceuta und Melilla (bis 1998),2008,10,0,0,0
Ceuta und Melilla (bis 1998),2008,11,0,0,0
Ceuta und Melilla (bis 1998),2008,12,0,0,0
Ceuta und Melilla (bis 1998),2009,1,0,0,0
Ceuta und Melilla (bis 1998),2009,2,0,0,0
Ceuta und Melilla (bis 1998),2009,3,0,0,0
Ceuta und Melilla (bis 1998),2009,4,0,0,0
Ceuta und Melilla (bis 1998),2009,5,0,0,0
Ceuta und Melilla (bis 1998),2009,6,0,0,0
Ceuta und Melilla (bis 1998),2009,7,0,0,0
Ceuta und Melilla (bis 1998),2009,8,0,0,0
Ceuta und Melilla (bis 1998),2009,9,0,0,0
Ceuta und Melilla (bis 1998),2009,10,0,0,0
Ceuta und Melilla (bis 1998),2009,11,0,0,0
Ceuta und Melilla (bis 1998),2009,12,0,0,0
Ceuta und Melilla (bis 1998),2010,1,0,0,0
Ceuta und Melilla (bis 1998),2010,2,0,0,0
Ceuta und Melilla (bis 1998),2010,3,0,0,0
Ceuta und Melilla (bis 1998),2010,4,0,0,0
Ceuta und Melilla (bis 1998),2010,5,0,0,0
Ceuta und Melilla (bis 1998),2010,6,0,0,0
Ceuta und Melilla (bis 1998),2010,7,0,0,0
Ceuta und Melilla (bis 1998),2010,8,0,0,0
Ceuta und Melilla (bis 1998),2010,9,0,0,0
Ceuta und Melilla (bis 1998),2010,10,0,0,0
Ceuta und Melilla (bis 1998),2010,11,0,0,0
Ceuta und Melilla (bis 1998),2010,12,0,0,0
Ceuta und Melilla (bis 1998),2011,1,0,0,0
Ceuta und Melilla (bis 1998),2011,2,0,0,0
Ceuta und Melilla (bis 1998),2011,3,0,0,0
Ceuta und Melilla (bis 1998),2011,4,0,0,0
Ceuta und Melilla (bis 1998),2011,5,0,0,0
Ceuta und Melilla (bis 1998),2011,6,0,0,0
Ceuta und Melilla (bis 1998),2011,7,0,0,0
Ceuta und Melilla (bis 1998),2011,8,0,0,0
Ceuta und Melilla (bis 1998),2011,9,0,0,0
Ceuta und Melilla (bis 1998),2011,10,0,0,0
Ceuta und Melilla (bis 1998),2011,11,0,0,0
Ceuta und Melilla (bis 1998),2011,12,0,0,0
Ceuta und Melilla (bis 1998),2012,1,0,0,0
Ceuta und Melilla (bis 1998),2012,2,0,0,0
Ceuta und Melilla (bis 1998),2012,3,0,0,0
Ceuta und Melilla (bis 1998),2012,4,0,0,0
Ceuta und Melilla (bis 1998),2012,5,0,0,0
Ceuta und Melilla (bis 1998),2012,6,0,0,0
Ceuta und Melilla (bis 1998),2012,7,0,0,0
Ceuta und Melilla (bis 1998),2012,8,0,0,0
Ceuta und Melilla (bis 1998),2012,9,0,0,0
Ceuta und Melilla (bis 1998),2012,10,0,0,0
Ceuta und Melilla (bis 1998),2012,11,0,0,0
Ceuta und Melilla (bis 1998),2012,12,0,0,0
Ceuta und Melilla (bis 1998),2013,1,0,0,0
Ceuta und Melilla (bis 1998),2013,2,0,0,0
Ceuta und Melilla (bis 1998),2013,3,0,0,0
Ceuta und Melilla (bis 1998),2013,4,0,0,0
Ceuta und Melilla (bis 1998),2013,5,0,0,0
Ceuta und Melilla (bis 1998),2013,6,0,0,0
Ceuta und Melilla (bis 1998),2013,7,0,0,0
Ceuta und Melilla (bis 1998),2013,8,0,0,0
Ceuta und Melilla (bis 1998),2013,9,0,0,0
Ceuta und Melilla (bis 1998),2013,10,0,0,0
Ceuta und Melilla (bis 1998),2013,11,0,0,0
Ceuta und Melilla (bis 1998),2013,12,0,0,0
Ceuta und Melilla (bis 1998),2014,1,0,0,0
Ceuta und Melilla (bis 1998),2014,2,0,0,0
Ceuta und Melilla (bis 1998),2014,3,0,0,0
Ceuta und Melilla (bis 1998),2014,4,0,0,0
Ceuta und Melilla (bis 1998),2014,5,0,0,0
Ceuta und Melilla (bis 1998),2014,6,0,0,0
Ceuta und Melilla (bis 1998),2014,7,0,0,0
Ceuta und Melilla (bis 1998),2014,8,0,0,0
Ceuta und Melilla (bis 1998),2014,9,0,0,0
Ceuta und Melilla (bis 1998),2014,10,0,0,0
Ceuta und Melilla (bis 1998),2014,11,0,0,0
Ceuta und Melilla (bis 1998),2014,12,0,0,0
Ceuta und Melilla (bis 1998),2015,1,0,0,0
Ceuta und Melilla (bis 1998),2015,2,0,0,0
Ceuta und Melilla (bis 1998),2015,3,0,0,0
Ceuta und Melilla (bis 1998),2015,4,0,0,0
Ceuta und Melilla (bis 1998),2015,5,0,0,0
Ceuta und Melilla (bis 1998),2015,6,0,0,0
Ceuta und Melilla (bis 1998),2015,7,0,0,0
Ceuta und Melilla (bis 1998),2015,8,0,0,0
Ceuta und Melilla (bis 1998),2015,9,0,0,0
Ceuta und Melilla (bis 1998),2015,10,0,0,0
Ceuta und Melilla (bis 1998),2015,11,0,0,0
Ceuta und Melilla (bis 1998),2015,12,0,0,0
Ceuta und Melilla (bis 1998),2016,1,0,0,0
Ceuta und Melilla (bis 1998),2016,2,0,0,0
Ceuta und Melilla (bis 1998),2016,3,0,0,0
Ceuta und Melilla (bis 1998),2016,4,0,0,0
Ceuta und Melilla (bis 1998),2016,5,0,0,0
Ceuta und Melilla (bis 1998),2016,6,0,0,0
Ceuta und Melilla (bis 1998),2016,7,0,0,0
Ceuta und Melilla (bis 1998),2016,8,0,0,0
Ceuta und Melilla (bis 1998),2016,9,0,0,0
Ceuta und Melilla (bis 1998),2016,10,0,0,0
Ceuta und Melilla (bis 1998),2016,11,0,0,0
Ceuta und Melilla (bis 1998),2016,12,0,0,0
Ceuta und Melilla (bis 1998),2017,1,0,0,0
Ceuta und Melilla (bis 1998),2017,2,0,0,0
Ceuta und Melilla (bis 1998),2017,3,0,0,0
Ceuta und Melilla (bis 1998),2017,4,0,0,0
Ceuta und Melilla (bis 1998),2017,5,0,0,0
Ceuta und Melilla (bis 1998),2017,6,0,0,0
Ceuta und Melilla (bis 1998),2017,7,0,0,0
Ceuta und Melilla (bis 1998),2017,8,0,0,0
Ceuta und Melilla (bis 1998),2017,9,0,0,0
Ceuta und Melilla (bis 1998),2017,10,0,0,0
Ceuta und Melilla (bis 1998),2017,11,0,0,0
Ceuta und Melilla (bis 1998),2017,12,0,0,0
Ceuta und Melilla (bis 1998),2018,1,0,0,0
Ceuta und Melilla (bis 1998),2018,2,0,0,0
Ceuta und Melilla (bis 1998),2018,3,0,0,0
Ceuta und Melilla (bis 1998),2018,4,0,0,0
Ceuta und Melilla (bis 1998),2018,5,0,0,0
Ceuta und Melilla (bis 1998),2018,6,0,0,0
Ceuta und Melilla (bis 1998),2018,7,0,0,0
Ceuta und Melilla (bis 1998),2018,8,0,0,0
Ceuta und Melilla (bis 1998),2018,9,0,0,0
Ceuta und Melilla (bis 1998),2018,10,0,0,0
Ceuta und Melilla (bis 1998),2018,11,0,0,0
Ceuta und Melilla (bis 1998),2018,12,0,0,0
Ceuta und Melilla (bis 1998),2019,1,0,0,0
Ceuta und Melilla (bis 1998),2019,2,0,0,0
Ceuta und Melilla (bis 1998),2019,3,0,0,0
Ceuta und Melilla (bis 1998),2019,4,0,0,0
Ceuta und Melilla (bis 1998),2019,5,0,0,0
Ceuta und Melilla (bis 1998),2019,6,0,0,0
Ceuta und Melilla (bis 1998),2019,7,0,0,0
Ceuta und Melilla (bis 1998),2019,8,0,0,0
Ceuta und Melilla (bis 1998),2019,9,0,0,0
Ceuta und Melilla (bis 1998),2019,10,0,0,0
Ceuta und Melilla (bis 1998),2019,11,0,0,0
Ceuta und Melilla (bis 1998),2019,12,0,0,0
Ceuta und Melilla (bis 1998),2020,1,0,0,0
Ceuta und Melilla (bis 1998),2020,2,0,0,0
Ceuta und Melilla (bis 1998),2020,3,0,0,0
Ceuta und Melilla (bis 1998),2020,4,0,0,0
Ceuta und Melilla (bis 1998),2020,5,0,0,0
Ceuta und Melilla (bis 1998),2020,6,0,0,0
Ceuta und Melilla (bis 1998),2020,7,0,0,0
Ceuta und Melilla (bis 1998),2020,8,0,0,0
Ceuta und Melilla (bis 1998),2020,9,0,0,0
Ceuta und Melilla (bis 1998),2020,10,0,0,0
Ceuta und Melilla (bis 1998),2020,11,0,0,0
Ceuta und Melilla (bis 1998),2020,12,0,0,0
Ceuta und Melilla (bis 1998),2021,1,0,0,0
Ceuta und Melilla (bis 1998),2021,2,0,0,0
Ceuta und Melilla (bis 1998),2021,3,0,0,0
Ceuta und Melilla (bis 1998),2021,4,0,0,0
Ceuta und Melilla (bis 1998),2021,5,0,0,0
Ceuta und Melilla (bis 1998),2021,6,0,0,0
Ceuta und Melilla (bis 1998),2021,7,0,0,0
Ceuta und Melilla (bis 1998),2021,8,0,0,0
Ceuta und Melilla (bis 1998),2021,9,0,0,0
Ceuta und Melilla (bis 1998),2021,10,0,0,0
Ceuta und Melilla (bis 1998),2021,11,0,0,0
Ceuta und Melilla (bis 1998),2021,12,0,0,0
Ceuta und Melilla (bis 1998),2022,1,0,0,0
Ceuta und Melilla (bis 1998),2022,2,0,0,0
Ceuta und Melilla (bis 1998),2022,3,0,0,0
Ceuta und Melilla (bis 1998),2022,4,0,0,0
Ceuta und Melilla (bis 1998),2022,5,0,0,0
Ceuta und Melilla (bis 1998),2022,6,0,0,0
Ceuta und Melilla (bis 1998),2022,7,0,0,0
Ceuta und Melilla (bis 1998),2022,8,0,0,0
Ceuta und Melilla (bis 1998),2022,9,0,0,0
Ceuta und Melilla (bis 1998),2022,10,0,0,0
Ceuta und Melilla (bis 1998),2022,11,0,0,0
Ceuta und Melilla (bis 1998),2022,12,0,0,0
Ceuta und Melilla (bis 1998),2023,1,0,0,0
Ceuta und Melilla (bis 1998),2023,2,0,0,0
Ceuta und Melilla (bis 1998),2023,3,0,0,0
Ceuta und Melilla (bis 1998),2023,4,0,0,0
Ceuta und Melilla (bis 1998),2023,5,0,0,0
Ceuta und Melilla (bis 1998),2023,6,0,0,0
Ceuta und Melilla (bis 1998),2023,7,0,0,0
Ceuta und Melilla (bis 1998),2023,8,0,0,0
Ceuta und Melilla (bis 1998),2023,9,0,0,0
Ceuta und Melilla (bis 1998),2023,10,0,0,0
Ceuta und Melilla (bis 1998),2023,11,0,0,0
Ceuta und Melilla (bis 1998),2023,12,0,0,0
Ceuta und Melilla (bis 1998),2024,1,0,0,0
Ceuta und Melilla (bis 1998),2024,2,0,0,0
Ceuta und Melilla (bis 1998),2024,3,0,0,0
Ceuta und Melilla (bis 1998),2024,4,0,0,0
Ceuta und Melilla (bis 1998),2024,5,0,0,0
Ceuta und Melilla (bis 1998),2024,6,0,0,0
Ceuta und Melilla (bis 1998),2024,7,0,0,0
Ceuta und Melilla (bis 1998),2024,8,0,0,0
Ceuta und Melilla (bis 1998),2024,9,0,0,0
Ceuta und Melilla (bis 1998),2024,10,0,0,0
Ceuta und Melilla (bis 1998),2024,11,0,0,0
Ceuta und Melilla (bis 1998),2024,12,0,0,0
Chile,2008,1,108347000,183353000,291700000
Chile,2008,2,88275000,232725000,321000000
Chile,2008,3,136217000,167722000,303939000
Chile,2008,4,124054000,199788000,323842000
Chile,2008,5,107618000,260300000,367918000
Chile,2008,6,141154000,182956000,324110000
Chile,2008,7,157202000,238488000,395690000
Chile,2008,8,122070000,242230000,364300000
Chile,2008,9,115469000,157302000,272771000
Chile,2008,10,229710000,124210000,353920000
Chile,2008,11,116252000,155542000,271794000
Chile,2008,12,104197000,100079000,204276000
Chile,2009,1,136614000,172612000,309226000
Chile,2009,2,114395000,104938000,219333000
Chile,2009,3,99849000,111401000,211250000
Chile,2009,4,68373000,103991000,172364000
Chile,2009,5,88615000,151585000,240200000
Chile,2009,6,84877000,137706000,222583000
Chile,2009,7,104444000,77526000,181970000
Chile,2009,8,88886000,191603000,280489000
Chile,2009,9,96701000,94104000,190805000
Chile,2009,10,94010000,135758000,229768000
Chile,2009,11,138316000,89269000,227585000
Chile,2009,12,98972000,140146000,239118000
Chile,2010,1,100189000,107107000,207296000
Chile,2010,2,105321000,149824000,255145000
Chile,2010,3,117868000,129203000,247071000
Chile,2010,4,100416000,114825000,215241000
Chile,2010,5,107934000,109955000,217889000
Chile,2010,6,136455000,193732000,330187000
Chile,2010,7,163134000,145158000,308292000
Chile,2010,8,167038000,173197000,340235000
Chile,2010,9,187230000,103001000,290231000
Chile,2010,10,175538000,154706000,330244000
Chile,2010,11,227863000,104177000,332040000
Chile,2010,12,221855000,143350000,365205000
Chile,2011,1,148900000,215473000,364373000
Chile,2011,2,248647000,132896000,381543000
Chile,2011,3,197293000,215835000,413128000
Chile,2011,4,129383000,172139000,301522000
Chile,2011,5,195242000,183311000,378553000
Chile,2011,6,148872000,260816000,409688000
Chile,2011,7,161438000,149626000,311064000
Chile,2011,8,202728000,152741000,355469000
Chile,2011,9,234097000,154258000,388355000
Chile,2011,10,204036000,107709000,311745000
Chile,2011,11,211131000,144856000,355987000
Chile,2011,12,186580000,119368000,305948000
Chile,2012,1,163125000,137490000,300615000
Chile,2012,2,167344000,151999000,319343000
Chile,2012,3,203223000,174437000,377660000
Chile,2012,4,193204000,130968000,324172000
Chile,2012,5,153427000,183388000,336815000
Chile,2012,6,299105000,145034000,444139000
Chile,2012,7,250762000,165596000,416358000
Chile,2012,8,225616000,205854000,431470000
Chile,2012,9,191952000,90199000,282151000
Chile,2012,10,299353000,107102000,406455000
Chile,2012,11,224368000,96101000,320469000
Chile,2012,12,197385000,174215000,371600000
Chile,2013,1,272693000,120578000,393271000
Chile,2013,2,228080000,120529000,348609000
Chile,2013,3,242647000,134312000,376959000
Chile,2013,4,295480000,179115000,474595000
Chile,2013,5,220154000,123160000,343314000
Chile,2013,6,184740000,150030000,334770000
Chile,2013,7,295257000,220734000,515991000
Chile,2013,8,242439000,114420000,356859000
Chile,2013,9,174880000,80225000,255105000
Chile,2013,10,261985000,132546000,394531000
Chile,2013,11,214637000,107960000,322597000
Chile,2013,12,153208000,99043000,252251000
Chile,2014,1,130903000,137164000,268067000
Chile,2014,2,213420000,136036000,349456000
Chile,2014,3,152214000,106793000,259007000
Chile,2014,4,148802000,153496000,302298000
Chile,2014,5,144687000,115417000,260104000
Chile,2014,6,161653000,219014000,380667000
Chile,2014,7,217952000,143973000,361925000
Chile,2014,8,161069000,123471000,284540000
Chile,2014,9,140320000,103452000,243772000
Chile,2014,10,152872000,138855000,291727000
Chile,2014,11,196998000,98560000,295558000
Chile,2014,12,292395000,48579000,340974000
Chile,2015,1,161967000,112205000,274172000
Chile,2015,2,213606000,95391000,308997000
Chile,2015,3,180873000,122761000,303634000
Chile,2015,4,155261000,165712000,320973000
Chile,2015,5,140688000,151820000,292508000
Chile,2015,6,181643000,151336000,332979000
Chile,2015,7,256787000,104004000,360791000
Chile,2015,8,154630000,156612000,311242000
Chile,2015,9,239573000,93823000,333396000
Chile,2015,10,242414000,77045000,319459000
Chile,2015,11,163471000,137358000,300829000
Chile,2015,12,296037000,121849000,417886000
Chile,2016,1,126295000,119310000,245605000
Chile,2016,2,162248000,101534000,263782000
Chile,2016,3,238707000,98545000,337252000
Chile,2016,4,144309000,138942000,283251000
Chile,2016,5,201740000,105200000,306940000
Chile,2016,6,239043000,107116000,346159000
Chile,2016,7,170509000,98274000,268783000
Chile,2016,8,305686000,110215000,415901000
Chile,2016,9,230443000,103279000,333722000
Chile,2016,10,190914000,99101000,290015000
Chile,2016,11,246975000,102298000,349273000
Chile,2016,12,185686000,121878000,307564000
Chile,2017,1,162570000,109359000,271929000
Chile,2017,2,174603000,110204000,284807000
Chile,2017,3,196681000,156005000,352686000
Chile,2017,4,163623000,105486000,269109000
Chile,2017,5,182270000,135861000,318131000
Chile,2017,6,167066000,154017000,321083000
Chile,2017,7,206631000,131559000,338190000
Chile,2017,8,166463000,146683000,313146000
Chile,2017,9,176526000,144135000,320661000
Chile,2017,10,165616000,150910000,316526000
Chile,2017,11,257442000,121720000,379162000
Chile,2017,12,272405000,109274000,381679000
Chile,2018,1,170423000,91752000,262175000
Chile,2018,2,176065000,149440000,325505000
Chile,2018,3,191790000,109159000,300949000
Chile,2018,4,194536000,171300000,365836000
Chile,2018,5,164240000,104642000,268882000
Chile,2018,6,255703000,117095000,372798000
Chile,2018,7,229521000,123210000,352731000
Chile,2018,8,223315000,105479000,328794000
Chile,2018,9,201050000,92183000,293233000
Chile,2018,10,319703000,108601000,428304000
Chile,2018,11,310606000,116536000,427142000
Chile,2018,12,227621000,119199000,346820000
Chile,2019,1,226007000,77613000,303620000
Chile,2019,2,425020000,89232000,514252000
Chile,2019,3,201053000,75494000,276547000
Chile,2019,4,196132000,99847000,295979000
Chile,2019,5,194449000,67695000,262144000
Chile,2019,6,188162000,151238000,339400000
Chile,2019,7,193512000,129748000,323260000
Chile,2019,8,185818000,75901000,261719000
Chile,2019,9,242949000,78321000,321270000
Chile,2019,10,321843000,151032000,472875000
Chile,2019,11,303924000,56271000,360195000
Chile,2019,12,205519000,63845000,269364000
Chile,2020,1,133771000,82010000,215781000
Chile,2020,2,171466000,101031000,272497000
Chile,2020,3,238664000,138401000,377065000
Chile,2020,4,142956000,82314000,225270000
Chile,2020,5,134634000,83268000,217902000
Chile,2020,6,134646000,100279000,234925000
Chile,2020,7,165933000,105733000,271666000
Chile,2020,8,119072000,70992000,190064000
Chile,2020,9,145389000,85074000,230463000
Chile,2020,10,151366000,106995000,258361000
Chile,2020,11,175955000,158187000,334142000
Chile,2020,12,177631000,95493000,273124000
Chile,2021,1,157568000,78979000,236547000
Chile,2021,2,175535000,144244000,319779000
Chile,2021,3,207092000,55336000,262428000
Chile,2021,4,198614000,66491000,265105000
Chile,2021,5,171007000,86340000,257347000
Chile,2021,6,246417000,129173000,375590000
Chile,2021,7,302343000,107891000,410234000
Chile,2021,8,251260000,107445000,358705000
Chile,2021,9,281368000,118327000,399695000
Chile,2021,10,196654000,72676000,269330000
Chile,2021,11,278621000,58234000,336855000
Chile,2021,12,252170000,95356000,347526000
Chile,2022,1,181952000,196339000,378291000
Chile,2022,2,183494000,90907000,274401000
Chile,2022,3,213325000,134176000,347501000
Chile,2022,4,200856000,83622000,284478000
Chile,2022,5,199207000,95723000,294930000
Chile,2022,6,187186000,178943000,366129000
Chile,2022,7,285949000,190252000,476201000
Chile,2022,8,217711000,85214000,302925000
Chile,2022,9,282099000,65708000,347807000
Chile,2022,10,230361000,116401000,346762000
Chile,2022,11,327866000,143349000,471215000
Chile,2022,12,282287000,85713000,368000000
Chile,2023,1,188581000,119076000,307657000
Chile,2023,2,191752000,155612000,347364000
Chile,2023,3,350381000,99144000,449525000
Chile,2023,4,168908000,116659000,285567000
Chile,2023,5,211980000,116798000,328778000
Chile,2023,6,263533000,123590000,387123000
Chile,2023,7,227375000,150040000,377415000
Chile,2023,8,198588000,128054000,326642000
Chile,2023,9,286133000,121575000,407708000
Chile,2023,10,251760000,124539000,376299000
Chile,2023,11,504267000,95521000,599788000
Chile,2023,12,546665000,181084000,727749000
Chile,2024,1,189571000,109580000,299151000
Chile,2024,2,218359000,194066000,412425000
Chile,2024,3,273585000,162362000,435947000
Chile,2024,4,416123000,220241000,636364000
Chile,2024,5,273783000,139233000,413016000
Chile,2024,6,322365000,84136000,406501000
Chile,2024,7,214135000,152278000,366413000
Chile,2024,8,277007000,209715000,486722000
Chile,2024,9,178160000,171131000,349291000
Chile,2024,10,205681000,100850000,306531000
Chile,2024,11,221407000,168310000,389717000
Chile,2024,12,259672000,122373000,382045000
China,2008,1,2725803000,5299818000,8025621000
China,2008,2,2571970000,4690154000,7262124000
China,2008,3,2564858000,4117396000,6682254000
China,2008,4,2998456000,4366588000,7365044000
China,2008,5,2833606000,4337811000,7171417000
China,2008,6,3128444000,4486690000,7615134000
China,2008,7,3211311000,5327290000,8538601000
China,2008,8,2557854000,5275912000,7833766000
China,2008,9,2815552000,5656560000,8472112000
China,2008,10,3095803000,6105114000,9200917000
China,2008,11,2781951000,5981908000,8763859000
China,2008,12,2779657000,5179899000,7959556000
China,2009,1,2273108000,5224722000,7497830000
China,2009,2,2405159000,4709379000,7114538000
China,2009,3,2947537000,4129442000,7076979000
China,2009,4,2861398000,4212805000,7074203000
China,2009,5,2790112000,3829077000,6619189000
China,2009,6,3259342000,4191962000,7451304000
China,2009,7,3648075000,4788336000,8436411000
China,2009,8,3189789000,4523850000,7713639000
China,2009,9,3357525000,5429039000,8786564000
China,2009,10,3356591000,5366239000,8722830000
China,2009,11,3614213000,5258717000,8872930000
China,2009,12,3569649000,5042645000,8612294000
China,2010,1,3146155000,5045425000,8191580000
China,2010,2,3853401000,4966662000,8820063000
China,2010,3,4775998000,6743713000,11519711000
China,2010,4,4125888000,5220654000,9346542000
China,2010,5,4393292000,5981913000,10375205000
China,2010,6,4707408000,6884894000,11592302000
China,2010,7,4767003000,6315846000,11082849000
China,2010,8,4229529000,7209579000,11439108000
China,2010,9,4814798000,7639510000,12454308000
China,2010,10,4736919000,7195493000,11932412000
China,2010,11,5179839000,7415323000,12595162000
China,2010,12,5060641000,6651153000,11711794000
China,2011,1,4625790000,6689482000,11315272000
China,2011,2,5066956000,6317625000,11384581000
China,2011,3,6102519000,6164046000,12266565000
China,2011,4,4893827000,5902252000,10796079000
China,2011,5,5844668000,6685509000,12530177000
China,2011,6,5153919000,6326014000,11479933000
China,2011,7,5410026000,6348773000,11758799000
China,2011,8,5466627000,7176991000,12643618000
China,2011,9,5590244000,7140277000,12730521000
China,2011,10,5413185000,7224012000,12637197000
China,2011,11,5859479000,7149210000,13008689000
China,2011,12,5435890000,6403975000,11839865000
China,2012,1,5036145000,7031486000,12067631000
China,2012,2,5546350000,6329687000,11876037000
China,2012,3,6149917000,5959555000,12109472000
China,2012,4,5320254000,5863129000,11183383000
China,2012,5,5969177000,6258137000,12227314000
China,2012,6,6335530000,6530108000,12865638000
China,2012,7,5967855000,6654590000,12622445000
China,2012,8,5514024000,7277569000,12791593000
China,2012,9,5177998000,6914877000,12092875000
China,2012,10,5619445000,7207683000,12827128000
China,2012,11,5467544000,6734266000,12201810000
China,2012,12,4641901000,5768207000,10410108000
China,2013,1,5073515000,7207005000,12280520000
China,2013,2,4959345000,6012397000,10971742000
China,2013,3,5504486000,5698010000,11202496000
China,2013,4,5997442000,5612256000,11609698000
China,2013,5,5252695000,5772385000,11025080000
China,2013,6,5474916000,5673314000,11148230000
China,2013,7,6101092000,6589100000,12690192000
China,2013,8,5662664000,6638799000,12301463000
China,2013,9,5697571000,6606858000,12304429000
China,2013,10,5975447000,6764155000,12739602000
China,2013,11,5864853000,6303431000,12168284000
China,2013,12,5347564000,5666667000,11014231000
China,2014,1,5602117000,7090499000,12692616000
China,2014,2,5367145000,6081312000,11448457000
China,2014,3,6027029000,5902876000,11929905000
China,2014,4,6237955000,5584342000,11822297000
China,2014,5,6183917000,5873516000,12057433000
China,2014,6,6267639000,6423919000,12691558000
China,2014,7,7105278000,6768987000,13874265000
China,2014,8,5727188000,6862531000,12589719000
China,2014,9,6671989000,7853001000,14524990000
China,2014,10,6836984000,7488339000,14325323000
China,2014,11,6099746000,7097222000,13196968000
China,2014,12,6241825000,6801454000,13043279000
China,2015,1,5480882000,8024403000,13505285000
China,2015,2,5697331000,7446204000,13143535000
China,2015,3,6649980000,8165989000,14815969000
China,2015,4,6316358000,6216124000,12532482000
China,2015,5,5511597000,6622888000,12134485000
China,2015,6,6185590000,7370629000,13556219000
China,2015,7,6506170000,8072682000,14578852000
China,2015,8,5390686000,7707121000,13097807000
China,2015,9,5922020000,8311342000,14233362000
China,2015,10,5728866000,8415979000,14144845000
China,2015,11,5911766000,8271740000,14183506000
China,2015,12,5982497000,7305101000,13287598000
China,2016,1,5149875000,8432075000,13581950000
China,2016,2,5832848000,7972407000,13805255000
China,2016,3,6077938000,7456979000,13534917000
China,2016,4,6541676000,6956923000,13498599000
China,2016,5,5861140000,6883625000,12744765000
China,2016,6,6783906000,7653159000,14437065000
China,2016,7,6383920000,7252299000,13636219000
China,2016,8,6257054000,8200155000,14457209000
China,2016,9,6570328000,7991041000,14561369000
China,2016,10,6282450000,8755776000,15038226000
China,2016,11,7053896000,8507798000,15561694000
China,2016,12,7250816000,8109674000,15360490000
China,2017,1,6277451000,8944074000,15221525000
China,2017,2,6296241000,7550680000,13846921000
China,2017,3,7886896000,8328465000,16215361000
China,2017,4,6090000000,7666117000,13756117000
China,2017,5,7473722000,8352969000,15826691000
China,2017,6,7077624000,8066736000,15144360000
China,2017,7,7336777000,8425277000,15762054000
China,2017,8,7690495000,8927702000,16618197000
China,2017,9,7183381000,8718271000,15901652000
China,2017,10,7034906000,8950213000,15985119000
China,2017,11,8065831000,9625737000,17691568000
China,2017,12,7727833000,8280377000,16008210000
China,2018,1,7328944000,10105921000,17434865000
China,2018,2,6914648000,7728483000,14643131000
China,2018,3,7864498000,8051616000,15916114000
China,2018,4,7429058000,7685863000,15114921000
China,2018,5,7544212000,7783011000,15327223000
China,2018,6,8241496000,8430218000,16671714000
China,2018,7,7961838000,9328363000,17290201000
China,2018,8,7840679000,9373697000,17214376000
China,2018,9,7944833000,8811817000,16756650000
China,2018,10,8477698000,10500268000,18977966000
China,2018,11,8357248000,9886681000,18243929000
China,2018,12,7098732000,8378584000,15477316000
China,2019,1,7795964000,10473120000,18269084000
China,2019,2,7402599000,8444778000,15847377000
China,2019,3,8261053000,8418667000,16679720000
China,2019,4,8275277000,8526228000,16801505000
China,2019,5,8168977000,8661973000,16830950000
China,2019,6,7201497000,8071245000,15272742000
China,2019,7,8726262000,9632086000,18358348000
China,2019,8,7381877000,9373790000,16755667000
China,2019,9,7671916000,9445297000,17117213000
China,2019,10,8623219000,10443390000,19066609000
China,2019,11,8165549000,9906683000,18072232000
China,2019,12,8309772000,8656913000,16966685000
China,2020,1,7293039000,10430100000,17723139000
China,2020,2,6738489000,7411906000,14150395000
China,2020,3,7471103000,7939725000,15410828000
China,2020,4,7217231000,9499088000,16716319000
China,2020,5,7171704000,10958912000,18130616000
China,2020,6,8218296000,9880819000,18099115000
China,2020,7,8721356000,10372765000,19094121000
China,2020,8,7306657000,9458112000,16764769000
China,2020,9,8470667000,9904040000,18374707000
China,2020,10,8645292000,10378407000,19023699000
China,2020,11,9342169000,10893198000,20235367000
China,2020,12,9244091000,10246188000,19490279000
China,2021,1,7535262000,10786146000,18321408000
China,2021,2,8324262000,9999080000,18323342000
China,2021,3,10317335000,12046138000,22363473000
China,2021,4,8377213000,11029359000,19406572000
China,2021,5,8379032000,10432011000,18811043000
China,2021,6,9510544000,11130384000,20640928000
China,2021,7,8339493000,10936285000,19275778000
China,2021,8,7625545000,11460327000,19085872000
China,2021,9,8443335000,12447993000,20891328000
China,2021,10,9376684000,13543747000,22920431000
China,2021,11,8913602000,14228543000,23142145000
China,2021,12,8422084000,14924296000,23346380000
China,2022,1,7916324000,15264083000,23180407000
China,2022,2,9056133000,13302260000,22358393000
China,2022,3,10435606000,17022493000,27458099000
China,2022,4,8253991000,16569995000,24823986000
China,2022,5,9200553000,17617851000,26818404000
China,2022,6,9081064000,16112989000,25194053000
China,2022,7,8863788000,14817212000,23681000000
China,2022,8,8816922000,16130979000,24947901000
China,2022,9,9009221000,17355287000,26364508000
China,2022,10,8514558000,17158196000,25672754000
China,2022,11,9327030000,17400705000,26727735000
China,2022,12,8286409000,14102530000,22388939000
China,2023,1,7291695000,14859477000,22151172000
China,2023,2,7953010000,12751223000,20704233000
China,2023,3,9020086000,13353293000,22373379000
China,2023,4,7740977000,11932265000,19673242000
China,2023,5,8724795000,13192674000,21917469000
China,2023,6,8826950000,13570517000,22397467000
China,2023,7,8270362000,12736728000,21007090000
China,2023,8,8220457000,12883295000,21103752000
China,2023,9,7576420000,12604573000,20180993000
China,2023,10,7906632000,13740383000,21647015000
China,2023,11,8569515000,13811191000,22380706000
China,2023,12,7245597000,11394970000,18640567000
China,2024,1,7662041000,11578537000,19240578000
China,2024,2,7945287000,12006685000,19951972000
China,2024,3,8420303000,12768120000,21188423000
China,2024,4,8771393000,12675263000,21446656000
China,2024,5,7481714000,12556988000,20038702000
China,2024,6,7971812000,12121878000,20093690000
China,2024,7,7951502000,13681306000,21632808000
China,2024,8,7002553000,13114427000,20116980000
China,2024,9,6870479000,14131115000,21001594000
China,2024,10,7149919000,15130798000,22280717000
China,2024,11,6691718000,14090798000,20782516000
China,2024,12,6058587000,12364241000,18422828000
Cookinseln (ab 2001),2008,1,864000,1000,865000
Cookinseln (ab 2001),2008,2,117000,7000,124000
Cookinseln (ab 2001),2008,3,206000,13000,219000
Cookinseln (ab 2001),2008,4,177000,0,177000
Cookinseln (ab 2001),2008,5,94000,0,94000
Cookinseln (ab 2001),2008,6,81000,0,81000
Cookinseln (ab 2001),2008,7,99000,24000,123000
Cookinseln (ab 2001),2008,8,0,1000,1000
Cookinseln (ab 2001),2008,9,3000,41000,44000
Cookinseln (ab 2001),2008,10,24000,0,24000
Cookinseln (ab 2001),2008,11,75000,0,75000
Cookinseln (ab 2001),2008,12,33000,5000,38000
Cookinseln (ab 2001),2009,1,444000,5000,449000
Cookinseln (ab 2001),2009,2,585000,0,585000
Cookinseln (ab 2001),2009,3,758000,1000,759000
Cookinseln (ab 2001),2009,4,229000,10000,239000
Cookinseln (ab 2001),2009,5,547000,0,547000
Cookinseln (ab 2001),2009,6,526000,26000,552000
Cookinseln (ab 2001),2009,7,94000,0,94000
Cookinseln (ab 2001),2009,8,7000,0,7000
Cookinseln (ab 2001),2009,9,33000,0,33000
Cookinseln (ab 2001),2009,10,10000,0,10000
Cookinseln (ab 2001),2009,11,17000,0,17000
Cookinseln (ab 2001),2009,12,0,14000,14000
Cookinseln (ab 2001),2010,1,0,24000,24000
Cookinseln (ab 2001),2010,2,0,0,0
Cookinseln (ab 2001),2010,3,0,0,0
Cookinseln (ab 2001),2010,4,0,33000,33000
Cookinseln (ab 2001),2010,5,1000,0,1000
Cookinseln (ab 2001),2010,6,1000,0,1000
Cookinseln (ab 2001),2010,7,0,0,0
Cookinseln (ab 2001),2010,8,0,0,0
Cookinseln (ab 2001),2010,9,0,0,0
Cookinseln (ab 2001),2010,10,0,27000,27000
Cookinseln (ab 2001),2010,11,0,0,0
Cookinseln (ab 2001),2010,12,0,2000,2000
Cookinseln (ab 2001),2011,1,0,0,0
Cookinseln (ab 2001),2011,2,0,17000,17000
Cookinseln (ab 2001),2011,3,0,0,0
Cookinseln (ab 2001),2011,4,0,0,0
Cookinseln (ab 2001),2011,5,0,0,0
Cookinseln (ab 2001),2011,6,0,0,0
Cookinseln (ab 2001),2011,7,8000,0,8000
Cookinseln (ab 2001),2011,8,0,0,0
Cookinseln (ab 2001),2011,9,162000,0,162000
Cookinseln (ab 2001),2011,10,81000,0,81000
Cookinseln (ab 2001),2011,11,96000,0,96000
Cookinseln (ab 2001),2011,12,0,1000,1000
Cookinseln (ab 2001),2012,1,0,0,0
Cookinseln (ab 2001),2012,2,0,0,0
Cookinseln (ab 2001),2012,3,0,0,0
Cookinseln (ab 2001),2012,4,0,0,0
Cookinseln (ab 2001),2012,5,101000,0,101000
Cookinseln (ab 2001),2012,6,252000,0,252000
Cookinseln (ab 2001),2012,7,3000,0,3000
Cookinseln (ab 2001),2012,8,80000,0,80000
Cookinseln (ab 2001),2012,9,0,6000,6000
Cookinseln (ab 2001),2012,10,4000,0,4000
Cookinseln (ab 2001),2012,11,0,2000,2000
Cookinseln (ab 2001),2012,12,0,5000,5000
Cookinseln (ab 2001),2013,1,0,0,0
Cookinseln (ab 2001),2013,2,4000,0,4000
Cookinseln (ab 2001),2013,3,2000,0,2000
Cookinseln (ab 2001),2013,4,16000,0,16000
Cookinseln (ab 2001),2013,5,25000,3000,28000
Cookinseln (ab 2001),2013,6,0,3000,3000
Cookinseln (ab 2001),2013,7,1000,0,1000
Cookinseln (ab 2001),2013,8,8000,0,8000
Cookinseln (ab 2001),2013,9,3000,0,3000
Cookinseln (ab 2001),2013,10,11000,0,11000
Cookinseln (ab 2001),2013,11,6000,0,6000
Cookinseln (ab 2001),2013,12,2000,0,2000
Cookinseln (ab 2001),2014,1,35000,0,35000
Cookinseln (ab 2001),2014,2,0,0,0
Cookinseln (ab 2001),2014,3,2000,6000,8000
Cookinseln (ab 2001),2014,4,0,2000,2000
Cookinseln (ab 2001),2014,5,5000,1000,6000
Cookinseln (ab 2001),2014,6,23000,0,23000
Cookinseln (ab 2001),2014,7,6000,0,6000
Cookinseln (ab 2001),2014,8,0,0,0
Cookinseln (ab 2001),2014,9,1800000,0,1800000
Cookinseln (ab 2001),2014,10,5000,3000,8000
Cookinseln (ab 2001),2014,11,35000,398000,433000
Cookinseln (ab 2001),2014,12,0,2000,2000
Cookinseln (ab 2001),2015,1,7000,0,7000
Cookinseln (ab 2001),2015,2,12000,617000,629000
Cookinseln (ab 2001),2015,3,0,264000,264000
Cookinseln (ab 2001),2015,4,19000,0,19000
Cookinseln (ab 2001),2015,5,1000,12000,13000
Cookinseln (ab 2001),2015,6,0,902000,902000
Cookinseln (ab 2001),2015,7,13000,2000,15000
Cookinseln (ab 2001),2015,8,2000,0,2000
Cookinseln (ab 2001),2015,9,0,0,0
Cookinseln (ab 2001),2015,10,0,3000,3000
Cookinseln (ab 2001),2015,11,21000,0,21000
Cookinseln (ab 2001),2015,12,33000,23000,56000
Cookinseln (ab 2001),2016,1,51000,0,51000
Cookinseln (ab 2001),2016,2,12000,0,12000
Cookinseln (ab 2001),2016,3,0,552000,552000
Cookinseln (ab 2001),2016,4,19000,531000,550000
Cookinseln (ab 2001),2016,5,13000,257000,270000
Cookinseln (ab 2001),2016,6,0,3000,3000
Cookinseln (ab 2001),2016,7,14000,382000,396000
Cookinseln (ab 2001),2016,8,0,306000,306000
Cookinseln (ab 2001),2016,9,5000,376000,381000
Cookinseln (ab 2001),2016,10,78000,284000,362000
Cookinseln (ab 2001),2016,11,4000,642000,646000
Cookinseln (ab 2001),2016,12,262000,275000,537000
Cookinseln (ab 2001),2017,1,533000,530000,1063000
Cookinseln (ab 2001),2017,2,427000,388000,815000
Cookinseln (ab 2001),2017,3,0,336000,336000
Cookinseln (ab 2001),2017,4,4000,511000,515000
Cookinseln (ab 2001),2017,5,75000,260000,335000
Cookinseln (ab 2001),2017,6,7000,464000,471000
Cookinseln (ab 2001),2017,7,22000,716000,738000
Cookinseln (ab 2001),2017,8,49000,21000,70000
Cookinseln (ab 2001),2017,9,11000,7000,18000
Cookinseln (ab 2001),2017,10,11000,0,11000
Cookinseln (ab 2001),2017,11,0,2000,2000
Cookinseln (ab 2001),2017,12,1000,0,1000
Cookinseln (ab 2001),2018,1,0,0,0
Cookinseln (ab 2001),2018,2,0,0,0
Cookinseln (ab 2001),2018,3,0,10000,10000
Cookinseln (ab 2001),2018,4,0,1000,1000
Cookinseln (ab 2001),2018,5,367000,12000,379000
Cookinseln (ab 2001),2018,6,3000,21000,24000
Cookinseln (ab 2001),2018,7,16000,1000,17000
Cookinseln (ab 2001),2018,8,416000,0,416000
Cookinseln (ab 2001),2018,9,6000,0,6000
Cookinseln (ab 2001),2018,10,5000,1000,6000
Cookinseln (ab 2001),2018,11,0,17000,17000
Cookinseln (ab 2001),2018,12,39000,1000,40000
Cookinseln (ab 2001),2019,1,858000,0,858000
Cookinseln (ab 2001),2019,2,15000,0,15000
Cookinseln (ab 2001),2019,3,0,65000,65000
Cookinseln (ab 2001),2019,4,10000,0,10000
Cookinseln (ab 2001),2019,5,15000,0,15000
Cookinseln (ab 2001),2019,6,19000,0,19000
Cookinseln (ab 2001),2019,7,7000,0,7000
Cookinseln (ab 2001),2019,8,6000,0,6000
Cookinseln (ab 2001),2019,9,3000,0,3000
Cookinseln (ab 2001),2019,10,7000,0,7000
Cookinseln (ab 2001),2019,11,10000,5000,15000
Cookinseln (ab 2001),2019,12,0,0,0
Cookinseln (ab 2001),2020,1,9000,8000,17000
Cookinseln (ab 2001),2020,2,21000,7000,28000
Cookinseln (ab 2001),2020,3,0,11000,11000
Cookinseln (ab 2001),2020,4,0,0,0
Cookinseln (ab 2001),2020,5,1000,0,1000
Cookinseln (ab 2001),2020,6,179000,4000,183000
Cookinseln (ab 2001),2020,7,22000,5000,27000
Cookinseln (ab 2001),2020,8,17000,0,17000
Cookinseln (ab 2001),2020,9,50000,0,50000
Cookinseln (ab 2001),2020,10,4000,0,4000
Cookinseln (ab 2001),2020,11,4000,4000,8000
Cookinseln (ab 2001),2020,12,3000,0,3000
Cookinseln (ab 2001),2021,1,0,0,0
Cookinseln (ab 2001),2021,2,7000,8000,15000
Cookinseln (ab 2001),2021,3,46000,0,46000
Cookinseln (ab 2001),2021,4,0,19000,19000
Cookinseln (ab 2001),2021,5,5000,0,5000
Cookinseln (ab 2001),2021,6,2162000,13000,2175000
Cookinseln (ab 2001),2021,7,0,0,0
Cookinseln (ab 2001),2021,8,10000,0,10000
Cookinseln (ab 2001),2021,9,0,0,0
Cookinseln (ab 2001),2021,10,18000,1000,19000
Cookinseln (ab 2001),2021,11,3000,3000,6000
Cookinseln (ab 2001),2021,12,232000,0,232000
Cookinseln (ab 2001),2022,1,5000,2000,7000
Cookinseln (ab 2001),2022,2,2000,0,2000
Cookinseln (ab 2001),2022,3,40000,119000,159000
Cookinseln (ab 2001),2022,4,33000,0,33000
Cookinseln (ab 2001),2022,5,0,0,0
Cookinseln (ab 2001),2022,6,2000,0,2000
Cookinseln (ab 2001),2022,7,5000,0,5000
Cookinseln (ab 2001),2022,8,9000,0,9000
Cookinseln (ab 2001),2022,9,0,0,0
Cookinseln (ab 2001),2022,10,8000,0,8000
Cookinseln (ab 2001),2022,11,9000,0,9000
Cookinseln (ab 2001),2022,12,0,0,0
Cookinseln (ab 2001),2023,1,4000,0,4000
Cookinseln (ab 2001),2023,2,33000,0,33000
Cookinseln (ab 2001),2023,3,3000,0,3000
Cookinseln (ab 2001),2023,4,0,0,0
Cookinseln (ab 2001),2023,5,0,0,0
Cookinseln (ab 2001),2023,6,0,0,0
Cookinseln (ab 2001),2023,7,0,0,0
Cookinseln (ab 2001),2023,8,0,44000,44000
Cookinseln (ab 2001),2023,9,27000,0,27000
Cookinseln (ab 2001),2023,10,6000,0,6000
Cookinseln (ab 2001),2023,11,157000,0,157000
Cookinseln (ab 2001),2023,12,3000,0,3000
Cookinseln (ab 2001),2024,1,0,20000,20000
Cookinseln (ab 2001),2024,2,42000,0,42000
Cookinseln (ab 2001),2024,3,2000,0,2000
Cookinseln (ab 2001),2024,4,0,0,0
Cookinseln (ab 2001),2024,5,2000,0,2000
Cookinseln (ab 2001),2024,6,2000,0,2000
Cookinseln (ab 2001),2024,7,0,0,0
Cookinseln (ab 2001),2024,8,1000,73000,74000
Cookinseln (ab 2001),2024,9,0,0,0
Cookinseln (ab 2001),2024,10,0,0,0
Cookinseln (ab 2001),2024,11,165000,0,165000
Cookinseln (ab 2001),2024,12,4000,0,4000
Costa Rica,2008,1,11233000,42040000,53273000
Costa Rica,2008,2,11592000,34776000,46368000
Costa Rica,2008,3,11114000,42165000,53279000
Costa Rica,2008,4,13159000,41820000,54979000
Costa Rica,2008,5,9889000,38346000,48235000
Costa Rica,2008,6,13150000,35042000,48192000
Costa Rica,2008,7,13009000,31107000,44116000
Costa Rica,2008,8,25543000,34174000,59717000
Costa Rica,2008,9,15375000,35356000,50731000
Costa Rica,2008,10,13545000,30068000,43613000
Costa Rica,2008,11,11250000,34364000,45614000
Costa Rica,2008,12,7837000,33232000,41069000
Costa Rica,2009,1,7105000,27864000,34969000
Costa Rica,2009,2,11600000,27718000,39318000
Costa Rica,2009,3,10474000,49399000,59873000
Costa Rica,2009,4,8157000,36511000,44668000
Costa Rica,2009,5,19846000,32994000,52840000
Costa Rica,2009,6,10994000,28922000,39916000
Costa Rica,2009,7,10539000,26403000,36942000
Costa Rica,2009,8,10185000,23365000,33550000
Costa Rica,2009,9,9938000,19056000,28994000
Costa Rica,2009,10,11498000,22927000,34425000
Costa Rica,2009,11,14164000,27186000,41350000
Costa Rica,2009,12,18052000,25975000,44027000
Costa Rica,2010,1,8463000,27087000,35550000
Costa Rica,2010,2,13007000,33673000,46680000
Costa Rica,2010,3,15133000,48126000,63259000
Costa Rica,2010,4,11704000,41002000,52706000
Costa Rica,2010,5,11537000,40196000,51733000
Costa Rica,2010,6,15981000,35997000,51978000
Costa Rica,2010,7,14717000,33813000,48530000
Costa Rica,2010,8,10835000,25112000,35947000
Costa Rica,2010,9,11014000,25407000,36421000
Costa Rica,2010,10,11751000,26133000,37884000
Costa Rica,2010,11,13396000,27024000,40420000
Costa Rica,2010,12,17596000,24774000,42370000
Costa Rica,2011,1,13567000,26580000,40147000
Costa Rica,2011,2,19805000,28282000,48087000
Costa Rica,2011,3,24761000,36250000,61011000
Costa Rica,2011,4,22498000,38917000,61415000
Costa Rica,2011,5,11049000,38809000,49858000
Costa Rica,2011,6,12392000,37597000,49989000
Costa Rica,2011,7,13663000,27108000,40771000
Costa Rica,2011,8,13932000,29635000,43567000
Costa Rica,2011,9,13527000,31159000,44686000
Costa Rica,2011,10,12536000,35329000,47865000
Costa Rica,2011,11,12633000,32525000,45158000
Costa Rica,2011,12,13596000,37775000,51371000
Costa Rica,2012,1,15984000,35610000,51594000
Costa Rica,2012,2,13543000,41014000,54557000
Costa Rica,2012,3,15553000,38766000,54319000
Costa Rica,2012,4,15423000,44353000,59776000
Costa Rica,2012,5,15621000,46980000,62601000
Costa Rica,2012,6,16451000,38924000,55375000
Costa Rica,2012,7,15258000,33271000,48529000
Costa Rica,2012,8,14834000,35352000,50186000
Costa Rica,2012,9,13765000,34963000,48728000
Costa Rica,2012,10,13871000,34742000,48613000
Costa Rica,2012,11,15777000,46098000,61875000
Costa Rica,2012,12,11685000,32927000,44612000
Costa Rica,2013,1,13010000,36003000,49013000
Costa Rica,2013,2,14720000,43197000,57917000
Costa Rica,2013,3,14817000,48314000,63131000
Costa Rica,2013,4,14914000,48606000,63520000
Costa Rica,2013,5,12768000,46403000,59171000
Costa Rica,2013,6,12389000,40802000,53191000
Costa Rica,2013,7,14458000,38158000,52616000
Costa Rica,2013,8,13444000,32798000,46242000
Costa Rica,2013,9,12959000,31008000,43967000
Costa Rica,2013,10,15456000,38724000,54180000
Costa Rica,2013,11,12440000,29763000,42203000
Costa Rica,2013,12,11136000,37511000,48647000
Costa Rica,2014,1,11278000,40559000,51837000
Costa Rica,2014,2,14628000,37051000,51679000
Costa Rica,2014,3,16660000,46510000,63170000
Costa Rica,2014,4,13426000,46438000,59864000
Costa Rica,2014,5,11512000,45887000,57399000
Costa Rica,2014,6,15264000,47145000,62409000
Costa Rica,2014,7,17704000,39955000,57659000
Costa Rica,2014,8,15242000,35576000,50818000
Costa Rica,2014,9,12081000,36599000,48680000
Costa Rica,2014,10,15722000,39359000,55081000
Costa Rica,2014,11,12287000,33440000,45727000
Costa Rica,2014,12,18600000,41308000,59908000
Costa Rica,2015,1,14276000,31566000,45842000
Costa Rica,2015,2,17539000,33656000,51195000
Costa Rica,2015,3,19468000,45566000,65034000
Costa Rica,2015,4,15287000,43418000,58705000
Costa Rica,2015,5,16559000,44340000,60899000
Costa Rica,2015,6,16337000,39544000,55881000
Costa Rica,2015,7,19662000,40975000,60637000
Costa Rica,2015,8,17841000,32945000,50786000
Costa Rica,2015,9,18432000,34591000,53023000
Costa Rica,2015,10,16651000,33285000,49936000
Costa Rica,2015,11,17072000,34511000,51583000
Costa Rica,2015,12,19020000,34833000,53853000
Costa Rica,2016,1,13433000,30346000,43779000
Costa Rica,2016,2,25910000,43350000,69260000
Costa Rica,2016,3,23975000,45244000,69219000
Costa Rica,2016,4,21289000,56181000,77470000
Costa Rica,2016,5,17857000,61740000,79597000
Costa Rica,2016,6,21649000,47940000,69589000
Costa Rica,2016,7,19064000,44013000,63077000
Costa Rica,2016,8,16754000,41875000,58629000
Costa Rica,2016,9,23069000,37172000,60241000
Costa Rica,2016,10,19451000,39216000,58667000
Costa Rica,2016,11,21296000,46247000,67543000
Costa Rica,2016,12,18128000,46090000,64218000
Costa Rica,2017,1,15224000,33199000,48423000
Costa Rica,2017,2,17200000,50283000,67483000
Costa Rica,2017,3,21625000,44836000,66461000
Costa Rica,2017,4,19885000,48388000,68273000
Costa Rica,2017,5,20929000,54314000,75243000
Costa Rica,2017,6,19701000,49178000,68879000
Costa Rica,2017,7,19905000,44312000,64217000
Costa Rica,2017,8,23202000,41243000,64445000
Costa Rica,2017,9,16331000,40640000,56971000
Costa Rica,2017,10,19720000,38909000,58629000
Costa Rica,2017,11,22688000,39413000,62101000
Costa Rica,2017,12,17320000,41019000,58339000
Costa Rica,2018,1,18361000,42293000,60654000
Costa Rica,2018,2,15844000,47144000,62988000
Costa Rica,2018,3,20441000,54291000,74732000
Costa Rica,2018,4,32900000,56467000,89367000
Costa Rica,2018,5,23201000,52698000,75899000
Costa Rica,2018,6,20119000,46400000,66519000
Costa Rica,2018,7,19162000,51488000,70650000
Costa Rica,2018,8,18790000,41332000,60122000
Costa Rica,2018,9,24069000,38990000,63059000
Costa Rica,2018,10,17981000,45185000,63166000
Costa Rica,2018,11,18374000,41907000,60281000
Costa Rica,2018,12,16328000,37652000,53980000
Costa Rica,2019,1,14190000,42161000,56351000
Costa Rica,2019,2,14295000,54864000,69159000
Costa Rica,2019,3,16644000,64390000,81034000
Costa Rica,2019,4,15705000,58455000,74160000
Costa Rica,2019,5,16884000,54993000,71877000
Costa Rica,2019,6,14318000,55118000,69436000
Costa Rica,2019,7,19867000,50226000,70093000
Costa Rica,2019,8,21314000,44856000,66170000
Costa Rica,2019,9,20179000,49045000,69224000
Costa Rica,2019,10,20560000,45984000,66544000
Costa Rica,2019,11,22831000,43200000,66031000
Costa Rica,2019,12,16585000,40051000,56636000
Costa Rica,2020,1,18307000,43363000,61670000
Costa Rica,2020,2,19866000,63642000,83508000
Costa Rica,2020,3,17505000,66332000,83837000
Costa Rica,2020,4,17483000,53919000,71402000
Costa Rica,2020,5,10104000,49462000,59566000
Costa Rica,2020,6,12552000,48252000,60804000
Costa Rica,2020,7,20609000,46576000,67185000
Costa Rica,2020,8,18376000,40705000,59081000
Costa Rica,2020,9,13792000,57765000,71557000
Costa Rica,2020,10,19017000,43590000,62607000
Costa Rica,2020,11,16008000,50180000,66188000
Costa Rica,2020,12,12192000,47349000,59541000
Costa Rica,2021,1,11617000,39720000,51337000
Costa Rica,2021,2,14465000,46921000,61386000
Costa Rica,2021,3,18673000,59287000,77960000
Costa Rica,2021,4,18491000,94083000,112574000
Costa Rica,2021,5,19547000,57285000,76832000
Costa Rica,2021,6,16739000,58151000,74890000
Costa Rica,2021,7,21720000,59586000,81306000
Costa Rica,2021,8,21662000,55368000,77030000
Costa Rica,2021,9,23124000,38255000,61379000
Costa Rica,2021,10,23496000,58902000,82398000
Costa Rica,2021,11,24389000,66071000,90460000
Costa Rica,2021,12,32653000,48151000,80804000
Costa Rica,2022,1,19660000,42641000,62301000
Costa Rica,2022,2,33541000,51291000,84832000
Costa Rica,2022,3,28365000,75768000,104133000
Costa Rica,2022,4,21825000,65409000,87234000
Costa Rica,2022,5,29095000,67095000,96190000
Costa Rica,2022,6,23956000,76661000,100617000
Costa Rica,2022,7,29204000,72419000,101623000
Costa Rica,2022,8,22342000,64105000,86447000
Costa Rica,2022,9,29626000,53257000,82883000
Costa Rica,2022,10,24651000,57417000,82068000
Costa Rica,2022,11,31435000,50134000,81569000
Costa Rica,2022,12,25784000,57342000,83126000
Costa Rica,2023,1,29764000,51955000,81719000
Costa Rica,2023,2,28519000,60564000,89083000
Costa Rica,2023,3,29485000,66535000,96020000
Costa Rica,2023,4,30843000,66522000,97365000
Costa Rica,2023,5,31897000,77232000,109129000
Costa Rica,2023,6,42473000,76350000,118823000
Costa Rica,2023,7,27650000,57072000,84722000
Costa Rica,2023,8,28051000,61637000,89688000
Costa Rica,2023,9,26649000,52113000,78762000
Costa Rica,2023,10,28329000,69817000,98146000
Costa Rica,2023,11,32381000,53399000,85780000
Costa Rica,2023,12,27573000,46787000,74360000
Costa Rica,2024,1,25397000,58648000,84045000
Costa Rica,2024,2,30535000,57639000,88174000
Costa Rica,2024,3,33434000,60990000,94424000
Costa Rica,2024,4,39654000,72966000,112620000
Costa Rica,2024,5,37393000,57812000,95205000
Costa Rica,2024,6,32393000,51767000,84160000
Costa Rica,2024,7,45453000,73558000,119011000
Costa Rica,2024,8,34349000,53646000,87995000
Costa Rica,2024,9,32399000,60091000,92490000
Costa Rica,2024,10,38635000,55789000,94424000
Costa Rica,2024,11,30738000,55078000,85816000
Costa Rica,2024,12,34618000,55138000,89756000
Cote d'Ivoire,2008,1,14004000,83676000,97680000
Cote d'Ivoire,2008,2,8370000,71437000,79807000
Cote d'Ivoire,2008,3,9309000,64584000,73893000
Cote d'Ivoire,2008,4,8411000,136907000,145318000
Cote d'Ivoire,2008,5,12390000,101373000,113763000
Cote d'Ivoire,2008,6,8140000,25819000,33959000
Cote d'Ivoire,2008,7,13515000,139088000,152603000
Cote d'Ivoire,2008,8,8568000,87095000,95663000
Cote d'Ivoire,2008,9,7500000,40522000,48022000
Cote d'Ivoire,2008,10,8613000,73938000,82551000
Cote d'Ivoire,2008,11,7867000,105975000,113842000
Cote d'Ivoire,2008,12,9475000,82414000,91889000
Cote d'Ivoire,2009,1,10331000,58890000,69221000
Cote d'Ivoire,2009,2,8401000,99786000,108187000
Cote d'Ivoire,2009,3,7041000,56593000,63634000
Cote d'Ivoire,2009,4,7986000,38110000,46096000
Cote d'Ivoire,2009,5,8232000,64369000,72601000
Cote d'Ivoire,2009,6,7306000,61193000,68499000
Cote d'Ivoire,2009,7,6309000,125709000,132018000
Cote d'Ivoire,2009,8,8024000,47442000,55466000
Cote d'Ivoire,2009,9,6184000,128149000,134333000
Cote d'Ivoire,2009,10,7778000,39826000,47604000
Cote d'Ivoire,2009,11,9785000,128447000,138232000
Cote d'Ivoire,2009,12,7684000,70170000,77854000
Cote d'Ivoire,2010,1,6758000,39339000,46097000
Cote d'Ivoire,2010,2,9327000,130243000,139570000
Cote d'Ivoire,2010,3,12600000,56314000,68914000
Cote d'Ivoire,2010,4,8019000,114518000,122537000
Cote d'Ivoire,2010,5,9601000,76604000,86205000
Cote d'Ivoire,2010,6,10563000,72857000,83420000
Cote d'Ivoire,2010,7,10004000,57492000,67496000
Cote d'Ivoire,2010,8,11908000,55034000,66942000
Cote d'Ivoire,2010,9,10994000,82648000,93642000
Cote d'Ivoire,2010,10,7356000,53622000,60978000
Cote d'Ivoire,2010,11,7425000,68813000,76238000
Cote d'Ivoire,2010,12,10115000,38822000,48937000
Cote d'Ivoire,2011,1,5045000,88982000,94027000
Cote d'Ivoire,2011,2,4613000,182634000,187247000
Cote d'Ivoire,2011,3,1433000,70299000,71732000
Cote d'Ivoire,2011,4,872000,59067000,59939000
Cote d'Ivoire,2011,5,6265000,53164000,59429000
Cote d'Ivoire,2011,6,15327000,72821000,88148000
Cote d'Ivoire,2011,7,9659000,82324000,91983000
Cote d'Ivoire,2011,8,11633000,164290000,175923000
Cote d'Ivoire,2011,9,11175000,106158000,117333000
Cote d'Ivoire,2011,10,9312000,68476000,77788000
Cote d'Ivoire,2011,11,9103000,63263000,72366000
Cote d'Ivoire,2011,12,13623000,53762000,67385000
Cote d'Ivoire,2012,1,10532000,149628000,160160000
Cote d'Ivoire,2012,2,10637000,73078000,83715000
Cote d'Ivoire,2012,3,11207000,69668000,80875000
Cote d'Ivoire,2012,4,9592000,108746000,118338000
Cote d'Ivoire,2012,5,12229000,37349000,49578000
Cote d'Ivoire,2012,6,9392000,43542000,52934000
Cote d'Ivoire,2012,7,11643000,41875000,53518000
Cote d'Ivoire,2012,8,15803000,45725000,61528000
Cote d'Ivoire,2012,9,14136000,48910000,63046000
Cote d'Ivoire,2012,10,11935000,261029000,272964000
Cote d'Ivoire,2012,11,18884000,52904000,71788000
Cote d'Ivoire,2012,12,9984000,87628000,97612000
Cote d'Ivoire,2013,1,9665000,78935000,88600000
Cote d'Ivoire,2013,2,9804000,85283000,95087000
Cote d'Ivoire,2013,3,18374000,42263000,60637000
Cote d'Ivoire,2013,4,11954000,105195000,117149000
Cote d'Ivoire,2013,5,14443000,44374000,58817000
Cote d'Ivoire,2013,6,14609000,87415000,102024000
Cote d'Ivoire,2013,7,16647000,48730000,65377000
Cote d'Ivoire,2013,8,9535000,71864000,81399000
Cote d'Ivoire,2013,9,9762000,128947000,138709000
Cote d'Ivoire,2013,10,11063000,49574000,60637000
Cote d'Ivoire,2013,11,10720000,135163000,145883000
Cote d'Ivoire,2013,12,10404000,107909000,118313000
Cote d'Ivoire,2014,1,11439000,65661000,77100000
Cote d'Ivoire,2014,2,11395000,131730000,143125000
Cote d'Ivoire,2014,3,12617000,70431000,83048000
Cote d'Ivoire,2014,4,10165000,51103000,61268000
Cote d'Ivoire,2014,5,13229000,103161000,116390000
Cote d'Ivoire,2014,6,10963000,48885000,59848000
Cote d'Ivoire,2014,7,11070000,45733000,56803000
Cote d'Ivoire,2014,8,9725000,92217000,101942000
Cote d'Ivoire,2014,9,11865000,60362000,72227000
Cote d'Ivoire,2014,10,12977000,101686000,114663000
Cote d'Ivoire,2014,11,14053000,59682000,73735000
Cote d'Ivoire,2014,12,14531000,62068000,76599000
Cote d'Ivoire,2015,1,11592000,107279000,118871000
Cote d'Ivoire,2015,2,12661000,68036000,80697000
Cote d'Ivoire,2015,3,15741000,69863000,85604000
Cote d'Ivoire,2015,4,14704000,110852000,125556000
Cote d'Ivoire,2015,5,10167000,90352000,100519000
Cote d'Ivoire,2015,6,16716000,157519000,174235000
Cote d'Ivoire,2015,7,15343000,50090000,65433000
Cote d'Ivoire,2015,8,9932000,50608000,60540000
Cote d'Ivoire,2015,9,10279000,51149000,61428000
Cote d'Ivoire,2015,10,11954000,59852000,71806000
Cote d'Ivoire,2015,11,10878000,57509000,68387000
Cote d'Ivoire,2015,12,12649000,95380000,108029000
Cote d'Ivoire,2016,1,12713000,69248000,81961000
Cote d'Ivoire,2016,2,18390000,55635000,74025000
Cote d'Ivoire,2016,3,20474000,97081000,117555000
Cote d'Ivoire,2016,4,17420000,121631000,139051000
Cote d'Ivoire,2016,5,15897000,94906000,110803000
Cote d'Ivoire,2016,6,12385000,119167000,131552000
Cote d'Ivoire,2016,7,13552000,64163000,77715000
Cote d'Ivoire,2016,8,17996000,51167000,69163000
Cote d'Ivoire,2016,9,14973000,63638000,78611000
Cote d'Ivoire,2016,10,15759000,49520000,65279000
Cote d'Ivoire,2016,11,16614000,67048000,83662000
Cote d'Ivoire,2016,12,16927000,75140000,92067000
Cote d'Ivoire,2017,1,24237000,65946000,90183000
Cote d'Ivoire,2017,2,20201000,77060000,97261000
Cote d'Ivoire,2017,3,17050000,72472000,89522000
Cote d'Ivoire,2017,4,14565000,112410000,126975000
Cote d'Ivoire,2017,5,24849000,86687000,111536000
Cote d'Ivoire,2017,6,19781000,61564000,81345000
Cote d'Ivoire,2017,7,21376000,45989000,67365000
Cote d'Ivoire,2017,8,15289000,77311000,92600000
Cote d'Ivoire,2017,9,15872000,71283000,87155000
Cote d'Ivoire,2017,10,15009000,36432000,51441000
Cote d'Ivoire,2017,11,16567000,48012000,64579000
Cote d'Ivoire,2017,12,13789000,56732000,70521000
Cote d'Ivoire,2018,1,17286000,86055000,103341000
Cote d'Ivoire,2018,2,15606000,81642000,97248000
Cote d'Ivoire,2018,3,19343000,80279000,99622000
Cote d'Ivoire,2018,4,17625000,65977000,83602000
Cote d'Ivoire,2018,5,19670000,60186000,79856000
Cote d'Ivoire,2018,6,18724000,114941000,133665000
Cote d'Ivoire,2018,7,13071000,115773000,128844000
Cote d'Ivoire,2018,8,10672000,56407000,67079000
Cote d'Ivoire,2018,9,13710000,101202000,114912000
Cote d'Ivoire,2018,10,21049000,119058000,140107000
Cote d'Ivoire,2018,11,27481000,49890000,77371000
Cote d'Ivoire,2018,12,16780000,49100000,65880000
Cote d'Ivoire,2019,1,14500000,61917000,76417000
Cote d'Ivoire,2019,2,14375000,97916000,112291000
Cote d'Ivoire,2019,3,17969000,63614000,81583000
Cote d'Ivoire,2019,4,19258000,67075000,86333000
Cote d'Ivoire,2019,5,16711000,124951000,141662000
Cote d'Ivoire,2019,6,24605000,49446000,74051000
Cote d'Ivoire,2019,7,29850000,70883000,100733000
Cote d'Ivoire,2019,8,16933000,59151000,76084000
Cote d'Ivoire,2019,9,10541000,60067000,70608000
Cote d'Ivoire,2019,10,16295000,55966000,72261000
Cote d'Ivoire,2019,11,15852000,94414000,110266000
Cote d'Ivoire,2019,12,15059000,34800000,49859000
Cote d'Ivoire,2020,1,20628000,68971000,89599000
Cote d'Ivoire,2020,2,17569000,61263000,78832000
Cote d'Ivoire,2020,3,16965000,64166000,81131000
Cote d'Ivoire,2020,4,16312000,55313000,71625000
Cote d'Ivoire,2020,5,14587000,59493000,74080000
Cote d'Ivoire,2020,6,19421000,46429000,65850000
Cote d'Ivoire,2020,7,37144000,61585000,98729000
Cote d'Ivoire,2020,8,17110000,46474000,63584000
Cote d'Ivoire,2020,9,17724000,63528000,81252000
Cote d'Ivoire,2020,10,20648000,56381000,77029000
Cote d'Ivoire,2020,11,17408000,53162000,70570000
Cote d'Ivoire,2020,12,22896000,31178000,54074000
Cote d'Ivoire,2021,1,35936000,71686000,107622000
Cote d'Ivoire,2021,2,21403000,49484000,70887000
Cote d'Ivoire,2021,3,25828000,63269000,89097000
Cote d'Ivoire,2021,4,24279000,46238000,70517000
Cote d'Ivoire,2021,5,19768000,58839000,78607000
Cote d'Ivoire,2021,6,26913000,54322000,81235000
Cote d'Ivoire,2021,7,38040000,63163000,101203000
Cote d'Ivoire,2021,8,23135000,44818000,67953000
Cote d'Ivoire,2021,9,26054000,84756000,110810000
Cote d'Ivoire,2021,10,24229000,56441000,80670000
Cote d'Ivoire,2021,11,23580000,77256000,100836000
Cote d'Ivoire,2021,12,43230000,56677000,99907000
Cote d'Ivoire,2022,1,25440000,73798000,99238000
Cote d'Ivoire,2022,2,20580000,55676000,76256000
Cote d'Ivoire,2022,3,26943000,75476000,102419000
Cote d'Ivoire,2022,4,28403000,77742000,106145000
Cote d'Ivoire,2022,5,29548000,105232000,134780000
Cote d'Ivoire,2022,6,33440000,87308000,120748000
Cote d'Ivoire,2022,7,25252000,89087000,114339000
Cote d'Ivoire,2022,8,26615000,86149000,112764000
Cote d'Ivoire,2022,9,27973000,82429000,110402000
Cote d'Ivoire,2022,10,25365000,77249000,102614000
Cote d'Ivoire,2022,11,35628000,79614000,115242000
Cote d'Ivoire,2022,12,36520000,59704000,96224000
Cote d'Ivoire,2023,1,41658000,72889000,114547000
Cote d'Ivoire,2023,2,35732000,76010000,111742000
Cote d'Ivoire,2023,3,32282000,100522000,132804000
Cote d'Ivoire,2023,4,21351000,91707000,113058000
Cote d'Ivoire,2023,5,27004000,85369000,112373000
Cote d'Ivoire,2023,6,43071000,91562000,134633000
Cote d'Ivoire,2023,7,32568000,64444000,97012000
Cote d'Ivoire,2023,8,30084000,74454000,104538000
Cote d'Ivoire,2023,9,33664000,71451000,105115000
Cote d'Ivoire,2023,10,34655000,81591000,116246000
Cote d'Ivoire,2023,11,29838000,88500000,118338000
Cote d'Ivoire,2023,12,37036000,71633000,108669000
Cote d'Ivoire,2024,1,25588000,123027000,148615000
Cote d'Ivoire,2024,2,23535000,134012000,157547000
Cote d'Ivoire,2024,3,28212000,90222000,118434000
Cote d'Ivoire,2024,4,53459000,155468000,208927000
Cote d'Ivoire,2024,5,20124000,123145000,143269000
Cote d'Ivoire,2024,6,24911000,110291000,135202000
Cote d'Ivoire,2024,7,47357000,208407000,255764000
Cote d'Ivoire,2024,8,20874000,124263000,145137000
Cote d'Ivoire,2024,9,23403000,159967000,183370000
Cote d'Ivoire,2024,10,22890000,132885000,155775000
Cote d'Ivoire,2024,11,33569000,161984000,195553000
Cote d'Ivoire,2024,12,35455000,154823000,190278000
Curacao (ab 2013),2008,1,0,0,0
Curacao (ab 2013),2008,2,0,0,0
Curacao (ab 2013),2008,3,0,0,0
Curacao (ab 2013),2008,4,0,0,0
Curacao (ab 2013),2008,5,0,0,0
Curacao (ab 2013),2008,6,0,0,0
Curacao (ab 2013),2008,7,0,0,0
Curacao (ab 2013),2008,8,0,0,0
Curacao (ab 2013),2008,9,0,0,0
Curacao (ab 2013),2008,10,0,0,0
Curacao (ab 2013),2008,11,0,0,0
Curacao (ab 2013),2008,12,0,0,0
Curacao (ab 2013),2009,1,0,0,0
Curacao (ab 2013),2009,2,0,0,0
Curacao (ab 2013),2009,3,0,0,0
Curacao (ab 2013),2009,4,0,0,0
Curacao (ab 2013),2009,5,0,0,0
Curacao (ab 2013),2009,6,0,0,0
Curacao (ab 2013),2009,7,0,0,0
Curacao (ab 2013),2009,8,0,0,0
Curacao (ab 2013),2009,9,0,0,0
Curacao (ab 2013),2009,10,0,0,0
Curacao (ab 2013),2009,11,0,0,0
Curacao (ab 2013),2009,12,0,0,0
Curacao (ab 2013),2010,1,0,0,0
Curacao (ab 2013),2010,2,0,0,0
Curacao (ab 2013),2010,3,0,0,0
Curacao (ab 2013),2010,4,0,0,0
Curacao (ab 2013),2010,5,0,0,0
Curacao (ab 2013),2010,6,0,0,0
Curacao (ab 2013),2010,7,0,0,0
Curacao (ab 2013),2010,8,0,0,0
Curacao (ab 2013),2010,9,0,0,0
Curacao (ab 2013),2010,10,0,0,0
Curacao (ab 2013),2010,11,0,0,0
Curacao (ab 2013),2010,12,0,0,0
Curacao (ab 2013),2011,1,0,0,0
Curacao (ab 2013),2011,2,0,0,0
Curacao (ab 2013),2011,3,0,0,0
Curacao (ab 2013),2011,4,0,0,0
Curacao (ab 2013),2011,5,0,0,0
Curacao (ab 2013),2011,6,0,0,0
Curacao (ab 2013),2011,7,0,0,0
Curacao (ab 2013),2011,8,0,0,0
Curacao (ab 2013),2011,9,0,0,0
Curacao (ab 2013),2011,10,0,0,0
Curacao (ab 2013),2011,11,0,0,0
Curacao (ab 2013),2011,12,0,0,0
Curacao (ab 2013),2012,1,0,0,0
Curacao (ab 2013),2012,2,0,0,0
Curacao (ab 2013),2012,3,0,0,0
Curacao (ab 2013),2012,4,0,0,0
Curacao (ab 2013),2012,5,0,0,0
Curacao (ab 2013),2012,6,0,0,0
Curacao (ab 2013),2012,7,0,0,0
Curacao (ab 2013),2012,8,0,0,0
Curacao (ab 2013),2012,9,0,0,0
Curacao (ab 2013),2012,10,0,0,0
Curacao (ab 2013),2012,11,0,0,0
Curacao (ab 2013),2012,12,0,0,0
Curacao (ab 2013),2013,1,4120000,22000,4142000
Curacao (ab 2013),2013,2,1300000,20000,1320000
Curacao (ab 2013),2013,3,988000,26000,1014000
Curacao (ab 2013),2013,4,1528000,21000,1549000
Curacao (ab 2013),2013,5,1364000,189000,1553000
Curacao (ab 2013),2013,6,1057000,12000,1069000
Curacao (ab 2013),2013,7,1854000,13000,1867000
Curacao (ab 2013),2013,8,1151000,43000,1194000
Curacao (ab 2013),2013,9,925000,62000,987000
Curacao (ab 2013),2013,10,1227000,40000,1267000
Curacao (ab 2013),2013,11,1092000,48000,1140000
Curacao (ab 2013),2013,12,1067000,81000,1148000
Curacao (ab 2013),2014,1,1108000,31000,1139000
Curacao (ab 2013),2014,2,1618000,19000,1637000
Curacao (ab 2013),2014,3,1116000,40000,1156000
Curacao (ab 2013),2014,4,1763000,24000,1787000
Curacao (ab 2013),2014,5,686000,16000,702000
Curacao (ab 2013),2014,6,1044000,29000,1073000
Curacao (ab 2013),2014,7,1322000,208000,1530000
Curacao (ab 2013),2014,8,1115000,1125000,2240000
Curacao (ab 2013),2014,9,933000,84000,1017000
Curacao (ab 2013),2014,10,1096000,9000,1105000
Curacao (ab 2013),2014,11,1068000,12000,1080000
Curacao (ab 2013),2014,12,1142000,7000,1149000
Curacao (ab 2013),2015,1,3258000,51000,3309000
Curacao (ab 2013),2015,2,761000,34000,795000
Curacao (ab 2013),2015,3,1480000,11000,1491000
Curacao (ab 2013),2015,4,3215000,29000,3244000
Curacao (ab 2013),2015,5,750000,7000,757000
Curacao (ab 2013),2015,6,1362000,203000,1565000
Curacao (ab 2013),2015,7,2986000,8000,2994000
Curacao (ab 2013),2015,8,2089000,16000,2105000
Curacao (ab 2013),2015,9,1392000,14000,1406000
Curacao (ab 2013),2015,10,1252000,4000,1256000
Curacao (ab 2013),2015,11,3100000,11000,3111000
Curacao (ab 2013),2015,12,2133000,21000,2154000
Curacao (ab 2013),2016,1,3034000,9000,3043000
Curacao (ab 2013),2016,2,1245000,130000,1375000
Curacao (ab 2013),2016,3,2089000,17000,2106000
Curacao (ab 2013),2016,4,1809000,34000,1843000
Curacao (ab 2013),2016,5,2888000,2000,2890000
Curacao (ab 2013),2016,6,2633000,2000,2635000
Curacao (ab 2013),2016,7,1755000,7000,1762000
Curacao (ab 2013),2016,8,1396000,470000,1866000
Curacao (ab 2013),2016,9,2371000,6000,2377000
Curacao (ab 2013),2016,10,2449000,818000,3267000
Curacao (ab 2013),2016,11,1696000,127000,1823000
Curacao (ab 2013),2016,12,1073000,29000,1102000
Curacao (ab 2013),2017,1,2126000,13000,2139000
Curacao (ab 2013),2017,2,1871000,46000,1917000
Curacao (ab 2013),2017,3,1791000,766000,2557000
Curacao (ab 2013),2017,4,1275000,5000,1280000
Curacao (ab 2013),2017,5,1322000,11000,1333000
Curacao (ab 2013),2017,6,2002000,11000,2013000
Curacao (ab 2013),2017,7,2450000,25000,2475000
Curacao (ab 2013),2017,8,1822000,20000,1842000
Curacao (ab 2013),2017,9,1936000,23000,1959000
Curacao (ab 2013),2017,10,1940000,89000,2029000
Curacao (ab 2013),2017,11,2117000,5000,2122000
Curacao (ab 2013),2017,12,6677000,0,6677000
Curacao (ab 2013),2018,1,2332000,18000,2350000
Curacao (ab 2013),2018,2,4790000,142000,4932000
Curacao (ab 2013),2018,3,2060000,113000,2173000
Curacao (ab 2013),2018,4,1622000,60000,1682000
Curacao (ab 2013),2018,5,1320000,492000,1812000
Curacao (ab 2013),2018,6,1978000,81000,2059000
Curacao (ab 2013),2018,7,1085000,281000,1366000
Curacao (ab 2013),2018,8,12415000,244000,12659000
Curacao (ab 2013),2018,9,7648000,14000,7662000
Curacao (ab 2013),2018,10,1673000,187000,1860000
Curacao (ab 2013),2018,11,1662000,46000,1708000
Curacao (ab 2013),2018,12,1059000,60000,1119000
Curacao (ab 2013),2019,1,2051000,204000,2255000
Curacao (ab 2013),2019,2,1410000,29000,1439000
Curacao (ab 2013),2019,3,1520000,38000,1558000
Curacao (ab 2013),2019,4,1929000,111000,2040000
Curacao (ab 2013),2019,5,1613000,80000,1693000
Curacao (ab 2013),2019,6,3097000,1000,3098000
Curacao (ab 2013),2019,7,1620000,1000,1621000
Curacao (ab 2013),2019,8,1044000,77000,1121000
Curacao (ab 2013),2019,9,1331000,17000,1348000
Curacao (ab 2013),2019,10,1567000,94000,1661000
Curacao (ab 2013),2019,11,1841000,17000,1858000
Curacao (ab 2013),2019,12,1464000,21000,1485000
Curacao (ab 2013),2020,1,1563000,26000,1589000
Curacao (ab 2013),2020,2,1479000,74000,1553000
Curacao (ab 2013),2020,3,1115000,73000,1188000
Curacao (ab 2013),2020,4,642000,1000,643000
Curacao (ab 2013),2020,5,480000,2000,482000
Curacao (ab 2013),2020,6,911000,34000,945000
Curacao (ab 2013),2020,7,1751000,3000,1754000
Curacao (ab 2013),2020,8,1400000,5000,1405000
Curacao (ab 2013),2020,9,1205000,10000,1215000
Curacao (ab 2013),2020,10,1328000,153000,1481000
Curacao (ab 2013),2020,11,878000,6000,884000
Curacao (ab 2013),2020,12,1411000,18000,1429000
Curacao (ab 2013),2021,1,670000,24000,694000
Curacao (ab 2013),2021,2,876000,0,876000
Curacao (ab 2013),2021,3,2443000,31000,2474000
Curacao (ab 2013),2021,4,965000,55000,1020000
Curacao (ab 2013),2021,5,1098000,0,1098000
Curacao (ab 2013),2021,6,1034000,42000,1076000
Curacao (ab 2013),2021,7,1665000,8000,1673000
Curacao (ab 2013),2021,8,1055000,10000,1065000
Curacao (ab 2013),2021,9,868000,35000,903000
Curacao (ab 2013),2021,10,916000,4000,920000
Curacao (ab 2013),2021,11,4707000,26000,4733000
Curacao (ab 2013),2021,12,1348000,5000,1353000
Curacao (ab 2013),2022,1,1398000,26000,1424000
Curacao (ab 2013),2022,2,1075000,8000,1083000
Curacao (ab 2013),2022,3,1770000,96000,1866000
Curacao (ab 2013),2022,4,749000,11000,760000
Curacao (ab 2013),2022,5,1106000,6000,1112000
Curacao (ab 2013),2022,6,1375000,48000,1423000
Curacao (ab 2013),2022,7,2256000,17000,2273000
Curacao (ab 2013),2022,8,1209000,21000,1230000
Curacao (ab 2013),2022,9,1441000,34000,1475000
Curacao (ab 2013),2022,10,1290000,19000,1309000
Curacao (ab 2013),2022,11,955000,15000,970000
Curacao (ab 2013),2022,12,1276000,41000,1317000
Curacao (ab 2013),2023,1,780000,7000,787000
Curacao (ab 2013),2023,2,1510000,3000,1513000
Curacao (ab 2013),2023,3,1611000,34000,1645000
Curacao (ab 2013),2023,4,2377000,2000,2379000
Curacao (ab 2013),2023,5,1001000,34000,1035000
Curacao (ab 2013),2023,6,1566000,25000,1591000
Curacao (ab 2013),2023,7,1311000,3000,1314000
Curacao (ab 2013),2023,8,2249000,9000,2258000
Curacao (ab 2013),2023,9,2078000,6000,2084000
Curacao (ab 2013),2023,10,1460000,52000,1512000
Curacao (ab 2013),2023,11,1404000,2000,1406000
Curacao (ab 2013),2023,12,1305000,36000,1341000
Curacao (ab 2013),2024,1,1593000,7000,1600000
Curacao (ab 2013),2024,2,1067000,40000,1107000
Curacao (ab 2013),2024,3,1755000,45000,1800000
Curacao (ab 2013),2024,4,1623000,28000,1651000
Curacao (ab 2013),2024,5,1328000,20000,1348000
Curacao (ab 2013),2024,6,1200000,0,1200000
Curacao (ab 2013),2024,7,1787000,489000,2276000
Curacao (ab 2013),2024,8,2684000,63000,2747000
Curacao (ab 2013),2024,9,1036000,12000,1048000
Curacao (ab 2013),2024,10,2274000,5000,2279000
Curacao (ab 2013),2024,11,1865000,17000,1882000
Curacao (ab 2013),2024,12,1463000,68000,1531000
Demokratische Republik Kongo,2008,1,6375000,2243000,8618000
Demokratische Republik Kongo,2008,2,3560000,676000,4236000
Demokratische Republik Kongo,2008,3,4401000,382000,4783000
Demokratische Republik Kongo,2008,4,6266000,238000,6504000
Demokratische Republik Kongo,2008,5,9551000,994000,10545000
Demokratische Republik Kongo,2008,6,14638000,708000,15346000
Demokratische Republik Kongo,2008,7,5813000,1987000,7800000
Demokratische Republik Kongo,2008,8,8598000,1069000,9667000
Demokratische Republik Kongo,2008,9,3939000,541000,4480000
Demokratische Republik Kongo,2008,10,7155000,676000,7831000
Demokratische Republik Kongo,2008,11,5856000,676000,6532000
Demokratische Republik Kongo,2008,12,7050000,736000,7786000
Demokratische Republik Kongo,2009,1,9137000,446000,9583000
Demokratische Republik Kongo,2009,2,4263000,602000,4865000
Demokratische Republik Kongo,2009,3,8466000,1391000,9857000
Demokratische Republik Kongo,2009,4,5203000,3176000,8379000
Demokratische Republik Kongo,2009,5,7495000,2753000,10248000
Demokratische Republik Kongo,2009,6,4965000,1348000,6313000
Demokratische Republik Kongo,2009,7,5144000,1154000,6298000
Demokratische Republik Kongo,2009,8,3977000,526000,4503000
Demokratische Republik Kongo,2009,9,2610000,771000,3381000
Demokratische Republik Kongo,2009,10,10022000,1319000,11341000
Demokratische Republik Kongo,2009,11,9346000,1088000,10434000
Demokratische Republik Kongo,2009,12,4926000,545000,5471000
Demokratische Republik Kongo,2010,1,6000000,1680000,7680000
Demokratische Republik Kongo,2010,2,5599000,1871000,7470000
Demokratische Republik Kongo,2010,3,9701000,2186000,11887000
Demokratische Republik Kongo,2010,4,7899000,1287000,9186000
Demokratische Republik Kongo,2010,5,4413000,1746000,6159000
Demokratische Republik Kongo,2010,6,6490000,1760000,8250000
Demokratische Republik Kongo,2010,7,5850000,2542000,8392000
Demokratische Republik Kongo,2010,8,7042000,904000,7946000
Demokratische Republik Kongo,2010,9,8944000,1358000,10302000
Demokratische Republik Kongo,2010,10,13353000,1097000,14450000
Demokratische Republik Kongo,2010,11,11520000,965000,12485000
Demokratische Republik Kongo,2010,12,6879000,478000,7357000
Demokratische Republik Kongo,2011,1,18254000,509000,18763000
Demokratische Republik Kongo,2011,2,5928000,2302000,8230000
Demokratische Republik Kongo,2011,3,6609000,1968000,8577000
Demokratische Republik Kongo,2011,4,4341000,524000,4865000
Demokratische Republik Kongo,2011,5,13993000,589000,14582000
Demokratische Republik Kongo,2011,6,7853000,806000,8659000
Demokratische Republik Kongo,2011,7,10037000,550000,10587000
Demokratische Republik Kongo,2011,8,7870000,525000,8395000
Demokratische Republik Kongo,2011,9,8399000,527000,8926000
Demokratische Republik Kongo,2011,10,9334000,854000,10188000
Demokratische Republik Kongo,2011,11,5659000,570000,6229000
Demokratische Republik Kongo,2011,12,15523000,1112000,16635000
Demokratische Republik Kongo,2012,1,6929000,516000,7445000
Demokratische Republik Kongo,2012,2,5350000,656000,6006000
Demokratische Republik Kongo,2012,3,7922000,10776000,18698000
Demokratische Republik Kongo,2012,4,6647000,288000,6935000
Demokratische Republik Kongo,2012,5,13515000,8551000,22066000
Demokratische Republik Kongo,2012,6,18570000,7611000,26181000
Demokratische Republik Kongo,2012,7,13707000,9745000,23452000
Demokratische Republik Kongo,2012,8,5618000,15909000,21527000
Demokratische Republik Kongo,2012,9,9965000,3794000,13759000
Demokratische Republik Kongo,2012,10,8514000,9090000,17604000
Demokratische Republik Kongo,2012,11,20994000,10842000,31836000
Demokratische Republik Kongo,2012,12,11594000,625000,12219000
Demokratische Republik Kongo,2013,1,6704000,12701000,19405000
Demokratische Republik Kongo,2013,2,7189000,11377000,18566000
Demokratische Republik Kongo,2013,3,13321000,16920000,30241000
Demokratische Republik Kongo,2013,4,22159000,11599000,33758000
Demokratische Republik Kongo,2013,5,6854000,10131000,16985000
Demokratische Republik Kongo,2013,6,15574000,1542000,17116000
Demokratische Republik Kongo,2013,7,11511000,11328000,22839000
Demokratische Republik Kongo,2013,8,16212000,5946000,22158000
Demokratische Republik Kongo,2013,9,10992000,6025000,17017000
Demokratische Republik Kongo,2013,10,20821000,5974000,26795000
Demokratische Republik Kongo,2013,11,8717000,221000,8938000
Demokratische Republik Kongo,2013,12,17694000,7476000,25170000
Demokratische Republik Kongo,2014,1,5706000,7521000,13227000
Demokratische Republik Kongo,2014,2,5748000,982000,6730000
Demokratische Republik Kongo,2014,3,16946000,1622000,18568000
Demokratische Republik Kongo,2014,4,8225000,11476000,19701000
Demokratische Republik Kongo,2014,5,13724000,331000,14055000
Demokratische Republik Kongo,2014,6,6148000,8171000,14319000
Demokratische Republik Kongo,2014,7,8218000,10518000,18736000
Demokratische Republik Kongo,2014,8,6501000,12758000,19259000
Demokratische Republik Kongo,2014,9,12325000,2035000,14360000
Demokratische Republik Kongo,2014,10,15290000,12989000,28279000
Demokratische Republik Kongo,2014,11,20450000,15929000,36379000
Demokratische Republik Kongo,2014,12,9497000,393000,9890000
Demokratische Republik Kongo,2015,1,11522000,8938000,20460000
Demokratische Republik Kongo,2015,2,13105000,5821000,18926000
Demokratische Republik Kongo,2015,3,7710000,4578000,12288000
Demokratische Republik Kongo,2015,4,14268000,5678000,19946000
Demokratische Republik Kongo,2015,5,8165000,7192000,15357000
Demokratische Republik Kongo,2015,6,11206000,8172000,19378000
Demokratische Republik Kongo,2015,7,17736000,6754000,24490000
Demokratische Republik Kongo,2015,8,18843000,6194000,25037000
Demokratische Republik Kongo,2015,9,10909000,6808000,17717000
Demokratische Republik Kongo,2015,10,6660000,9457000,16117000
Demokratische Republik Kongo,2015,11,14031000,6896000,20927000
Demokratische Republik Kongo,2015,12,13711000,6914000,20625000
Demokratische Republik Kongo,2016,1,5235000,7067000,12302000
Demokratische Republik Kongo,2016,2,3759000,5659000,9418000
Demokratische Republik Kongo,2016,3,8554000,3740000,12294000
Demokratische Republik Kongo,2016,4,10668000,7520000,18188000
Demokratische Republik Kongo,2016,5,7622000,17040000,24662000
Demokratische Republik Kongo,2016,6,6333000,10176000,16509000
Demokratische Republik Kongo,2016,7,4846000,16239000,21085000
Demokratische Republik Kongo,2016,8,8519000,7358000,15877000
Demokratische Republik Kongo,2016,9,7671000,10680000,18351000
Demokratische Republik Kongo,2016,10,5409000,8071000,13480000
Demokratische Republik Kongo,2016,11,8806000,5219000,14025000
Demokratische Republik Kongo,2016,12,4939000,7276000,12215000
Demokratische Republik Kongo,2017,1,8126000,6601000,14727000
Demokratische Republik Kongo,2017,2,3329000,10769000,14098000
Demokratische Republik Kongo,2017,3,5546000,20746000,26292000
Demokratische Republik Kongo,2017,4,5235000,12684000,17919000
Demokratische Republik Kongo,2017,5,8879000,10947000,19826000
Demokratische Republik Kongo,2017,6,7120000,7085000,14205000
Demokratische Republik Kongo,2017,7,11245000,9990000,21235000
Demokratische Republik Kongo,2017,8,5298000,6773000,12071000
Demokratische Republik Kongo,2017,9,3545000,14141000,17686000
Demokratische Republik Kongo,2017,10,5260000,2702000,7962000
Demokratische Republik Kongo,2017,11,4637000,4184000,8821000
Demokratische Republik Kongo,2017,12,4770000,317000,5087000
Demokratische Republik Kongo,2018,1,3756000,14454000,18210000
Demokratische Republik Kongo,2018,2,4762000,12280000,17042000
Demokratische Republik Kongo,2018,3,3405000,17547000,20952000
Demokratische Republik Kongo,2018,4,4882000,20453000,25335000
Demokratische Republik Kongo,2018,5,9317000,22972000,32289000
Demokratische Republik Kongo,2018,6,13436000,12057000,25493000
Demokratische Republik Kongo,2018,7,6781000,13292000,20073000
Demokratische Republik Kongo,2018,8,11492000,5508000,17000000
Demokratische Republik Kongo,2018,9,9350000,8086000,17436000
Demokratische Republik Kongo,2018,10,7841000,20978000,28819000
Demokratische Republik Kongo,2018,11,9153000,24469000,33622000
Demokratische Republik Kongo,2018,12,5782000,6058000,11840000
Demokratische Republik Kongo,2019,1,4661000,3923000,8584000
Demokratische Republik Kongo,2019,2,4458000,14473000,18931000
Demokratische Republik Kongo,2019,3,6564000,9487000,16051000
Demokratische Republik Kongo,2019,4,8446000,1399000,9845000
Demokratische Republik Kongo,2019,5,7786000,5775000,13561000
Demokratische Republik Kongo,2019,6,4293000,2531000,6824000
Demokratische Republik Kongo,2019,7,6092000,6710000,12802000
Demokratische Republik Kongo,2019,8,6557000,3825000,10382000
Demokratische Republik Kongo,2019,9,8426000,4221000,12647000
Demokratische Republik Kongo,2019,10,5081000,3139000,8220000
Demokratische Republik Kongo,2019,11,5680000,9140000,14820000
Demokratische Republik Kongo,2019,12,12258000,369000,12627000
Demokratische Republik Kongo,2020,1,5977000,5005000,10982000
Demokratische Republik Kongo,2020,2,6504000,4058000,10562000
Demokratische Republik Kongo,2020,3,11360000,11522000,22882000
Demokratische Republik Kongo,2020,4,7935000,4779000,12714000
Demokratische Republik Kongo,2020,5,6879000,1476000,8355000
Demokratische Republik Kongo,2020,6,12869000,2623000,15492000
Demokratische Republik Kongo,2020,7,7685000,281000,7966000
Demokratische Republik Kongo,2020,8,7322000,161000,7483000
Demokratische Republik Kongo,2020,9,7365000,938000,8303000
Demokratische Republik Kongo,2020,10,7022000,6148000,13170000
Demokratische Republik Kongo,2020,11,12501000,8365000,20866000
Demokratische Republik Kongo,2020,12,6765000,1008000,7773000
Demokratische Republik Kongo,2021,1,6977000,11933000,18910000
Demokratische Republik Kongo,2021,2,7564000,18815000,26379000
Demokratische Republik Kongo,2021,3,11571000,12435000,24006000
Demokratische Republik Kongo,2021,4,4477000,2800000,7277000
Demokratische Republik Kongo,2021,5,5568000,7709000,13277000
Demokratische Republik Kongo,2021,6,7053000,11850000,18903000
Demokratische Republik Kongo,2021,7,6457000,3350000,9807000
Demokratische Republik Kongo,2021,8,15581000,464000,16045000
Demokratische Republik Kongo,2021,9,10410000,5215000,15625000
Demokratische Republik Kongo,2021,10,6397000,6824000,13221000
Demokratische Republik Kongo,2021,11,10423000,9150000,19573000
Demokratische Republik Kongo,2021,12,10190000,30045000,40235000
Demokratische Republik Kongo,2022,1,5238000,10098000,15336000
Demokratische Republik Kongo,2022,2,6650000,24305000,30955000
Demokratische Republik Kongo,2022,3,8998000,13963000,22961000
Demokratische Republik Kongo,2022,4,7133000,7718000,14851000
Demokratische Republik Kongo,2022,5,8247000,3132000,11379000
Demokratische Republik Kongo,2022,6,22246000,6235000,28481000
Demokratische Republik Kongo,2022,7,9381000,7715000,17096000
Demokratische Republik Kongo,2022,8,26055000,20301000,46356000
Demokratische Republik Kongo,2022,9,17194000,14339000,31533000
Demokratische Republik Kongo,2022,10,13612000,15156000,28768000
Demokratische Republik Kongo,2022,11,15454000,29815000,45269000
Demokratische Republik Kongo,2022,12,16164000,12202000,28366000
Demokratische Republik Kongo,2023,1,7803000,27264000,35067000
Demokratische Republik Kongo,2023,2,12216000,17062000,29278000
Demokratische Republik Kongo,2023,3,25982000,52849000,78831000
Demokratische Republik Kongo,2023,4,14116000,17868000,31984000
Demokratische Republik Kongo,2023,5,9700000,18994000,28694000
Demokratische Republik Kongo,2023,6,16319000,7444000,23763000
Demokratische Republik Kongo,2023,7,9275000,12601000,21876000
Demokratische Republik Kongo,2023,8,13374000,11388000,24762000
Demokratische Republik Kongo,2023,9,14745000,11020000,25765000
Demokratische Republik Kongo,2023,10,20330000,15890000,36220000
Demokratische Republik Kongo,2023,11,9314000,5157000,14471000
Demokratische Republik Kongo,2023,12,11548000,17975000,29523000
Demokratische Republik Kongo,2024,1,12080000,19150000,31230000
Demokratische Republik Kongo,2024,2,10480000,17953000,28433000
Demokratische Republik Kongo,2024,3,12759000,32772000,45531000
Demokratische Republik Kongo,2024,4,8999000,69388000,78387000
Demokratische Republik Kongo,2024,5,9889000,22507000,32396000
Demokratische Republik Kongo,2024,6,15922000,20706000,36628000
Demokratische Republik Kongo,2024,7,9145000,32372000,41517000
Demokratische Republik Kongo,2024,8,6097000,9547000,15644000
Demokratische Republik Kongo,2024,9,16564000,10430000,26994000
Demokratische Republik Kongo,2024,10,7893000,19056000,26949000
Demokratische Republik Kongo,2024,11,8303000,3138000,11441000
Demokratische Republik Kongo,2024,12,6672000,9124000,15796000
Demokratische Volksrepublik Korea,2008,1,886000,894000,1780000
Demokratische Volksrepublik Korea,2008,2,1129000,220000,1349000
Demokratische Volksrepublik Korea,2008,3,2623000,190000,2813000
Demokratische Volksrepublik Korea,2008,4,3721000,384000,4105000
Demokratische Volksrepublik Korea,2008,5,2153000,327000,2480000
Demokratische Volksrepublik Korea,2008,6,901000,1295000,2196000
Demokratische Volksrepublik Korea,2008,7,1951000,303000,2254000
Demokratische Volksrepublik Korea,2008,8,3930000,841000,4771000
Demokratische Volksrepublik Korea,2008,9,599000,1435000,2034000
Demokratische Volksrepublik Korea,2008,10,617000,828000,1445000
Demokratische Volksrepublik Korea,2008,11,864000,60000,924000
Demokratische Volksrepublik Korea,2008,12,1563000,8285000,9848000
Demokratische Volksrepublik Korea,2009,1,1176000,2682000,3858000
Demokratische Volksrepublik Korea,2009,2,3849000,1694000,5543000
Demokratische Volksrepublik Korea,2009,3,5909000,797000,6706000
Demokratische Volksrepublik Korea,2009,4,2609000,1074000,3683000
Demokratische Volksrepublik Korea,2009,5,1540000,1094000,2634000
Demokratische Volksrepublik Korea,2009,6,3676000,3139000,6815000
Demokratische Volksrepublik Korea,2009,7,1547000,2825000,4372000
Demokratische Volksrepublik Korea,2009,8,699000,2744000,3443000
Demokratische Volksrepublik Korea,2009,9,1784000,4473000,6257000
Demokratische Volksrepublik Korea,2009,10,858000,2698000,3556000
Demokratische Volksrepublik Korea,2009,11,690000,1518000,2208000
Demokratische Volksrepublik Korea,2009,12,867000,1475000,2342000
Demokratische Volksrepublik Korea,2010,1,540000,2040000,2580000
Demokratische Volksrepublik Korea,2010,2,911000,1251000,2162000
Demokratische Volksrepublik Korea,2010,3,1019000,876000,1895000
Demokratische Volksrepublik Korea,2010,4,724000,882000,1606000
Demokratische Volksrepublik Korea,2010,5,402000,420000,822000
Demokratische Volksrepublik Korea,2010,6,1069000,2218000,3287000
Demokratische Volksrepublik Korea,2010,7,1844000,3473000,5317000
Demokratische Volksrepublik Korea,2010,8,3340000,2336000,5676000
Demokratische Volksrepublik Korea,2010,9,994000,3399000,4393000
Demokratische Volksrepublik Korea,2010,10,2563000,2021000,4584000
Demokratische Volksrepublik Korea,2010,11,941000,1214000,2155000
Demokratische Volksrepublik Korea,2010,12,2661000,1442000,4103000
Demokratische Volksrepublik Korea,2011,1,653000,2754000,3407000
Demokratische Volksrepublik Korea,2011,2,3453000,2034000,5487000
Demokratische Volksrepublik Korea,2011,3,657000,2854000,3511000
Demokratische Volksrepublik Korea,2011,4,1330000,1536000,2866000
Demokratische Volksrepublik Korea,2011,5,609000,1757000,2366000
Demokratische Volksrepublik Korea,2011,6,558000,2775000,3333000
Demokratische Volksrepublik Korea,2011,7,1059000,3740000,4799000
Demokratische Volksrepublik Korea,2011,8,606000,4410000,5016000
Demokratische Volksrepublik Korea,2011,9,375000,3447000,3822000
Demokratische Volksrepublik Korea,2011,10,1331000,2376000,3707000
Demokratische Volksrepublik Korea,2011,11,764000,1378000,2142000
Demokratische Volksrepublik Korea,2011,12,996000,987000,1983000
Demokratische Volksrepublik Korea,2012,1,514000,1197000,1711000
Demokratische Volksrepublik Korea,2012,2,1236000,1232000,2468000
Demokratische Volksrepublik Korea,2012,3,1746000,395000,2141000
Demokratische Volksrepublik Korea,2012,4,1147000,559000,1706000
Demokratische Volksrepublik Korea,2012,5,1926000,310000,2236000
Demokratische Volksrepublik Korea,2012,6,4888000,196000,5084000
Demokratische Volksrepublik Korea,2012,7,2062000,1117000,3179000
Demokratische Volksrepublik Korea,2012,8,5284000,1206000,6490000
Demokratische Volksrepublik Korea,2012,9,1145000,1962000,3107000
Demokratische Volksrepublik Korea,2012,10,1940000,662000,2602000
Demokratische Volksrepublik Korea,2012,11,968000,143000,1111000
Demokratische Volksrepublik Korea,2012,12,375000,509000,884000
Demokratische Volksrepublik Korea,2013,1,201000,1562000,1763000
Demokratische Volksrepublik Korea,2013,2,506000,689000,1195000
Demokratische Volksrepublik Korea,2013,3,464000,250000,714000
Demokratische Volksrepublik Korea,2013,4,414000,434000,848000
Demokratische Volksrepublik Korea,2013,5,945000,252000,1197000
Demokratische Volksrepublik Korea,2013,6,423000,509000,932000
Demokratische Volksrepublik Korea,2013,7,3544000,886000,4430000
Demokratische Volksrepublik Korea,2013,8,4990000,1280000,6270000
Demokratische Volksrepublik Korea,2013,9,604000,1221000,1825000
Demokratische Volksrepublik Korea,2013,10,667000,1121000,1788000
Demokratische Volksrepublik Korea,2013,11,733000,665000,1398000
Demokratische Volksrepublik Korea,2013,12,245000,179000,424000
Demokratische Volksrepublik Korea,2014,1,3460000,1239000,4699000
Demokratische Volksrepublik Korea,2014,2,365000,514000,879000
Demokratische Volksrepublik Korea,2014,3,470000,305000,775000
Demokratische Volksrepublik Korea,2014,4,578000,101000,679000
Demokratische Volksrepublik Korea,2014,5,335000,150000,485000
Demokratische Volksrepublik Korea,2014,6,604000,1009000,1613000
Demokratische Volksrepublik Korea,2014,7,796000,1174000,1970000
Demokratische Volksrepublik Korea,2014,8,569000,2166000,2735000
Demokratische Volksrepublik Korea,2014,9,647000,1727000,2374000
Demokratische Volksrepublik Korea,2014,10,818000,318000,1136000
Demokratische Volksrepublik Korea,2014,11,504000,119000,623000
Demokratische Volksrepublik Korea,2014,12,652000,31000,683000
Demokratische Volksrepublik Korea,2015,1,249000,417000,666000
Demokratische Volksrepublik Korea,2015,2,424000,212000,636000
Demokratische Volksrepublik Korea,2015,3,604000,490000,1094000
Demokratische Volksrepublik Korea,2015,4,871000,501000,1372000
Demokratische Volksrepublik Korea,2015,5,805000,362000,1167000
Demokratische Volksrepublik Korea,2015,6,503000,127000,630000
Demokratische Volksrepublik Korea,2015,7,661000,106000,767000
Demokratische Volksrepublik Korea,2015,8,337000,143000,480000
Demokratische Volksrepublik Korea,2015,9,638000,313000,951000
Demokratische Volksrepublik Korea,2015,10,618000,295000,913000
Demokratische Volksrepublik Korea,2015,11,934000,202000,1136000
Demokratische Volksrepublik Korea,2015,12,573000,105000,678000
Demokratische Volksrepublik Korea,2016,1,176000,313000,489000
Demokratische Volksrepublik Korea,2016,2,296000,289000,585000
Demokratische Volksrepublik Korea,2016,3,340000,173000,513000
Demokratische Volksrepublik Korea,2016,4,892000,134000,1026000
Demokratische Volksrepublik Korea,2016,5,840000,204000,1044000
Demokratische Volksrepublik Korea,2016,6,611000,229000,840000
Demokratische Volksrepublik Korea,2016,7,723000,320000,1043000
Demokratische Volksrepublik Korea,2016,8,395000,317000,712000
Demokratische Volksrepublik Korea,2016,9,312000,487000,799000
Demokratische Volksrepublik Korea,2016,10,185000,112000,297000
Demokratische Volksrepublik Korea,2016,11,505000,363000,868000
Demokratische Volksrepublik Korea,2016,12,429000,412000,841000
Demokratische Volksrepublik Korea,2017,1,219000,138000,357000
Demokratische Volksrepublik Korea,2017,2,263000,58000,321000
Demokratische Volksrepublik Korea,2017,3,144000,141000,285000
Demokratische Volksrepublik Korea,2017,4,905000,64000,969000
Demokratische Volksrepublik Korea,2017,5,322000,81000,403000
Demokratische Volksrepublik Korea,2017,6,193000,165000,358000
Demokratische Volksrepublik Korea,2017,7,365000,277000,642000
Demokratische Volksrepublik Korea,2017,8,261000,232000,493000
Demokratische Volksrepublik Korea,2017,9,570000,165000,735000
Demokratische Volksrepublik Korea,2017,10,238000,142000,380000
Demokratische Volksrepublik Korea,2017,11,185000,86000,271000
Demokratische Volksrepublik Korea,2017,12,194000,123000,317000
Demokratische Volksrepublik Korea,2018,1,285000,38000,323000
Demokratische Volksrepublik Korea,2018,2,192000,6000,198000
Demokratische Volksrepublik Korea,2018,3,21000,13000,34000
Demokratische Volksrepublik Korea,2018,4,84000,14000,98000
Demokratische Volksrepublik Korea,2018,5,173000,3000,176000
Demokratische Volksrepublik Korea,2018,6,201000,36000,237000
Demokratische Volksrepublik Korea,2018,7,470000,10000,480000
Demokratische Volksrepublik Korea,2018,8,66000,21000,87000
Demokratische Volksrepublik Korea,2018,9,67000,8000,75000
Demokratische Volksrepublik Korea,2018,10,802000,30000,832000
Demokratische Volksrepublik Korea,2018,11,181000,5000,186000
Demokratische Volksrepublik Korea,2018,12,119000,32000,151000
Demokratische Volksrepublik Korea,2019,1,35000,32000,67000
Demokratische Volksrepublik Korea,2019,2,140000,8000,148000
Demokratische Volksrepublik Korea,2019,3,139000,27000,166000
Demokratische Volksrepublik Korea,2019,4,115000,21000,136000
Demokratische Volksrepublik Korea,2019,5,92000,23000,115000
Demokratische Volksrepublik Korea,2019,6,63000,6000,69000
Demokratische Volksrepublik Korea,2019,7,123000,11000,134000
Demokratische Volksrepublik Korea,2019,8,38000,15000,53000
Demokratische Volksrepublik Korea,2019,9,110000,17000,127000
Demokratische Volksrepublik Korea,2019,10,113000,10000,123000
Demokratische Volksrepublik Korea,2019,11,74000,23000,97000
Demokratische Volksrepublik Korea,2019,12,75000,13000,88000
Demokratische Volksrepublik Korea,2020,1,0,0,0
Demokratische Volksrepublik Korea,2020,2,0,0,0
Demokratische Volksrepublik Korea,2020,3,0,0,0
Demokratische Volksrepublik Korea,2020,4,0,0,0
Demokratische Volksrepublik Korea,2020,5,0,0,0
Demokratische Volksrepublik Korea,2020,6,0,0,0
Demokratische Volksrepublik Korea,2020,7,0,0,0
Demokratische Volksrepublik Korea,2020,8,0,0,0
Demokratische Volksrepublik Korea,2020,9,0,0,0
Demokratische Volksrepublik Korea,2020,10,0,0,0
Demokratische Volksrepublik Korea,2020,11,0,0,0
Demokratische Volksrepublik Korea,2020,12,0,0,0
Demokratische Volksrepublik Korea,2021,1,0,0,0
Demokratische Volksrepublik Korea,2021,2,0,0,0
Demokratische Volksrepublik Korea,2021,3,0,0,0
Demokratische Volksrepublik Korea,2021,4,0,0,0
Demokratische Volksrepublik Korea,2021,5,0,0,0
Demokratische Volksrepublik Korea,2021,6,0,0,0
Demokratische Volksrepublik Korea,2021,7,0,0,0
Demokratische Volksrepublik Korea,2021,8,0,0,0
Demokratische Volksrepublik Korea,2021,9,0,0,0
Demokratische Volksrepublik Korea,2021,10,0,0,0
Demokratische Volksrepublik Korea,2021,11,0,0,0
Demokratische Volksrepublik Korea,2021,12,0,0,0
Demokratische Volksrepublik Korea,2022,1,0,0,0
Demokratische Volksrepublik Korea,2022,2,0,0,0
Demokratische Volksrepublik Korea,2022,3,0,0,0
Demokratische Volksrepublik Korea,2022,4,0,0,0
Demokratische Volksrepublik Korea,2022,5,0,0,0
Demokratische Volksrepublik Korea,2022,6,0,0,0
Demokratische Volksrepublik Korea,2022,7,0,0,0
Demokratische Volksrepublik Korea,2022,8,0,0,0
Demokratische Volksrepublik Korea,2022,9,0,0,0
Demokratische Volksrepublik Korea,2022,10,0,0,0
Demokratische Volksrepublik Korea,2022,11,0,0,0
Demokratische Volksrepublik Korea,2022,12,0,0,0
Demokratische Volksrepublik Korea,2023,1,0,0,0
Demokratische Volksrepublik Korea,2023,2,0,0,0
Demokratische Volksrepublik Korea,2023,3,0,0,0
Demokratische Volksrepublik Korea,2023,4,0,0,0
Demokratische Volksrepublik Korea,2023,5,0,0,0
Demokratische Volksrepublik Korea,2023,6,0,0,0
Demokratische Volksrepublik Korea,2023,7,0,0,0
Demokratische Volksrepublik Korea,2023,8,0,0,0
Demokratische Volksrepublik Korea,2023,9,0,0,0
Demokratische Volksrepublik Korea,2023,10,0,0,0
Demokratische Volksrepublik Korea,2023,11,0,0,0
Demokratische Volksrepublik Korea,2023,12,0,0,0
Demokratische Volksrepublik Korea,2024,1,0,0,0
Demokratische Volksrepublik Korea,2024,2,0,0,0
Demokratische Volksrepublik Korea,2024,3,0,0,0
Demokratische Volksrepublik Korea,2024,4,0,0,0
Demokratische Volksrepublik Korea,2024,5,0,0,0
Demokratische Volksrepublik Korea,2024,6,0,0,0
Demokratische Volksrepublik Korea,2024,7,0,0,0
Demokratische Volksrepublik Korea,2024,8,0,0,0
Demokratische Volksrepublik Korea,2024,9,0,0,0
Demokratische Volksrepublik Korea,2024,10,0,0,0
Demokratische Volksrepublik Korea,2024,11,0,0,0
Demokratische Volksrepublik Korea,2024,12,0,0,0
Demokratische Volksrepublik Laos,2008,1,1405000,3084000,4489000
Demokratische Volksrepublik Laos,2008,2,1164000,2877000,4041000
Demokratische Volksrepublik Laos,2008,3,667000,1472000,2139000
Demokratische Volksrepublik Laos,2008,4,2517000,955000,3472000
Demokratische Volksrepublik Laos,2008,5,1063000,1911000,2974000
Demokratische Volksrepublik Laos,2008,6,1376000,2812000,4188000
Demokratische Volksrepublik Laos,2008,7,442000,3335000,3777000
Demokratische Volksrepublik Laos,2008,8,1023000,2043000,3066000
Demokratische Volksrepublik Laos,2008,9,1515000,3495000,5010000
Demokratische Volksrepublik Laos,2008,10,964000,4569000,5533000
Demokratische Volksrepublik Laos,2008,11,2200000,4172000,6372000
Demokratische Volksrepublik Laos,2008,12,1345000,2908000,4253000
Demokratische Volksrepublik Laos,2009,1,737000,2909000,3646000
Demokratische Volksrepublik Laos,2009,2,837000,2476000,3313000
Demokratische Volksrepublik Laos,2009,3,1295000,3386000,4681000
Demokratische Volksrepublik Laos,2009,4,1594000,4250000,5844000
Demokratische Volksrepublik Laos,2009,5,800000,3802000,4602000
Demokratische Volksrepublik Laos,2009,6,1213000,3068000,4281000
Demokratische Volksrepublik Laos,2009,7,1469000,3609000,5078000
Demokratische Volksrepublik Laos,2009,8,258000,4566000,4824000
Demokratische Volksrepublik Laos,2009,9,900000,3758000,4658000
Demokratische Volksrepublik Laos,2009,10,1169000,3457000,4626000
Demokratische Volksrepublik Laos,2009,11,1330000,2442000,3772000
Demokratische Volksrepublik Laos,2009,12,257000,3304000,3561000
Demokratische Volksrepublik Laos,2010,1,1428000,2543000,3971000
Demokratische Volksrepublik Laos,2010,2,6314000,3354000,9668000
Demokratische Volksrepublik Laos,2010,3,871000,4464000,5335000
Demokratische Volksrepublik Laos,2010,4,1018000,3011000,4029000
Demokratische Volksrepublik Laos,2010,5,201000,3362000,3563000
Demokratische Volksrepublik Laos,2010,6,399000,4025000,4424000
Demokratische Volksrepublik Laos,2010,7,717000,6416000,7133000
Demokratische Volksrepublik Laos,2010,8,652000,4155000,4807000
Demokratische Volksrepublik Laos,2010,9,634000,3867000,4501000
Demokratische Volksrepublik Laos,2010,10,1095000,4332000,5427000
Demokratische Volksrepublik Laos,2010,11,1416000,6205000,7621000
Demokratische Volksrepublik Laos,2010,12,1555000,3164000,4719000
Demokratische Volksrepublik Laos,2011,1,1255000,3352000,4607000
Demokratische Volksrepublik Laos,2011,2,502000,4156000,4658000
Demokratische Volksrepublik Laos,2011,3,4797000,6641000,11438000
Demokratische Volksrepublik Laos,2011,4,1405000,6196000,7601000
Demokratische Volksrepublik Laos,2011,5,2833000,5634000,8467000
Demokratische Volksrepublik Laos,2011,6,629000,4380000,5009000
Demokratische Volksrepublik Laos,2011,7,494000,5647000,6141000
Demokratische Volksrepublik Laos,2011,8,565000,4084000,4649000
Demokratische Volksrepublik Laos,2011,9,1575000,9631000,11206000
Demokratische Volksrepublik Laos,2011,10,1399000,3291000,4690000
Demokratische Volksrepublik Laos,2011,11,4628000,5964000,10592000
Demokratische Volksrepublik Laos,2011,12,8014000,2735000,10749000
Demokratische Volksrepublik Laos,2012,1,1099000,4550000,5649000
Demokratische Volksrepublik Laos,2012,2,1121000,4466000,5587000
Demokratische Volksrepublik Laos,2012,3,923000,5744000,6667000
Demokratische Volksrepublik Laos,2012,4,2759000,3625000,6384000
Demokratische Volksrepublik Laos,2012,5,3820000,2936000,6756000
Demokratische Volksrepublik Laos,2012,6,6628000,4903000,11531000
Demokratische Volksrepublik Laos,2012,7,950000,5244000,6194000
Demokratische Volksrepublik Laos,2012,8,998000,5529000,6527000
Demokratische Volksrepublik Laos,2012,9,2578000,5260000,7838000
Demokratische Volksrepublik Laos,2012,10,7955000,7708000,15663000
Demokratische Volksrepublik Laos,2012,11,45368000,7060000,52428000
Demokratische Volksrepublik Laos,2012,12,45638000,3889000,49527000
Demokratische Volksrepublik Laos,2013,1,3728000,5858000,9586000
Demokratische Volksrepublik Laos,2013,2,959000,4066000,5025000
Demokratische Volksrepublik Laos,2013,3,1611000,5518000,7129000
Demokratische Volksrepublik Laos,2013,4,3966000,8431000,12397000
Demokratische Volksrepublik Laos,2013,5,1052000,3850000,4902000
Demokratische Volksrepublik Laos,2013,6,2357000,5327000,7684000
Demokratische Volksrepublik Laos,2013,7,2243000,6951000,9194000
Demokratische Volksrepublik Laos,2013,8,3979000,7474000,11453000
Demokratische Volksrepublik Laos,2013,9,6339000,7693000,14032000
Demokratische Volksrepublik Laos,2013,10,5256000,6354000,11610000
Demokratische Volksrepublik Laos,2013,11,1819000,6641000,8460000
Demokratische Volksrepublik Laos,2013,12,3452000,4511000,7963000
Demokratische Volksrepublik Laos,2014,1,3413000,5482000,8895000
Demokratische Volksrepublik Laos,2014,2,3957000,5283000,9240000
Demokratische Volksrepublik Laos,2014,3,7891000,7013000,14904000
Demokratische Volksrepublik Laos,2014,4,1471000,5663000,7134000
Demokratische Volksrepublik Laos,2014,5,4256000,4232000,8488000
Demokratische Volksrepublik Laos,2014,6,3455000,5690000,9145000
Demokratische Volksrepublik Laos,2014,7,6213000,5807000,12020000
Demokratische Volksrepublik Laos,2014,8,13626000,8211000,21837000
Demokratische Volksrepublik Laos,2014,9,7170000,7086000,14256000
Demokratische Volksrepublik Laos,2014,10,20457000,5002000,25459000
Demokratische Volksrepublik Laos,2014,11,7893000,5918000,13811000
Demokratische Volksrepublik Laos,2014,12,4391000,4752000,9143000
Demokratische Volksrepublik Laos,2015,1,1124000,4817000,5941000
Demokratische Volksrepublik Laos,2015,2,1055000,8292000,9347000
Demokratische Volksrepublik Laos,2015,3,3088000,8567000,11655000
Demokratische Volksrepublik Laos,2015,4,5496000,6617000,12113000
Demokratische Volksrepublik Laos,2015,5,1746000,6350000,8096000
Demokratische Volksrepublik Laos,2015,6,2520000,5893000,8413000
Demokratische Volksrepublik Laos,2015,7,3168000,6574000,9742000
Demokratische Volksrepublik Laos,2015,8,3388000,4293000,7681000
Demokratische Volksrepublik Laos,2015,9,4398000,6173000,10571000
Demokratische Volksrepublik Laos,2015,10,4595000,7086000,11681000
Demokratische Volksrepublik Laos,2015,11,5988000,5041000,11029000
Demokratische Volksrepublik Laos,2015,12,4428000,4830000,9258000
Demokratische Volksrepublik Laos,2016,1,2371000,8066000,10437000
Demokratische Volksrepublik Laos,2016,2,4111000,7171000,11282000
Demokratische Volksrepublik Laos,2016,3,2503000,6664000,9167000
Demokratische Volksrepublik Laos,2016,4,1083000,7172000,8255000
Demokratische Volksrepublik Laos,2016,5,717000,4615000,5332000
Demokratische Volksrepublik Laos,2016,6,2858000,5379000,8237000
Demokratische Volksrepublik Laos,2016,7,4310000,6483000,10793000
Demokratische Volksrepublik Laos,2016,8,2059000,6752000,8811000
Demokratische Volksrepublik Laos,2016,9,3339000,6593000,9932000
Demokratische Volksrepublik Laos,2016,10,2315000,5533000,7848000
Demokratische Volksrepublik Laos,2016,11,2457000,5141000,7598000
Demokratische Volksrepublik Laos,2016,12,3713000,5016000,8729000
Demokratische Volksrepublik Laos,2017,1,1780000,4488000,6268000
Demokratische Volksrepublik Laos,2017,2,2365000,6487000,8852000
Demokratische Volksrepublik Laos,2017,3,3506000,8248000,11754000
Demokratische Volksrepublik Laos,2017,4,1375000,7522000,8897000
Demokratische Volksrepublik Laos,2017,5,1346000,5410000,6756000
Demokratische Volksrepublik Laos,2017,6,1192000,6484000,7676000
Demokratische Volksrepublik Laos,2017,7,2220000,6740000,8960000
Demokratische Volksrepublik Laos,2017,8,3009000,6384000,9393000
Demokratische Volksrepublik Laos,2017,9,1852000,8552000,10404000
Demokratische Volksrepublik Laos,2017,10,3254000,5987000,9241000
Demokratische Volksrepublik Laos,2017,11,4343000,8704000,13047000
Demokratische Volksrepublik Laos,2017,12,3683000,4421000,8104000
Demokratische Volksrepublik Laos,2018,1,2483000,9474000,11957000
Demokratische Volksrepublik Laos,2018,2,3910000,6542000,10452000
Demokratische Volksrepublik Laos,2018,3,3446000,6607000,10053000
Demokratische Volksrepublik Laos,2018,4,1839000,8812000,10651000
Demokratische Volksrepublik Laos,2018,5,1947000,5556000,7503000
Demokratische Volksrepublik Laos,2018,6,1509000,7760000,9269000
Demokratische Volksrepublik Laos,2018,7,1169000,10135000,11304000
Demokratische Volksrepublik Laos,2018,8,1489000,8476000,9965000
Demokratische Volksrepublik Laos,2018,9,2197000,9078000,11275000
Demokratische Volksrepublik Laos,2018,10,1639000,8581000,10220000
Demokratische Volksrepublik Laos,2018,11,2169000,7894000,10063000
Demokratische Volksrepublik Laos,2018,12,5728000,3583000,9311000
Demokratische Volksrepublik Laos,2019,1,1058000,10657000,11715000
Demokratische Volksrepublik Laos,2019,2,1359000,7752000,9111000
Demokratische Volksrepublik Laos,2019,3,2505000,8734000,11239000
Demokratische Volksrepublik Laos,2019,4,3210000,8670000,11880000
Demokratische Volksrepublik Laos,2019,5,2921000,7802000,10723000
Demokratische Volksrepublik Laos,2019,6,1824000,7517000,9341000
Demokratische Volksrepublik Laos,2019,7,1531000,10358000,11889000
Demokratische Volksrepublik Laos,2019,8,1301000,7747000,9048000
Demokratische Volksrepublik Laos,2019,9,1302000,10043000,11345000
Demokratische Volksrepublik Laos,2019,10,1452000,10259000,11711000
Demokratische Volksrepublik Laos,2019,11,1119000,10110000,11229000
Demokratische Volksrepublik Laos,2019,12,1424000,8075000,9499000
Demokratische Volksrepublik Laos,2020,1,1204000,8374000,9578000
Demokratische Volksrepublik Laos,2020,2,1254000,5788000,7042000
Demokratische Volksrepublik Laos,2020,3,1841000,9951000,11792000
Demokratische Volksrepublik Laos,2020,4,4234000,7861000,12095000
Demokratische Volksrepublik Laos,2020,5,5014000,9098000,14112000
Demokratische Volksrepublik Laos,2020,6,5165000,6861000,12026000
Demokratische Volksrepublik Laos,2020,7,13447000,9733000,23180000
Demokratische Volksrepublik Laos,2020,8,8141000,7905000,16046000
Demokratische Volksrepublik Laos,2020,9,3655000,10190000,13845000
Demokratische Volksrepublik Laos,2020,10,2052000,10207000,12259000
Demokratische Volksrepublik Laos,2020,11,2145000,8716000,10861000
Demokratische Volksrepublik Laos,2020,12,2118000,10028000,12146000
Demokratische Volksrepublik Laos,2021,1,1507000,8327000,9834000
Demokratische Volksrepublik Laos,2021,2,1325000,8646000,9971000
Demokratische Volksrepublik Laos,2021,3,2181000,12220000,14401000
Demokratische Volksrepublik Laos,2021,4,1889000,15651000,17540000
Demokratische Volksrepublik Laos,2021,5,1959000,8687000,10646000
Demokratische Volksrepublik Laos,2021,6,2134000,12441000,14575000
Demokratische Volksrepublik Laos,2021,7,3038000,11243000,14281000
Demokratische Volksrepublik Laos,2021,8,967000,9740000,10707000
Demokratische Volksrepublik Laos,2021,9,1314000,11415000,12729000
Demokratische Volksrepublik Laos,2021,10,1341000,10592000,11933000
Demokratische Volksrepublik Laos,2021,11,2031000,13277000,15308000
Demokratische Volksrepublik Laos,2021,12,8136000,8843000,16979000
Demokratische Volksrepublik Laos,2022,1,1463000,11179000,12642000
Demokratische Volksrepublik Laos,2022,2,1905000,9696000,11601000
Demokratische Volksrepublik Laos,2022,3,2193000,14729000,16922000
Demokratische Volksrepublik Laos,2022,4,2003000,17982000,19985000
Demokratische Volksrepublik Laos,2022,5,3101000,16921000,20022000
Demokratische Volksrepublik Laos,2022,6,7174000,10760000,17934000
Demokratische Volksrepublik Laos,2022,7,2124000,14418000,16542000
Demokratische Volksrepublik Laos,2022,8,2711000,19454000,22165000
Demokratische Volksrepublik Laos,2022,9,4119000,15724000,19843000
Demokratische Volksrepublik Laos,2022,10,3531000,14577000,18108000
Demokratische Volksrepublik Laos,2022,11,2764000,20060000,22824000
Demokratische Volksrepublik Laos,2022,12,3003000,13038000,16041000
Demokratische Volksrepublik Laos,2023,1,2081000,13812000,15893000
Demokratische Volksrepublik Laos,2023,2,3366000,11834000,15200000
Demokratische Volksrepublik Laos,2023,3,2017000,16696000,18713000
Demokratische Volksrepublik Laos,2023,4,2529000,13839000,16368000
Demokratische Volksrepublik Laos,2023,5,2828000,11520000,14348000
Demokratische Volksrepublik Laos,2023,6,4077000,13054000,17131000
Demokratische Volksrepublik Laos,2023,7,3575000,15650000,19225000
Demokratische Volksrepublik Laos,2023,8,3399000,17530000,20929000
Demokratische Volksrepublik Laos,2023,9,2309000,15752000,18061000
Demokratische Volksrepublik Laos,2023,10,2636000,14005000,16641000
Demokratische Volksrepublik Laos,2023,11,10352000,18142000,28494000
Demokratische Volksrepublik Laos,2023,12,8614000,13796000,22410000
Demokratische Volksrepublik Laos,2024,1,2549000,19309000,21858000
Demokratische Volksrepublik Laos,2024,2,3322000,21020000,24342000
Demokratische Volksrepublik Laos,2024,3,2798000,15029000,17827000
Demokratische Volksrepublik Laos,2024,4,2557000,26782000,29339000
Demokratische Volksrepublik Laos,2024,5,2721000,22630000,25351000
Demokratische Volksrepublik Laos,2024,6,1860000,14265000,16125000
Demokratische Volksrepublik Laos,2024,7,6878000,27592000,34470000
Demokratische Volksrepublik Laos,2024,8,2685000,22724000,25409000
Demokratische Volksrepublik Laos,2024,9,1550000,24815000,26365000
Demokratische Volksrepublik Laos,2024,10,1884000,23153000,25037000
Demokratische Volksrepublik Laos,2024,11,1727000,29966000,31693000
Demokratische Volksrepublik Laos,2024,12,3441000,21062000,24503000
Dominica,2008,1,138000,0,138000
Dominica,2008,2,75000,7000,82000
Dominica,2008,3,168000,1000,169000
Dominica,2008,4,86000,0,86000
Dominica,2008,5,277000,1000,278000
Dominica,2008,6,119000,1000,120000
Dominica,2008,7,51000,0,51000
Dominica,2008,8,56000,0,56000
Dominica,2008,9,73000,0,73000
Dominica,2008,10,111000,27000,138000
Dominica,2008,11,76000,0,76000
Dominica,2008,12,67000,0,67000
Dominica,2009,1,13000,3000,16000
Dominica,2009,2,51000,0,51000
Dominica,2009,3,34000,13000,47000
Dominica,2009,4,53000,12000,65000
Dominica,2009,5,111000,64000,175000
Dominica,2009,6,161000,2000,163000
Dominica,2009,7,14000,76000,90000
Dominica,2009,8,100000,0,100000
Dominica,2009,9,18000,6000,24000
Dominica,2009,10,123000,0,123000
Dominica,2009,11,44000,0,44000
Dominica,2009,12,154000,0,154000
Dominica,2010,1,123000,0,123000
Dominica,2010,2,103000,8000,111000
Dominica,2010,3,169000,1000,170000
Dominica,2010,4,45000,0,45000
Dominica,2010,5,46000,0,46000
Dominica,2010,6,39000,0,39000
Dominica,2010,7,52000,0,52000
Dominica,2010,8,42000,0,42000
Dominica,2010,9,46000,0,46000
Dominica,2010,10,112000,0,112000
Dominica,2010,11,48000,0,48000
Dominica,2010,12,24000,13000,37000
Dominica,2011,1,34000,0,34000
Dominica,2011,2,21000,0,21000
Dominica,2011,3,25000,0,25000
Dominica,2011,4,230000,0,230000
Dominica,2011,5,98000,0,98000
Dominica,2011,6,16000,0,16000
Dominica,2011,7,56000,0,56000
Dominica,2011,8,57000,0,57000
Dominica,2011,9,21000,0,21000
Dominica,2011,10,16000,0,16000
Dominica,2011,11,92000,0,92000
Dominica,2011,12,78000,0,78000
Dominica,2012,1,31000,44000,75000
Dominica,2012,2,72000,0,72000
Dominica,2012,3,438000,0,438000
Dominica,2012,4,32000,0,32000
Dominica,2012,5,265000,4000,269000
Dominica,2012,6,49000,0,49000
Dominica,2012,7,54000,0,54000
Dominica,2012,8,64000,0,64000
Dominica,2012,9,96000,0,96000
Dominica,2012,10,54000,0,54000
Dominica,2012,11,36000,1000,37000
Dominica,2012,12,24000,0,24000
Dominica,2013,1,71000,0,71000
Dominica,2013,2,41000,0,41000
Dominica,2013,3,19000,2000,21000
Dominica,2013,4,69000,51000,120000
Dominica,2013,5,14000,0,14000
Dominica,2013,6,157000,1000,158000
Dominica,2013,7,56000,4000,60000
Dominica,2013,8,19000,0,19000
Dominica,2013,9,7000,19000,26000
Dominica,2013,10,124000,0,124000
Dominica,2013,11,29000,0,29000
Dominica,2013,12,40000,0,40000
Dominica,2014,1,26000,0,26000
Dominica,2014,2,36000,2000,38000
Dominica,2014,3,26000,0,26000
Dominica,2014,4,93000,0,93000
Dominica,2014,5,162000,1000,163000
Dominica,2014,6,6000,1000,7000
Dominica,2014,7,104000,0,104000
Dominica,2014,8,61000,0,61000
Dominica,2014,9,165000,1000,166000
Dominica,2014,10,213000,0,213000
Dominica,2014,11,10000,0,10000
Dominica,2014,12,18000,0,18000
Dominica,2015,1,7000,0,7000
Dominica,2015,2,60000,0,60000
Dominica,2015,3,76000,0,76000
Dominica,2015,4,53000,0,53000
Dominica,2015,5,52000,0,52000
Dominica,2015,6,74000,14000,88000
Dominica,2015,7,36000,2000,38000
Dominica,2015,8,51000,3000,54000
Dominica,2015,9,483000,0,483000
Dominica,2015,10,18000,1000,19000
Dominica,2015,11,136000,0,136000
Dominica,2015,12,19000,0,19000
Dominica,2016,1,48000,2000,50000
Dominica,2016,2,46000,1000,47000
Dominica,2016,3,19000,4000,23000
Dominica,2016,4,61000,6000,67000
Dominica,2016,5,80000,5000,85000
Dominica,2016,6,65000,5000,70000
Dominica,2016,7,110000,6000,116000
Dominica,2016,8,81000,1000,82000
Dominica,2016,9,35000,4000,39000
Dominica,2016,10,335000,5000,340000
Dominica,2016,11,81000,28000,109000
Dominica,2016,12,61000,15000,76000
Dominica,2017,1,89000,5000,94000
Dominica,2017,2,30000,3000,33000
Dominica,2017,3,48000,25000,73000
Dominica,2017,4,136000,13000,149000
Dominica,2017,5,91000,36000,127000
Dominica,2017,6,73000,31000,104000
Dominica,2017,7,48000,1000,49000
Dominica,2017,8,212000,3000,215000
Dominica,2017,9,345000,0,345000
Dominica,2017,10,92000,14000,106000
Dominica,2017,11,50000,1000,51000
Dominica,2017,12,77000,3000,80000
Dominica,2018,1,70000,4000,74000
Dominica,2018,2,74000,0,74000
Dominica,2018,3,55000,1000,56000
Dominica,2018,4,2000,2000,4000
Dominica,2018,5,53000,3000,56000
Dominica,2018,6,174000,1000,175000
Dominica,2018,7,22000,5000,27000
Dominica,2018,8,59000,2000,61000
Dominica,2018,9,301000,13000,314000
Dominica,2018,10,196000,37000,233000
Dominica,2018,11,439000,4000,443000
Dominica,2018,12,56000,0,56000
Dominica,2019,1,38000,7000,45000
Dominica,2019,2,122000,1000,123000
Dominica,2019,3,39000,6000,45000
Dominica,2019,4,9000,8000,17000
Dominica,2019,5,318000,24000,342000
Dominica,2019,6,70000,36000,106000
Dominica,2019,7,421000,3000,424000
Dominica,2019,8,72000,37000,109000
Dominica,2019,9,181000,6000,187000
Dominica,2019,10,75000,2000,77000
Dominica,2019,11,132000,1000,133000
Dominica,2019,12,74000,34000,108000
Dominica,2020,1,60000,7000,67000
Dominica,2020,2,61000,1000,62000
Dominica,2020,3,73000,0,73000
Dominica,2020,4,0,11000,11000
Dominica,2020,5,60000,35000,95000
Dominica,2020,6,27000,7000,34000
Dominica,2020,7,20000,48000,68000
Dominica,2020,8,34000,14000,48000
Dominica,2020,9,120000,30000,150000
Dominica,2020,10,40000,42000,82000
Dominica,2020,11,167000,10000,177000
Dominica,2020,12,113000,5000,118000
Dominica,2021,1,34000,15000,49000
Dominica,2021,2,51000,50000,101000
Dominica,2021,3,166000,34000,200000
Dominica,2021,4,98000,20000,118000
Dominica,2021,5,31000,56000,87000
Dominica,2021,6,35000,5000,40000
Dominica,2021,7,102000,30000,132000
Dominica,2021,8,172000,13000,185000
Dominica,2021,9,110000,2000,112000
Dominica,2021,10,264000,2000,266000
Dominica,2021,11,25000,15000,40000
Dominica,2021,12,27000,7000,34000
Dominica,2022,1,101000,7000,108000
Dominica,2022,2,43000,25000,68000
Dominica,2022,3,66000,38000,104000
Dominica,2022,4,97000,32000,129000
Dominica,2022,5,44000,72000,116000
Dominica,2022,6,26000,70000,96000
Dominica,2022,7,130000,204000,334000
Dominica,2022,8,188000,119000,307000
Dominica,2022,9,39000,26000,65000
Dominica,2022,10,69000,133000,202000
Dominica,2022,11,155000,66000,221000
Dominica,2022,12,21000,20000,41000
Dominica,2023,1,18000,99000,117000
Dominica,2023,2,41000,94000,135000
Dominica,2023,3,78000,50000,128000
Dominica,2023,4,41000,23000,64000
Dominica,2023,5,52000,134000,186000
Dominica,2023,6,174000,174000,348000
Dominica,2023,7,175000,80000,255000
Dominica,2023,8,52000,115000,167000
Dominica,2023,9,52000,193000,245000
Dominica,2023,10,5000,63000,68000
Dominica,2023,11,71000,61000,132000
Dominica,2023,12,47000,53000,100000
Dominica,2024,1,20000,91000,111000
Dominica,2024,2,7000,146000,153000
Dominica,2024,3,34000,15000,49000
Dominica,2024,4,94000,2000,96000
Dominica,2024,5,42000,21000,63000
Dominica,2024,6,47000,69000,116000
Dominica,2024,7,197000,267000,464000
Dominica,2024,8,73000,29000,102000
Dominica,2024,9,116000,26000,142000
Dominica,2024,10,300000,24000,324000
Dominica,2024,11,58000,12000,70000
Dominica,2024,12,46000,19000,65000
Dominikanische Republik,2008,1,11913000,8216000,20129000
Dominikanische Republik,2008,2,12886000,5719000,18605000
Dominikanische Republik,2008,3,10233000,6332000,16565000
Dominikanische Republik,2008,4,13428000,7408000,20836000
Dominikanische Republik,2008,5,7689000,9552000,17241000
Dominikanische Republik,2008,6,11145000,5935000,17080000
Dominikanische Republik,2008,7,9753000,8036000,17789000
Dominikanische Republik,2008,8,7390000,10454000,17844000
Dominikanische Republik,2008,9,8318000,5627000,13945000
Dominikanische Republik,2008,10,15687000,8609000,24296000
Dominikanische Republik,2008,11,8269000,9623000,17892000
Dominikanische Republik,2008,12,9483000,7135000,16618000
Dominikanische Republik,2009,1,7770000,6446000,14216000
Dominikanische Republik,2009,2,16993000,7217000,24210000
Dominikanische Republik,2009,3,17888000,8842000,26730000
Dominikanische Republik,2009,4,6657000,6260000,12917000
Dominikanische Republik,2009,5,10747000,8605000,19352000
Dominikanische Republik,2009,6,11936000,8516000,20452000
Dominikanische Republik,2009,7,9317000,7671000,16988000
Dominikanische Republik,2009,8,13242000,7536000,20778000
Dominikanische Republik,2009,9,7896000,7993000,15889000
Dominikanische Republik,2009,10,12953000,9184000,22137000
Dominikanische Republik,2009,11,18152000,7868000,26020000
Dominikanische Republik,2009,12,11326000,8474000,19800000
Dominikanische Republik,2010,1,8906000,8219000,17125000
Dominikanische Republik,2010,2,11476000,8849000,20325000
Dominikanische Republik,2010,3,17662000,10244000,27906000
Dominikanische Republik,2010,4,12767000,7188000,19955000
Dominikanische Republik,2010,5,11952000,12740000,24692000
Dominikanische Republik,2010,6,12661000,9733000,22394000
Dominikanische Republik,2010,7,11828000,13798000,25626000
Dominikanische Republik,2010,8,10619000,7620000,18239000
Dominikanische Republik,2010,9,11799000,12701000,24500000
Dominikanische Republik,2010,10,14743000,8393000,23136000
Dominikanische Republik,2010,11,14637000,9728000,24365000
Dominikanische Republik,2010,12,13848000,7438000,21286000
Dominikanische Republik,2011,1,13310000,9895000,23205000
Dominikanische Republik,2011,2,15917000,9645000,25562000
Dominikanische Republik,2011,3,15309000,11630000,26939000
Dominikanische Republik,2011,4,10723000,9593000,20316000
Dominikanische Republik,2011,5,13389000,8638000,22027000
Dominikanische Republik,2011,6,11362000,13279000,24641000
Dominikanische Republik,2011,7,12821000,12274000,25095000
Dominikanische Republik,2011,8,12744000,11526000,24270000
Dominikanische Republik,2011,9,12205000,13209000,25414000
Dominikanische Republik,2011,10,11508000,10248000,21756000
Dominikanische Republik,2011,11,15713000,9777000,25490000
Dominikanische Republik,2011,12,17365000,11253000,28618000
Dominikanische Republik,2012,1,11821000,10562000,22383000
Dominikanische Republik,2012,2,16934000,9753000,26687000
Dominikanische Republik,2012,3,15362000,15090000,30452000
Dominikanische Republik,2012,4,13620000,12520000,26140000
Dominikanische Republik,2012,5,17852000,12344000,30196000
Dominikanische Republik,2012,6,13750000,12164000,25914000
Dominikanische Republik,2012,7,12137000,12479000,24616000
Dominikanische Republik,2012,8,12463000,13067000,25530000
Dominikanische Republik,2012,9,15416000,14124000,29540000
Dominikanische Republik,2012,10,15348000,12780000,28128000
Dominikanische Republik,2012,11,16858000,11320000,28178000
Dominikanische Republik,2012,12,11632000,10618000,22250000
Dominikanische Republik,2013,1,13869000,11424000,25293000
Dominikanische Republik,2013,2,16347000,11669000,28016000
Dominikanische Republik,2013,3,11165000,11589000,22754000
Dominikanische Republik,2013,4,13657000,16021000,29678000
Dominikanische Republik,2013,5,18222000,14988000,33210000
Dominikanische Republik,2013,6,12264000,17332000,29596000
Dominikanische Republik,2013,7,13553000,17792000,31345000
Dominikanische Republik,2013,8,17024000,15033000,32057000
Dominikanische Republik,2013,9,15161000,14864000,30025000
Dominikanische Republik,2013,10,18538000,15850000,34388000
Dominikanische Republik,2013,11,20664000,12018000,32682000
Dominikanische Republik,2013,12,15614000,14490000,30104000
Dominikanische Republik,2014,1,18387000,13125000,31512000
Dominikanische Republik,2014,2,16271000,12233000,28504000
Dominikanische Republik,2014,3,14643000,16826000,31469000
Dominikanische Republik,2014,4,12023000,17197000,29220000
Dominikanische Republik,2014,5,11689000,14921000,26610000
Dominikanische Republik,2014,6,11364000,16453000,27817000
Dominikanische Republik,2014,7,14029000,17144000,31173000
Dominikanische Republik,2014,8,11010000,16038000,27048000
Dominikanische Republik,2014,9,13228000,16678000,29906000
Dominikanische Republik,2014,10,14173000,14480000,28653000
Dominikanische Republik,2014,11,13444000,14413000,27857000
Dominikanische Republik,2014,12,14440000,13852000,28292000
Dominikanische Republik,2015,1,15354000,12140000,27494000
Dominikanische Republik,2015,2,14543000,14762000,29305000
Dominikanische Republik,2015,3,16880000,16222000,33102000
Dominikanische Republik,2015,4,16255000,16581000,32836000
Dominikanische Republik,2015,5,12634000,18480000,31114000
Dominikanische Republik,2015,6,18419000,20289000,38708000
Dominikanische Republik,2015,7,14919000,18349000,33268000
Dominikanische Republik,2015,8,16334000,17898000,34232000
Dominikanische Republik,2015,9,17287000,17889000,35176000
Dominikanische Republik,2015,10,22937000,14650000,37587000
Dominikanische Republik,2015,11,19741000,16374000,36115000
Dominikanische Republik,2015,12,23586000,13411000,36997000
Dominikanische Republik,2016,1,13003000,10548000,23551000
Dominikanische Republik,2016,2,16994000,14026000,31020000
Dominikanische Republik,2016,3,16629000,13509000,30138000
Dominikanische Republik,2016,4,20726000,14966000,35692000
Dominikanische Republik,2016,5,13893000,16205000,30098000
Dominikanische Republik,2016,6,21479000,14593000,36072000
Dominikanische Republik,2016,7,15849000,16341000,32190000
Dominikanische Republik,2016,8,16618000,19616000,36234000
Dominikanische Republik,2016,9,16757000,17622000,34379000
Dominikanische Republik,2016,10,22670000,15574000,38244000
Dominikanische Republik,2016,11,26528000,16484000,43012000
Dominikanische Republik,2016,12,21596000,15647000,37243000
Dominikanische Republik,2017,1,22275000,12724000,34999000
Dominikanische Republik,2017,2,16840000,13776000,30616000
Dominikanische Republik,2017,3,21728000,13499000,35227000
Dominikanische Republik,2017,4,14699000,15896000,30595000
Dominikanische Republik,2017,5,15973000,14789000,30762000
Dominikanische Republik,2017,6,13136000,14503000,27639000
Dominikanische Republik,2017,7,18172000,16793000,34965000
Dominikanische Republik,2017,8,18742000,17042000,35784000
Dominikanische Republik,2017,9,16271000,14797000,31068000
Dominikanische Republik,2017,10,20391000,14776000,35167000
Dominikanische Republik,2017,11,29245000,13427000,42672000
Dominikanische Republik,2017,12,24122000,12724000,36846000
Dominikanische Republik,2018,1,32968000,12656000,45624000
Dominikanische Republik,2018,2,25019000,11942000,36961000
Dominikanische Republik,2018,3,18934000,14279000,33213000
Dominikanische Republik,2018,4,22296000,15843000,38139000
Dominikanische Republik,2018,5,16196000,14363000,30559000
Dominikanische Republik,2018,6,20435000,15402000,35837000
Dominikanische Republik,2018,7,20345000,16518000,36863000
Dominikanische Republik,2018,8,23090000,18122000,41212000
Dominikanische Republik,2018,9,30855000,15460000,46315000
Dominikanische Republik,2018,10,20606000,14333000,34939000
Dominikanische Republik,2018,11,27526000,16379000,43905000
Dominikanische Republik,2018,12,23261000,12496000,35757000
Dominikanische Republik,2019,1,22165000,16819000,38984000
Dominikanische Republik,2019,2,21090000,17415000,38505000
Dominikanische Republik,2019,3,20813000,16676000,37489000
Dominikanische Republik,2019,4,22467000,18875000,41342000
Dominikanische Republik,2019,5,22507000,16977000,39484000
Dominikanische Republik,2019,6,15493000,19056000,34549000
Dominikanische Republik,2019,7,20727000,20732000,41459000
Dominikanische Republik,2019,8,19685000,21660000,41345000
Dominikanische Republik,2019,9,24142000,20389000,44531000
Dominikanische Republik,2019,10,31628000,20935000,52563000
Dominikanische Republik,2019,11,26407000,19873000,46280000
Dominikanische Republik,2019,12,22574000,18289000,40863000
Dominikanische Republik,2020,1,24396000,19452000,43848000
Dominikanische Republik,2020,2,24012000,17150000,41162000
Dominikanische Republik,2020,3,23491000,24813000,48304000
Dominikanische Republik,2020,4,16199000,19842000,36041000
Dominikanische Republik,2020,5,10822000,18853000,29675000
Dominikanische Republik,2020,6,18016000,19456000,37472000
Dominikanische Republik,2020,7,18887000,22406000,41293000
Dominikanische Republik,2020,8,17894000,20949000,38843000
Dominikanische Republik,2020,9,16986000,21106000,38092000
Dominikanische Republik,2020,10,20468000,20864000,41332000
Dominikanische Republik,2020,11,20769000,19454000,40223000
Dominikanische Republik,2020,12,16052000,14190000,30242000
Dominikanische Republik,2021,1,10980000,17593000,28573000
Dominikanische Republik,2021,2,17554000,20258000,37812000
Dominikanische Republik,2021,3,22600000,21674000,44274000
Dominikanische Republik,2021,4,19637000,20614000,40251000
Dominikanische Republik,2021,5,20718000,18931000,39649000
Dominikanische Republik,2021,6,21675000,23040000,44715000
Dominikanische Republik,2021,7,21820000,22875000,44695000
Dominikanische Republik,2021,8,16809000,21394000,38203000
Dominikanische Republik,2021,9,33097000,21147000,54244000
Dominikanische Republik,2021,10,36029000,21913000,57942000
Dominikanische Republik,2021,11,31565000,21598000,53163000
Dominikanische Republik,2021,12,31885000,19893000,51778000
Dominikanische Republik,2022,1,26112000,18590000,44702000
Dominikanische Republik,2022,2,28632000,18554000,47186000
Dominikanische Republik,2022,3,29208000,24322000,53530000
Dominikanische Republik,2022,4,28187000,19586000,47773000
Dominikanische Republik,2022,5,35848000,26329000,62177000
Dominikanische Republik,2022,6,27363000,23459000,50822000
Dominikanische Republik,2022,7,35253000,25245000,60498000
Dominikanische Republik,2022,8,26964000,24843000,51807000
Dominikanische Republik,2022,9,34027000,23997000,58024000
Dominikanische Republik,2022,10,33828000,24796000,58624000
Dominikanische Republik,2022,11,33497000,30654000,64151000
Dominikanische Republik,2022,12,25548000,19156000,44704000
Dominikanische Republik,2023,1,21399000,22852000,44251000
Dominikanische Republik,2023,2,30062000,18767000,48829000
Dominikanische Republik,2023,3,42507000,24029000,66536000
Dominikanische Republik,2023,4,25332000,24888000,50220000
Dominikanische Republik,2023,5,33856000,25114000,58970000
Dominikanische Republik,2023,6,34042000,30000000,64042000
Dominikanische Republik,2023,7,29655000,29408000,59063000
Dominikanische Republik,2023,8,26664000,28425000,55089000
Dominikanische Republik,2023,9,35422000,24527000,59949000
Dominikanische Republik,2023,10,32372000,25266000,57638000
Dominikanische Republik,2023,11,34735000,24725000,59460000
Dominikanische Republik,2023,12,26687000,19970000,46657000
Dominikanische Republik,2024,1,35493000,20649000,56142000
Dominikanische Republik,2024,2,34747000,18876000,53623000
Dominikanische Republik,2024,3,34360000,19434000,53794000
Dominikanische Republik,2024,4,37860000,27932000,65792000
Dominikanische Republik,2024,5,28675000,29391000,58066000
Dominikanische Republik,2024,6,30237000,26305000,56542000
Dominikanische Republik,2024,7,36419000,30112000,66531000
Dominikanische Republik,2024,8,40418000,27560000,67978000
Dominikanische Republik,2024,9,40615000,22729000,63344000
Dominikanische Republik,2024,10,35818000,23989000,59807000
Dominikanische Republik,2024,11,36816000,21132000,57948000
Dominikanische Republik,2024,12,33069000,20042000,53111000
Dschibuti,2008,1,951000,0,951000
Dschibuti,2008,2,1416000,0,1416000
Dschibuti,2008,3,1377000,0,1377000
Dschibuti,2008,4,1274000,24000,1298000
Dschibuti,2008,5,1721000,57000,1778000
Dschibuti,2008,6,901000,50000,951000
Dschibuti,2008,7,933000,3000,936000
Dschibuti,2008,8,867000,0,867000
Dschibuti,2008,9,816000,91000,907000
Dschibuti,2008,10,1282000,0,1282000
Dschibuti,2008,11,959000,1000,960000
Dschibuti,2008,12,557000,0,557000
Dschibuti,2009,1,1224000,0,1224000
Dschibuti,2009,2,851000,1000,852000
Dschibuti,2009,3,1621000,47000,1668000
Dschibuti,2009,4,590000,15000,605000
Dschibuti,2009,5,478000,0,478000
Dschibuti,2009,6,400000,7000,407000
Dschibuti,2009,7,679000,29000,708000
Dschibuti,2009,8,442000,29000,471000
Dschibuti,2009,9,373000,29000,402000
Dschibuti,2009,10,801000,1000,802000
Dschibuti,2009,11,2007000,0,2007000
Dschibuti,2009,12,758000,0,758000
Dschibuti,2010,1,217000,61000,278000
Dschibuti,2010,2,529000,0,529000
Dschibuti,2010,3,2295000,0,2295000
Dschibuti,2010,4,251000,5000,256000
Dschibuti,2010,5,671000,20000,691000
Dschibuti,2010,6,771000,154000,925000
Dschibuti,2010,7,373000,1000,374000
Dschibuti,2010,8,605000,0,605000
Dschibuti,2010,9,190000,1000,191000
Dschibuti,2010,10,342000,0,342000
Dschibuti,2010,11,425000,10000,435000
Dschibuti,2010,12,172000,22000,194000
Dschibuti,2011,1,742000,24000,766000
Dschibuti,2011,2,296000,0,296000
Dschibuti,2011,3,746000,139000,885000
Dschibuti,2011,4,546000,30000,576000
Dschibuti,2011,5,852000,0,852000
Dschibuti,2011,6,448000,21000,469000
Dschibuti,2011,7,1061000,0,1061000
Dschibuti,2011,8,321000,0,321000
Dschibuti,2011,9,197000,19000,216000
Dschibuti,2011,10,308000,1000,309000
Dschibuti,2011,11,533000,105000,638000
Dschibuti,2011,12,1352000,122000,1474000
Dschibuti,2012,1,379000,1000,380000
Dschibuti,2012,2,292000,0,292000
Dschibuti,2012,3,1123000,126000,1249000
Dschibuti,2012,4,1088000,17000,1105000
Dschibuti,2012,5,1592000,0,1592000
Dschibuti,2012,6,561000,3000,564000
Dschibuti,2012,7,761000,0,761000
Dschibuti,2012,8,923000,20000,943000
Dschibuti,2012,9,834000,0,834000
Dschibuti,2012,10,815000,220000,1035000
Dschibuti,2012,11,1273000,0,1273000
Dschibuti,2012,12,817000,0,817000
Dschibuti,2013,1,781000,0,781000
Dschibuti,2013,2,1361000,0,1361000
Dschibuti,2013,3,1049000,0,1049000
Dschibuti,2013,4,1422000,0,1422000
Dschibuti,2013,5,1192000,2000,1194000
Dschibuti,2013,6,4142000,3000,4145000
Dschibuti,2013,7,1538000,2000,1540000
Dschibuti,2013,8,1102000,0,1102000
Dschibuti,2013,9,1478000,0,1478000
Dschibuti,2013,10,975000,3000,978000
Dschibuti,2013,11,1385000,2000,1387000
Dschibuti,2013,12,823000,0,823000
Dschibuti,2014,1,422000,0,422000
Dschibuti,2014,2,447000,0,447000
Dschibuti,2014,3,532000,2000,534000
Dschibuti,2014,4,719000,0,719000
Dschibuti,2014,5,581000,0,581000
Dschibuti,2014,6,658000,1000,659000
Dschibuti,2014,7,635000,0,635000
Dschibuti,2014,8,419000,0,419000
Dschibuti,2014,9,832000,0,832000
Dschibuti,2014,10,660000,1000,661000
Dschibuti,2014,11,1518000,0,1518000
Dschibuti,2014,12,747000,1000,748000
Dschibuti,2015,1,1176000,2000,1178000
Dschibuti,2015,2,886000,0,886000
Dschibuti,2015,3,975000,7000,982000
Dschibuti,2015,4,2250000,41000,2291000
Dschibuti,2015,5,1258000,0,1258000
Dschibuti,2015,6,1746000,0,1746000
Dschibuti,2015,7,1744000,0,1744000
Dschibuti,2015,8,1878000,7000,1885000
Dschibuti,2015,9,1143000,0,1143000
Dschibuti,2015,10,1314000,41000,1355000
Dschibuti,2015,11,2046000,0,2046000
Dschibuti,2015,12,2179000,0,2179000
Dschibuti,2016,1,2702000,0,2702000
Dschibuti,2016,2,2643000,0,2643000
Dschibuti,2016,3,1669000,0,1669000
Dschibuti,2016,4,1000000,0,1000000
Dschibuti,2016,5,856000,13000,869000
Dschibuti,2016,6,2528000,0,2528000
Dschibuti,2016,7,1037000,45000,1082000
Dschibuti,2016,8,2948000,33000,2981000
Dschibuti,2016,9,1126000,84000,1210000
Dschibuti,2016,10,1108000,0,1108000
Dschibuti,2016,11,3039000,0,3039000
Dschibuti,2016,12,1143000,80000,1223000
Dschibuti,2017,1,2117000,0,2117000
Dschibuti,2017,2,1528000,2000,1530000
Dschibuti,2017,3,1901000,3000,1904000
Dschibuti,2017,4,1454000,30000,1484000
Dschibuti,2017,5,1765000,295000,2060000
Dschibuti,2017,6,1508000,0,1508000
Dschibuti,2017,7,1015000,0,1015000
Dschibuti,2017,8,2703000,0,2703000
Dschibuti,2017,9,1839000,0,1839000
Dschibuti,2017,10,1311000,1000,1312000
Dschibuti,2017,11,1109000,2000,1111000
Dschibuti,2017,12,1272000,0,1272000
Dschibuti,2018,1,403000,2000,405000
Dschibuti,2018,2,663000,3000,666000
Dschibuti,2018,3,838000,42000,880000
Dschibuti,2018,4,1421000,6000,1427000
Dschibuti,2018,5,1068000,0,1068000
Dschibuti,2018,6,879000,2000,881000
Dschibuti,2018,7,2842000,1000,2843000
Dschibuti,2018,8,996000,0,996000
Dschibuti,2018,9,1046000,239000,1285000
Dschibuti,2018,10,1204000,2000,1206000
Dschibuti,2018,11,1651000,6000,1657000
Dschibuti,2018,12,1228000,3000,1231000
Dschibuti,2019,1,1373000,41000,1414000
Dschibuti,2019,2,1672000,18000,1690000
Dschibuti,2019,3,1374000,6000,1380000
Dschibuti,2019,4,1253000,6000,1259000
Dschibuti,2019,5,2179000,10000,2189000
Dschibuti,2019,6,692000,75000,767000
Dschibuti,2019,7,1164000,5000,1169000
Dschibuti,2019,8,1717000,1000,1718000
Dschibuti,2019,9,1322000,73000,1395000
Dschibuti,2019,10,1015000,5000,1020000
Dschibuti,2019,11,2103000,5000,2108000
Dschibuti,2019,12,880000,139000,1019000
Dschibuti,2020,1,1929000,49000,1978000
Dschibuti,2020,2,1529000,18000,1547000
Dschibuti,2020,3,680000,4000,684000
Dschibuti,2020,4,1247000,1000,1248000
Dschibuti,2020,5,764000,26000,790000
Dschibuti,2020,6,2262000,532000,2794000
Dschibuti,2020,7,1256000,2000,1258000
Dschibuti,2020,8,1433000,443000,1876000
Dschibuti,2020,9,839000,56000,895000
Dschibuti,2020,10,1095000,117000,1212000
Dschibuti,2020,11,1785000,310000,2095000
Dschibuti,2020,12,1336000,52000,1388000
Dschibuti,2021,1,2097000,43000,2140000
Dschibuti,2021,2,1407000,38000,1445000
Dschibuti,2021,3,2615000,7000,2622000
Dschibuti,2021,4,3639000,45000,3684000
Dschibuti,2021,5,2510000,207000,2717000
Dschibuti,2021,6,2563000,674000,3237000
Dschibuti,2021,7,2019000,15000,2034000
Dschibuti,2021,8,1631000,32000,1663000
Dschibuti,2021,9,1430000,83000,1513000
Dschibuti,2021,10,784000,6000,790000
Dschibuti,2021,11,1296000,321000,1617000
Dschibuti,2021,12,745000,184000,929000
Dschibuti,2022,1,848000,105000,953000
Dschibuti,2022,2,2710000,89000,2799000
Dschibuti,2022,3,2284000,80000,2364000
Dschibuti,2022,4,2139000,71000,2210000
Dschibuti,2022,5,2115000,44000,2159000
Dschibuti,2022,6,1317000,108000,1425000
Dschibuti,2022,7,1109000,64000,1173000
Dschibuti,2022,8,856000,97000,953000
Dschibuti,2022,9,2364000,129000,2493000
Dschibuti,2022,10,1160000,128000,1288000
Dschibuti,2022,11,1375000,212000,1587000
Dschibuti,2022,12,899000,182000,1081000
Dschibuti,2023,1,1554000,112000,1666000
Dschibuti,2023,2,1623000,46000,1669000
Dschibuti,2023,3,1168000,77000,1245000
Dschibuti,2023,4,1399000,287000,1686000
Dschibuti,2023,5,978000,92000,1070000
Dschibuti,2023,6,1544000,48000,1592000
Dschibuti,2023,7,1140000,168000,1308000
Dschibuti,2023,8,1191000,164000,1355000
Dschibuti,2023,9,772000,127000,899000
Dschibuti,2023,10,1009000,116000,1125000
Dschibuti,2023,11,1215000,296000,1511000
Dschibuti,2023,12,527000,194000,721000
Dschibuti,2024,1,1546000,293000,1839000
Dschibuti,2024,2,1855000,99000,1954000
Dschibuti,2024,3,1046000,64000,1110000
Dschibuti,2024,4,1261000,106000,1367000
Dschibuti,2024,5,820000,207000,1027000
Dschibuti,2024,6,2632000,60000,2692000
Dschibuti,2024,7,2886000,2000,2888000
Dschibuti,2024,8,2752000,118000,2870000
Dschibuti,2024,9,2806000,2000,2808000
Dschibuti,2024,10,980000,318000,1298000
Dschibuti,2024,11,1210000,22000,1232000
Dschibuti,2024,12,1203000,22000,1225000
Dänemark,2008,1,1322818000,917326000,2240144000
Dänemark,2008,2,1322643000,1006513000,2329156000
Dänemark,2008,3,1324767000,1014119000,2338886000
Dänemark,2008,4,1396813000,991581000,2388394000
Dänemark,2008,5,1394150000,969245000,2363395000
Dänemark,2008,6,1396665000,939299000,2335964000
Dänemark,2008,7,1350699000,1178139000,2528838000
Dänemark,2008,8,1346683000,887291000,2233974000
Dänemark,2008,9,1377014000,1001952000,2378966000
Dänemark,2008,10,1469010000,1009229000,2478239000
Dänemark,2008,11,1228635000,1021606000,2250241000
Dänemark,2008,12,1077014000,971076000,2048090000
Dänemark,2009,1,1203507000,880501000,2084008000
Dänemark,2009,2,1042771000,864454000,1907225000
Dänemark,2009,3,1148119000,869642000,2017761000
Dänemark,2009,4,1049669000,783765000,1833434000
Dänemark,2009,5,982117000,785901000,1768018000
Dänemark,2009,6,1068718000,746096000,1814814000
Dänemark,2009,7,1005963000,915782000,1921745000
Dänemark,2009,8,979832000,783930000,1763762000
Dänemark,2009,9,1145028000,891791000,2036819000
Dänemark,2009,10,1108177000,1024699000,2132876000
Dänemark,2009,11,1051875000,864759000,1916634000
Dänemark,2009,12,1022895000,1175632000,2198527000
Dänemark,2010,1,1008903000,754803000,1763706000
Dänemark,2010,2,1023997000,713511000,1737508000
Dänemark,2010,3,1230451000,970003000,2200454000
Dänemark,2010,4,1077366000,789209000,1866575000
Dänemark,2010,5,1105033000,887529000,1992562000
Dänemark,2010,6,1155011000,900099000,2055110000
Dänemark,2010,7,1061690000,885892000,1947582000
Dänemark,2010,8,1126668000,887150000,2013818000
Dänemark,2010,9,1239450000,928601000,2168051000
Dänemark,2010,10,1217202000,1002622000,2219824000
Dänemark,2010,11,1241457000,838065000,2079522000
Dänemark,2010,12,1566351000,1072196000,2638547000
Dänemark,2011,1,1138579000,861755000,2000334000
Dänemark,2011,2,1166778000,946477000,2113255000
Dänemark,2011,3,1403141000,975230000,2378371000
Dänemark,2011,4,1122280000,896503000,2018783000
Dänemark,2011,5,1240762000,1101911000,2342673000
Dänemark,2011,6,1229943000,1057473000,2287416000
Dänemark,2011,7,1179259000,913340000,2092599000
Dänemark,2011,8,1236807000,978451000,2215258000
Dänemark,2011,9,1346898000,986410000,2333308000
Dänemark,2011,10,1246080000,1087245000,2333325000
Dänemark,2011,11,1278960000,1197086000,2476046000
Dänemark,2011,12,1179827000,1176200000,2356027000
Dänemark,2012,1,1106181000,852899000,1959080000
Dänemark,2012,2,1263789000,1013911000,2277700000
Dänemark,2012,3,1317469000,1004841000,2322310000
Dänemark,2012,4,1142520000,866553000,2009073000
Dänemark,2012,5,1309061000,968793000,2277854000
Dänemark,2012,6,1286089000,952144000,2238233000
Dänemark,2012,7,1180051000,899207000,2079258000
Dänemark,2012,8,1237937000,967536000,2205473000
Dänemark,2012,9,1260368000,932711000,2193079000
Dänemark,2012,10,1365848000,1075315000,2441163000
Dänemark,2012,11,1285455000,964945000,2250400000
Dänemark,2012,12,1120321000,814251000,1934572000
Dänemark,2013,1,1249839000,877468000,2127307000
Dänemark,2013,2,1229265000,995185000,2224450000
Dänemark,2013,3,1267162000,899319000,2166481000
Dänemark,2013,4,1309397000,858500000,2167897000
Dänemark,2013,5,1325622000,979683000,2305305000
Dänemark,2013,6,1398980000,950949000,2349929000
Dänemark,2013,7,1294157000,916231000,2210388000
Dänemark,2013,8,1346842000,1010381000,2357223000
Dänemark,2013,9,1415899000,1026450000,2442349000
Dänemark,2013,10,1449806000,1084267000,2534073000
Dänemark,2013,11,1397316000,1062650000,2459966000
Dänemark,2013,12,1142614000,897670000,2040284000
Dänemark,2014,1,1328094000,1071909000,2400003000
Dänemark,2014,2,1332966000,986372000,2319338000
Dänemark,2014,3,1350857000,973426000,2324283000
Dänemark,2014,4,1381750000,982462000,2364212000
Dänemark,2014,5,1358411000,902203000,2260614000
Dänemark,2014,6,1340307000,1026786000,2367093000
Dänemark,2014,7,1326556000,992733000,2319289000
Dänemark,2014,8,1349663000,883940000,2233603000
Dänemark,2014,9,1508007000,1030467000,2538474000
Dänemark,2014,10,1668743000,1073356000,2742099000
Dänemark,2014,11,1473822000,1001825000,2475647000
Dänemark,2014,12,1363681000,906241000,2269922000
Dänemark,2015,1,1447619000,847691000,2295310000
Dänemark,2015,2,1414434000,908727000,2323161000
Dänemark,2015,3,1561608000,962849000,2524457000
Dänemark,2015,4,1393048000,905348000,2298396000
Dänemark,2015,5,1409042000,948007000,2357049000
Dänemark,2015,6,1501801000,1100907000,2602708000
Dänemark,2015,7,1400285000,985950000,2386235000
Dänemark,2015,8,1365287000,1000393000,2365680000
Dänemark,2015,9,1584506000,1001716000,2586222000
Dänemark,2015,10,1590517000,1078869000,2669386000
Dänemark,2015,11,1528580000,1089295000,2617875000
Dänemark,2015,12,1391042000,962151000,2353193000
Dänemark,2016,1,1409808000,894032000,2303840000
Dänemark,2016,2,1500037000,972172000,2472209000
Dänemark,2016,3,1582057000,1009569000,2591626000
Dänemark,2016,4,1583428000,1008126000,2591554000
Dänemark,2016,5,1471435000,943350000,2414785000
Dänemark,2016,6,1598408000,993323000,2591731000
Dänemark,2016,7,1361830000,937448000,2299278000
Dänemark,2016,8,1492275000,899702000,2391977000
Dänemark,2016,9,1571229000,1008341000,2579570000
Dänemark,2016,10,1528613000,1004645000,2533258000
Dänemark,2016,11,1693381000,1021860000,2715241000
Dänemark,2016,12,1380082000,985379000,2365461000
Dänemark,2017,1,1508276000,967363000,2475639000
Dänemark,2017,2,1510421000,871653000,2382074000
Dänemark,2017,3,1685036000,1035762000,2720798000
Dänemark,2017,4,1622056000,920355000,2542411000
Dänemark,2017,5,1512267000,965904000,2478171000
Dänemark,2017,6,1660857000,964339000,2625196000
Dänemark,2017,7,1364278000,960240000,2324518000
Dänemark,2017,8,1512867000,981245000,2494112000
Dänemark,2017,9,1605092000,1124237000,2729329000
Dänemark,2017,10,1604811000,1058245000,2663056000
Dänemark,2017,11,1597530000,1061660000,2659190000
Dänemark,2017,12,1511286000,998559000,2509845000
Dänemark,2018,1,1551925000,939728000,2491653000
Dänemark,2018,2,1529332000,984887000,2514219000
Dänemark,2018,3,1503819000,992776000,2496595000
Dänemark,2018,4,1949581000,1008671000,2958252000
Dänemark,2018,5,2519186000,1012977000,3532163000
Dänemark,2018,6,1730893000,1045783000,2776676000
Dänemark,2018,7,1471981000,949601000,2421582000
Dänemark,2018,8,1487601000,1089701000,2577302000
Dänemark,2018,9,1549308000,1658243000,3207551000
Dänemark,2018,10,1688463000,1000732000,2689195000
Dänemark,2018,11,1691018000,1081401000,2772419000
Dänemark,2018,12,1434530000,911705000,2346235000
Dänemark,2019,1,1567188000,973140000,2540328000
Dänemark,2019,2,1511377000,968740000,2480117000
Dänemark,2019,3,1710166000,1033841000,2744007000
Dänemark,2019,4,1567289000,961860000,2529149000
Dänemark,2019,5,1559328000,965158000,2524486000
Dänemark,2019,6,1601570000,966549000,2568119000
Dänemark,2019,7,1555581000,956952000,2512533000
Dänemark,2019,8,1506788000,970163000,2476951000
Dänemark,2019,9,1631771000,1050903000,2682674000
Dänemark,2019,10,1745009000,1044514000,2789523000
Dänemark,2019,11,1821031000,1044834000,2865865000
Dänemark,2019,12,1476479000,905102000,2381581000
Dänemark,2020,1,1519908000,951043000,2470951000
Dänemark,2020,2,1669614000,994875000,2664489000
Dänemark,2020,3,1639130000,1053625000,2692755000
Dänemark,2020,4,1268000000,870688000,2138688000
Dänemark,2020,5,1350986000,806462000,2157448000
Dänemark,2020,6,1681822000,878533000,2560355000
Dänemark,2020,7,1418187000,886857000,2305044000
Dänemark,2020,8,1453523000,892765000,2346288000
Dänemark,2020,9,1700610000,980921000,2681531000
Dänemark,2020,10,1667212000,977336000,2644548000
Dänemark,2020,11,1651819000,1004141000,2655960000
Dänemark,2020,12,1492161000,863898000,2356059000
Dänemark,2021,1,1608639000,887535000,2496174000
Dänemark,2021,2,1628493000,905509000,2534002000
Dänemark,2021,3,1815573000,1075265000,2890838000
Dänemark,2021,4,1583290000,953679000,2536969000
Dänemark,2021,5,1680497000,1002070000,2682567000
Dänemark,2021,6,1815124000,1047990000,2863114000
Dänemark,2021,7,1679511000,1030078000,2709589000
Dänemark,2021,8,1621168000,966309000,2587477000
Dänemark,2021,9,1881249000,1150968000,3032217000
Dänemark,2021,10,1866819000,1160168000,3026987000
Dänemark,2021,11,1944093000,1259663000,3203756000
Dänemark,2021,12,1796739000,1190360000,2987099000
Dänemark,2022,1,1836957000,1081173000,2918130000
Dänemark,2022,2,1844446000,1118229000,2962675000
Dänemark,2022,3,2276570000,1644336000,3920906000
Dänemark,2022,4,1891869000,1132884000,3024753000
Dänemark,2022,5,2095332000,1314662000,3409994000
Dänemark,2022,6,2148863000,1327439000,3476302000
Dänemark,2022,7,1825970000,1446763000,3272733000
Dänemark,2022,8,1968521000,1517385000,3485906000
Dänemark,2022,9,2167808000,1408443000,3576251000
Dänemark,2022,10,1854054000,1276673000,3130727000
Dänemark,2022,11,2153424000,1426988000,3580412000
Dänemark,2022,12,1919131000,1282725000,3201856000
Dänemark,2023,1,1931293000,1185142000,3116435000
Dänemark,2023,2,1752219000,1393800000,3146019000
Dänemark,2023,3,2085564000,1417109000,3502673000
Dänemark,2023,4,1682720000,1095760000,2778480000
Dänemark,2023,5,1860570000,1237131000,3097701000
Dänemark,2023,6,2010313000,1343194000,3353507000
Dänemark,2023,7,1681840000,1269310000,2951150000
Dänemark,2023,8,1815407000,1214738000,3030145000
Dänemark,2023,9,1906758000,1277376000,3184134000
Dänemark,2023,10,1860617000,1186693000,3047310000
Dänemark,2023,11,2000122000,1220290000,3220412000
Dänemark,2023,12,1685524000,1033561000,2719085000
Dänemark,2024,1,1977543000,1233873000,3211416000
Dänemark,2024,2,1808056000,1251785000,3059841000
Dänemark,2024,3,1862355000,1295788000,3158143000
Dänemark,2024,4,2045129000,1248118000,3293247000
Dänemark,2024,5,1933814000,1168622000,3102436000
Dänemark,2024,6,1845713000,1287552000,3133265000
Dänemark,2024,7,1746947000,1158463000,2905410000
Dänemark,2024,8,1796932000,1229193000,3026125000
Dänemark,2024,9,1936923000,1172442000,3109365000
Dänemark,2024,10,1996717000,1287874000,3284591000
Dänemark,2024,11,1891359000,1217693000,3109052000
Dänemark,2024,12,1661160000,1240878000,2902038000
Ecuador,2008,1,19119000,32607000,51726000
Ecuador,2008,2,20916000,47573000,68489000
Ecuador,2008,3,16494000,34936000,51430000
Ecuador,2008,4,23371000,49395000,72766000
Ecuador,2008,5,26599000,47594000,74193000
Ecuador,2008,6,18519000,33091000,51610000
Ecuador,2008,7,23086000,30243000,53329000
Ecuador,2008,8,22580000,30226000,52806000
Ecuador,2008,9,17857000,36715000,54572000
Ecuador,2008,10,27087000,37464000,64551000
Ecuador,2008,11,21955000,46455000,68410000
Ecuador,2008,12,26147000,36251000,62398000
Ecuador,2009,1,23464000,44757000,68221000
Ecuador,2009,2,26135000,40303000,66438000
Ecuador,2009,3,21202000,39951000,61153000
Ecuador,2009,4,17025000,40479000,57504000
Ecuador,2009,5,16043000,35501000,51544000
Ecuador,2009,6,19163000,31541000,50704000
Ecuador,2009,7,28543000,32508000,61051000
Ecuador,2009,8,15197000,25857000,41054000
Ecuador,2009,9,23661000,30835000,54496000
Ecuador,2009,10,17750000,31532000,49282000
Ecuador,2009,11,22232000,30502000,52734000
Ecuador,2009,12,27728000,23827000,51555000
Ecuador,2010,1,19365000,31208000,50573000
Ecuador,2010,2,23912000,35560000,59472000
Ecuador,2010,3,36876000,41230000,78106000
Ecuador,2010,4,23477000,40609000,64086000
Ecuador,2010,5,30986000,33515000,64501000
Ecuador,2010,6,30229000,39526000,69755000
Ecuador,2010,7,28598000,37852000,66450000
Ecuador,2010,8,32694000,30749000,63443000
Ecuador,2010,9,38006000,31530000,69536000
Ecuador,2010,10,28374000,31640000,60014000
Ecuador,2010,11,74247000,30105000,104352000
Ecuador,2010,12,65841000,28718000,94559000
Ecuador,2011,1,23294000,36402000,59696000
Ecuador,2011,2,29018000,44436000,73454000
Ecuador,2011,3,30883000,46763000,77646000
Ecuador,2011,4,32269000,48285000,80554000
Ecuador,2011,5,36265000,42135000,78400000
Ecuador,2011,6,36104000,38235000,74339000
Ecuador,2011,7,30599000,39214000,69813000
Ecuador,2011,8,24353000,54314000,78667000
Ecuador,2011,9,40686000,38649000,79335000
Ecuador,2011,10,34123000,41847000,75970000
Ecuador,2011,11,38749000,32588000,71337000
Ecuador,2011,12,54210000,47910000,102120000
Ecuador,2012,1,49756000,40921000,90677000
Ecuador,2012,2,33956000,42763000,76719000
Ecuador,2012,3,58735000,48912000,107647000
Ecuador,2012,4,35677000,45684000,81361000
Ecuador,2012,5,37562000,44714000,82276000
Ecuador,2012,6,36071000,48003000,84074000
Ecuador,2012,7,51102000,48027000,99129000
Ecuador,2012,8,38939000,43814000,82753000
Ecuador,2012,9,31132000,33888000,65020000
Ecuador,2012,10,36821000,46981000,83802000
Ecuador,2012,11,36807000,43547000,80354000
Ecuador,2012,12,31983000,35981000,67964000
Ecuador,2013,1,33187000,43149000,76336000
Ecuador,2013,2,33827000,42973000,76800000
Ecuador,2013,3,32331000,46438000,78769000
Ecuador,2013,4,30948000,48467000,79415000
Ecuador,2013,5,30409000,43162000,73571000
Ecuador,2013,6,28773000,39143000,67916000
Ecuador,2013,7,37601000,36242000,73843000
Ecuador,2013,8,35965000,34967000,70932000
Ecuador,2013,9,44910000,34816000,79726000
Ecuador,2013,10,40386000,44216000,84602000
Ecuador,2013,11,34451000,32367000,66818000
Ecuador,2013,12,29768000,37119000,66887000
Ecuador,2014,1,33665000,45123000,78788000
Ecuador,2014,2,32547000,40863000,73410000
Ecuador,2014,3,28157000,47688000,75845000
Ecuador,2014,4,28687000,47343000,76030000
Ecuador,2014,5,35924000,44985000,80909000
Ecuador,2014,6,34134000,49316000,83450000
Ecuador,2014,7,34831000,42249000,77080000
Ecuador,2014,8,45236000,43808000,89044000
Ecuador,2014,9,35619000,47180000,82799000
Ecuador,2014,10,38660000,54077000,92737000
Ecuador,2014,11,32045000,38399000,70444000
Ecuador,2014,12,32061000,41733000,73794000
Ecuador,2015,1,36381000,46367000,82748000
Ecuador,2015,2,32895000,41567000,74462000
Ecuador,2015,3,39430000,45635000,85065000
Ecuador,2015,4,36882000,47024000,83906000
Ecuador,2015,5,30573000,41209000,71782000
Ecuador,2015,6,40695000,43196000,83891000
Ecuador,2015,7,35079000,42585000,77664000
Ecuador,2015,8,30356000,38858000,69214000
Ecuador,2015,9,32609000,36820000,69429000
Ecuador,2015,10,37203000,43542000,80745000
Ecuador,2015,11,34521000,38107000,72628000
Ecuador,2015,12,30093000,40735000,70828000
Ecuador,2016,1,26113000,46317000,72430000
Ecuador,2016,2,27319000,48712000,76031000
Ecuador,2016,3,24498000,57503000,82001000
Ecuador,2016,4,25156000,48646000,73802000
Ecuador,2016,5,29488000,41409000,70897000
Ecuador,2016,6,31488000,47848000,79336000
Ecuador,2016,7,27762000,42713000,70475000
Ecuador,2016,8,27869000,39828000,67697000
Ecuador,2016,9,49389000,38709000,88098000
Ecuador,2016,10,44247000,38778000,83025000
Ecuador,2016,11,34289000,41704000,75993000
Ecuador,2016,12,30900000,37963000,68863000
Ecuador,2017,1,33646000,42384000,76030000
Ecuador,2017,2,36868000,42793000,79661000
Ecuador,2017,3,36766000,42956000,79722000
Ecuador,2017,4,30562000,42999000,73561000
Ecuador,2017,5,42359000,53036000,95395000
Ecuador,2017,6,39940000,40941000,80881000
Ecuador,2017,7,36630000,40045000,76675000
Ecuador,2017,8,37044000,39785000,76829000
Ecuador,2017,9,36006000,41742000,77748000
Ecuador,2017,10,37536000,37330000,74866000
Ecuador,2017,11,41048000,46674000,87722000
Ecuador,2017,12,41764000,42876000,84640000
Ecuador,2018,1,36444000,53638000,90082000
Ecuador,2018,2,39414000,44469000,83883000
Ecuador,2018,3,40906000,42950000,83856000
Ecuador,2018,4,35314000,39024000,74338000
Ecuador,2018,5,41562000,43998000,85560000
Ecuador,2018,6,47040000,42053000,89093000
Ecuador,2018,7,40510000,40149000,80659000
Ecuador,2018,8,42940000,49369000,92309000
Ecuador,2018,9,42376000,34296000,76672000
Ecuador,2018,10,38764000,41596000,80360000
Ecuador,2018,11,37184000,41710000,78894000
Ecuador,2018,12,37315000,31183000,68498000
Ecuador,2019,1,32417000,55148000,87565000
Ecuador,2019,2,36755000,42376000,79131000
Ecuador,2019,3,37057000,37066000,74123000
Ecuador,2019,4,34380000,42561000,76941000
Ecuador,2019,5,44039000,40473000,84512000
Ecuador,2019,6,34199000,31855000,66054000
Ecuador,2019,7,49108000,32919000,82027000
Ecuador,2019,8,40584000,34386000,74970000
Ecuador,2019,9,36054000,31126000,67180000
Ecuador,2019,10,43392000,37872000,81264000
Ecuador,2019,11,34200000,31656000,65856000
Ecuador,2019,12,32042000,29600000,61642000
Ecuador,2020,1,34964000,39744000,74708000
Ecuador,2020,2,42570000,38087000,80657000
Ecuador,2020,3,39693000,36363000,76056000
Ecuador,2020,4,28336000,40245000,68581000
Ecuador,2020,5,24471000,37551000,62022000
Ecuador,2020,6,28953000,42917000,71870000
Ecuador,2020,7,30980000,41191000,72171000
Ecuador,2020,8,43010000,30654000,73664000
Ecuador,2020,9,27274000,33876000,61150000
Ecuador,2020,10,37696000,36820000,74516000
Ecuador,2020,11,30181000,33235000,63416000
Ecuador,2020,12,32989000,25888000,58877000
Ecuador,2021,1,29533000,49707000,79240000
Ecuador,2021,2,35557000,53909000,89466000
Ecuador,2021,3,37214000,43651000,80865000
Ecuador,2021,4,61389000,41112000,102501000
Ecuador,2021,5,52591000,43862000,96453000
Ecuador,2021,6,41459000,40039000,81498000
Ecuador,2021,7,38535000,34228000,72763000
Ecuador,2021,8,37351000,32030000,69381000
Ecuador,2021,9,37145000,31810000,68955000
Ecuador,2021,10,47903000,50083000,97986000
Ecuador,2021,11,37249000,36201000,73450000
Ecuador,2021,12,74044000,38200000,112244000
Ecuador,2022,1,51542000,42089000,93631000
Ecuador,2022,2,57125000,36706000,93831000
Ecuador,2022,3,43710000,35431000,79141000
Ecuador,2022,4,43257000,44357000,87614000
Ecuador,2022,5,45631000,38619000,84250000
Ecuador,2022,6,55207000,40584000,95791000
Ecuador,2022,7,44705000,39561000,84266000
Ecuador,2022,8,47190000,33705000,80895000
Ecuador,2022,9,45700000,39715000,85415000
Ecuador,2022,10,44730000,45251000,89981000
Ecuador,2022,11,45601000,44564000,90165000
Ecuador,2022,12,43136000,37669000,80805000
Ecuador,2023,1,41968000,61511000,103479000
Ecuador,2023,2,45971000,54817000,100788000
Ecuador,2023,3,43664000,65932000,109596000
Ecuador,2023,4,49415000,60747000,110162000
Ecuador,2023,5,45605000,64215000,109820000
Ecuador,2023,6,48002000,62589000,110591000
Ecuador,2023,7,50453000,55976000,106429000
Ecuador,2023,8,45822000,53049000,98871000
Ecuador,2023,9,41281000,45812000,87093000
Ecuador,2023,10,51062000,43955000,95017000
Ecuador,2023,11,37426000,48947000,86373000
Ecuador,2023,12,38530000,48966000,87496000
Ecuador,2024,1,38117000,63077000,101194000
Ecuador,2024,2,38318000,48267000,86585000
Ecuador,2024,3,37233000,58883000,96116000
Ecuador,2024,4,41496000,54855000,96351000
Ecuador,2024,5,37790000,44389000,82179000
Ecuador,2024,6,44207000,65867000,110074000
Ecuador,2024,7,47439000,79129000,126568000
Ecuador,2024,8,39453000,73055000,112508000
Ecuador,2024,9,44516000,83901000,128417000
Ecuador,2024,10,40637000,97070000,137707000
Ecuador,2024,11,39182000,61669000,100851000
Ecuador,2024,12,39651000,89939000,129590000
El Salvador,2008,1,6537000,7586000,14123000
El Salvador,2008,2,6017000,8161000,14178000
El Salvador,2008,3,6953000,6503000,13456000
El Salvador,2008,4,14219000,10469000,24688000
El Salvador,2008,5,4490000,9892000,14382000
El Salvador,2008,6,8883000,10748000,19631000
El Salvador,2008,7,7800000,8171000,15971000
El Salvador,2008,8,4914000,9358000,14272000
El Salvador,2008,9,6320000,7187000,13507000
El Salvador,2008,10,5363000,7694000,13057000
El Salvador,2008,11,5420000,5521000,10941000
El Salvador,2008,12,4791000,5569000,10360000
El Salvador,2009,1,6897000,5844000,12741000
El Salvador,2009,2,3490000,9856000,13346000
El Salvador,2009,3,6745000,9214000,15959000
El Salvador,2009,4,52329000,10455000,62784000
El Salvador,2009,5,4705000,10245000,14950000
El Salvador,2009,6,3402000,8843000,12245000
El Salvador,2009,7,4152000,10370000,14522000
El Salvador,2009,8,2866000,6276000,9142000
El Salvador,2009,9,3750000,4003000,7753000
El Salvador,2009,10,4388000,2608000,6996000
El Salvador,2009,11,3902000,2270000,6172000
El Salvador,2009,12,5698000,1789000,7487000
El Salvador,2010,1,4734000,8165000,12899000
El Salvador,2010,2,5101000,11508000,16609000
El Salvador,2010,3,5796000,17579000,23375000
El Salvador,2010,4,5222000,9002000,14224000
El Salvador,2010,5,5990000,10594000,16584000
El Salvador,2010,6,7309000,8494000,15803000
El Salvador,2010,7,5316000,8857000,14173000
El Salvador,2010,8,4899000,4007000,8906000
El Salvador,2010,9,6476000,3999000,10475000
El Salvador,2010,10,6253000,2920000,9173000
El Salvador,2010,11,6650000,2913000,9563000
El Salvador,2010,12,3830000,2783000,6613000
El Salvador,2011,1,5882000,12393000,18275000
El Salvador,2011,2,5705000,15780000,21485000
El Salvador,2011,3,5790000,32992000,38782000
El Salvador,2011,4,5776000,22825000,28601000
El Salvador,2011,5,7897000,20193000,28090000
El Salvador,2011,6,4313000,16532000,20845000
El Salvador,2011,7,5749000,12789000,18538000
El Salvador,2011,8,5498000,10869000,16367000
El Salvador,2011,9,7336000,6857000,14193000
El Salvador,2011,10,5640000,6729000,12369000
El Salvador,2011,11,6767000,8597000,15364000
El Salvador,2011,12,7470000,4857000,12327000
El Salvador,2012,1,7311000,5909000,13220000
El Salvador,2012,2,4225000,13577000,17802000
El Salvador,2012,3,50804000,13442000,64246000
El Salvador,2012,4,4467000,8640000,13107000
El Salvador,2012,5,5955000,8620000,14575000
El Salvador,2012,6,7119000,6775000,13894000
El Salvador,2012,7,91192000,3955000,95147000
El Salvador,2012,8,96335000,4890000,101225000
El Salvador,2012,9,5983000,3316000,9299000
El Salvador,2012,10,7345000,2997000,10342000
El Salvador,2012,11,9627000,2384000,12011000
El Salvador,2012,12,6095000,2877000,8972000
El Salvador,2013,1,5639000,6678000,12317000
El Salvador,2013,2,5780000,7654000,13434000
El Salvador,2013,3,7360000,9095000,16455000
El Salvador,2013,4,9674000,10356000,20030000
El Salvador,2013,5,11443000,5432000,16875000
El Salvador,2013,6,7631000,7751000,15382000
El Salvador,2013,7,8156000,4849000,13005000
El Salvador,2013,8,10732000,4497000,15229000
El Salvador,2013,9,45354000,4105000,49459000
El Salvador,2013,10,7462000,3831000,11293000
El Salvador,2013,11,52451000,2462000,54913000
El Salvador,2013,12,8389000,2093000,10482000
El Salvador,2014,1,56055000,3527000,59582000
El Salvador,2014,2,56894000,2605000,59499000
El Salvador,2014,3,7418000,4691000,12109000
El Salvador,2014,4,7203000,3371000,10574000
El Salvador,2014,5,6389000,4517000,10906000
El Salvador,2014,6,7508000,4233000,11741000
El Salvador,2014,7,61265000,3511000,64776000
El Salvador,2014,8,7798000,3082000,10880000
El Salvador,2014,9,8283000,2921000,11204000
El Salvador,2014,10,7605000,2595000,10200000
El Salvador,2014,11,9078000,2320000,11398000
El Salvador,2014,12,6292000,2661000,8953000
El Salvador,2015,1,6355000,4378000,10733000
El Salvador,2015,2,7717000,4829000,12546000
El Salvador,2015,3,13912000,4560000,18472000
El Salvador,2015,4,7881000,3801000,11682000
El Salvador,2015,5,10636000,5318000,15954000
El Salvador,2015,6,11666000,6120000,17786000
El Salvador,2015,7,9580000,4153000,13733000
El Salvador,2015,8,11703000,3749000,15452000
El Salvador,2015,9,10065000,3900000,13965000
El Salvador,2015,10,10888000,2815000,13703000
El Salvador,2015,11,76001000,2384000,78385000
El Salvador,2015,12,8483000,2307000,10790000
El Salvador,2016,1,6587000,3288000,9875000
El Salvador,2016,2,12159000,3324000,15483000
El Salvador,2016,3,9575000,3964000,13539000
El Salvador,2016,4,8870000,4045000,12915000
El Salvador,2016,5,11912000,4348000,16260000
El Salvador,2016,6,13276000,3426000,16702000
El Salvador,2016,7,11573000,3759000,15332000
El Salvador,2016,8,15007000,3224000,18231000
El Salvador,2016,9,14717000,3124000,17841000
El Salvador,2016,10,11264000,4731000,15995000
El Salvador,2016,11,11184000,2847000,14031000
El Salvador,2016,12,11717000,3544000,15261000
El Salvador,2017,1,7590000,3207000,10797000
El Salvador,2017,2,11008000,3598000,14606000
El Salvador,2017,3,12970000,4770000,17740000
El Salvador,2017,4,9458000,4705000,14163000
El Salvador,2017,5,13942000,4129000,18071000
El Salvador,2017,6,9989000,5277000,15266000
El Salvador,2017,7,7710000,6855000,14565000
El Salvador,2017,8,8766000,4283000,13049000
El Salvador,2017,9,8297000,5508000,13805000
El Salvador,2017,10,10357000,5773000,16130000
El Salvador,2017,11,7699000,4584000,12283000
El Salvador,2017,12,6750000,4303000,11053000
El Salvador,2018,1,12082000,4546000,16628000
El Salvador,2018,2,8449000,4093000,12542000
El Salvador,2018,3,10496000,5090000,15586000
El Salvador,2018,4,8648000,4518000,13166000
El Salvador,2018,5,22081000,5586000,27667000
El Salvador,2018,6,18316000,7589000,25905000
El Salvador,2018,7,14893000,7363000,22256000
El Salvador,2018,8,26220000,5788000,32008000
El Salvador,2018,9,26229000,4293000,30522000
El Salvador,2018,10,12911000,3985000,16896000
El Salvador,2018,11,33926000,3716000,37642000
El Salvador,2018,12,21301000,3051000,24352000
El Salvador,2019,1,52507000,3970000,56477000
El Salvador,2019,2,23711000,3376000,27087000
El Salvador,2019,3,13466000,4931000,18397000
El Salvador,2019,4,8958000,3890000,12848000
El Salvador,2019,5,34255000,3773000,38028000
El Salvador,2019,6,15941000,3142000,19083000
El Salvador,2019,7,53548000,3294000,56842000
El Salvador,2019,8,14266000,3473000,17739000
El Salvador,2019,9,108498000,2355000,110853000
El Salvador,2019,10,56188000,3332000,59520000
El Salvador,2019,11,34215000,2543000,36758000
El Salvador,2019,12,31292000,1973000,33265000
El Salvador,2020,1,10390000,2571000,12961000
El Salvador,2020,2,12469000,2919000,15388000
El Salvador,2020,3,10740000,3127000,13867000
El Salvador,2020,4,7772000,2846000,10618000
El Salvador,2020,5,3956000,1906000,5862000
El Salvador,2020,6,5938000,2242000,8180000
El Salvador,2020,7,8572000,2387000,10959000
El Salvador,2020,8,5856000,2858000,8714000
El Salvador,2020,9,11111000,3224000,14335000
El Salvador,2020,10,11685000,3405000,15090000
El Salvador,2020,11,23427000,4455000,27882000
El Salvador,2020,12,7569000,4787000,12356000
El Salvador,2021,1,6490000,4379000,10869000
El Salvador,2021,2,9686000,4038000,13724000
El Salvador,2021,3,12667000,5109000,17776000
El Salvador,2021,4,9013000,5902000,14915000
El Salvador,2021,5,9511000,4828000,14339000
El Salvador,2021,6,15988000,6331000,22319000
El Salvador,2021,7,13950000,7056000,21006000
El Salvador,2021,8,10702000,6049000,16751000
El Salvador,2021,9,12610000,5863000,18473000
El Salvador,2021,10,10264000,1609000,11873000
El Salvador,2021,11,15621000,2486000,18107000
El Salvador,2021,12,10144000,2595000,12739000
El Salvador,2022,1,9615000,2196000,11811000
El Salvador,2022,2,14785000,1699000,16484000
El Salvador,2022,3,11169000,3692000,14861000
El Salvador,2022,4,13071000,3223000,16294000
El Salvador,2022,5,12542000,3394000,15936000
El Salvador,2022,6,12526000,3892000,16418000
El Salvador,2022,7,9691000,5545000,15236000
El Salvador,2022,8,14297000,3586000,17883000
El Salvador,2022,9,12329000,3940000,16269000
El Salvador,2022,10,10659000,3237000,13896000
El Salvador,2022,11,10049000,3096000,13145000
El Salvador,2022,12,10334000,2704000,13038000
El Salvador,2023,1,9632000,3025000,12657000
El Salvador,2023,2,11559000,4249000,15808000
El Salvador,2023,3,11885000,4172000,16057000
El Salvador,2023,4,13625000,4661000,18286000
El Salvador,2023,5,10606000,3899000,14505000
El Salvador,2023,6,15013000,5432000,20445000
El Salvador,2023,7,11972000,8240000,20212000
El Salvador,2023,8,10513000,8029000,18542000
El Salvador,2023,9,14476000,6846000,21322000
El Salvador,2023,10,16987000,8893000,25880000
El Salvador,2023,11,15222000,6328000,21550000
El Salvador,2023,12,8682000,4592000,13274000
El Salvador,2024,1,9217000,6205000,15422000
El Salvador,2024,2,12888000,5861000,18749000
El Salvador,2024,3,12100000,7426000,19526000
El Salvador,2024,4,11911000,6249000,18160000
El Salvador,2024,5,10211000,5357000,15568000
El Salvador,2024,6,17536000,5664000,23200000
El Salvador,2024,7,12544000,8017000,20561000
El Salvador,2024,8,17523000,6324000,23847000
El Salvador,2024,9,12068000,7770000,19838000
El Salvador,2024,10,11802000,7455000,19257000
El Salvador,2024,11,13044000,5279000,18323000
El Salvador,2024,12,13911000,7092000,21003000
Eritrea (ab 1994),2008,1,1161000,2000,1163000
Eritrea (ab 1994),2008,2,463000,2000,465000
Eritrea (ab 1994),2008,3,391000,57000,448000
Eritrea (ab 1994),2008,4,1930000,6000,1936000
Eritrea (ab 1994),2008,5,939000,3000,942000
Eritrea (ab 1994),2008,6,562000,8000,570000
Eritrea (ab 1994),2008,7,377000,6000,383000
Eritrea (ab 1994),2008,8,652000,65000,717000
Eritrea (ab 1994),2008,9,248000,0,248000
Eritrea (ab 1994),2008,10,477000,6000,483000
Eritrea (ab 1994),2008,11,508000,19000,527000
Eritrea (ab 1994),2008,12,1362000,7000,1369000
Eritrea (ab 1994),2009,1,578000,6000,584000
Eritrea (ab 1994),2009,2,730000,72000,802000
Eritrea (ab 1994),2009,3,296000,7000,303000
Eritrea (ab 1994),2009,4,452000,22000,474000
Eritrea (ab 1994),2009,5,340000,7000,347000
Eritrea (ab 1994),2009,6,757000,111000,868000
Eritrea (ab 1994),2009,7,764000,1596000,2360000
Eritrea (ab 1994),2009,8,2039000,6000,2045000
Eritrea (ab 1994),2009,9,1581000,0,1581000
Eritrea (ab 1994),2009,10,285000,4000,289000
Eritrea (ab 1994),2009,11,329000,6000,335000
Eritrea (ab 1994),2009,12,4844000,89000,4933000
Eritrea (ab 1994),2010,1,909000,1000,910000
Eritrea (ab 1994),2010,2,3861000,3000,3864000
Eritrea (ab 1994),2010,3,1473000,16000,1489000
Eritrea (ab 1994),2010,4,462000,8000,470000
Eritrea (ab 1994),2010,5,646000,0,646000
Eritrea (ab 1994),2010,6,2278000,21000,2299000
Eritrea (ab 1994),2010,7,1067000,0,1067000
Eritrea (ab 1994),2010,8,810000,0,810000
Eritrea (ab 1994),2010,9,6347000,0,6347000
Eritrea (ab 1994),2010,10,388000,0,388000
Eritrea (ab 1994),2010,11,529000,136000,665000
Eritrea (ab 1994),2010,12,635000,0,635000
Eritrea (ab 1994),2011,1,735000,0,735000
Eritrea (ab 1994),2011,2,387000,0,387000
Eritrea (ab 1994),2011,3,6997000,13000,7010000
Eritrea (ab 1994),2011,4,771000,0,771000
Eritrea (ab 1994),2011,5,336000,0,336000
Eritrea (ab 1994),2011,6,579000,0,579000
Eritrea (ab 1994),2011,7,985000,0,985000
Eritrea (ab 1994),2011,8,493000,0,493000
Eritrea (ab 1994),2011,9,1712000,90000,1802000
Eritrea (ab 1994),2011,10,878000,0,878000
Eritrea (ab 1994),2011,11,6323000,13000,6336000
Eritrea (ab 1994),2011,12,4207000,10000,4217000
Eritrea (ab 1994),2012,1,1268000,26000,1294000
Eritrea (ab 1994),2012,2,1547000,0,1547000
Eritrea (ab 1994),2012,3,473000,0,473000
Eritrea (ab 1994),2012,4,380000,46000,426000
Eritrea (ab 1994),2012,5,323000,0,323000
Eritrea (ab 1994),2012,6,1024000,9000,1033000
Eritrea (ab 1994),2012,7,3457000,0,3457000
Eritrea (ab 1994),2012,8,625000,0,625000
Eritrea (ab 1994),2012,9,8898000,0,8898000
Eritrea (ab 1994),2012,10,4760000,17000,4777000
Eritrea (ab 1994),2012,11,950000,39000,989000
Eritrea (ab 1994),2012,12,3297000,0,3297000
Eritrea (ab 1994),2013,1,7967000,0,7967000
Eritrea (ab 1994),2013,2,218000,5000,223000
Eritrea (ab 1994),2013,3,1287000,0,1287000
Eritrea (ab 1994),2013,4,2556000,15000,2571000
Eritrea (ab 1994),2013,5,4168000,5000,4173000
Eritrea (ab 1994),2013,6,1862000,3000,1865000
Eritrea (ab 1994),2013,7,3770000,2000,3772000
Eritrea (ab 1994),2013,8,795000,1000,796000
Eritrea (ab 1994),2013,9,776000,0,776000
Eritrea (ab 1994),2013,10,5677000,10000,5687000
Eritrea (ab 1994),2013,11,797000,0,797000
Eritrea (ab 1994),2013,12,344000,0,344000
Eritrea (ab 1994),2014,1,847000,0,847000
Eritrea (ab 1994),2014,2,897000,2000,899000
Eritrea (ab 1994),2014,3,631000,8000,639000
Eritrea (ab 1994),2014,4,461000,18000,479000
Eritrea (ab 1994),2014,5,2939000,0,2939000
Eritrea (ab 1994),2014,6,1305000,0,1305000
Eritrea (ab 1994),2014,7,2769000,0,2769000
Eritrea (ab 1994),2014,8,764000,0,764000
Eritrea (ab 1994),2014,9,6619000,0,6619000
Eritrea (ab 1994),2014,10,499000,0,499000
Eritrea (ab 1994),2014,11,681000,13000,694000
Eritrea (ab 1994),2014,12,929000,6000,935000
Eritrea (ab 1994),2015,1,684000,0,684000
Eritrea (ab 1994),2015,2,200000,0,200000
Eritrea (ab 1994),2015,3,508000,0,508000
Eritrea (ab 1994),2015,4,1189000,0,1189000
Eritrea (ab 1994),2015,5,414000,6000,420000
Eritrea (ab 1994),2015,6,380000,6000,386000
Eritrea (ab 1994),2015,7,3554000,0,3554000
Eritrea (ab 1994),2015,8,452000,5578000,6030000
Eritrea (ab 1994),2015,9,2006000,0,2006000
Eritrea (ab 1994),2015,10,3075000,2000,3077000
Eritrea (ab 1994),2015,11,810000,0,810000
Eritrea (ab 1994),2015,12,854000,1000,855000
Eritrea (ab 1994),2016,1,2585000,0,2585000
Eritrea (ab 1994),2016,2,807000,0,807000
Eritrea (ab 1994),2016,3,1091000,0,1091000
Eritrea (ab 1994),2016,4,694000,2000,696000
Eritrea (ab 1994),2016,5,403000,0,403000
Eritrea (ab 1994),2016,6,502000,0,502000
Eritrea (ab 1994),2016,7,159000,0,159000
Eritrea (ab 1994),2016,8,772000,0,772000
Eritrea (ab 1994),2016,9,318000,0,318000
Eritrea (ab 1994),2016,10,455000,0,455000
Eritrea (ab 1994),2016,11,547000,0,547000
Eritrea (ab 1994),2016,12,171000,0,171000
Eritrea (ab 1994),2017,1,225000,0,225000
Eritrea (ab 1994),2017,2,274000,0,274000
Eritrea (ab 1994),2017,3,282000,0,282000
Eritrea (ab 1994),2017,4,491000,0,491000
Eritrea (ab 1994),2017,5,54000,0,54000
Eritrea (ab 1994),2017,6,433000,0,433000
Eritrea (ab 1994),2017,7,331000,0,331000
Eritrea (ab 1994),2017,8,150000,0,150000
Eritrea (ab 1994),2017,9,1471000,0,1471000
Eritrea (ab 1994),2017,10,1375000,10000,1385000
Eritrea (ab 1994),2017,11,3283000,0,3283000
Eritrea (ab 1994),2017,12,866000,9000,875000
Eritrea (ab 1994),2018,1,411000,0,411000
Eritrea (ab 1994),2018,2,93000,15000,108000
Eritrea (ab 1994),2018,3,472000,0,472000
Eritrea (ab 1994),2018,4,1789000,2000,1791000
Eritrea (ab 1994),2018,5,179000,0,179000
Eritrea (ab 1994),2018,6,426000,0,426000
Eritrea (ab 1994),2018,7,640000,0,640000
Eritrea (ab 1994),2018,8,4427000,0,4427000
Eritrea (ab 1994),2018,9,70000,21000,91000
Eritrea (ab 1994),2018,10,382000,2000,384000
Eritrea (ab 1994),2018,11,2473000,18000,2491000
Eritrea (ab 1994),2018,12,2023000,14000,2037000
Eritrea (ab 1994),2019,1,853000,0,853000
Eritrea (ab 1994),2019,2,434000,1000,435000
Eritrea (ab 1994),2019,3,1353000,26000,1379000
Eritrea (ab 1994),2019,4,36000,0,36000
Eritrea (ab 1994),2019,5,394000,0,394000
Eritrea (ab 1994),2019,6,326000,27000,353000
Eritrea (ab 1994),2019,7,235000,0,235000
Eritrea (ab 1994),2019,8,470000,29000,499000
Eritrea (ab 1994),2019,9,7907000,13000,7920000
Eritrea (ab 1994),2019,10,108000,0,108000
Eritrea (ab 1994),2019,11,392000,1000,393000
Eritrea (ab 1994),2019,12,437000,16000,453000
Eritrea (ab 1994),2020,1,278000,16000,294000
Eritrea (ab 1994),2020,2,10000,0,10000
Eritrea (ab 1994),2020,3,1995000,0,1995000
Eritrea (ab 1994),2020,4,593000,1000,594000
Eritrea (ab 1994),2020,5,199000,1000,200000
Eritrea (ab 1994),2020,6,399000,16000,415000
Eritrea (ab 1994),2020,7,129000,2000,131000
Eritrea (ab 1994),2020,8,447000,1000,448000
Eritrea (ab 1994),2020,9,540000,144000,684000
Eritrea (ab 1994),2020,10,179000,12000,191000
Eritrea (ab 1994),2020,11,644000,17000,661000
Eritrea (ab 1994),2020,12,390000,11000,401000
Eritrea (ab 1994),2021,1,713000,11000,724000
Eritrea (ab 1994),2021,2,192000,8000,200000
Eritrea (ab 1994),2021,3,198000,27000,225000
Eritrea (ab 1994),2021,4,91000,10000,101000
Eritrea (ab 1994),2021,5,73000,46000,119000
Eritrea (ab 1994),2021,6,679000,82000,761000
Eritrea (ab 1994),2021,7,433000,42000,475000
Eritrea (ab 1994),2021,8,193000,10000,203000
Eritrea (ab 1994),2021,9,49000,10000,59000
Eritrea (ab 1994),2021,10,612000,10000,622000
Eritrea (ab 1994),2021,11,290000,17000,307000
Eritrea (ab 1994),2021,12,520000,3000,523000
Eritrea (ab 1994),2022,1,87000,1000,88000
Eritrea (ab 1994),2022,2,462000,11000,473000
Eritrea (ab 1994),2022,3,309000,47000,356000
Eritrea (ab 1994),2022,4,209000,34000,243000
Eritrea (ab 1994),2022,5,1485000,30000,1515000
Eritrea (ab 1994),2022,6,58000,65000,123000
Eritrea (ab 1994),2022,7,218000,67000,285000
Eritrea (ab 1994),2022,8,339000,10000,349000
Eritrea (ab 1994),2022,9,94000,20000,114000
Eritrea (ab 1994),2022,10,74000,44000,118000
Eritrea (ab 1994),2022,11,515000,6000,521000
Eritrea (ab 1994),2022,12,348000,10000,358000
Eritrea (ab 1994),2023,1,240000,10000,250000
Eritrea (ab 1994),2023,2,60000,19000,79000
Eritrea (ab 1994),2023,3,174000,29000,203000
Eritrea (ab 1994),2023,4,922000,56000,978000
Eritrea (ab 1994),2023,5,95000,87000,182000
Eritrea (ab 1994),2023,6,198000,30000,228000
Eritrea (ab 1994),2023,7,84000,39000,123000
Eritrea (ab 1994),2023,8,301000,36000,337000
Eritrea (ab 1994),2023,9,434000,1000,435000
Eritrea (ab 1994),2023,10,571000,2000,573000
Eritrea (ab 1994),2023,11,344000,26000,370000
Eritrea (ab 1994),2023,12,1073000,74000,1147000
Eritrea (ab 1994),2024,1,62000,5000,67000
Eritrea (ab 1994),2024,2,143000,35000,178000
Eritrea (ab 1994),2024,3,326000,106000,432000
Eritrea (ab 1994),2024,4,261000,52000,313000
Eritrea (ab 1994),2024,5,111000,57000,168000
Eritrea (ab 1994),2024,6,118000,66000,184000
Eritrea (ab 1994),2024,7,151000,70000,221000
Eritrea (ab 1994),2024,8,132000,18000,150000
Eritrea (ab 1994),2024,9,44000,28000,72000
Eritrea (ab 1994),2024,10,479000,40000,519000
Eritrea (ab 1994),2024,11,197000,30000,227000
Eritrea (ab 1994),2024,12,229000,31000,260000
Estland (ab 1992),2008,1,130987000,23668000,154655000
Estland (ab 1992),2008,2,127730000,29245000,156975000
Estland (ab 1992),2008,3,134382000,33631000,168013000
Estland (ab 1992),2008,4,149810000,34733000,184543000
Estland (ab 1992),2008,5,140710000,30455000,171165000
Estland (ab 1992),2008,6,127684000,28049000,155733000
Estland (ab 1992),2008,7,152079000,31454000,183533000
Estland (ab 1992),2008,8,131622000,25235000,156857000
Estland (ab 1992),2008,9,124404000,28691000,153095000
Estland (ab 1992),2008,10,126235000,31478000,157713000
Estland (ab 1992),2008,11,101935000,31724000,133659000
Estland (ab 1992),2008,12,75152000,29618000,104770000
Estland (ab 1992),2009,1,70475000,28573000,99048000
Estland (ab 1992),2009,2,64283000,26926000,91209000
Estland (ab 1992),2009,3,68786000,28935000,97721000
Estland (ab 1992),2009,4,70359000,29186000,99545000
Estland (ab 1992),2009,5,60098000,26199000,86297000
Estland (ab 1992),2009,6,70150000,25721000,95871000
Estland (ab 1992),2009,7,63153000,29377000,92530000
Estland (ab 1992),2009,8,67546000,31287000,98833000
Estland (ab 1992),2009,9,90367000,30342000,120709000
Estland (ab 1992),2009,10,79647000,28554000,108201000
Estland (ab 1992),2009,11,70999000,29419000,100418000
Estland (ab 1992),2009,12,70626000,30274000,100900000
Estland (ab 1992),2010,1,72727000,22912000,95639000
Estland (ab 1992),2010,2,77962000,27640000,105602000
Estland (ab 1992),2010,3,95243000,30875000,126118000
Estland (ab 1992),2010,4,92630000,30112000,122742000
Estland (ab 1992),2010,5,99443000,39158000,138601000
Estland (ab 1992),2010,6,99862000,36203000,136065000
Estland (ab 1992),2010,7,96983000,36183000,133166000
Estland (ab 1992),2010,8,98070000,39428000,137498000
Estland (ab 1992),2010,9,123638000,35320000,158958000
Estland (ab 1992),2010,10,116441000,43143000,159584000
Estland (ab 1992),2010,11,110794000,40159000,150953000
Estland (ab 1992),2010,12,105256000,38974000,144230000
Estland (ab 1992),2011,1,111374000,35006000,146380000
Estland (ab 1992),2011,2,113917000,42757000,156674000
Estland (ab 1992),2011,3,137608000,48670000,186278000
Estland (ab 1992),2011,4,124381000,41368000,165749000
Estland (ab 1992),2011,5,136044000,43180000,179224000
Estland (ab 1992),2011,6,137273000,47700000,184973000
Estland (ab 1992),2011,7,154251000,43618000,197869000
Estland (ab 1992),2011,8,149586000,38018000,187604000
Estland (ab 1992),2011,9,137143000,48503000,185646000
Estland (ab 1992),2011,10,118056000,53954000,172010000
Estland (ab 1992),2011,11,126466000,50736000,177202000
Estland (ab 1992),2011,12,105734000,40108000,145842000
Estland (ab 1992),2012,1,107722000,38267000,145989000
Estland (ab 1992),2012,2,117740000,47171000,164911000
Estland (ab 1992),2012,3,137306000,39556000,176862000
Estland (ab 1992),2012,4,134780000,41082000,175862000
Estland (ab 1992),2012,5,154490000,41815000,196305000
Estland (ab 1992),2012,6,137131000,44208000,181339000
Estland (ab 1992),2012,7,136580000,37055000,173635000
Estland (ab 1992),2012,8,135937000,35228000,171165000
Estland (ab 1992),2012,9,133097000,39825000,172922000
Estland (ab 1992),2012,10,145733000,51933000,197666000
Estland (ab 1992),2012,11,127086000,42669000,169755000
Estland (ab 1992),2012,12,114003000,32043000,146046000
Estland (ab 1992),2013,1,117982000,36584000,154566000
Estland (ab 1992),2013,2,127783000,34709000,162492000
Estland (ab 1992),2013,3,132621000,38638000,171259000
Estland (ab 1992),2013,4,154111000,38302000,192413000
Estland (ab 1992),2013,5,145869000,43018000,188887000
Estland (ab 1992),2013,6,153853000,37425000,191278000
Estland (ab 1992),2013,7,157791000,46860000,204651000
Estland (ab 1992),2013,8,143586000,42544000,186130000
Estland (ab 1992),2013,9,138179000,44344000,182523000
Estland (ab 1992),2013,10,169856000,44950000,214806000
Estland (ab 1992),2013,11,138296000,49002000,187298000
Estland (ab 1992),2013,12,106635000,42840000,149475000
Estland (ab 1992),2014,1,138052000,36236000,174288000
Estland (ab 1992),2014,2,180780000,45611000,226391000
Estland (ab 1992),2014,3,137786000,42443000,180229000
Estland (ab 1992),2014,4,144491000,48631000,193122000
Estland (ab 1992),2014,5,142570000,43035000,185605000
Estland (ab 1992),2014,6,139906000,46994000,186900000
Estland (ab 1992),2014,7,147083000,46387000,193470000
Estland (ab 1992),2014,8,137552000,39030000,176582000
Estland (ab 1992),2014,9,148696000,51214000,199910000
Estland (ab 1992),2014,10,147457000,48043000,195500000
Estland (ab 1992),2014,11,137240000,45584000,182824000
Estland (ab 1992),2014,12,116655000,35514000,152169000
Estland (ab 1992),2015,1,119108000,39751000,158859000
Estland (ab 1992),2015,2,121283000,45806000,167089000
Estland (ab 1992),2015,3,137518000,50557000,188075000
Estland (ab 1992),2015,4,144962000,51465000,196427000
Estland (ab 1992),2015,5,130585000,51859000,182444000
Estland (ab 1992),2015,6,139181000,50990000,190171000
Estland (ab 1992),2015,7,147011000,44761000,191772000
Estland (ab 1992),2015,8,127414000,45696000,173110000
Estland (ab 1992),2015,9,139762000,48696000,188458000
Estland (ab 1992),2015,10,138125000,49719000,187844000
Estland (ab 1992),2015,11,131361000,43551000,174912000
Estland (ab 1992),2015,12,112751000,41831000,154582000
Estland (ab 1992),2016,1,121430000,40523000,161953000
Estland (ab 1992),2016,2,129958000,48579000,178537000
Estland (ab 1992),2016,3,152121000,57342000,209463000
Estland (ab 1992),2016,4,148491000,58001000,206492000
Estland (ab 1992),2016,5,144891000,53477000,198368000
Estland (ab 1992),2016,6,139621000,50040000,189661000
Estland (ab 1992),2016,7,141369000,50311000,191680000
Estland (ab 1992),2016,8,128001000,53447000,181448000
Estland (ab 1992),2016,9,141222000,56384000,197606000
Estland (ab 1992),2016,10,140112000,58316000,198428000
Estland (ab 1992),2016,11,143243000,59119000,202362000
Estland (ab 1992),2016,12,126915000,53866000,180781000
Estland (ab 1992),2017,1,130871000,59836000,190707000
Estland (ab 1992),2017,2,131717000,54595000,186312000
Estland (ab 1992),2017,3,161358000,60326000,221684000
Estland (ab 1992),2017,4,161351000,57579000,218930000
Estland (ab 1992),2017,5,153840000,62509000,216349000
Estland (ab 1992),2017,6,144809000,52215000,197024000
Estland (ab 1992),2017,7,148445000,51286000,199731000
Estland (ab 1992),2017,8,151885000,53179000,205064000
Estland (ab 1992),2017,9,154934000,62144000,217078000
Estland (ab 1992),2017,10,151342000,61528000,212870000
Estland (ab 1992),2017,11,150250000,63943000,214193000
Estland (ab 1992),2017,12,139616000,58482000,198098000
Estland (ab 1992),2018,1,159730000,64520000,224250000
Estland (ab 1992),2018,2,147758000,63873000,211631000
Estland (ab 1992),2018,3,167736000,71929000,239665000
Estland (ab 1992),2018,4,161591000,70608000,232199000
Estland (ab 1992),2018,5,224947000,70146000,295093000
Estland (ab 1992),2018,6,165527000,73176000,238703000
Estland (ab 1992),2018,7,229158000,72350000,301508000
Estland (ab 1992),2018,8,150692000,72926000,223618000
Estland (ab 1992),2018,9,149637000,53440000,203077000
Estland (ab 1992),2018,10,169129000,73774000,242903000
Estland (ab 1992),2018,11,151845000,74523000,226368000
Estland (ab 1992),2018,12,123323000,63701000,187024000
Estland (ab 1992),2019,1,154433000,78109000,232542000
Estland (ab 1992),2019,2,145415000,72410000,217825000
Estland (ab 1992),2019,3,166690000,74586000,241276000
Estland (ab 1992),2019,4,163511000,81731000,245242000
Estland (ab 1992),2019,5,150750000,70361000,221111000
Estland (ab 1992),2019,6,146543000,70050000,216593000
Estland (ab 1992),2019,7,150677000,60682000,211359000
Estland (ab 1992),2019,8,141553000,64491000,206044000
Estland (ab 1992),2019,9,162689000,62772000,225461000
Estland (ab 1992),2019,10,162881000,60526000,223407000
Estland (ab 1992),2019,11,154098000,63278000,217376000
Estland (ab 1992),2019,12,125730000,55291000,181021000
Estland (ab 1992),2020,1,143451000,59014000,202465000
Estland (ab 1992),2020,2,143791000,58883000,202674000
Estland (ab 1992),2020,3,150587000,71111000,221698000
Estland (ab 1992),2020,4,114785000,61176000,175961000
Estland (ab 1992),2020,5,109160000,67287000,176447000
Estland (ab 1992),2020,6,134343000,79110000,213453000
Estland (ab 1992),2020,7,139068000,69845000,208913000
Estland (ab 1992),2020,8,149084000,58477000,207561000
Estland (ab 1992),2020,9,161099000,73068000,234167000
Estland (ab 1992),2020,10,159164000,68542000,227706000
Estland (ab 1992),2020,11,182768000,76219000,258987000
Estland (ab 1992),2020,12,234137000,61897000,296034000
Estland (ab 1992),2021,1,149960000,56992000,206952000
Estland (ab 1992),2021,2,156900000,66787000,223687000
Estland (ab 1992),2021,3,211473000,67484000,278957000
Estland (ab 1992),2021,4,193618000,64729000,258347000
Estland (ab 1992),2021,5,189421000,74252000,263673000
Estland (ab 1992),2021,6,197185000,72703000,269888000
Estland (ab 1992),2021,7,178903000,75320000,254223000
Estland (ab 1992),2021,8,187821000,69902000,257723000
Estland (ab 1992),2021,9,197358000,79191000,276549000
Estland (ab 1992),2021,10,202214000,75071000,277285000
Estland (ab 1992),2021,11,203741000,81923000,285664000
Estland (ab 1992),2021,12,173994000,64224000,238218000
Estland (ab 1992),2022,1,187181000,69289000,256470000
Estland (ab 1992),2022,2,199909000,72818000,272727000
Estland (ab 1992),2022,3,229176000,96128000,325304000
Estland (ab 1992),2022,4,212966000,81492000,294458000
Estland (ab 1992),2022,5,237627000,90040000,327667000
Estland (ab 1992),2022,6,224456000,83848000,308304000
Estland (ab 1992),2022,7,218789000,70475000,289264000
Estland (ab 1992),2022,8,222926000,75799000,298725000
Estland (ab 1992),2022,9,248303000,84130000,332433000
Estland (ab 1992),2022,10,226759000,91434000,318193000
Estland (ab 1992),2022,11,229828000,85666000,315494000
Estland (ab 1992),2022,12,187858000,76130000,263988000
Estland (ab 1992),2023,1,223041000,82214000,305255000
Estland (ab 1992),2023,2,210751000,82247000,292998000
Estland (ab 1992),2023,3,243493000,96140000,339633000
Estland (ab 1992),2023,4,211624000,89180000,300804000
Estland (ab 1992),2023,5,245603000,98239000,343842000
Estland (ab 1992),2023,6,255354000,88601000,343955000
Estland (ab 1992),2023,7,202925000,72442000,275367000
Estland (ab 1992),2023,8,208718000,68995000,277713000
Estland (ab 1992),2023,9,220086000,88603000,308689000
Estland (ab 1992),2023,10,198809000,82824000,281633000
Estland (ab 1992),2023,11,226812000,83573000,310385000
Estland (ab 1992),2023,12,163083000,64874000,227957000
Estland (ab 1992),2024,1,177738000,77507000,255245000
Estland (ab 1992),2024,2,200504000,73606000,274110000
Estland (ab 1992),2024,3,239540000,88346000,327886000
Estland (ab 1992),2024,4,226592000,94088000,320680000
Estland (ab 1992),2024,5,208859000,80694000,289553000
Estland (ab 1992),2024,6,191020000,79190000,270210000
Estland (ab 1992),2024,7,198435000,80609000,279044000
Estland (ab 1992),2024,8,195031000,70957000,265988000
Estland (ab 1992),2024,9,203910000,79446000,283356000
Estland (ab 1992),2024,10,217196000,81415000,298611000
Estland (ab 1992),2024,11,207486000,69042000,276528000
Estland (ab 1992),2024,12,239068000,76721000,315789000
Eswatini,2008,1,562000,3216000,3778000
Eswatini,2008,2,115000,658000,773000
Eswatini,2008,3,669000,1657000,2326000
Eswatini,2008,4,367000,1463000,1830000
Eswatini,2008,5,168000,1032000,1200000
Eswatini,2008,6,129000,2369000,2498000
Eswatini,2008,7,360000,429000,789000
Eswatini,2008,8,844000,484000,1328000
Eswatini,2008,9,433000,126000,559000
Eswatini,2008,10,420000,321000,741000
Eswatini,2008,11,205000,92000,297000
Eswatini,2008,12,255000,180000,435000
Eswatini,2009,1,312000,86000,398000
Eswatini,2009,2,205000,19000,224000
Eswatini,2009,3,527000,12000,539000
Eswatini,2009,4,291000,91000,382000
Eswatini,2009,5,121000,143000,264000
Eswatini,2009,6,320000,215000,535000
Eswatini,2009,7,396000,13000,409000
Eswatini,2009,8,401000,24000,425000
Eswatini,2009,9,293000,38000,331000
Eswatini,2009,10,496000,257000,753000
Eswatini,2009,11,230000,482000,712000
Eswatini,2009,12,355000,728000,1083000
Eswatini,2010,1,630000,275000,905000
Eswatini,2010,2,563000,121000,684000
Eswatini,2010,3,266000,18000,284000
Eswatini,2010,4,600000,9125000,9725000
Eswatini,2010,5,355000,120000,475000
Eswatini,2010,6,539000,209000,748000
Eswatini,2010,7,140000,1082000,1222000
Eswatini,2010,8,860000,84000,944000
Eswatini,2010,9,799000,115000,914000
Eswatini,2010,10,164000,1516000,1680000
Eswatini,2010,11,287000,1159000,1446000
Eswatini,2010,12,253000,648000,901000
Eswatini,2011,1,310000,7000,317000
Eswatini,2011,2,1830000,782000,2612000
Eswatini,2011,3,401000,8592000,8993000
Eswatini,2011,4,74000,965000,1039000
Eswatini,2011,5,138000,431000,569000
Eswatini,2011,6,384000,841000,1225000
Eswatini,2011,7,107000,112000,219000
Eswatini,2011,8,192000,2528000,2720000
Eswatini,2011,9,369000,88000,457000
Eswatini,2011,10,229000,208000,437000
Eswatini,2011,11,307000,640000,947000
Eswatini,2011,12,209000,7000,216000
Eswatini,2012,1,76000,415000,491000
Eswatini,2012,2,89000,1100000,1189000
Eswatini,2012,3,229000,1405000,1634000
Eswatini,2012,4,83000,189000,272000
Eswatini,2012,5,500000,284000,784000
Eswatini,2012,6,472000,11732000,12204000
Eswatini,2012,7,600000,6626000,7226000
Eswatini,2012,8,329000,1268000,1597000
Eswatini,2012,9,549000,457000,1006000
Eswatini,2012,10,314000,156000,470000
Eswatini,2012,11,258000,17000,275000
Eswatini,2012,12,495000,2000,497000
Eswatini,2013,1,869000,1136000,2005000
Eswatini,2013,2,167000,1037000,1204000
Eswatini,2013,3,175000,1132000,1307000
Eswatini,2013,4,1145000,3870000,5015000
Eswatini,2013,5,1025000,801000,1826000
Eswatini,2013,6,423000,1065000,1488000
Eswatini,2013,7,499000,24000,523000
Eswatini,2013,8,1442000,96000,1538000
Eswatini,2013,9,292000,582000,874000
Eswatini,2013,10,415000,316000,731000
Eswatini,2013,11,209000,399000,608000
Eswatini,2013,12,485000,97000,582000
Eswatini,2014,1,389000,183000,572000
Eswatini,2014,2,420000,58000,478000
Eswatini,2014,3,487000,358000,845000
Eswatini,2014,4,799000,57000,856000
Eswatini,2014,5,579000,1382000,1961000
Eswatini,2014,6,535000,229000,764000
Eswatini,2014,7,506000,629000,1135000
Eswatini,2014,8,2181000,156000,2337000
Eswatini,2014,9,300000,1033000,1333000
Eswatini,2014,10,2881000,1087000,3968000
Eswatini,2014,11,729000,23000,752000
Eswatini,2014,12,402000,12000,414000
Eswatini,2015,1,402000,28000,430000
Eswatini,2015,2,486000,8000,494000
Eswatini,2015,3,1453000,41000,1494000
Eswatini,2015,4,827000,263000,1090000
Eswatini,2015,5,492000,179000,671000
Eswatini,2015,6,737000,158000,895000
Eswatini,2015,7,345000,147000,492000
Eswatini,2015,8,567000,23000,590000
Eswatini,2015,9,603000,230000,833000
Eswatini,2015,10,1742000,49000,1791000
Eswatini,2015,11,943000,170000,1113000
Eswatini,2015,12,363000,138000,501000
Eswatini,2016,1,430000,2000,432000
Eswatini,2016,2,834000,205000,1039000
Eswatini,2016,3,318000,402000,720000
Eswatini,2016,4,733000,139000,872000
Eswatini,2016,5,416000,170000,586000
Eswatini,2016,6,485000,41000,526000
Eswatini,2016,7,635000,351000,986000
Eswatini,2016,8,198000,29000,227000
Eswatini,2016,9,802000,340000,1142000
Eswatini,2016,10,937000,738000,1675000
Eswatini,2016,11,439000,124000,563000
Eswatini,2016,12,85000,325000,410000
Eswatini,2017,1,157000,290000,447000
Eswatini,2017,2,391000,388000,779000
Eswatini,2017,3,314000,235000,549000
Eswatini,2017,4,281000,190000,471000
Eswatini,2017,5,359000,279000,638000
Eswatini,2017,6,320000,327000,647000
Eswatini,2017,7,486000,519000,1005000
Eswatini,2017,8,496000,308000,804000
Eswatini,2017,9,378000,282000,660000
Eswatini,2017,10,784000,268000,1052000
Eswatini,2017,11,1092000,786000,1878000
Eswatini,2017,12,4273000,325000,4598000
Eswatini,2018,1,456000,647000,1103000
Eswatini,2018,2,634000,361000,995000
Eswatini,2018,3,252000,234000,486000
Eswatini,2018,4,700000,528000,1228000
Eswatini,2018,5,340000,199000,539000
Eswatini,2018,6,364000,352000,716000
Eswatini,2018,7,479000,247000,726000
Eswatini,2018,8,190000,171000,361000
Eswatini,2018,9,209000,143000,352000
Eswatini,2018,10,736000,650000,1386000
Eswatini,2018,11,2669000,822000,3491000
Eswatini,2018,12,303000,287000,590000
Eswatini,2019,1,976000,292000,1268000
Eswatini,2019,2,318000,239000,557000
Eswatini,2019,3,336000,366000,702000
Eswatini,2019,4,295000,416000,711000
Eswatini,2019,5,1017000,293000,1310000
Eswatini,2019,6,763000,539000,1302000
Eswatini,2019,7,817000,440000,1257000
Eswatini,2019,8,809000,252000,1061000
Eswatini,2019,9,296000,748000,1044000
Eswatini,2019,10,1081000,1005000,2086000
Eswatini,2019,11,1058000,448000,1506000
Eswatini,2019,12,528000,536000,1064000
Eswatini,2020,1,98000,286000,384000
Eswatini,2020,2,771000,289000,1060000
Eswatini,2020,3,692000,579000,1271000
Eswatini,2020,4,506000,297000,803000
Eswatini,2020,5,493000,416000,909000
Eswatini,2020,6,293000,658000,951000
Eswatini,2020,7,513000,400000,913000
Eswatini,2020,8,343000,646000,989000
Eswatini,2020,9,464000,288000,752000
Eswatini,2020,10,506000,691000,1197000
Eswatini,2020,11,237000,376000,613000
Eswatini,2020,12,2712000,523000,3235000
Eswatini,2021,1,575000,245000,820000
Eswatini,2021,2,305000,375000,680000
Eswatini,2021,3,1760000,459000,2219000
Eswatini,2021,4,1409000,241000,1650000
Eswatini,2021,5,861000,457000,1318000
Eswatini,2021,6,1094000,128000,1222000
Eswatini,2021,7,528000,354000,882000
Eswatini,2021,8,437000,265000,702000
Eswatini,2021,9,522000,408000,930000
Eswatini,2021,10,365000,506000,871000
Eswatini,2021,11,526000,470000,996000
Eswatini,2021,12,304000,564000,868000
Eswatini,2022,1,727000,554000,1281000
Eswatini,2022,2,576000,433000,1009000
Eswatini,2022,3,681000,510000,1191000
Eswatini,2022,4,1387000,243000,1630000
Eswatini,2022,5,315000,700000,1015000
Eswatini,2022,6,1274000,489000,1763000
Eswatini,2022,7,644000,360000,1004000
Eswatini,2022,8,1366000,346000,1712000
Eswatini,2022,9,2344000,329000,2673000
Eswatini,2022,10,749000,499000,1248000
Eswatini,2022,11,2081000,537000,2618000
Eswatini,2022,12,2874000,658000,3532000
Eswatini,2023,1,1021000,333000,1354000
Eswatini,2023,2,546000,947000,1493000
Eswatini,2023,3,1720000,921000,2641000
Eswatini,2023,4,265000,785000,1050000
Eswatini,2023,5,1472000,294000,1766000
Eswatini,2023,6,819000,418000,1237000
Eswatini,2023,7,1817000,404000,2221000
Eswatini,2023,8,1199000,1266000,2465000
Eswatini,2023,9,1087000,598000,1685000
Eswatini,2023,10,1578000,1127000,2705000
Eswatini,2023,11,904000,960000,1864000
Eswatini,2023,12,1438000,1057000,2495000
Eswatini,2024,1,943000,610000,1553000
Eswatini,2024,2,1460000,897000,2357000
Eswatini,2024,3,837000,818000,1655000
Eswatini,2024,4,624000,902000,1526000
Eswatini,2024,5,4556000,1281000,5837000
Eswatini,2024,6,3188000,623000,3811000
Eswatini,2024,7,1187000,706000,1893000
Eswatini,2024,8,966000,1361000,2327000
Eswatini,2024,9,1439000,913000,2352000
Eswatini,2024,10,989000,894000,1883000
Eswatini,2024,11,1409000,1237000,2646000
Eswatini,2024,12,1966000,1362000,3328000
Falklandinseln,2008,1,354000,0,354000
Falklandinseln,2008,2,77000,0,77000
Falklandinseln,2008,3,10000,0,10000
Falklandinseln,2008,4,5000,53000,58000
Falklandinseln,2008,5,18000,139000,157000
Falklandinseln,2008,6,8000,93000,101000
Falklandinseln,2008,7,1000,350000,351000
Falklandinseln,2008,8,1000,0,1000
Falklandinseln,2008,9,12000,102000,114000
Falklandinseln,2008,10,37000,0,37000
Falklandinseln,2008,11,9000,0,9000
Falklandinseln,2008,12,231000,0,231000
Falklandinseln,2009,1,5000,2000,7000
Falklandinseln,2009,2,102000,0,102000
Falklandinseln,2009,3,37000,44000,81000
Falklandinseln,2009,4,9000,208000,217000
Falklandinseln,2009,5,25000,206000,231000
Falklandinseln,2009,6,2000,0,2000
Falklandinseln,2009,7,111000,115000,226000
Falklandinseln,2009,8,1693000,0,1693000
Falklandinseln,2009,9,3000,0,3000
Falklandinseln,2009,10,14000,0,14000
Falklandinseln,2009,11,4000,2000,6000
Falklandinseln,2009,12,0,46000,46000
Falklandinseln,2010,1,40000,1000,41000
Falklandinseln,2010,2,43000,0,43000
Falklandinseln,2010,3,7000,383000,390000
Falklandinseln,2010,4,1000,212000,213000
Falklandinseln,2010,5,0,347000,347000
Falklandinseln,2010,6,0,138000,138000
Falklandinseln,2010,7,0,0,0
Falklandinseln,2010,8,1000,0,1000
Falklandinseln,2010,9,3000,186000,189000
Falklandinseln,2010,10,348000,0,348000
Falklandinseln,2010,11,39000,0,39000
Falklandinseln,2010,12,0,75000,75000
Falklandinseln,2011,1,0,329000,329000
Falklandinseln,2011,2,0,356000,356000
Falklandinseln,2011,3,0,0,0
Falklandinseln,2011,4,19000,365000,384000
Falklandinseln,2011,5,0,547000,547000
Falklandinseln,2011,6,4000,0,4000
Falklandinseln,2011,7,0,370000,370000
Falklandinseln,2011,8,0,95000,95000
Falklandinseln,2011,9,0,12000,12000
Falklandinseln,2011,10,0,0,0
Falklandinseln,2011,11,0,0,0
Falklandinseln,2011,12,0,0,0
Falklandinseln,2012,1,33000,0,33000
Falklandinseln,2012,2,182000,511000,693000
Falklandinseln,2012,3,0,0,0
Falklandinseln,2012,4,0,111000,111000
Falklandinseln,2012,5,21000,772000,793000
Falklandinseln,2012,6,2000,730000,732000
Falklandinseln,2012,7,13000,191000,204000
Falklandinseln,2012,8,0,0,0
Falklandinseln,2012,9,3000,66000,69000
Falklandinseln,2012,10,1000,154000,155000
Falklandinseln,2012,11,0,0,0
Falklandinseln,2012,12,0,179000,179000
Falklandinseln,2013,1,0,0,0
Falklandinseln,2013,2,0,0,0
Falklandinseln,2013,3,0,31000,31000
Falklandinseln,2013,4,0,0,0
Falklandinseln,2013,5,1000,0,1000
Falklandinseln,2013,6,0,0,0
Falklandinseln,2013,7,0,59000,59000
Falklandinseln,2013,8,2000,213000,215000
Falklandinseln,2013,9,0,0,0
Falklandinseln,2013,10,11000,0,11000
Falklandinseln,2013,11,106000,0,106000
Falklandinseln,2013,12,3000,0,3000
Falklandinseln,2014,1,0,3000,3000
Falklandinseln,2014,2,2596000,38000,2634000
Falklandinseln,2014,3,0,80000,80000
Falklandinseln,2014,4,0,1000,1000
Falklandinseln,2014,5,56000,54000,110000
Falklandinseln,2014,6,2000,125000,127000
Falklandinseln,2014,7,2000,44000,46000
Falklandinseln,2014,8,0,0,0
Falklandinseln,2014,9,0,82000,82000
Falklandinseln,2014,10,140000,1000,141000
Falklandinseln,2014,11,159000,0,159000
Falklandinseln,2014,12,0,0,0
Falklandinseln,2015,1,1000,31000,32000
Falklandinseln,2015,2,107000,13000,120000
Falklandinseln,2015,3,5000,540000,545000
Falklandinseln,2015,4,19000,69000,88000
Falklandinseln,2015,5,15000,0,15000
Falklandinseln,2015,6,1000,295000,296000
Falklandinseln,2015,7,0,0,0
Falklandinseln,2015,8,74000,13000,87000
Falklandinseln,2015,9,3000,0,3000
Falklandinseln,2015,10,37000,1000,38000
Falklandinseln,2015,11,60000,0,60000
Falklandinseln,2015,12,33000,2000,35000
Falklandinseln,2016,1,9000,22000,31000
Falklandinseln,2016,2,157000,0,157000
Falklandinseln,2016,3,0,405000,405000
Falklandinseln,2016,4,7000,995000,1002000
Falklandinseln,2016,5,11000,281000,292000
Falklandinseln,2016,6,1000,767000,768000
Falklandinseln,2016,7,0,174000,174000
Falklandinseln,2016,8,0,168000,168000
Falklandinseln,2016,9,41000,0,41000
Falklandinseln,2016,10,0,0,0
Falklandinseln,2016,11,5000,26000,31000
Falklandinseln,2016,12,307000,0,307000
Falklandinseln,2017,1,10000,0,10000
Falklandinseln,2017,2,9000,424000,433000
Falklandinseln,2017,3,37000,153000,190000
Falklandinseln,2017,4,0,553000,553000
Falklandinseln,2017,5,22000,213000,235000
Falklandinseln,2017,6,1000,76000,77000
Falklandinseln,2017,7,0,347000,347000
Falklandinseln,2017,8,11000,245000,256000
Falklandinseln,2017,9,36000,80000,116000
Falklandinseln,2017,10,26000,198000,224000
Falklandinseln,2017,11,39000,74000,113000
Falklandinseln,2017,12,14000,32000,46000
Falklandinseln,2018,1,0,274000,274000
Falklandinseln,2018,2,5000,286000,291000
Falklandinseln,2018,3,0,261000,261000
Falklandinseln,2018,4,0,234000,234000
Falklandinseln,2018,5,0,533000,533000
Falklandinseln,2018,6,0,956000,956000
Falklandinseln,2018,7,0,12000,12000
Falklandinseln,2018,8,38000,245000,283000
Falklandinseln,2018,9,0,171000,171000
Falklandinseln,2018,10,0,396000,396000
Falklandinseln,2018,11,3000,169000,172000
Falklandinseln,2018,12,28000,70000,98000
Falklandinseln,2019,1,0,101000,101000
Falklandinseln,2019,2,0,314000,314000
Falklandinseln,2019,3,23000,159000,182000
Falklandinseln,2019,4,2000,1313000,1315000
Falklandinseln,2019,5,2000,77000,79000
Falklandinseln,2019,6,0,322000,322000
Falklandinseln,2019,7,0,1273000,1273000
Falklandinseln,2019,8,0,540000,540000
Falklandinseln,2019,9,4000,214000,218000
Falklandinseln,2019,10,28000,202000,230000
Falklandinseln,2019,11,0,303000,303000
Falklandinseln,2019,12,6000,328000,334000
Falklandinseln,2020,1,0,629000,629000
Falklandinseln,2020,2,1000,259000,260000
Falklandinseln,2020,3,1000,109000,110000
Falklandinseln,2020,4,22000,150000,172000
Falklandinseln,2020,5,5000,367000,372000
Falklandinseln,2020,6,0,390000,390000
Falklandinseln,2020,7,3000,273000,276000
Falklandinseln,2020,8,5000,569000,574000
Falklandinseln,2020,9,2000,271000,273000
Falklandinseln,2020,10,2000,144000,146000
Falklandinseln,2020,11,11000,199000,210000
Falklandinseln,2020,12,1000,89000,90000
Falklandinseln,2021,1,27000,448000,475000
Falklandinseln,2021,2,6000,458000,464000
Falklandinseln,2021,3,24000,199000,223000
Falklandinseln,2021,4,0,390000,390000
Falklandinseln,2021,5,23000,333000,356000
Falklandinseln,2021,6,20000,808000,828000
Falklandinseln,2021,7,5000,253000,258000
Falklandinseln,2021,8,22000,483000,505000
Falklandinseln,2021,9,10000,258000,268000
Falklandinseln,2021,10,0,369000,369000
Falklandinseln,2021,11,4000,173000,177000
Falklandinseln,2021,12,27000,237000,264000
Falklandinseln,2022,1,0,244000,244000
Falklandinseln,2022,2,4000,294000,298000
Falklandinseln,2022,3,7000,695000,702000
Falklandinseln,2022,4,128000,818000,946000
Falklandinseln,2022,5,7000,1930000,1937000
Falklandinseln,2022,6,6000,681000,687000
Falklandinseln,2022,7,2000,699000,701000
Falklandinseln,2022,8,3000,1149000,1152000
Falklandinseln,2022,9,16000,382000,398000
Falklandinseln,2022,10,11000,549000,560000
Falklandinseln,2022,11,8000,221000,229000
Falklandinseln,2022,12,0,372000,372000
Falklandinseln,2023,1,13000,402000,415000
Falklandinseln,2023,2,0,399000,399000
Falklandinseln,2023,3,18000,622000,640000
Falklandinseln,2023,4,108000,496000,604000
Falklandinseln,2023,5,3000,600000,603000
Falklandinseln,2023,6,11000,699000,710000
Falklandinseln,2023,7,14000,687000,701000
Falklandinseln,2023,8,45000,453000,498000
Falklandinseln,2023,9,3000,350000,353000
Falklandinseln,2023,10,5000,517000,522000
Falklandinseln,2023,11,14000,268000,282000
Falklandinseln,2023,12,35000,253000,288000
Falklandinseln,2024,1,39000,165000,204000
Falklandinseln,2024,2,12000,564000,576000
Falklandinseln,2024,3,115000,397000,512000
Falklandinseln,2024,4,12000,256000,268000
Falklandinseln,2024,5,0,446000,446000
Falklandinseln,2024,6,0,689000,689000
Falklandinseln,2024,7,12000,809000,821000
Falklandinseln,2024,8,15000,107000,122000
Falklandinseln,2024,9,0,876000,876000
Falklandinseln,2024,10,98000,498000,596000
Falklandinseln,2024,11,0,163000,163000
Falklandinseln,2024,12,0,607000,607000
Fidschi,2008,1,169000,77000,246000
Fidschi,2008,2,142000,376000,518000
Fidschi,2008,3,196000,6000,202000
Fidschi,2008,4,406000,144000,550000
Fidschi,2008,5,174000,74000,248000
Fidschi,2008,6,415000,98000,513000
Fidschi,2008,7,307000,39000,346000
Fidschi,2008,8,1864000,41000,1905000
Fidschi,2008,9,340000,356000,696000
Fidschi,2008,10,241000,420000,661000
Fidschi,2008,11,366000,1634000,2000000
Fidschi,2008,12,1680000,166000,1846000
Fidschi,2009,1,244000,42000,286000
Fidschi,2009,2,220000,164000,384000
Fidschi,2009,3,261000,39000,300000
Fidschi,2009,4,212000,201000,413000
Fidschi,2009,5,134000,110000,244000
Fidschi,2009,6,220000,70000,290000
Fidschi,2009,7,222000,170000,392000
Fidschi,2009,8,356000,157000,513000
Fidschi,2009,9,440000,315000,755000
Fidschi,2009,10,189000,641000,830000
Fidschi,2009,11,144000,71000,215000
Fidschi,2009,12,705000,105000,810000
Fidschi,2010,1,240000,157000,397000
Fidschi,2010,2,310000,99000,409000
Fidschi,2010,3,726000,384000,1110000
Fidschi,2010,4,101000,147000,248000
Fidschi,2010,5,66000,95000,161000
Fidschi,2010,6,47000,77000,124000
Fidschi,2010,7,86000,207000,293000
Fidschi,2010,8,131000,115000,246000
Fidschi,2010,9,146000,163000,309000
Fidschi,2010,10,235000,202000,437000
Fidschi,2010,11,120000,121000,241000
Fidschi,2010,12,160000,197000,357000
Fidschi,2011,1,125000,32000,157000
Fidschi,2011,2,879000,393000,1272000
Fidschi,2011,3,518000,192000,710000
Fidschi,2011,4,415000,68000,483000
Fidschi,2011,5,1936000,155000,2091000
Fidschi,2011,6,220000,306000,526000
Fidschi,2011,7,278000,43000,321000
Fidschi,2011,8,442000,430000,872000
Fidschi,2011,9,167000,167000,334000
Fidschi,2011,10,29558000,95000,29653000
Fidschi,2011,11,122000,218000,340000
Fidschi,2011,12,1169000,181000,1350000
Fidschi,2012,1,630000,132000,762000
Fidschi,2012,2,262000,190000,452000
Fidschi,2012,3,286000,104000,390000
Fidschi,2012,4,842000,219000,1061000
Fidschi,2012,5,258000,189000,447000
Fidschi,2012,6,447000,220000,667000
Fidschi,2012,7,261000,316000,577000
Fidschi,2012,8,402000,328000,730000
Fidschi,2012,9,273000,221000,494000
Fidschi,2012,10,443000,878000,1321000
Fidschi,2012,11,580000,141000,721000
Fidschi,2012,12,800000,298000,1098000
Fidschi,2013,1,495000,162000,657000
Fidschi,2013,2,366000,137000,503000
Fidschi,2013,3,1122000,747000,1869000
Fidschi,2013,4,1258000,346000,1604000
Fidschi,2013,5,360000,26000,386000
Fidschi,2013,6,464000,135000,599000
Fidschi,2013,7,679000,45000,724000
Fidschi,2013,8,673000,176000,849000
Fidschi,2013,9,784000,118000,902000
Fidschi,2013,10,517000,206000,723000
Fidschi,2013,11,1180000,222000,1402000
Fidschi,2013,12,722000,120000,842000
Fidschi,2014,1,480000,208000,688000
Fidschi,2014,2,117000,274000,391000
Fidschi,2014,3,543000,230000,773000
Fidschi,2014,4,351000,207000,558000
Fidschi,2014,5,701000,169000,870000
Fidschi,2014,6,895000,111000,1006000
Fidschi,2014,7,2938000,159000,3097000
Fidschi,2014,8,1056000,104000,1160000
Fidschi,2014,9,284000,219000,503000
Fidschi,2014,10,310000,316000,626000
Fidschi,2014,11,374000,254000,628000
Fidschi,2014,12,583000,190000,773000
Fidschi,2015,1,490000,162000,652000
Fidschi,2015,2,424000,243000,667000
Fidschi,2015,3,517000,499000,1016000
Fidschi,2015,4,559000,69000,628000
Fidschi,2015,5,699000,60000,759000
Fidschi,2015,6,370000,225000,595000
Fidschi,2015,7,527000,218000,745000
Fidschi,2015,8,266000,144000,410000
Fidschi,2015,9,822000,496000,1318000
Fidschi,2015,10,311000,289000,600000
Fidschi,2015,11,1341000,123000,1464000
Fidschi,2015,12,1351000,174000,1525000
Fidschi,2016,1,137000,81000,218000
Fidschi,2016,2,588000,171000,759000
Fidschi,2016,3,538000,275000,813000
Fidschi,2016,4,576000,151000,727000
Fidschi,2016,5,882000,359000,1241000
Fidschi,2016,6,855000,98000,953000
Fidschi,2016,7,1045000,112000,1157000
Fidschi,2016,8,913000,123000,1036000
Fidschi,2016,9,1203000,302000,1505000
Fidschi,2016,10,705000,74000,779000
Fidschi,2016,11,1237000,149000,1386000
Fidschi,2016,12,286000,153000,439000
Fidschi,2017,1,694000,301000,995000
Fidschi,2017,2,667000,64000,731000
Fidschi,2017,3,4977000,197000,5174000
Fidschi,2017,4,162000,185000,347000
Fidschi,2017,5,768000,115000,883000
Fidschi,2017,6,581000,252000,833000
Fidschi,2017,7,851000,252000,1103000
Fidschi,2017,8,442000,76000,518000
Fidschi,2017,9,658000,284000,942000
Fidschi,2017,10,425000,111000,536000
Fidschi,2017,11,419000,51000,470000
Fidschi,2017,12,1364000,197000,1561000
Fidschi,2018,1,628000,173000,801000
Fidschi,2018,2,283000,97000,380000
Fidschi,2018,3,666000,88000,754000
Fidschi,2018,4,572000,51000,623000
Fidschi,2018,5,440000,142000,582000
Fidschi,2018,6,1236000,52000,1288000
Fidschi,2018,7,457000,190000,647000
Fidschi,2018,8,740000,39000,779000
Fidschi,2018,9,684000,152000,836000
Fidschi,2018,10,764000,88000,852000
Fidschi,2018,11,1279000,99000,1378000
Fidschi,2018,12,394000,63000,457000
Fidschi,2019,1,515000,123000,638000
Fidschi,2019,2,888000,86000,974000
Fidschi,2019,3,1154000,305000,1459000
Fidschi,2019,4,464000,89000,553000
Fidschi,2019,5,359000,42000,401000
Fidschi,2019,6,972000,58000,1030000
Fidschi,2019,7,468000,62000,530000
Fidschi,2019,8,1384000,425000,1809000
Fidschi,2019,9,509000,132000,641000
Fidschi,2019,10,348000,101000,449000
Fidschi,2019,11,903000,257000,1160000
Fidschi,2019,12,702000,67000,769000
Fidschi,2020,1,2018000,182000,2200000
Fidschi,2020,2,1501000,47000,1548000
Fidschi,2020,3,922000,77000,999000
Fidschi,2020,4,156000,1263000,1419000
Fidschi,2020,5,459000,1497000,1956000
Fidschi,2020,6,234000,145000,379000
Fidschi,2020,7,868000,136000,1004000
Fidschi,2020,8,383000,340000,723000
Fidschi,2020,9,193000,4248000,4441000
Fidschi,2020,10,209000,220000,429000
Fidschi,2020,11,682000,2285000,2967000
Fidschi,2020,12,856000,6435000,7291000
Fidschi,2021,1,183000,189000,372000
Fidschi,2021,2,489000,80000,569000
Fidschi,2021,3,478000,3605000,4083000
Fidschi,2021,4,342000,1438000,1780000
Fidschi,2021,5,368000,56000,424000
Fidschi,2021,6,489000,55000,544000
Fidschi,2021,7,1229000,3003000,4232000
Fidschi,2021,8,287000,32000,319000
Fidschi,2021,9,198000,226000,424000
Fidschi,2021,10,579000,135000,714000
Fidschi,2021,11,227000,240000,467000
Fidschi,2021,12,289000,39000,328000
Fidschi,2022,1,1276000,226000,1502000
Fidschi,2022,2,2531000,259000,2790000
Fidschi,2022,3,496000,203000,699000
Fidschi,2022,4,218000,43000,261000
Fidschi,2022,5,1634000,48000,1682000
Fidschi,2022,6,1586000,103000,1689000
Fidschi,2022,7,462000,12000,474000
Fidschi,2022,8,1134000,115000,1249000
Fidschi,2022,9,1479000,164000,1643000
Fidschi,2022,10,806000,115000,921000
Fidschi,2022,11,1180000,205000,1385000
Fidschi,2022,12,532000,63000,595000
Fidschi,2023,1,578000,250000,828000
Fidschi,2023,2,824000,79000,903000
Fidschi,2023,3,765000,60000,825000
Fidschi,2023,4,667000,270000,937000
Fidschi,2023,5,450000,43000,493000
Fidschi,2023,6,1355000,226000,1581000
Fidschi,2023,7,13909000,74000,13983000
Fidschi,2023,8,1804000,167000,1971000
Fidschi,2023,9,2328000,32000,2360000
Fidschi,2023,10,215000,178000,393000
Fidschi,2023,11,761000,655000,1416000
Fidschi,2023,12,1136000,60000,1196000
Fidschi,2024,1,1514000,207000,1721000
Fidschi,2024,2,2851000,93000,2944000
Fidschi,2024,3,845000,20000,865000
Fidschi,2024,4,857000,297000,1154000
Fidschi,2024,5,486000,437000,923000
Fidschi,2024,6,1002000,50000,1052000
Fidschi,2024,7,1281000,141000,1422000
Fidschi,2024,8,580000,56000,636000
Fidschi,2024,9,754000,59000,813000
Fidschi,2024,10,515000,116000,631000
Fidschi,2024,11,631000,180000,811000
Fidschi,2024,12,591000,26000,617000
Finnland,2008,1,879023000,677650000,1556673000
Finnland,2008,2,851603000,652476000,1504079000
Finnland,2008,3,895406000,697335000,1592741000
Finnland,2008,4,861841000,722793000,1584634000
Finnland,2008,5,825166000,698687000,1523853000
Finnland,2008,6,855886000,644190000,1500076000
Finnland,2008,7,788271000,626446000,1414717000
Finnland,2008,8,749602000,721864000,1471466000
Finnland,2008,9,802398000,603853000,1406251000
Finnland,2008,10,822863000,586409000,1409272000
Finnland,2008,11,727916000,616669000,1344585000
Finnland,2008,12,583448000,508473000,1091921000
Finnland,2009,1,628900000,443201000,1072101000
Finnland,2009,2,630810000,449196000,1080006000
Finnland,2009,3,613857000,442882000,1056739000
Finnland,2009,4,612662000,414627000,1027289000
Finnland,2009,5,559045000,405193000,964238000
Finnland,2009,6,533092000,423718000,956810000
Finnland,2009,7,588916000,400071000,988987000
Finnland,2009,8,494904000,420668000,915572000
Finnland,2009,9,614707000,468377000,1083084000
Finnland,2009,10,638561000,486159000,1124720000
Finnland,2009,11,583699000,511784000,1095483000
Finnland,2009,12,585994000,436820000,1022814000
Finnland,2010,1,505771000,389720000,895491000
Finnland,2010,2,588867000,411605000,1000472000
Finnland,2010,3,669225000,418190000,1087415000
Finnland,2010,4,586192000,442649000,1028841000
Finnland,2010,5,638102000,511950000,1150052000
Finnland,2010,6,684691000,688909000,1373600000
Finnland,2010,7,651783000,498745000,1150528000
Finnland,2010,8,622045000,508393000,1130438000
Finnland,2010,9,676420000,533794000,1210214000
Finnland,2010,10,692477000,526415000,1218892000
Finnland,2010,11,694796000,587434000,1282230000
Finnland,2010,12,633250000,513083000,1146333000
Finnland,2011,1,646465000,549531000,1195996000
Finnland,2011,2,712258000,573804000,1286062000
Finnland,2011,3,809335000,593551000,1402886000
Finnland,2011,4,698994000,601165000,1300159000
Finnland,2011,5,744130000,512295000,1256425000
Finnland,2011,6,692417000,536866000,1229283000
Finnland,2011,7,703985000,539853000,1243838000
Finnland,2011,8,677096000,572362000,1249458000
Finnland,2011,9,714833000,537113000,1251946000
Finnland,2011,10,715253000,509324000,1224577000
Finnland,2011,11,682547000,530095000,1212642000
Finnland,2011,12,651688000,522252000,1173940000
Finnland,2012,1,651147000,491848000,1142995000
Finnland,2012,2,732869000,511270000,1244139000
Finnland,2012,3,775253000,562375000,1337628000
Finnland,2012,4,668395000,491971000,1160366000
Finnland,2012,5,678440000,544893000,1223333000
Finnland,2012,6,681362000,540693000,1222055000
Finnland,2012,7,623155000,490727000,1113882000
Finnland,2012,8,652026000,599517000,1251543000
Finnland,2012,9,653030000,504013000,1157043000
Finnland,2012,10,703918000,528870000,1232788000
Finnland,2012,11,648518000,501464000,1149982000
Finnland,2012,12,566358000,407079000,973437000
Finnland,2013,1,647191000,493325000,1140516000
Finnland,2013,2,653561000,432250000,1085811000
Finnland,2013,3,687217000,487739000,1174956000
Finnland,2013,4,750636000,511731000,1262367000
Finnland,2013,5,660015000,503249000,1163264000
Finnland,2013,6,674937000,539100000,1214037000
Finnland,2013,7,612538000,452556000,1065094000
Finnland,2013,8,659194000,582188000,1241382000
Finnland,2013,9,745656000,516270000,1261926000
Finnland,2013,10,740814000,520820000,1261634000
Finnland,2013,11,675779000,505392000,1181171000
Finnland,2013,12,658921000,512585000,1171506000
Finnland,2014,1,710171000,570076000,1280247000
Finnland,2014,2,766147000,536898000,1303045000
Finnland,2014,3,748526000,577859000,1326385000
Finnland,2014,4,770368000,531465000,1301833000
Finnland,2014,5,705218000,621405000,1326623000
Finnland,2014,6,732013000,565678000,1297691000
Finnland,2014,7,721279000,649534000,1370813000
Finnland,2014,8,683064000,553030000,1236094000
Finnland,2014,9,776747000,663680000,1440427000
Finnland,2014,10,786117000,693436000,1479553000
Finnland,2014,11,711726000,707166000,1418892000
Finnland,2014,12,656401000,609071000,1265472000
Finnland,2015,1,710410000,586264000,1296674000
Finnland,2015,2,701792000,653329000,1355121000
Finnland,2015,3,817543000,721346000,1538889000
Finnland,2015,4,792451000,728172000,1520623000
Finnland,2015,5,727274000,661175000,1388449000
Finnland,2015,6,786606000,775777000,1562383000
Finnland,2015,7,749703000,701636000,1451339000
Finnland,2015,8,697646000,614330000,1311976000
Finnland,2015,9,806824000,1243113000,2049937000
Finnland,2015,10,762963000,739728000,1502691000
Finnland,2015,11,768492000,737465000,1505957000
Finnland,2015,12,658407000,624078000,1282485000
Finnland,2016,1,707840000,571120000,1278960000
Finnland,2016,2,780526000,672356000,1452882000
Finnland,2016,3,783320000,631302000,1414622000
Finnland,2016,4,794795000,616470000,1411265000
Finnland,2016,5,760614000,621704000,1382318000
Finnland,2016,6,796966000,666619000,1463585000
Finnland,2016,7,682749000,591568000,1274317000
Finnland,2016,8,721776000,520100000,1241876000
Finnland,2016,9,860742000,1168857000,2029599000
Finnland,2016,10,789516000,698754000,1488270000
Finnland,2016,11,812193000,676254000,1488447000
Finnland,2016,12,739606000,590925000,1330531000
Finnland,2017,1,785561000,617113000,1402674000
Finnland,2017,2,902698000,646695000,1549393000
Finnland,2017,3,967870000,679867000,1647737000
Finnland,2017,4,931621000,638706000,1570327000
Finnland,2017,5,949655000,655238000,1604893000
Finnland,2017,6,945165000,626200000,1571365000
Finnland,2017,7,821589000,642008000,1463597000
Finnland,2017,8,899198000,1201670000,2100868000
Finnland,2017,9,981902000,642693000,1624595000
Finnland,2017,10,948529000,664932000,1613461000
Finnland,2017,11,1039277000,659492000,1698769000
Finnland,2017,12,884648000,601998000,1486646000
Finnland,2018,1,939696000,587951000,1527647000
Finnland,2018,2,895901000,637704000,1533605000
Finnland,2018,3,992520000,715654000,1708174000
Finnland,2018,4,966261000,659469000,1625730000
Finnland,2018,5,963172000,684840000,1648012000
Finnland,2018,6,945811000,689481000,1635292000
Finnland,2018,7,906441000,1227115000,2133556000
Finnland,2018,8,887926000,640891000,1528817000
Finnland,2018,9,894459000,665333000,1559792000
Finnland,2018,10,995426000,734853000,1730279000
Finnland,2018,11,925820000,687668000,1613488000
Finnland,2018,12,796017000,749940000,1545957000
Finnland,2019,1,925334000,694199000,1619533000
Finnland,2019,2,879812000,694330000,1574142000
Finnland,2019,3,979890000,1289931000,2269821000
Finnland,2019,4,937953000,767561000,1705514000
Finnland,2019,5,955515000,812795000,1768310000
Finnland,2019,6,913169000,694533000,1607702000
Finnland,2019,7,888197000,646004000,1534201000
Finnland,2019,8,910022000,679183000,1589205000
Finnland,2019,9,994549000,718786000,1713335000
Finnland,2019,10,1042237000,710669000,1752906000
Finnland,2019,11,894790000,693549000,1588339000
Finnland,2019,12,737595000,639391000,1376986000
Finnland,2020,1,905773000,628905000,1534678000
Finnland,2020,2,918586000,645200000,1563786000
Finnland,2020,3,979546000,687948000,1667494000
Finnland,2020,4,673893000,569274000,1243167000
Finnland,2020,5,696303000,508568000,1204871000
Finnland,2020,6,807557000,605161000,1412718000
Finnland,2020,7,799087000,641558000,1440645000
Finnland,2020,8,821388000,600497000,1421885000
Finnland,2020,9,910107000,655205000,1565312000
Finnland,2020,10,911372000,646580000,1557952000
Finnland,2020,11,956472000,672142000,1628614000
Finnland,2020,12,766220000,673455000,1439675000
Finnland,2021,1,841170000,548445000,1389615000
Finnland,2021,2,892126000,731135000,1623261000
Finnland,2021,3,1063000000,731357000,1794357000
Finnland,2021,4,973562000,617919000,1591481000
Finnland,2021,5,969030000,707207000,1676237000
Finnland,2021,6,1074412000,686568000,1760980000
Finnland,2021,7,977729000,710691000,1688420000
Finnland,2021,8,888728000,667655000,1556383000
Finnland,2021,9,1056951000,689898000,1746849000
Finnland,2021,10,1082062000,762718000,1844780000
Finnland,2021,11,1136156000,788051000,1924207000
Finnland,2021,12,1053451000,759274000,1812725000
Finnland,2022,1,983955000,687603000,1671558000
Finnland,2022,2,1026057000,724791000,1750848000
Finnland,2022,3,1221000000,900807000,2121807000
Finnland,2022,4,1099042000,815027000,1914069000
Finnland,2022,5,1180955000,827167000,2008122000
Finnland,2022,6,1147233000,875388000,2022621000
Finnland,2022,7,940577000,821201000,1761778000
Finnland,2022,8,1031503000,923621000,1955124000
Finnland,2022,9,1112000000,930047000,2042047000
Finnland,2022,10,1006352000,842201000,1848553000
Finnland,2022,11,1078445000,951212000,2029657000
Finnland,2022,12,884667000,679818000,1564485000
Finnland,2023,1,990459000,743928000,1734387000
Finnland,2023,2,943515000,663805000,1607320000
Finnland,2023,3,1199112000,920610000,2119722000
Finnland,2023,4,964352000,864341000,1828693000
Finnland,2023,5,1035884000,800167000,1836051000
Finnland,2023,6,1051186000,769417000,1820603000
Finnland,2023,7,865208000,694598000,1559806000
Finnland,2023,8,956097000,728433000,1684530000
Finnland,2023,9,965685000,760826000,1726511000
Finnland,2023,10,952512000,764911000,1717423000
Finnland,2023,11,997838000,848889000,1846727000
Finnland,2023,12,831615000,640180000,1471795000
Finnland,2024,1,989070000,764112000,1753182000
Finnland,2024,2,957436000,656513000,1613949000
Finnland,2024,3,899010000,641688000,1540698000
Finnland,2024,4,1030646000,742303000,1772949000
Finnland,2024,5,928125000,706778000,1634903000
Finnland,2024,6,843640000,1407250000,2250890000
Finnland,2024,7,893451000,730009000,1623460000
Finnland,2024,8,998891000,653175000,1652066000
Finnland,2024,9,932484000,738870000,1671354000
Finnland,2024,10,975072000,788491000,1763563000
Finnland,2024,11,853730000,710543000,1564273000
Finnland,2024,12,752378000,614058000,1366436000
Frankreich,2008,1,8016554000,5346249000,13362803000
Frankreich,2008,2,8295645000,5850302000,14145947000
Frankreich,2008,3,7920745000,4905490000,12826235000
Frankreich,2008,4,8699666000,5966264000,14665930000
Frankreich,2008,5,7352414000,5081428000,12433842000
Frankreich,2008,6,8410928000,5311208000,13722136000
Frankreich,2008,7,7826478000,5968510000,13794988000
Frankreich,2008,8,6346012000,4370691000,10716703000
Frankreich,2008,9,8216787000,5316800000,13533587000
Frankreich,2008,10,8603134000,5683270000,14286404000
Frankreich,2008,11,7302370000,4932700000,12235070000
Frankreich,2008,12,6727209000,4635698000,11362907000
Frankreich,2009,1,6817858000,4544639000,11362497000
Frankreich,2009,2,6650937000,4671609000,11322546000
Frankreich,2009,3,7098550000,4784856000,11883406000
Frankreich,2009,4,6675356000,4843470000,11518826000
Frankreich,2009,5,6448634000,4059892000,10508526000
Frankreich,2009,6,7073539000,4552993000,11626532000
Frankreich,2009,7,6429973000,4132414000,10562387000
Frankreich,2009,8,5740008000,4041118000,9781126000
Frankreich,2009,9,7025395000,4555715000,11581110000
Frankreich,2009,10,7641831000,5218795000,12860626000
Frankreich,2009,11,7045280000,3931653000,10976933000
Frankreich,2009,12,6656718000,4001349000,10658067000
Frankreich,2010,1,6700293000,4420775000,11121068000
Frankreich,2010,2,7098686000,4726966000,11825652000
Frankreich,2010,3,8009900000,5037255000,13047155000
Frankreich,2010,4,7307336000,4755295000,12062631000
Frankreich,2010,5,7194266000,4756394000,11950660000
Frankreich,2010,6,8374380000,5714261000,14088641000
Frankreich,2010,7,7531144000,5998297000,13529441000
Frankreich,2010,8,6055391000,4377737000,10433128000
Frankreich,2010,9,7675732000,4956342000,12632074000
Frankreich,2010,10,8117774000,5133737000,13251511000
Frankreich,2010,11,8111793000,5483289000,13595082000
Frankreich,2010,12,7405110000,5312192000,12717302000
Frankreich,2011,1,8217943000,4649239000,12867182000
Frankreich,2011,2,8128547000,5566999000,13695546000
Frankreich,2011,3,9441189000,5968462000,15409651000
Frankreich,2011,4,8112210000,4875374000,12987584000
Frankreich,2011,5,8811657000,6007738000,14819395000
Frankreich,2011,6,8830069000,6745346000,15575415000
Frankreich,2011,7,7615612000,4942819000,12558431000
Frankreich,2011,8,7233457000,4882447000,12115904000
Frankreich,2011,9,9503965000,5838437000,15342402000
Frankreich,2011,10,8140977000,5848658000,13989635000
Frankreich,2011,11,9521817000,5491803000,15013620000
Frankreich,2011,12,7886824000,5130962000,13017786000
Frankreich,2012,1,8645916000,5111938000,13757854000
Frankreich,2012,2,9004629000,5089718000,14094347000
Frankreich,2012,3,9404080000,5845333000,15249413000
Frankreich,2012,4,7709083000,5607336000,13316419000
Frankreich,2012,5,8849672000,5597152000,14446824000
Frankreich,2012,6,9116277000,5212199000,14328476000
Frankreich,2012,7,8970373000,5490249000,14460622000
Frankreich,2012,8,7028665000,5021587000,12050252000
Frankreich,2012,9,8721623000,5062955000,13784578000
Frankreich,2012,10,9417932000,5398415000,14816347000
Frankreich,2012,11,8715387000,5830879000,14546266000
Frankreich,2012,12,6855858000,4369065000,11224923000
Frankreich,2013,1,8419462000,4999008000,13418470000
Frankreich,2013,2,8614274000,4932416000,13546690000
Frankreich,2013,3,8556981000,6093789000,14650770000
Frankreich,2013,4,8259538000,5298578000,13558116000
Frankreich,2013,5,7381747000,5402607000,12784354000
Frankreich,2013,6,8870082000,5649226000,14519308000
Frankreich,2013,7,8376578000,5560996000,13937574000
Frankreich,2013,8,6687367000,4498805000,11186172000
Frankreich,2013,9,8943145000,4566175000,13509320000
Frankreich,2013,10,9340487000,6262596000,15603083000
Frankreich,2013,11,8513764000,5287882000,13801646000
Frankreich,2013,12,7286999000,4936871000,12223870000
Frankreich,2014,1,8566057000,5300789000,13866846000
Frankreich,2014,2,8775048000,5705753000,14480801000
Frankreich,2014,3,8345349000,6714107000,15059456000
Frankreich,2014,4,8528596000,5665260000,14193856000
Frankreich,2014,5,8042380000,4604601000,12646981000
Frankreich,2014,6,8662472000,6558089000,15220561000
Frankreich,2014,7,9024658000,5436172000,14460830000
Frankreich,2014,8,6452348000,4313894000,10766242000
Frankreich,2014,9,8814474000,5833474000,14647948000
Frankreich,2014,10,9099720000,5776413000,14876133000
Frankreich,2014,11,8481174000,5719800000,14200974000
Frankreich,2014,12,7787536000,5085235000,12872771000
Frankreich,2015,1,8522635000,5160919000,13683554000
Frankreich,2015,2,9171181000,5637640000,14808821000
Frankreich,2015,3,8955762000,6439896000,15395658000
Frankreich,2015,4,8929953000,5377947000,14307900000
Frankreich,2015,5,8456530000,5234598000,13691128000
Frankreich,2015,6,9049211000,5886551000,14935762000
Frankreich,2015,7,8532128000,5462462000,13994590000
Frankreich,2015,8,6245595000,4608855000,10854450000
Frankreich,2015,9,9157048000,5695721000,14852769000
Frankreich,2015,10,9433601000,6215327000,15648928000
Frankreich,2015,11,8797051000,5811944000,14608995000
Frankreich,2015,12,7511537000,5287179000,12798716000
Frankreich,2016,1,8451864000,5068127000,13519991000
Frankreich,2016,2,8583315000,6046800000,14630115000
Frankreich,2016,3,8964752000,5776339000,14741091000
Frankreich,2016,4,8860628000,5679324000,14539952000
Frankreich,2016,5,8034106000,5634478000,13668584000
Frankreich,2016,6,8836737000,5947849000,14784586000
Frankreich,2016,7,7946997000,5621316000,13568313000
Frankreich,2016,8,7055167000,4529554000,11584721000
Frankreich,2016,9,9000752000,5424212000,14424964000
Frankreich,2016,10,8459327000,5771001000,14230328000
Frankreich,2016,11,9175144000,5254331000,14429475000
Frankreich,2016,12,7737050000,4898114000,12635164000
Frankreich,2017,1,8612396000,5467227000,14079623000
Frankreich,2017,2,8651969000,5331833000,13983802000
Frankreich,2017,3,9256897000,5838733000,15095630000
Frankreich,2017,4,8641780000,5122607000,13764387000
Frankreich,2017,5,9395919000,5211755000,14607674000
Frankreich,2017,6,9019110000,5483060000,14502170000
Frankreich,2017,7,8458815000,5258285000,13717100000
Frankreich,2017,8,7841793000,4803288000,12645081000
Frankreich,2017,9,9148458000,5163291000,14311749000
Frankreich,2017,10,9011328000,6016177000,15027505000
Frankreich,2017,11,9700845000,5686849000,15387694000
Frankreich,2017,12,7922067000,4919534000,12841601000
Frankreich,2018,1,9282575000,5137091000,14419666000
Frankreich,2018,2,8427027000,5449354000,13876381000
Frankreich,2018,3,9628696000,5595807000,15224503000
Frankreich,2018,4,9177564000,5688290000,14865854000
Frankreich,2018,5,8335615000,5117562000,13453177000
Frankreich,2018,6,9435854000,5663085000,15098939000
Frankreich,2018,7,8993492000,5876432000,14869924000
Frankreich,2018,8,7176857000,4622468000,11799325000
Frankreich,2018,9,8931630000,5159322000,14090952000
Frankreich,2018,10,9011276000,5923412000,14934688000
Frankreich,2018,11,9106429000,5725143000,14831572000
Frankreich,2018,12,7851818000,5065929000,12917747000
Frankreich,2019,1,9062083000,5326851000,14388934000
Frankreich,2019,2,9222799000,5557494000,14780293000
Frankreich,2019,3,9610468000,6064103000,15674571000
Frankreich,2019,4,9254281000,5521894000,14776175000
Frankreich,2019,5,8912184000,5728207000,14640391000
Frankreich,2019,6,8685150000,5573914000,14259064000
Frankreich,2019,7,9038111000,5788855000,14826966000
Frankreich,2019,8,7333296000,4518926000,11852222000
Frankreich,2019,9,9319089000,5716355000,15035444000
Frankreich,2019,10,9603467000,5810589000,15414056000
Frankreich,2019,11,9325961000,5504383000,14830344000
Frankreich,2019,12,7196636000,5087824000,12284460000
Frankreich,2020,1,8766705000,5164748000,13931453000
Frankreich,2020,2,9039027000,5596178000,14635205000
Frankreich,2020,3,7839298000,5344000000,13183298000
Frankreich,2020,4,4792485000,3407966000,8200451000
Frankreich,2020,5,6119708000,3873822000,9993530000
Frankreich,2020,6,7748779000,4382569000,12131348000
Frankreich,2020,7,7730236000,4311207000,12041443000
Frankreich,2020,8,6452333000,4108505000,10560838000
Frankreich,2020,9,8384514000,4741929000,13126443000
Frankreich,2020,10,8451109000,5201799000,13652908000
Frankreich,2020,11,8352807000,5656340000,14009147000
Frankreich,2020,12,7233071000,4574857000,11807928000
Frankreich,2021,1,7904223000,4432990000,12337213000
Frankreich,2021,2,8143508000,4926209000,13069717000
Frankreich,2021,3,9649772000,5801459000,15451231000
Frankreich,2021,4,8550549000,4912700000,13463249000
Frankreich,2021,5,8450253000,4723386000,13173639000
Frankreich,2021,6,9201329000,5460696000,14662025000
Frankreich,2021,7,8495060000,5193166000,13688226000
Frankreich,2021,8,7098452000,4419896000,11518348000
Frankreich,2021,9,8668309000,5249774000,13918083000
Frankreich,2021,10,8790151000,5681429000,14471580000
Frankreich,2021,11,9400307000,5732413000,15132720000
Frankreich,2021,12,8388921000,5387179000,13776100000
Frankreich,2022,1,9079292000,5270402000,14349694000
Frankreich,2022,2,9338113000,5548646000,14886759000
Frankreich,2022,3,10789422000,6623342000,17412764000
Frankreich,2022,4,9071738000,5548897000,14620635000
Frankreich,2022,5,10009965000,6049306000,16059271000
Frankreich,2022,6,10505863000,6325767000,16831630000
Frankreich,2022,7,9592395000,5621815000,15214210000
Frankreich,2022,8,8880757000,5160247000,14041004000
Frankreich,2022,9,11068362000,6103342000,17171704000
Frankreich,2022,10,9935755000,5947442000,15883197000
Frankreich,2022,11,10564250000,6072951000,16637201000
Frankreich,2022,12,9388602000,5708283000,15096885000
Frankreich,2023,1,10303857000,5553766000,15857623000
Frankreich,2023,2,10069174000,5922527000,15991701000
Frankreich,2023,3,11279800000,6829793000,18109593000
Frankreich,2023,4,9369703000,5504337000,14874040000
Frankreich,2023,5,10004388000,6025966000,16030354000
Frankreich,2023,6,10816357000,6334953000,17151310000
Frankreich,2023,7,9564740000,5636673000,15201413000
Frankreich,2023,8,8503101000,4958416000,13461517000
Frankreich,2023,9,10134236000,5896250000,16030486000
Frankreich,2023,10,10298508000,5728216000,16026724000
Frankreich,2023,11,10651304000,6194598000,16845902000
Frankreich,2023,12,8829659000,5286397000,14116056000
Frankreich,2024,1,10515517000,5864133000,16379650000
Frankreich,2024,2,10502196000,5921501000,16423697000
Frankreich,2024,3,10256926000,5752073000,16008999000
Frankreich,2024,4,10965733000,6076924000,17042657000
Frankreich,2024,5,9398375000,5244651000,14643026000
Frankreich,2024,6,9506588000,5685677000,15192265000
Frankreich,2024,7,9939670000,5726014000,15665684000
Frankreich,2024,8,7998908000,4914214000,12913122000
Frankreich,2024,9,9640661000,5471604000,15112265000
Frankreich,2024,10,9919405000,6243346000,16162751000
Frankreich,2024,11,9340342000,5498987000,14839329000
Frankreich,2024,12,8344969000,5275499000,13620468000
Französisch-Guayana (bis 1996),2008,1,0,0,0
Französisch-Guayana (bis 1996),2008,2,0,0,0
Französisch-Guayana (bis 1996),2008,3,0,0,0
Französisch-Guayana (bis 1996),2008,4,0,0,0
Französisch-Guayana (bis 1996),2008,5,0,0,0
Französisch-Guayana (bis 1996),2008,6,0,0,0
Französisch-Guayana (bis 1996),2008,7,0,0,0
Französisch-Guayana (bis 1996),2008,8,0,0,0
Französisch-Guayana (bis 1996),2008,9,0,0,0
Französisch-Guayana (bis 1996),2008,10,0,0,0
Französisch-Guayana (bis 1996),2008,11,0,0,0
Französisch-Guayana (bis 1996),2008,12,0,0,0
Französisch-Guayana (bis 1996),2009,1,0,0,0
Französisch-Guayana (bis 1996),2009,2,0,0,0
Französisch-Guayana (bis 1996),2009,3,0,0,0
Französisch-Guayana (bis 1996),2009,4,0,0,0
Französisch-Guayana (bis 1996),2009,5,0,0,0
Französisch-Guayana (bis 1996),2009,6,0,0,0
Französisch-Guayana (bis 1996),2009,7,0,0,0
Französisch-Guayana (bis 1996),2009,8,0,0,0
Französisch-Guayana (bis 1996),2009,9,0,0,0
Französisch-Guayana (bis 1996),2009,10,0,0,0
Französisch-Guayana (bis 1996),2009,11,0,0,0
Französisch-Guayana (bis 1996),2009,12,0,0,0
Französisch-Guayana (bis 1996),2010,1,0,0,0
Französisch-Guayana (bis 1996),2010,2,0,0,0
Französisch-Guayana (bis 1996),2010,3,0,0,0
Französisch-Guayana (bis 1996),2010,4,0,0,0
Französisch-Guayana (bis 1996),2010,5,0,0,0
Französisch-Guayana (bis 1996),2010,6,0,0,0
Französisch-Guayana (bis 1996),2010,7,0,0,0
Französisch-Guayana (bis 1996),2010,8,0,0,0
Französisch-Guayana (bis 1996),2010,9,0,0,0
Französisch-Guayana (bis 1996),2010,10,0,0,0
Französisch-Guayana (bis 1996),2010,11,0,0,0
Französisch-Guayana (bis 1996),2010,12,0,0,0
Französisch-Guayana (bis 1996),2011,1,0,0,0
Französisch-Guayana (bis 1996),2011,2,0,0,0
Französisch-Guayana (bis 1996),2011,3,0,0,0
Französisch-Guayana (bis 1996),2011,4,0,0,0
Französisch-Guayana (bis 1996),2011,5,0,0,0
Französisch-Guayana (bis 1996),2011,6,0,0,0
Französisch-Guayana (bis 1996),2011,7,0,0,0
Französisch-Guayana (bis 1996),2011,8,0,0,0
Französisch-Guayana (bis 1996),2011,9,0,0,0
Französisch-Guayana (bis 1996),2011,10,0,0,0
Französisch-Guayana (bis 1996),2011,11,0,0,0
Französisch-Guayana (bis 1996),2011,12,0,0,0
Französisch-Guayana (bis 1996),2012,1,0,0,0
Französisch-Guayana (bis 1996),2012,2,0,0,0
Französisch-Guayana (bis 1996),2012,3,0,0,0
Französisch-Guayana (bis 1996),2012,4,0,0,0
Französisch-Guayana (bis 1996),2012,5,0,0,0
Französisch-Guayana (bis 1996),2012,6,0,0,0
Französisch-Guayana (bis 1996),2012,7,0,0,0
Französisch-Guayana (bis 1996),2012,8,0,0,0
Französisch-Guayana (bis 1996),2012,9,0,0,0
Französisch-Guayana (bis 1996),2012,10,0,0,0
Französisch-Guayana (bis 1996),2012,11,0,0,0
Französisch-Guayana (bis 1996),2012,12,0,0,0
Französisch-Guayana (bis 1996),2013,1,0,0,0
Französisch-Guayana (bis 1996),2013,2,0,0,0
Französisch-Guayana (bis 1996),2013,3,0,0,0
Französisch-Guayana (bis 1996),2013,4,0,0,0
Französisch-Guayana (bis 1996),2013,5,0,0,0
Französisch-Guayana (bis 1996),2013,6,0,0,0
Französisch-Guayana (bis 1996),2013,7,0,0,0
Französisch-Guayana (bis 1996),2013,8,0,0,0
Französisch-Guayana (bis 1996),2013,9,0,0,0
Französisch-Guayana (bis 1996),2013,10,0,0,0
Französisch-Guayana (bis 1996),2013,11,0,0,0
Französisch-Guayana (bis 1996),2013,12,0,0,0
Französisch-Guayana (bis 1996),2014,1,0,0,0
Französisch-Guayana (bis 1996),2014,2,0,0,0
Französisch-Guayana (bis 1996),2014,3,0,0,0
Französisch-Guayana (bis 1996),2014,4,0,0,0
Französisch-Guayana (bis 1996),2014,5,0,0,0
Französisch-Guayana (bis 1996),2014,6,0,0,0
Französisch-Guayana (bis 1996),2014,7,0,0,0
Französisch-Guayana (bis 1996),2014,8,0,0,0
Französisch-Guayana (bis 1996),2014,9,0,0,0
Französisch-Guayana (bis 1996),2014,10,0,0,0
Französisch-Guayana (bis 1996),2014,11,0,0,0
Französisch-Guayana (bis 1996),2014,12,0,0,0
Französisch-Guayana (bis 1996),2015,1,0,0,0
Französisch-Guayana (bis 1996),2015,2,0,0,0
Französisch-Guayana (bis 1996),2015,3,0,0,0
Französisch-Guayana (bis 1996),2015,4,0,0,0
Französisch-Guayana (bis 1996),2015,5,0,0,0
Französisch-Guayana (bis 1996),2015,6,0,0,0
Französisch-Guayana (bis 1996),2015,7,0,0,0
Französisch-Guayana (bis 1996),2015,8,0,0,0
Französisch-Guayana (bis 1996),2015,9,0,0,0
Französisch-Guayana (bis 1996),2015,10,0,0,0
Französisch-Guayana (bis 1996),2015,11,0,0,0
Französisch-Guayana (bis 1996),2015,12,0,0,0
Französisch-Guayana (bis 1996),2016,1,0,0,0
Französisch-Guayana (bis 1996),2016,2,0,0,0
Französisch-Guayana (bis 1996),2016,3,0,0,0
Französisch-Guayana (bis 1996),2016,4,0,0,0
Französisch-Guayana (bis 1996),2016,5,0,0,0
Französisch-Guayana (bis 1996),2016,6,0,0,0
Französisch-Guayana (bis 1996),2016,7,0,0,0
Französisch-Guayana (bis 1996),2016,8,0,0,0
Französisch-Guayana (bis 1996),2016,9,0,0,0
Französisch-Guayana (bis 1996),2016,10,0,0,0
Französisch-Guayana (bis 1996),2016,11,0,0,0
Französisch-Guayana (bis 1996),2016,12,0,0,0
Französisch-Guayana (bis 1996),2017,1,0,0,0
Französisch-Guayana (bis 1996),2017,2,0,0,0
Französisch-Guayana (bis 1996),2017,3,0,0,0
Französisch-Guayana (bis 1996),2017,4,0,0,0
Französisch-Guayana (bis 1996),2017,5,0,0,0
Französisch-Guayana (bis 1996),2017,6,0,0,0
Französisch-Guayana (bis 1996),2017,7,0,0,0
Französisch-Guayana (bis 1996),2017,8,0,0,0
Französisch-Guayana (bis 1996),2017,9,0,0,0
Französisch-Guayana (bis 1996),2017,10,0,0,0
Französisch-Guayana (bis 1996),2017,11,0,0,0
Französisch-Guayana (bis 1996),2017,12,0,0,0
Französisch-Guayana (bis 1996),2018,1,0,0,0
Französisch-Guayana (bis 1996),2018,2,0,0,0
Französisch-Guayana (bis 1996),2018,3,0,0,0
Französisch-Guayana (bis 1996),2018,4,0,0,0
Französisch-Guayana (bis 1996),2018,5,0,0,0
Französisch-Guayana (bis 1996),2018,6,0,0,0
Französisch-Guayana (bis 1996),2018,7,0,0,0
Französisch-Guayana (bis 1996),2018,8,0,0,0
Französisch-Guayana (bis 1996),2018,9,0,0,0
Französisch-Guayana (bis 1996),2018,10,0,0,0
Französisch-Guayana (bis 1996),2018,11,0,0,0
Französisch-Guayana (bis 1996),2018,12,0,0,0
Französisch-Guayana (bis 1996),2019,1,0,0,0
Französisch-Guayana (bis 1996),2019,2,0,0,0
Französisch-Guayana (bis 1996),2019,3,0,0,0
Französisch-Guayana (bis 1996),2019,4,0,0,0
Französisch-Guayana (bis 1996),2019,5,0,0,0
Französisch-Guayana (bis 1996),2019,6,0,0,0
Französisch-Guayana (bis 1996),2019,7,0,0,0
Französisch-Guayana (bis 1996),2019,8,0,0,0
Französisch-Guayana (bis 1996),2019,9,0,0,0
Französisch-Guayana (bis 1996),2019,10,0,0,0
Französisch-Guayana (bis 1996),2019,11,0,0,0
Französisch-Guayana (bis 1996),2019,12,0,0,0
Französisch-Guayana (bis 1996),2020,1,0,0,0
Französisch-Guayana (bis 1996),2020,2,0,0,0
Französisch-Guayana (bis 1996),2020,3,0,0,0
Französisch-Guayana (bis 1996),2020,4,0,0,0
Französisch-Guayana (bis 1996),2020,5,0,0,0
Französisch-Guayana (bis 1996),2020,6,0,0,0
Französisch-Guayana (bis 1996),2020,7,0,0,0
Französisch-Guayana (bis 1996),2020,8,0,0,0
Französisch-Guayana (bis 1996),2020,9,0,0,0
Französisch-Guayana (bis 1996),2020,10,0,0,0
Französisch-Guayana (bis 1996),2020,11,0,0,0
Französisch-Guayana (bis 1996),2020,12,0,0,0
Französisch-Guayana (bis 1996),2021,1,0,0,0
Französisch-Guayana (bis 1996),2021,2,0,0,0
Französisch-Guayana (bis 1996),2021,3,0,0,0
Französisch-Guayana (bis 1996),2021,4,0,0,0
Französisch-Guayana (bis 1996),2021,5,0,0,0
Französisch-Guayana (bis 1996),2021,6,0,0,0
Französisch-Guayana (bis 1996),2021,7,0,0,0
Französisch-Guayana (bis 1996),2021,8,0,0,0
Französisch-Guayana (bis 1996),2021,9,0,0,0
Französisch-Guayana (bis 1996),2021,10,0,0,0
Französisch-Guayana (bis 1996),2021,11,0,0,0
Französisch-Guayana (bis 1996),2021,12,0,0,0
Französisch-Guayana (bis 1996),2022,1,0,0,0
Französisch-Guayana (bis 1996),2022,2,0,0,0
Französisch-Guayana (bis 1996),2022,3,0,0,0
Französisch-Guayana (bis 1996),2022,4,0,0,0
Französisch-Guayana (bis 1996),2022,5,0,0,0
Französisch-Guayana (bis 1996),2022,6,0,0,0
Französisch-Guayana (bis 1996),2022,7,0,0,0
Französisch-Guayana (bis 1996),2022,8,0,0,0
Französisch-Guayana (bis 1996),2022,9,0,0,0
Französisch-Guayana (bis 1996),2022,10,0,0,0
Französisch-Guayana (bis 1996),2022,11,0,0,0
Französisch-Guayana (bis 1996),2022,12,0,0,0
Französisch-Guayana (bis 1996),2023,1,0,0,0
Französisch-Guayana (bis 1996),2023,2,0,0,0
Französisch-Guayana (bis 1996),2023,3,0,0,0
Französisch-Guayana (bis 1996),2023,4,0,0,0
Französisch-Guayana (bis 1996),2023,5,0,0,0
Französisch-Guayana (bis 1996),2023,6,0,0,0
Französisch-Guayana (bis 1996),2023,7,0,0,0
Französisch-Guayana (bis 1996),2023,8,0,0,0
Französisch-Guayana (bis 1996),2023,9,0,0,0
Französisch-Guayana (bis 1996),2023,10,0,0,0
Französisch-Guayana (bis 1996),2023,11,0,0,0
Französisch-Guayana (bis 1996),2023,12,0,0,0
Französisch-Guayana (bis 1996),2024,1,0,0,0
Französisch-Guayana (bis 1996),2024,2,0,0,0
Französisch-Guayana (bis 1996),2024,3,0,0,0
Französisch-Guayana (bis 1996),2024,4,0,0,0
Französisch-Guayana (bis 1996),2024,5,0,0,0
Französisch-Guayana (bis 1996),2024,6,0,0,0
Französisch-Guayana (bis 1996),2024,7,0,0,0
Französisch-Guayana (bis 1996),2024,8,0,0,0
Französisch-Guayana (bis 1996),2024,9,0,0,0
Französisch-Guayana (bis 1996),2024,10,0,0,0
Französisch-Guayana (bis 1996),2024,11,0,0,0
Französisch-Guayana (bis 1996),2024,12,0,0,0
Französisch-Polynesien,2008,1,1252000,1475000,2727000
Französisch-Polynesien,2008,2,1709000,186000,1895000
Französisch-Polynesien,2008,3,2011000,425000,2436000
Französisch-Polynesien,2008,4,1726000,269000,1995000
Französisch-Polynesien,2008,5,1956000,371000,2327000
Französisch-Polynesien,2008,6,1414000,245000,1659000
Französisch-Polynesien,2008,7,2273000,1157000,3430000
Französisch-Polynesien,2008,8,1543000,157000,1700000
Französisch-Polynesien,2008,9,1885000,386000,2271000
Französisch-Polynesien,2008,10,1792000,403000,2195000
Französisch-Polynesien,2008,11,1503000,1244000,2747000
Französisch-Polynesien,2008,12,2026000,1350000,3376000
Französisch-Polynesien,2009,1,1237000,807000,2044000
Französisch-Polynesien,2009,2,1463000,368000,1831000
Französisch-Polynesien,2009,3,1182000,110000,1292000
Französisch-Polynesien,2009,4,1554000,644000,2198000
Französisch-Polynesien,2009,5,1432000,97000,1529000
Französisch-Polynesien,2009,6,2452000,375000,2827000
Französisch-Polynesien,2009,7,2164000,78000,2242000
Französisch-Polynesien,2009,8,1748000,147000,1895000
Französisch-Polynesien,2009,9,1413000,539000,1952000
Französisch-Polynesien,2009,10,1765000,437000,2202000
Französisch-Polynesien,2009,11,3007000,183000,3190000
Französisch-Polynesien,2009,12,2144000,168000,2312000
Französisch-Polynesien,2010,1,2054000,768000,2822000
Französisch-Polynesien,2010,2,1999000,319000,2318000
Französisch-Polynesien,2010,3,2758000,559000,3317000
Französisch-Polynesien,2010,4,2238000,306000,2544000
Französisch-Polynesien,2010,5,2710000,118000,2828000
Französisch-Polynesien,2010,6,2801000,625000,3426000
Französisch-Polynesien,2010,7,2697000,316000,3013000
Französisch-Polynesien,2010,8,1856000,257000,2113000
Französisch-Polynesien,2010,9,2182000,574000,2756000
Französisch-Polynesien,2010,10,1301000,96000,1397000
Französisch-Polynesien,2010,11,1551000,279000,1830000
Französisch-Polynesien,2010,12,1676000,818000,2494000
Französisch-Polynesien,2011,1,1296000,507000,1803000
Französisch-Polynesien,2011,2,1513000,97000,1610000
Französisch-Polynesien,2011,3,1719000,930000,2649000
Französisch-Polynesien,2011,4,1699000,235000,1934000
Französisch-Polynesien,2011,5,1717000,223000,1940000
Französisch-Polynesien,2011,6,2091000,438000,2529000
Französisch-Polynesien,2011,7,3285000,368000,3653000
Französisch-Polynesien,2011,8,1399000,209000,1608000
Französisch-Polynesien,2011,9,1488000,229000,1717000
Französisch-Polynesien,2011,10,1531000,301000,1832000
Französisch-Polynesien,2011,11,1347000,399000,1746000
Französisch-Polynesien,2011,12,1084000,380000,1464000
Französisch-Polynesien,2012,1,1730000,816000,2546000
Französisch-Polynesien,2012,2,1611000,151000,1762000
Französisch-Polynesien,2012,3,2419000,107000,2526000
Französisch-Polynesien,2012,4,1565000,140000,1705000
Französisch-Polynesien,2012,5,1666000,116000,1782000
Französisch-Polynesien,2012,6,2002000,359000,2361000
Französisch-Polynesien,2012,7,1971000,318000,2289000
Französisch-Polynesien,2012,8,1925000,285000,2210000
Französisch-Polynesien,2012,9,2131000,656000,2787000
Französisch-Polynesien,2012,10,1873000,255000,2128000
Französisch-Polynesien,2012,11,1520000,165000,1685000
Französisch-Polynesien,2012,12,2031000,103000,2134000
Französisch-Polynesien,2013,1,1824000,284000,2108000
Französisch-Polynesien,2013,2,1174000,103000,1277000
Französisch-Polynesien,2013,3,1747000,402000,2149000
Französisch-Polynesien,2013,4,1558000,319000,1877000
Französisch-Polynesien,2013,5,1883000,127000,2010000
Französisch-Polynesien,2013,6,1883000,132000,2015000
Französisch-Polynesien,2013,7,1790000,168000,1958000
Französisch-Polynesien,2013,8,1804000,357000,2161000
Französisch-Polynesien,2013,9,5158000,509000,5667000
Französisch-Polynesien,2013,10,2719000,324000,3043000
Französisch-Polynesien,2013,11,1376000,69000,1445000
Französisch-Polynesien,2013,12,1594000,145000,1739000
Französisch-Polynesien,2014,1,1513000,367000,1880000
Französisch-Polynesien,2014,2,1916000,216000,2132000
Französisch-Polynesien,2014,3,1306000,229000,1535000
Französisch-Polynesien,2014,4,1318000,204000,1522000
Französisch-Polynesien,2014,5,2639000,165000,2804000
Französisch-Polynesien,2014,6,1796000,298000,2094000
Französisch-Polynesien,2014,7,1636000,261000,1897000
Französisch-Polynesien,2014,8,1933000,344000,2277000
Französisch-Polynesien,2014,9,2037000,405000,2442000
Französisch-Polynesien,2014,10,2386000,525000,2911000
Französisch-Polynesien,2014,11,1691000,157000,1848000
Französisch-Polynesien,2014,12,1655000,324000,1979000
Französisch-Polynesien,2015,1,1842000,393000,2235000
Französisch-Polynesien,2015,2,1426000,312000,1738000
Französisch-Polynesien,2015,3,1522000,415000,1937000
Französisch-Polynesien,2015,4,2343000,80000,2423000
Französisch-Polynesien,2015,5,2104000,145000,2249000
Französisch-Polynesien,2015,6,4803000,252000,5055000
Französisch-Polynesien,2015,7,3279000,419000,3698000
Französisch-Polynesien,2015,8,1366000,270000,1636000
Französisch-Polynesien,2015,9,2203000,620000,2823000
Französisch-Polynesien,2015,10,1775000,181000,1956000
Französisch-Polynesien,2015,11,2114000,144000,2258000
Französisch-Polynesien,2015,12,1766000,216000,1982000
Französisch-Polynesien,2016,1,2511000,184000,2695000
Französisch-Polynesien,2016,2,1717000,102000,1819000
Französisch-Polynesien,2016,3,2059000,226000,2285000
Französisch-Polynesien,2016,4,2346000,133000,2479000
Französisch-Polynesien,2016,5,2161000,80000,2241000
Französisch-Polynesien,2016,6,2848000,659000,3507000
Französisch-Polynesien,2016,7,3264000,175000,3439000
Französisch-Polynesien,2016,8,2282000,93000,2375000
Französisch-Polynesien,2016,9,3046000,461000,3507000
Französisch-Polynesien,2016,10,2631000,265000,2896000
Französisch-Polynesien,2016,11,2494000,258000,2752000
Französisch-Polynesien,2016,12,1798000,271000,2069000
Französisch-Polynesien,2017,1,2346000,216000,2562000
Französisch-Polynesien,2017,2,1731000,146000,1877000
Französisch-Polynesien,2017,3,2315000,247000,2562000
Französisch-Polynesien,2017,4,1710000,157000,1867000
Französisch-Polynesien,2017,5,2314000,211000,2525000
Französisch-Polynesien,2017,6,2666000,274000,2940000
Französisch-Polynesien,2017,7,3309000,214000,3523000
Französisch-Polynesien,2017,8,2164000,134000,2298000
Französisch-Polynesien,2017,9,2080000,606000,2686000
Französisch-Polynesien,2017,10,2158000,186000,2344000
Französisch-Polynesien,2017,11,2217000,113000,2330000
Französisch-Polynesien,2017,12,1559000,318000,1877000
Französisch-Polynesien,2018,1,3323000,290000,3613000
Französisch-Polynesien,2018,2,1457000,177000,1634000
Französisch-Polynesien,2018,3,1477000,271000,1748000
Französisch-Polynesien,2018,4,1525000,104000,1629000
Französisch-Polynesien,2018,5,1587000,108000,1695000
Französisch-Polynesien,2018,6,3671000,149000,3820000
Französisch-Polynesien,2018,7,1982000,506000,2488000
Französisch-Polynesien,2018,8,6190000,248000,6438000
Französisch-Polynesien,2018,9,2582000,172000,2754000
Französisch-Polynesien,2018,10,1886000,307000,2193000
Französisch-Polynesien,2018,11,2336000,320000,2656000
Französisch-Polynesien,2018,12,1970000,172000,2142000
Französisch-Polynesien,2019,1,1724000,496000,2220000
Französisch-Polynesien,2019,2,2295000,254000,2549000
Französisch-Polynesien,2019,3,1982000,161000,2143000
Französisch-Polynesien,2019,4,2404000,106000,2510000
Französisch-Polynesien,2019,5,3155000,24000,3179000
Französisch-Polynesien,2019,6,2794000,116000,2910000
Französisch-Polynesien,2019,7,2822000,318000,3140000
Französisch-Polynesien,2019,8,1691000,124000,1815000
Französisch-Polynesien,2019,9,1175000,448000,1623000
Französisch-Polynesien,2019,10,2104000,147000,2251000
Französisch-Polynesien,2019,11,2098000,174000,2272000
Französisch-Polynesien,2019,12,894000,37000,931000
Französisch-Polynesien,2020,1,1678000,224000,1902000
Französisch-Polynesien,2020,2,2441000,122000,2563000
Französisch-Polynesien,2020,3,1104000,170000,1274000
Französisch-Polynesien,2020,4,1023000,16000,1039000
Französisch-Polynesien,2020,5,1109000,18000,1127000
Französisch-Polynesien,2020,6,1851000,49000,1900000
Französisch-Polynesien,2020,7,1540000,112000,1652000
Französisch-Polynesien,2020,8,1097000,151000,1248000
Französisch-Polynesien,2020,9,1767000,40000,1807000
Französisch-Polynesien,2020,10,2252000,112000,2364000
Französisch-Polynesien,2020,11,1743000,182000,1925000
Französisch-Polynesien,2020,12,916000,446000,1362000
Französisch-Polynesien,2021,1,1776000,257000,2033000
Französisch-Polynesien,2021,2,1968000,230000,2198000
Französisch-Polynesien,2021,3,1794000,74000,1868000
Französisch-Polynesien,2021,4,1868000,56000,1924000
Französisch-Polynesien,2021,5,1277000,190000,1467000
Französisch-Polynesien,2021,6,1715000,48000,1763000
Französisch-Polynesien,2021,7,1716000,43000,1759000
Französisch-Polynesien,2021,8,1616000,265000,1881000
Französisch-Polynesien,2021,9,2423000,376000,2799000
Französisch-Polynesien,2021,10,1703000,200000,1903000
Französisch-Polynesien,2021,11,3282000,325000,3607000
Französisch-Polynesien,2021,12,1413000,349000,1762000
Französisch-Polynesien,2022,1,1465000,639000,2104000
Französisch-Polynesien,2022,2,2819000,323000,3142000
Französisch-Polynesien,2022,3,2326000,429000,2755000
Französisch-Polynesien,2022,4,1628000,80000,1708000
Französisch-Polynesien,2022,5,2690000,196000,2886000
Französisch-Polynesien,2022,6,1666000,115000,1781000
Französisch-Polynesien,2022,7,1005000,339000,1344000
Französisch-Polynesien,2022,8,1130000,349000,1479000
Französisch-Polynesien,2022,9,2156000,219000,2375000
Französisch-Polynesien,2022,10,1615000,182000,1797000
Französisch-Polynesien,2022,11,1728000,1000000,2728000
Französisch-Polynesien,2022,12,8011000,93000,8104000
Französisch-Polynesien,2023,1,1563000,1664000,3227000
Französisch-Polynesien,2023,2,2312000,477000,2789000
Französisch-Polynesien,2023,3,7733000,198000,7931000
Französisch-Polynesien,2023,4,1643000,244000,1887000
Französisch-Polynesien,2023,5,1776000,243000,2019000
Französisch-Polynesien,2023,6,1992000,216000,2208000
Französisch-Polynesien,2023,7,1508000,276000,1784000
Französisch-Polynesien,2023,8,2911000,104000,3015000
Französisch-Polynesien,2023,9,1873000,97000,1970000
Französisch-Polynesien,2023,10,1909000,163000,2072000
Französisch-Polynesien,2023,11,2104000,163000,2267000
Französisch-Polynesien,2023,12,1043000,98000,1141000
Französisch-Polynesien,2024,1,1376000,116000,1492000
Französisch-Polynesien,2024,2,1803000,46000,1849000
Französisch-Polynesien,2024,3,1835000,121000,1956000
Französisch-Polynesien,2024,4,2157000,28000,2185000
Französisch-Polynesien,2024,5,1178000,74000,1252000
Französisch-Polynesien,2024,6,1444000,43000,1487000
Französisch-Polynesien,2024,7,1943000,19000,1962000
Französisch-Polynesien,2024,8,1278000,81000,1359000
Französisch-Polynesien,2024,9,8342000,177000,8519000
Französisch-Polynesien,2024,10,1715000,148000,1863000
Französisch-Polynesien,2024,11,1978000,21000,1999000
Französisch-Polynesien,2024,12,2304000,103000,2407000
Französische Südgebiete (ab 2001),2008,1,525000,0,525000
Französische Südgebiete (ab 2001),2008,2,390000,1000,391000
Französische Südgebiete (ab 2001),2008,3,276000,0,276000
Französische Südgebiete (ab 2001),2008,4,563000,0,563000
Französische Südgebiete (ab 2001),2008,5,976000,0,976000
Französische Südgebiete (ab 2001),2008,6,530000,0,530000
Französische Südgebiete (ab 2001),2008,7,648000,0,648000
Französische Südgebiete (ab 2001),2008,8,665000,0,665000
Französische Südgebiete (ab 2001),2008,9,508000,44000,552000
Französische Südgebiete (ab 2001),2008,10,655000,0,655000
Französische Südgebiete (ab 2001),2008,11,358000,1000,359000
Französische Südgebiete (ab 2001),2008,12,485000,2000,487000
Französische Südgebiete (ab 2001),2009,1,617000,4000,621000
Französische Südgebiete (ab 2001),2009,2,576000,0,576000
Französische Südgebiete (ab 2001),2009,3,583000,6000,589000
Französische Südgebiete (ab 2001),2009,4,422000,0,422000
Französische Südgebiete (ab 2001),2009,5,494000,0,494000
Französische Südgebiete (ab 2001),2009,6,572000,0,572000
Französische Südgebiete (ab 2001),2009,7,603000,3000,606000
Französische Südgebiete (ab 2001),2009,8,233000,0,233000
Französische Südgebiete (ab 2001),2009,9,157000,0,157000
Französische Südgebiete (ab 2001),2009,10,197000,0,197000
Französische Südgebiete (ab 2001),2009,11,1553000,0,1553000
Französische Südgebiete (ab 2001),2009,12,500000,0,500000
Französische Südgebiete (ab 2001),2010,1,478000,0,478000
Französische Südgebiete (ab 2001),2010,2,228000,0,228000
Französische Südgebiete (ab 2001),2010,3,366000,0,366000
Französische Südgebiete (ab 2001),2010,4,460000,0,460000
Französische Südgebiete (ab 2001),2010,5,359000,0,359000
Französische Südgebiete (ab 2001),2010,6,560000,0,560000
Französische Südgebiete (ab 2001),2010,7,460000,0,460000
Französische Südgebiete (ab 2001),2010,8,270000,178000,448000
Französische Südgebiete (ab 2001),2010,9,530000,13000,543000
Französische Südgebiete (ab 2001),2010,10,420000,0,420000
Französische Südgebiete (ab 2001),2010,11,406000,0,406000
Französische Südgebiete (ab 2001),2010,12,245000,9000,254000
Französische Südgebiete (ab 2001),2011,1,195000,0,195000
Französische Südgebiete (ab 2001),2011,2,232000,0,232000
Französische Südgebiete (ab 2001),2011,3,1120000,0,1120000
Französische Südgebiete (ab 2001),2011,4,259000,0,259000
Französische Südgebiete (ab 2001),2011,5,443000,0,443000
Französische Südgebiete (ab 2001),2011,6,593000,0,593000
Französische Südgebiete (ab 2001),2011,7,581000,0,581000
Französische Südgebiete (ab 2001),2011,8,607000,0,607000
Französische Südgebiete (ab 2001),2011,9,359000,1000,360000
Französische Südgebiete (ab 2001),2011,10,609000,0,609000
Französische Südgebiete (ab 2001),2011,11,924000,0,924000
Französische Südgebiete (ab 2001),2011,12,343000,0,343000
Französische Südgebiete (ab 2001),2012,1,253000,0,253000
Französische Südgebiete (ab 2001),2012,2,503000,0,503000
Französische Südgebiete (ab 2001),2012,3,210000,37000,247000
Französische Südgebiete (ab 2001),2012,4,515000,40000,555000
Französische Südgebiete (ab 2001),2012,5,286000,0,286000
Französische Südgebiete (ab 2001),2012,6,482000,0,482000
Französische Südgebiete (ab 2001),2012,7,632000,0,632000
Französische Südgebiete (ab 2001),2012,8,870000,0,870000
Französische Südgebiete (ab 2001),2012,9,289000,0,289000
Französische Südgebiete (ab 2001),2012,10,154000,0,154000
Französische Südgebiete (ab 2001),2012,11,503000,0,503000
Französische Südgebiete (ab 2001),2012,12,397000,0,397000
Französische Südgebiete (ab 2001),2013,1,241000,0,241000
Französische Südgebiete (ab 2001),2013,2,296000,0,296000
Französische Südgebiete (ab 2001),2013,3,141000,0,141000
Französische Südgebiete (ab 2001),2013,4,536000,0,536000
Französische Südgebiete (ab 2001),2013,5,393000,0,393000
Französische Südgebiete (ab 2001),2013,6,199000,0,199000
Französische Südgebiete (ab 2001),2013,7,341000,0,341000
Französische Südgebiete (ab 2001),2013,8,262000,0,262000
Französische Südgebiete (ab 2001),2013,9,264000,0,264000
Französische Südgebiete (ab 2001),2013,10,213000,0,213000
Französische Südgebiete (ab 2001),2013,11,327000,0,327000
Französische Südgebiete (ab 2001),2013,12,191000,0,191000
Französische Südgebiete (ab 2001),2014,1,107000,0,107000
Französische Südgebiete (ab 2001),2014,2,220000,0,220000
Französische Südgebiete (ab 2001),2014,3,66000,0,66000
Französische Südgebiete (ab 2001),2014,4,266000,0,266000
Französische Südgebiete (ab 2001),2014,5,77000,0,77000
Französische Südgebiete (ab 2001),2014,6,70000,0,70000
Französische Südgebiete (ab 2001),2014,7,406000,0,406000
Französische Südgebiete (ab 2001),2014,8,60000,0,60000
Französische Südgebiete (ab 2001),2014,9,509000,0,509000
Französische Südgebiete (ab 2001),2014,10,292000,0,292000
Französische Südgebiete (ab 2001),2014,11,56000,0,56000
Französische Südgebiete (ab 2001),2014,12,106000,0,106000
Französische Südgebiete (ab 2001),2015,1,338000,45000,383000
Französische Südgebiete (ab 2001),2015,2,81000,0,81000
Französische Südgebiete (ab 2001),2015,3,40000,0,40000
Französische Südgebiete (ab 2001),2015,4,445000,10000,455000
Französische Südgebiete (ab 2001),2015,5,276000,0,276000
Französische Südgebiete (ab 2001),2015,6,144000,0,144000
Französische Südgebiete (ab 2001),2015,7,73000,0,73000
Französische Südgebiete (ab 2001),2015,8,94000,3000,97000
Französische Südgebiete (ab 2001),2015,9,103000,0,103000
Französische Südgebiete (ab 2001),2015,10,92000,71000,163000
Französische Südgebiete (ab 2001),2015,11,82000,0,82000
Französische Südgebiete (ab 2001),2015,12,142000,0,142000
Französische Südgebiete (ab 2001),2016,1,95000,0,95000
Französische Südgebiete (ab 2001),2016,2,100000,0,100000
Französische Südgebiete (ab 2001),2016,3,208000,0,208000
Französische Südgebiete (ab 2001),2016,4,463000,0,463000
Französische Südgebiete (ab 2001),2016,5,99000,0,99000
Französische Südgebiete (ab 2001),2016,6,110000,16000,126000
Französische Südgebiete (ab 2001),2016,7,135000,0,135000
Französische Südgebiete (ab 2001),2016,8,189000,0,189000
Französische Südgebiete (ab 2001),2016,9,309000,0,309000
Französische Südgebiete (ab 2001),2016,10,101000,0,101000
Französische Südgebiete (ab 2001),2016,11,209000,0,209000
Französische Südgebiete (ab 2001),2016,12,72000,59000,131000
Französische Südgebiete (ab 2001),2017,1,122000,0,122000
Französische Südgebiete (ab 2001),2017,2,133000,0,133000
Französische Südgebiete (ab 2001),2017,3,244000,0,244000
Französische Südgebiete (ab 2001),2017,4,83000,0,83000
Französische Südgebiete (ab 2001),2017,5,176000,0,176000
Französische Südgebiete (ab 2001),2017,6,158000,0,158000
Französische Südgebiete (ab 2001),2017,7,129000,0,129000
Französische Südgebiete (ab 2001),2017,8,114000,0,114000
Französische Südgebiete (ab 2001),2017,9,154000,0,154000
Französische Südgebiete (ab 2001),2017,10,246000,0,246000
Französische Südgebiete (ab 2001),2017,11,104000,0,104000
Französische Südgebiete (ab 2001),2017,12,196000,0,196000
Französische Südgebiete (ab 2001),2018,1,89000,0,89000
Französische Südgebiete (ab 2001),2018,2,121000,0,121000
Französische Südgebiete (ab 2001),2018,3,79000,0,79000
Französische Südgebiete (ab 2001),2018,4,85000,0,85000
Französische Südgebiete (ab 2001),2018,5,172000,0,172000
Französische Südgebiete (ab 2001),2018,6,277000,0,277000
Französische Südgebiete (ab 2001),2018,7,326000,0,326000
Französische Südgebiete (ab 2001),2018,8,316000,0,316000
Französische Südgebiete (ab 2001),2018,9,401000,0,401000
Französische Südgebiete (ab 2001),2018,10,144000,0,144000
Französische Südgebiete (ab 2001),2018,11,299000,0,299000
Französische Südgebiete (ab 2001),2018,12,448000,0,448000
Französische Südgebiete (ab 2001),2019,1,148000,0,148000
Französische Südgebiete (ab 2001),2019,2,170000,0,170000
Französische Südgebiete (ab 2001),2019,3,436000,0,436000
Französische Südgebiete (ab 2001),2019,4,488000,0,488000
Französische Südgebiete (ab 2001),2019,5,243000,0,243000
Französische Südgebiete (ab 2001),2019,6,154000,0,154000
Französische Südgebiete (ab 2001),2019,7,161000,23000,184000
Französische Südgebiete (ab 2001),2019,8,156000,12000,168000
Französische Südgebiete (ab 2001),2019,9,425000,1000,426000
Französische Südgebiete (ab 2001),2019,10,200000,0,200000
Französische Südgebiete (ab 2001),2019,11,408000,0,408000
Französische Südgebiete (ab 2001),2019,12,400000,0,400000
Französische Südgebiete (ab 2001),2020,1,352000,0,352000
Französische Südgebiete (ab 2001),2020,2,169000,1000,170000
Französische Südgebiete (ab 2001),2020,3,104000,0,104000
Französische Südgebiete (ab 2001),2020,4,73000,0,73000
Französische Südgebiete (ab 2001),2020,5,117000,0,117000
Französische Südgebiete (ab 2001),2020,6,381000,0,381000
Französische Südgebiete (ab 2001),2020,7,131000,0,131000
Französische Südgebiete (ab 2001),2020,8,109000,0,109000
Französische Südgebiete (ab 2001),2020,9,149000,9000,158000
Französische Südgebiete (ab 2001),2020,10,509000,0,509000
Französische Südgebiete (ab 2001),2020,11,97000,0,97000
Französische Südgebiete (ab 2001),2020,12,270000,0,270000
Französische Südgebiete (ab 2001),2021,1,141000,0,141000
Französische Südgebiete (ab 2001),2021,2,281000,0,281000
Französische Südgebiete (ab 2001),2021,3,1500000,0,1500000
Französische Südgebiete (ab 2001),2021,4,1543000,0,1543000
Französische Südgebiete (ab 2001),2021,5,443000,0,443000
Französische Südgebiete (ab 2001),2021,6,121000,17000,138000
Französische Südgebiete (ab 2001),2021,7,273000,0,273000
Französische Südgebiete (ab 2001),2021,8,66000,0,66000
Französische Südgebiete (ab 2001),2021,9,170000,0,170000
Französische Südgebiete (ab 2001),2021,10,224000,0,224000
Französische Südgebiete (ab 2001),2021,11,216000,3000,219000
Französische Südgebiete (ab 2001),2021,12,168000,0,168000
Französische Südgebiete (ab 2001),2022,1,342000,2000,344000
Französische Südgebiete (ab 2001),2022,2,72000,0,72000
Französische Südgebiete (ab 2001),2022,3,129000,0,129000
Französische Südgebiete (ab 2001),2022,4,164000,0,164000
Französische Südgebiete (ab 2001),2022,5,322000,0,322000
Französische Südgebiete (ab 2001),2022,6,75000,0,75000
Französische Südgebiete (ab 2001),2022,7,91000,0,91000
Französische Südgebiete (ab 2001),2022,8,129000,0,129000
Französische Südgebiete (ab 2001),2022,9,233000,14000,247000
Französische Südgebiete (ab 2001),2022,10,83000,6000,89000
Französische Südgebiete (ab 2001),2022,11,188000,0,188000
Französische Südgebiete (ab 2001),2022,12,109000,28000,137000
Französische Südgebiete (ab 2001),2023,1,202000,0,202000
Französische Südgebiete (ab 2001),2023,2,212000,0,212000
Französische Südgebiete (ab 2001),2023,3,253000,25000,278000
Französische Südgebiete (ab 2001),2023,4,155000,0,155000
Französische Südgebiete (ab 2001),2023,5,208000,0,208000
Französische Südgebiete (ab 2001),2023,6,228000,1000,229000
Französische Südgebiete (ab 2001),2023,7,217000,0,217000
Französische Südgebiete (ab 2001),2023,8,323000,0,323000
Französische Südgebiete (ab 2001),2023,9,193000,19000,212000
Französische Südgebiete (ab 2001),2023,10,247000,4000,251000
Französische Südgebiete (ab 2001),2023,11,324000,14000,338000
Französische Südgebiete (ab 2001),2023,12,220000,0,220000
Französische Südgebiete (ab 2001),2024,1,2086000,2000,2088000
Französische Südgebiete (ab 2001),2024,2,305000,0,305000
Französische Südgebiete (ab 2001),2024,3,238000,1000,239000
Französische Südgebiete (ab 2001),2024,4,318000,26000,344000
Französische Südgebiete (ab 2001),2024,5,204000,1000,205000
Französische Südgebiete (ab 2001),2024,6,183000,0,183000
Französische Südgebiete (ab 2001),2024,7,331000,3000,334000
Französische Südgebiete (ab 2001),2024,8,235000,1000,236000
Französische Südgebiete (ab 2001),2024,9,280000,0,280000
Französische Südgebiete (ab 2001),2024,10,251000,0,251000
Französische Südgebiete (ab 2001),2024,11,252000,3000,255000
Französische Südgebiete (ab 2001),2024,12,230000,7000,237000
Färöer,2008,1,1175000,590000,1765000
Färöer,2008,2,1086000,917000,2003000
Färöer,2008,3,1014000,1625000,2639000
Färöer,2008,4,1828000,1538000,3366000
Färöer,2008,5,3246000,1299000,4545000
Färöer,2008,6,2280000,866000,3146000
Färöer,2008,7,1356000,771000,2127000
Färöer,2008,8,1230000,697000,1927000
Färöer,2008,9,842000,288000,1130000
Färöer,2008,10,1845000,710000,2555000
Färöer,2008,11,2195000,473000,2668000
Färöer,2008,12,832000,1385000,2217000
Färöer,2009,1,571000,1219000,1790000
Färöer,2009,2,1220000,676000,1896000
Färöer,2009,3,730000,1257000,1987000
Färöer,2009,4,556000,1814000,2370000
Färöer,2009,5,1296000,803000,2099000
Färöer,2009,6,803000,1087000,1890000
Färöer,2009,7,776000,836000,1612000
Färöer,2009,8,579000,797000,1376000
Färöer,2009,9,731000,1138000,1869000
Färöer,2009,10,693000,1302000,1995000
Färöer,2009,11,867000,436000,1303000
Färöer,2009,12,740000,2445000,3185000
Färöer,2010,1,1004000,2438000,3442000
Färöer,2010,2,582000,2885000,3467000
Färöer,2010,3,1036000,2289000,3325000
Färöer,2010,4,598000,4175000,4773000
Färöer,2010,5,772000,1267000,2039000
Färöer,2010,6,1181000,2563000,3744000
Färöer,2010,7,1252000,380000,1632000
Färöer,2010,8,754000,813000,1567000
Färöer,2010,9,1080000,715000,1795000
Färöer,2010,10,842000,1604000,2446000
Färöer,2010,11,1032000,3258000,4290000
Färöer,2010,12,737000,1855000,2592000
Färöer,2011,1,1011000,799000,1810000
Färöer,2011,2,930000,1002000,1932000
Färöer,2011,3,607000,2773000,3380000
Färöer,2011,4,1417000,645000,2062000
Färöer,2011,5,806000,2299000,3105000
Färöer,2011,6,2490000,2556000,5046000
Färöer,2011,7,1444000,893000,2337000
Färöer,2011,8,2080000,2630000,4710000
Färöer,2011,9,910000,3013000,3923000
Färöer,2011,10,1069000,873000,1942000
Färöer,2011,11,1616000,1273000,2889000
Färöer,2011,12,651000,756000,1407000
Färöer,2012,1,1188000,974000,2162000
Färöer,2012,2,1606000,1156000,2762000
Färöer,2012,3,42076000,1277000,43353000
Färöer,2012,4,1395000,1919000,3314000
Färöer,2012,5,2498000,330000,2828000
Färöer,2012,6,3404000,3525000,6929000
Färöer,2012,7,2555000,616000,3171000
Färöer,2012,8,10144000,2976000,13120000
Färöer,2012,9,1313000,661000,1974000
Färöer,2012,10,2266000,3298000,5564000
Färöer,2012,11,2216000,1093000,3309000
Färöer,2012,12,994000,593000,1587000
Färöer,2013,1,4079000,674000,4753000
Färöer,2013,2,3792000,475000,4267000
Färöer,2013,3,2022000,1306000,3328000
Färöer,2013,4,3720000,1108000,4828000
Färöer,2013,5,1652000,3808000,5460000
Färöer,2013,6,2002000,1805000,3807000
Färöer,2013,7,2730000,4704000,7434000
Färöer,2013,8,2601000,3873000,6474000
Färöer,2013,9,2560000,1222000,3782000
Färöer,2013,10,2588000,3467000,6055000
Färöer,2013,11,1686000,925000,2611000
Färöer,2013,12,1455000,646000,2101000
Färöer,2014,1,1954000,7875000,9829000
Färöer,2014,2,2151000,742000,2893000
Färöer,2014,3,1687000,578000,2265000
Färöer,2014,4,9493000,2846000,12339000
Färöer,2014,5,1726000,1895000,3621000
Färöer,2014,6,2384000,728000,3112000
Färöer,2014,7,1955000,659000,2614000
Färöer,2014,8,4269000,136000,4405000
Färöer,2014,9,2099000,5579000,7678000
Färöer,2014,10,5857000,2331000,8188000
Färöer,2014,11,1794000,6775000,8569000
Färöer,2014,12,3067000,6409000,9476000
Färöer,2015,1,1854000,719000,2573000
Färöer,2015,2,4292000,983000,5275000
Färöer,2015,3,3307000,1039000,4346000
Färöer,2015,4,2303000,1438000,3741000
Färöer,2015,5,4069000,4135000,8204000
Färöer,2015,6,1873000,2534000,4407000
Färöer,2015,7,6630000,655000,7285000
Färöer,2015,8,3987000,348000,4335000
Färöer,2015,9,3478000,4439000,7917000
Färöer,2015,10,3190000,600000,3790000
Färöer,2015,11,1840000,595000,2435000
Färöer,2015,12,1743000,437000,2180000
Färöer,2016,1,4066000,2360000,6426000
Färöer,2016,2,4554000,2822000,7376000
Färöer,2016,3,1824000,1108000,2932000
Färöer,2016,4,2711000,503000,3214000
Färöer,2016,5,2524000,968000,3492000
Färöer,2016,6,2839000,417000,3256000
Färöer,2016,7,2432000,2611000,5043000
Färöer,2016,8,3102000,765000,3867000
Färöer,2016,9,7608000,1585000,9193000
Färöer,2016,10,2039000,4639000,6678000
Färöer,2016,11,2060000,1878000,3938000
Färöer,2016,12,55716000,911000,56627000
Färöer,2017,1,4613000,3706000,8319000
Färöer,2017,2,3035000,1208000,4243000
Färöer,2017,3,8872000,1297000,10169000
Färöer,2017,4,1885000,1228000,3113000
Färöer,2017,5,4124000,711000,4835000
Färöer,2017,6,3656000,937000,4593000
Färöer,2017,7,6878000,604000,7482000
Färöer,2017,8,2976000,855000,3831000
Färöer,2017,9,4425000,3281000,7706000
Färöer,2017,10,2537000,2676000,5213000
Färöer,2017,11,5229000,984000,6213000
Färöer,2017,12,4493000,676000,5169000
Färöer,2018,1,1779000,1268000,3047000
Färöer,2018,2,2627000,752000,3379000
Färöer,2018,3,6563000,1509000,8072000
Färöer,2018,4,5459000,6450000,11909000
Färöer,2018,5,6611000,978000,7589000
Färöer,2018,6,16100000,585000,16685000
Färöer,2018,7,8250000,1909000,10159000
Färöer,2018,8,6445000,977000,7422000
Färöer,2018,9,6706000,2831000,9537000
Färöer,2018,10,4103000,1444000,5547000
Färöer,2018,11,7281000,2764000,10045000
Färöer,2018,12,3084000,991000,4075000
Färöer,2019,1,4847000,1131000,5978000
Färöer,2019,2,2480000,971000,3451000
Färöer,2019,3,5342000,1533000,6875000
Färöer,2019,4,4159000,729000,4888000
Färöer,2019,5,5571000,5771000,11342000
Färöer,2019,6,3581000,996000,4577000
Färöer,2019,7,67880000,3400000,71280000
Färöer,2019,8,8295000,939000,9234000
Färöer,2019,9,8714000,820000,9534000
Färöer,2019,10,7011000,1456000,8467000
Färöer,2019,11,5266000,1886000,7152000
Färöer,2019,12,4406000,1294000,5700000
Färöer,2020,1,5566000,1593000,7159000
Färöer,2020,2,7819000,4707000,12526000
Färöer,2020,3,9081000,373000,9454000
Färöer,2020,4,3412000,3014000,6426000
Färöer,2020,5,4639000,671000,5310000
Färöer,2020,6,1991000,674000,2665000
Färöer,2020,7,9756000,735000,10491000
Färöer,2020,8,7568000,1002000,8570000
Färöer,2020,9,2771000,1690000,4461000
Färöer,2020,10,2171000,664000,2835000
Färöer,2020,11,1800000,2528000,4328000
Färöer,2020,12,4566000,412000,4978000
Färöer,2021,1,1582000,1800000,3382000
Färöer,2021,2,4475000,3331000,7806000
Färöer,2021,3,5701000,1020000,6721000
Färöer,2021,4,2786000,1568000,4354000
Färöer,2021,5,5636000,1479000,7115000
Färöer,2021,6,2547000,905000,3452000
Färöer,2021,7,6642000,2184000,8826000
Färöer,2021,8,8268000,731000,8999000
Färöer,2021,9,6394000,526000,6920000
Färöer,2021,10,7227000,777000,8004000
Färöer,2021,11,4228000,1038000,5266000
Färöer,2021,12,4743000,1470000,6213000
Färöer,2022,1,6782000,2154000,8936000
Färöer,2022,2,6024000,2113000,8137000
Färöer,2022,3,3602000,1979000,5581000
Färöer,2022,4,5621000,6856000,12477000
Färöer,2022,5,4537000,5576000,10113000
Färöer,2022,6,10480000,2101000,12581000
Färöer,2022,7,14596000,3297000,17893000
Färöer,2022,8,8607000,1343000,9950000
Färöer,2022,9,3740000,1720000,5460000
Färöer,2022,10,11147000,2607000,13754000
Färöer,2022,11,2803000,1221000,4024000
Färöer,2022,12,2652000,758000,3410000
Färöer,2023,1,6976000,5201000,12177000
Färöer,2023,2,7150000,6334000,13484000
Färöer,2023,3,3607000,1872000,5479000
Färöer,2023,4,3039000,1820000,4859000
Färöer,2023,5,2922000,5908000,8830000
Färöer,2023,6,6637000,3490000,10127000
Färöer,2023,7,3139000,8603000,11742000
Färöer,2023,8,2843000,3807000,6650000
Färöer,2023,9,2823000,8753000,11576000
Färöer,2023,10,3945000,3287000,7232000
Färöer,2023,11,3626000,2366000,5992000
Färöer,2023,12,2526000,5485000,8011000
Färöer,2024,1,3585000,1906000,5491000
Färöer,2024,2,3316000,2702000,6018000
Färöer,2024,3,3725000,3475000,7200000
Färöer,2024,4,5857000,6446000,12303000
Färöer,2024,5,2088000,7718000,9806000
Färöer,2024,6,4904000,2128000,7032000
Färöer,2024,7,3534000,6131000,9665000
Färöer,2024,8,2732000,5333000,8065000
Färöer,2024,9,5236000,5336000,10572000
Färöer,2024,10,4810000,4118000,8928000
Färöer,2024,11,3017000,2199000,5216000
Färöer,2024,12,3349000,1693000,5042000
Föderierte Staaten von Mikronesien (ab 1992),2008,1,0,0,0
Föderierte Staaten von Mikronesien (ab 1992),2008,2,1000,0,1000
Föderierte Staaten von Mikronesien (ab 1992),2008,3,18000,11000,29000
Föderierte Staaten von Mikronesien (ab 1992),2008,4,634000,4000,638000
Föderierte Staaten von Mikronesien (ab 1992),2008,5,6000,0,6000
Föderierte Staaten von Mikronesien (ab 1992),2008,6,0,0,0
Föderierte Staaten von Mikronesien (ab 1992),2008,7,18000,4000,22000
Föderierte Staaten von Mikronesien (ab 1992),2008,8,0,0,0
Föderierte Staaten von Mikronesien (ab 1992),2008,9,2000,0,2000
Föderierte Staaten von Mikronesien (ab 1992),2008,10,0,0,0
Föderierte Staaten von Mikronesien (ab 1992),2008,11,0,11000,11000
Föderierte Staaten von Mikronesien (ab 1992),2008,12,12000,0,12000
Föderierte Staaten von Mikronesien (ab 1992),2009,1,3000,0,3000
Föderierte Staaten von Mikronesien (ab 1992),2009,2,8000,0,8000
Föderierte Staaten von Mikronesien (ab 1992),2009,3,0,0,0
Föderierte Staaten von Mikronesien (ab 1992),2009,4,8000,8000,16000
Föderierte Staaten von Mikronesien (ab 1992),2009,5,1000,0,1000
Föderierte Staaten von Mikronesien (ab 1992),2009,6,0,12000,12000
Föderierte Staaten von Mikronesien (ab 1992),2009,7,0,0,0
Föderierte Staaten von Mikronesien (ab 1992),2009,8,0,0,0
Föderierte Staaten von Mikronesien (ab 1992),2009,9,0,0,0
Föderierte Staaten von Mikronesien (ab 1992),2009,10,56000,0,56000
Föderierte Staaten von Mikronesien (ab 1992),2009,11,21000,0,21000
Föderierte Staaten von Mikronesien (ab 1992),2009,12,0,5000,5000
Föderierte Staaten von Mikronesien (ab 1992),2010,1,0,0,0
Föderierte Staaten von Mikronesien (ab 1992),2010,2,0,8000,8000
Föderierte Staaten von Mikronesien (ab 1992),2010,3,0,0,0
Föderierte Staaten von Mikronesien (ab 1992),2010,4,1000,0,1000
Föderierte Staaten von Mikronesien (ab 1992),2010,5,0,11000,11000
Föderierte Staaten von Mikronesien (ab 1992),2010,6,1000,16000,17000
Föderierte Staaten von Mikronesien (ab 1992),2010,7,0,0,0
Föderierte Staaten von Mikronesien (ab 1992),2010,8,0,0,0
Föderierte Staaten von Mikronesien (ab 1992),2010,9,0,0,0
Föderierte Staaten von Mikronesien (ab 1992),2010,10,0,0,0
Föderierte Staaten von Mikronesien (ab 1992),2010,11,0,0,0
Föderierte Staaten von Mikronesien (ab 1992),2010,12,0,0,0
Föderierte Staaten von Mikronesien (ab 1992),2011,1,16000,0,16000
Föderierte Staaten von Mikronesien (ab 1992),2011,2,0,1000,1000
Föderierte Staaten von Mikronesien (ab 1992),2011,3,0,0,0
Föderierte Staaten von Mikronesien (ab 1992),2011,4,0,0,0
Föderierte Staaten von Mikronesien (ab 1992),2011,5,0,0,0
Föderierte Staaten von Mikronesien (ab 1992),2011,6,0,10000,10000
Föderierte Staaten von Mikronesien (ab 1992),2011,7,0,6000,6000
Föderierte Staaten von Mikronesien (ab 1992),2011,8,0,4000,4000
Föderierte Staaten von Mikronesien (ab 1992),2011,9,0,6000,6000
Föderierte Staaten von Mikronesien (ab 1992),2011,10,0,5000,5000
Föderierte Staaten von Mikronesien (ab 1992),2011,11,0,9000,9000
Föderierte Staaten von Mikronesien (ab 1992),2011,12,20000,4000,24000
Föderierte Staaten von Mikronesien (ab 1992),2012,1,0,0,0
Föderierte Staaten von Mikronesien (ab 1992),2012,2,0,8000,8000
Föderierte Staaten von Mikronesien (ab 1992),2012,3,0,0,0
Föderierte Staaten von Mikronesien (ab 1992),2012,4,0,4000,4000
Föderierte Staaten von Mikronesien (ab 1992),2012,5,0,6000,6000
Föderierte Staaten von Mikronesien (ab 1992),2012,6,0,5000,5000
Föderierte Staaten von Mikronesien (ab 1992),2012,7,0,6000,6000
Föderierte Staaten von Mikronesien (ab 1992),2012,8,0,12000,12000
Föderierte Staaten von Mikronesien (ab 1992),2012,9,0,5000,5000
Föderierte Staaten von Mikronesien (ab 1992),2012,10,0,6000,6000
Föderierte Staaten von Mikronesien (ab 1992),2012,11,0,4000,4000
Föderierte Staaten von Mikronesien (ab 1992),2012,12,1000,7000,8000
Föderierte Staaten von Mikronesien (ab 1992),2013,1,0,3000,3000
Föderierte Staaten von Mikronesien (ab 1992),2013,2,20000,4000,24000
Föderierte Staaten von Mikronesien (ab 1992),2013,3,0,6000,6000
Föderierte Staaten von Mikronesien (ab 1992),2013,4,0,4000,4000
Föderierte Staaten von Mikronesien (ab 1992),2013,5,0,6000,6000
Föderierte Staaten von Mikronesien (ab 1992),2013,6,0,5000,5000
Föderierte Staaten von Mikronesien (ab 1992),2013,7,0,1000,1000
Föderierte Staaten von Mikronesien (ab 1992),2013,8,93000,4000,97000
Föderierte Staaten von Mikronesien (ab 1992),2013,9,5000,4000,9000
Föderierte Staaten von Mikronesien (ab 1992),2013,10,0,0,0
Föderierte Staaten von Mikronesien (ab 1992),2013,11,0,10000,10000
Föderierte Staaten von Mikronesien (ab 1992),2013,12,0,0,0
Föderierte Staaten von Mikronesien (ab 1992),2014,1,0,0,0
Föderierte Staaten von Mikronesien (ab 1992),2014,2,27000,0,27000
Föderierte Staaten von Mikronesien (ab 1992),2014,3,0,4000,4000
Föderierte Staaten von Mikronesien (ab 1992),2014,4,2000,0,2000
Föderierte Staaten von Mikronesien (ab 1992),2014,5,0,3000,3000
Föderierte Staaten von Mikronesien (ab 1992),2014,6,2000,6000,8000
Föderierte Staaten von Mikronesien (ab 1992),2014,7,3000,6000,9000
Föderierte Staaten von Mikronesien (ab 1992),2014,8,6000,0,6000
Föderierte Staaten von Mikronesien (ab 1992),2014,9,0,0,0
Föderierte Staaten von Mikronesien (ab 1992),2014,10,3000,0,3000
Föderierte Staaten von Mikronesien (ab 1992),2014,11,0,1000,1000
Föderierte Staaten von Mikronesien (ab 1992),2014,12,127000,0,127000
Föderierte Staaten von Mikronesien (ab 1992),2015,1,0,7000,7000
Föderierte Staaten von Mikronesien (ab 1992),2015,2,0,0,0
Föderierte Staaten von Mikronesien (ab 1992),2015,3,55000,0,55000
Föderierte Staaten von Mikronesien (ab 1992),2015,4,0,8000,8000
Föderierte Staaten von Mikronesien (ab 1992),2015,5,0,0,0
Föderierte Staaten von Mikronesien (ab 1992),2015,6,3000,0,3000
Föderierte Staaten von Mikronesien (ab 1992),2015,7,7000,0,7000
Föderierte Staaten von Mikronesien (ab 1992),2015,8,3000,0,3000
Föderierte Staaten von Mikronesien (ab 1992),2015,9,1000,7000,8000
Föderierte Staaten von Mikronesien (ab 1992),2015,10,0,0,0
Föderierte Staaten von Mikronesien (ab 1992),2015,11,3000,0,3000
Föderierte Staaten von Mikronesien (ab 1992),2015,12,6000,8000,14000
Föderierte Staaten von Mikronesien (ab 1992),2016,1,6000,9000,15000
Föderierte Staaten von Mikronesien (ab 1992),2016,2,0,0,0
Föderierte Staaten von Mikronesien (ab 1992),2016,3,1000,0,1000
Föderierte Staaten von Mikronesien (ab 1992),2016,4,2000,0,2000
Föderierte Staaten von Mikronesien (ab 1992),2016,5,0,0,0
Föderierte Staaten von Mikronesien (ab 1992),2016,6,22000,0,22000
Föderierte Staaten von Mikronesien (ab 1992),2016,7,0,0,0
Föderierte Staaten von Mikronesien (ab 1992),2016,8,0,0,0
Föderierte Staaten von Mikronesien (ab 1992),2016,9,0,12000,12000
Föderierte Staaten von Mikronesien (ab 1992),2016,10,1000,18000,19000
Föderierte Staaten von Mikronesien (ab 1992),2016,11,0,10000,10000
Föderierte Staaten von Mikronesien (ab 1992),2016,12,214000,1000,215000
Föderierte Staaten von Mikronesien (ab 1992),2017,1,25000,0,25000
Föderierte Staaten von Mikronesien (ab 1992),2017,2,30000,0,30000
Föderierte Staaten von Mikronesien (ab 1992),2017,3,0,0,0
Föderierte Staaten von Mikronesien (ab 1992),2017,4,0,4000,4000
Föderierte Staaten von Mikronesien (ab 1992),2017,5,9000,4000,13000
Föderierte Staaten von Mikronesien (ab 1992),2017,6,1000,0,1000
Föderierte Staaten von Mikronesien (ab 1992),2017,7,2000,0,2000
Föderierte Staaten von Mikronesien (ab 1992),2017,8,0,0,0
Föderierte Staaten von Mikronesien (ab 1992),2017,9,2000,0,2000
Föderierte Staaten von Mikronesien (ab 1992),2017,10,8000,0,8000
Föderierte Staaten von Mikronesien (ab 1992),2017,11,2000,4000,6000
Föderierte Staaten von Mikronesien (ab 1992),2017,12,0,0,0
Föderierte Staaten von Mikronesien (ab 1992),2018,1,2000,0,2000
Föderierte Staaten von Mikronesien (ab 1992),2018,2,0,0,0
Föderierte Staaten von Mikronesien (ab 1992),2018,3,0,0,0
Föderierte Staaten von Mikronesien (ab 1992),2018,4,0,0,0
Föderierte Staaten von Mikronesien (ab 1992),2018,5,0,9000,9000
Föderierte Staaten von Mikronesien (ab 1992),2018,6,14000,0,14000
Föderierte Staaten von Mikronesien (ab 1992),2018,7,0,0,0
Föderierte Staaten von Mikronesien (ab 1992),2018,8,1000,0,1000
Föderierte Staaten von Mikronesien (ab 1992),2018,9,158000,5000,163000
Föderierte Staaten von Mikronesien (ab 1992),2018,10,15000,8000,23000
Föderierte Staaten von Mikronesien (ab 1992),2018,11,4000,5000,9000
Föderierte Staaten von Mikronesien (ab 1992),2018,12,0,0,0
Föderierte Staaten von Mikronesien (ab 1992),2019,1,0,0,0
Föderierte Staaten von Mikronesien (ab 1992),2019,2,0,0,0
Föderierte Staaten von Mikronesien (ab 1992),2019,3,0,0,0
Föderierte Staaten von Mikronesien (ab 1992),2019,4,2000,0,2000
Föderierte Staaten von Mikronesien (ab 1992),2019,5,6000,7000,13000
Föderierte Staaten von Mikronesien (ab 1992),2019,6,2000,0,2000
Föderierte Staaten von Mikronesien (ab 1992),2019,7,28000,0,28000
Föderierte Staaten von Mikronesien (ab 1992),2019,8,2000,0,2000
Föderierte Staaten von Mikronesien (ab 1992),2019,9,1000,0,1000
Föderierte Staaten von Mikronesien (ab 1992),2019,10,1000,0,1000
Föderierte Staaten von Mikronesien (ab 1992),2019,11,1000,4000,5000
Föderierte Staaten von Mikronesien (ab 1992),2019,12,7000,0,7000
Föderierte Staaten von Mikronesien (ab 1992),2020,1,110000,0,110000
Föderierte Staaten von Mikronesien (ab 1992),2020,2,2000,0,2000
Föderierte Staaten von Mikronesien (ab 1992),2020,3,0,7000,7000
Föderierte Staaten von Mikronesien (ab 1992),2020,4,1000,0,1000
Föderierte Staaten von Mikronesien (ab 1992),2020,5,0,0,0
Föderierte Staaten von Mikronesien (ab 1992),2020,6,0,0,0
Föderierte Staaten von Mikronesien (ab 1992),2020,7,0,0,0
Föderierte Staaten von Mikronesien (ab 1992),2020,8,0,0,0
Föderierte Staaten von Mikronesien (ab 1992),2020,9,0,0,0
Föderierte Staaten von Mikronesien (ab 1992),2020,10,0,1000,1000
Föderierte Staaten von Mikronesien (ab 1992),2020,11,0,9000,9000
Föderierte Staaten von Mikronesien (ab 1992),2020,12,0,0,0
Föderierte Staaten von Mikronesien (ab 1992),2021,1,0,0,0
Föderierte Staaten von Mikronesien (ab 1992),2021,2,0,5000,5000
Föderierte Staaten von Mikronesien (ab 1992),2021,3,126000,2000,128000
Föderierte Staaten von Mikronesien (ab 1992),2021,4,0,0,0
Föderierte Staaten von Mikronesien (ab 1992),2021,5,2000,0,2000
Föderierte Staaten von Mikronesien (ab 1992),2021,6,0,0,0
Föderierte Staaten von Mikronesien (ab 1992),2021,7,0,0,0
Föderierte Staaten von Mikronesien (ab 1992),2021,8,0,13000,13000
Föderierte Staaten von Mikronesien (ab 1992),2021,9,2000,5000,7000
Föderierte Staaten von Mikronesien (ab 1992),2021,10,38000,0,38000
Föderierte Staaten von Mikronesien (ab 1992),2021,11,0,4000,4000
Föderierte Staaten von Mikronesien (ab 1992),2021,12,0,14000,14000
Föderierte Staaten von Mikronesien (ab 1992),2022,1,3000,532000,535000
Föderierte Staaten von Mikronesien (ab 1992),2022,2,0,75000,75000
Föderierte Staaten von Mikronesien (ab 1992),2022,3,0,42000,42000
Föderierte Staaten von Mikronesien (ab 1992),2022,4,0,0,0
Föderierte Staaten von Mikronesien (ab 1992),2022,5,0,0,0
Föderierte Staaten von Mikronesien (ab 1992),2022,6,5000,8000,13000
Föderierte Staaten von Mikronesien (ab 1992),2022,7,25000,0,25000
Föderierte Staaten von Mikronesien (ab 1992),2022,8,3000,0,3000
Föderierte Staaten von Mikronesien (ab 1992),2022,9,22000,7000,29000
Föderierte Staaten von Mikronesien (ab 1992),2022,10,0,0,0
Föderierte Staaten von Mikronesien (ab 1992),2022,11,5000,0,5000
Föderierte Staaten von Mikronesien (ab 1992),2022,12,0,0,0
Föderierte Staaten von Mikronesien (ab 1992),2023,1,0,0,0
Föderierte Staaten von Mikronesien (ab 1992),2023,2,6000,0,6000
Föderierte Staaten von Mikronesien (ab 1992),2023,3,0,0,0
Föderierte Staaten von Mikronesien (ab 1992),2023,4,30000,0,30000
Föderierte Staaten von Mikronesien (ab 1992),2023,5,0,0,0
Föderierte Staaten von Mikronesien (ab 1992),2023,6,0,0,0
Föderierte Staaten von Mikronesien (ab 1992),2023,7,0,0,0
Föderierte Staaten von Mikronesien (ab 1992),2023,8,0,0,0
Föderierte Staaten von Mikronesien (ab 1992),2023,9,0,8000,8000
Föderierte Staaten von Mikronesien (ab 1992),2023,10,21000,0,21000
Föderierte Staaten von Mikronesien (ab 1992),2023,11,0,0,0
Föderierte Staaten von Mikronesien (ab 1992),2023,12,0,0,0
Föderierte Staaten von Mikronesien (ab 1992),2024,1,5000,0,5000
Föderierte Staaten von Mikronesien (ab 1992),2024,2,0,5000,5000
Föderierte Staaten von Mikronesien (ab 1992),2024,3,0,0,0
Föderierte Staaten von Mikronesien (ab 1992),2024,4,45000,5000,50000
Föderierte Staaten von Mikronesien (ab 1992),2024,5,0,0,0
Föderierte Staaten von Mikronesien (ab 1992),2024,6,0,0,0
Föderierte Staaten von Mikronesien (ab 1992),2024,7,0,0,0
Föderierte Staaten von Mikronesien (ab 1992),2024,8,5000,24000,29000
Föderierte Staaten von Mikronesien (ab 1992),2024,9,26000,0,26000
Föderierte Staaten von Mikronesien (ab 1992),2024,10,49000,0,49000
Föderierte Staaten von Mikronesien (ab 1992),2024,11,0,5000,5000
Föderierte Staaten von Mikronesien (ab 1992),2024,12,0,0,0
Gabun,2008,1,2704000,4052000,6756000
Gabun,2008,2,2563000,24237000,26800000
Gabun,2008,3,3971000,4621000,8592000
Gabun,2008,4,6569000,1109000,7678000
Gabun,2008,5,4660000,2271000,6931000
Gabun,2008,6,6469000,1599000,8068000
Gabun,2008,7,5395000,29520000,34915000
Gabun,2008,8,4214000,1233000,5447000
Gabun,2008,9,3104000,16370000,19474000
Gabun,2008,10,4006000,9450000,13456000
Gabun,2008,11,3649000,5741000,9390000
Gabun,2008,12,7725000,4649000,12374000
Gabun,2009,1,1981000,8218000,10199000
Gabun,2009,2,4418000,8613000,13031000
Gabun,2009,3,3564000,13385000,16949000
Gabun,2009,4,3565000,7242000,10807000
Gabun,2009,5,2710000,11139000,13849000
Gabun,2009,6,2149000,43899000,46048000
Gabun,2009,7,4581000,16726000,21307000
Gabun,2009,8,2188000,2889000,5077000
Gabun,2009,9,2277000,24767000,27044000
Gabun,2009,10,3915000,2367000,6282000
Gabun,2009,11,4684000,14183000,18867000
Gabun,2009,12,9728000,43682000,53410000
Gabun,2010,1,3447000,24992000,28439000
Gabun,2010,2,3329000,1178000,4507000
Gabun,2010,3,3785000,23084000,26869000
Gabun,2010,4,5835000,170000,6005000
Gabun,2010,5,4112000,727000,4839000
Gabun,2010,6,4445000,26453000,30898000
Gabun,2010,7,10011000,12432000,22443000
Gabun,2010,8,7567000,271000,7838000
Gabun,2010,9,5702000,844000,6546000
Gabun,2010,10,7873000,10285000,18158000
Gabun,2010,11,3684000,2949000,6633000
Gabun,2010,12,4581000,260000,4841000
Gabun,2011,1,3459000,658000,4117000
Gabun,2011,2,4079000,3295000,7374000
Gabun,2011,3,6538000,790000,7328000
Gabun,2011,4,11553000,453000,12006000
Gabun,2011,5,5646000,12582000,18228000
Gabun,2011,6,8498000,4102000,12600000
Gabun,2011,7,3845000,20135000,23980000
Gabun,2011,8,6092000,1076000,7168000
Gabun,2011,9,4857000,5258000,10115000
Gabun,2011,10,4343000,8250000,12593000
Gabun,2011,11,7770000,2332000,10102000
Gabun,2011,12,13533000,906000,14439000
Gabun,2012,1,6157000,11985000,18142000
Gabun,2012,2,8825000,8963000,17788000
Gabun,2012,3,4526000,13427000,17953000
Gabun,2012,4,4865000,33242000,38107000
Gabun,2012,5,3580000,639000,4219000
Gabun,2012,6,4254000,20338000,24592000
Gabun,2012,7,7151000,728000,7879000
Gabun,2012,8,7876000,1288000,9164000
Gabun,2012,9,7324000,1098000,8422000
Gabun,2012,10,10912000,20603000,31515000
Gabun,2012,11,8362000,6747000,15109000
Gabun,2012,12,8906000,1161000,10067000
Gabun,2013,1,4785000,9740000,14525000
Gabun,2013,2,6560000,10035000,16595000
Gabun,2013,3,6386000,2786000,9172000
Gabun,2013,4,6520000,1273000,7793000
Gabun,2013,5,4371000,6070000,10441000
Gabun,2013,6,6984000,659000,7643000
Gabun,2013,7,11098000,6192000,17290000
Gabun,2013,8,9330000,1138000,10468000
Gabun,2013,9,11896000,732000,12628000
Gabun,2013,10,7017000,14850000,21867000
Gabun,2013,11,6642000,687000,7329000
Gabun,2013,12,9145000,10414000,19559000
Gabun,2014,1,12772000,7616000,20388000
Gabun,2014,2,7372000,643000,8015000
Gabun,2014,3,6977000,647000,7624000
Gabun,2014,4,4876000,804000,5680000
Gabun,2014,5,5884000,461000,6345000
Gabun,2014,6,5312000,562000,5874000
Gabun,2014,7,6814000,803000,7617000
Gabun,2014,8,4868000,1327000,6195000
Gabun,2014,9,6186000,609000,6795000
Gabun,2014,10,6550000,100000,6650000
Gabun,2014,11,5068000,457000,5525000
Gabun,2014,12,7231000,737000,7968000
Gabun,2015,1,5032000,420000,5452000
Gabun,2015,2,3819000,224000,4043000
Gabun,2015,3,6146000,916000,7062000
Gabun,2015,4,3982000,701000,4683000
Gabun,2015,5,4082000,457000,4539000
Gabun,2015,6,3829000,330000,4159000
Gabun,2015,7,2953000,1545000,4498000
Gabun,2015,8,3482000,266000,3748000
Gabun,2015,9,6600000,4647000,11247000
Gabun,2015,10,4952000,7177000,12129000
Gabun,2015,11,4996000,3412000,8408000
Gabun,2015,12,3629000,2482000,6111000
Gabun,2016,1,4293000,3310000,7603000
Gabun,2016,2,2847000,4189000,7036000
Gabun,2016,3,2631000,987000,3618000
Gabun,2016,4,2317000,833000,3150000
Gabun,2016,5,6716000,1797000,8513000
Gabun,2016,6,2045000,1510000,3555000
Gabun,2016,7,3279000,1587000,4866000
Gabun,2016,8,2463000,1052000,3515000
Gabun,2016,9,1999000,1146000,3145000
Gabun,2016,10,2213000,3049000,5262000
Gabun,2016,11,2557000,1107000,3664000
Gabun,2016,12,4413000,989000,5402000
Gabun,2017,1,2770000,839000,3609000
Gabun,2017,2,3686000,1646000,5332000
Gabun,2017,3,2636000,748000,3384000
Gabun,2017,4,2191000,1304000,3495000
Gabun,2017,5,2911000,2246000,5157000
Gabun,2017,6,2702000,1380000,4082000
Gabun,2017,7,4269000,1987000,6256000
Gabun,2017,8,2928000,535000,3463000
Gabun,2017,9,5761000,1607000,7368000
Gabun,2017,10,3713000,1779000,5492000
Gabun,2017,11,3012000,2994000,6006000
Gabun,2017,12,2962000,321000,3283000
Gabun,2018,1,2857000,190000,3047000
Gabun,2018,2,3130000,7494000,10624000
Gabun,2018,3,5796000,1441000,7237000
Gabun,2018,4,7931000,3365000,11296000
Gabun,2018,5,5568000,7772000,13340000
Gabun,2018,6,3114000,2603000,5717000
Gabun,2018,7,4134000,1760000,5894000
Gabun,2018,8,3294000,3254000,6548000
Gabun,2018,9,3177000,1160000,4337000
Gabun,2018,10,4215000,570000,4785000
Gabun,2018,11,2044000,672000,2716000
Gabun,2018,12,3041000,2590000,5631000
Gabun,2019,1,1366000,1905000,3271000
Gabun,2019,2,3206000,1806000,5012000
Gabun,2019,3,5724000,3063000,8787000
Gabun,2019,4,2656000,3341000,5997000
Gabun,2019,5,2581000,1647000,4228000
Gabun,2019,6,5739000,2537000,8276000
Gabun,2019,7,2668000,1873000,4541000
Gabun,2019,8,3570000,1712000,5282000
Gabun,2019,9,2732000,2630000,5362000
Gabun,2019,10,2459000,2521000,4980000
Gabun,2019,11,2842000,803000,3645000
Gabun,2019,12,3885000,2257000,6142000
Gabun,2020,1,2092000,422000,2514000
Gabun,2020,2,2198000,1323000,3521000
Gabun,2020,3,2011000,3954000,5965000
Gabun,2020,4,1323000,2299000,3622000
Gabun,2020,5,1802000,2295000,4097000
Gabun,2020,6,2578000,5161000,7739000
Gabun,2020,7,2536000,5881000,8417000
Gabun,2020,8,1906000,3335000,5241000
Gabun,2020,9,2842000,6442000,9284000
Gabun,2020,10,2161000,1692000,3853000
Gabun,2020,11,2412000,4915000,7327000
Gabun,2020,12,2758000,3623000,6381000
Gabun,2021,1,2688000,270000,2958000
Gabun,2021,2,2433000,98000,2531000
Gabun,2021,3,2628000,7735000,10363000
Gabun,2021,4,3253000,9272000,12525000
Gabun,2021,5,1746000,6762000,8508000
Gabun,2021,6,2363000,1841000,4204000
Gabun,2021,7,4082000,7242000,11324000
Gabun,2021,8,1886000,6658000,8544000
Gabun,2021,9,3307000,6483000,9790000
Gabun,2021,10,4307000,7521000,11828000
Gabun,2021,11,3312000,138000,3450000
Gabun,2021,12,2354000,8224000,10578000
Gabun,2022,1,2517000,9068000,11585000
Gabun,2022,2,2610000,8596000,11206000
Gabun,2022,3,3089000,395000,3484000
Gabun,2022,4,2503000,16703000,19206000
Gabun,2022,5,2385000,49721000,52106000
Gabun,2022,6,4906000,19264000,24170000
Gabun,2022,7,5457000,16365000,21822000
Gabun,2022,8,7386000,29547000,36933000
Gabun,2022,9,2071000,10082000,12153000
Gabun,2022,10,8957000,7123000,16080000
Gabun,2022,11,3726000,335000,4061000
Gabun,2022,12,6449000,68011000,74460000
Gabun,2023,1,2717000,237000,2954000
Gabun,2023,2,4014000,190000,4204000
Gabun,2023,3,2960000,3720000,6680000
Gabun,2023,4,2261000,148000,2409000
Gabun,2023,5,2365000,8911000,11276000
Gabun,2023,6,3955000,8287000,12242000
Gabun,2023,7,2859000,8557000,11416000
Gabun,2023,8,3531000,210000,3741000
Gabun,2023,9,11814000,9230000,21044000
Gabun,2023,10,7949000,8905000,16854000
Gabun,2023,11,6294000,80000,6374000
Gabun,2023,12,1841000,851000,2692000
Gabun,2024,1,4686000,1717000,6403000
Gabun,2024,2,4283000,8391000,12674000
Gabun,2024,3,3666000,19653000,23319000
Gabun,2024,4,3969000,15670000,19639000
Gabun,2024,5,4926000,9421000,14347000
Gabun,2024,6,3606000,24768000,28374000
Gabun,2024,7,4258000,9195000,13453000
Gabun,2024,8,2002000,7164000,9166000
Gabun,2024,9,4895000,125000,5020000
Gabun,2024,10,5756000,69000,5825000
Gabun,2024,11,3603000,11211000,14814000
Gabun,2024,12,3196000,13670000,16866000
Gambia,2008,1,561000,0,561000
Gambia,2008,2,625000,3000,628000
Gambia,2008,3,685000,3000,688000
Gambia,2008,4,903000,1000,904000
Gambia,2008,5,926000,1000,927000
Gambia,2008,6,565000,6000,571000
Gambia,2008,7,460000,0,460000
Gambia,2008,8,789000,1000,790000
Gambia,2008,9,508000,3000,511000
Gambia,2008,10,514000,0,514000
Gambia,2008,11,769000,0,769000
Gambia,2008,12,570000,2000,572000
Gambia,2009,1,507000,0,507000
Gambia,2009,2,433000,9000,442000
Gambia,2009,3,1541000,0,1541000
Gambia,2009,4,2185000,0,2185000
Gambia,2009,5,402000,9000,411000
Gambia,2009,6,1033000,2000,1035000
Gambia,2009,7,1010000,0,1010000
Gambia,2009,8,2054000,37000,2091000
Gambia,2009,9,586000,2000,588000
Gambia,2009,10,758000,3000,761000
Gambia,2009,11,790000,0,790000
Gambia,2009,12,342000,21000,363000
Gambia,2010,1,792000,1000,793000
Gambia,2010,2,1557000,0,1557000
Gambia,2010,3,631000,6000,637000
Gambia,2010,4,435000,0,435000
Gambia,2010,5,740000,31000,771000
Gambia,2010,6,677000,8000,685000
Gambia,2010,7,554000,0,554000
Gambia,2010,8,946000,0,946000
Gambia,2010,9,605000,0,605000
Gambia,2010,10,589000,0,589000
Gambia,2010,11,636000,0,636000
Gambia,2010,12,830000,0,830000
Gambia,2011,1,421000,20000,441000
Gambia,2011,2,1252000,0,1252000
Gambia,2011,3,778000,3000,781000
Gambia,2011,4,473000,3000,476000
Gambia,2011,5,639000,10000,649000
Gambia,2011,6,476000,26000,502000
Gambia,2011,7,512000,10000,522000
Gambia,2011,8,750000,8000,758000
Gambia,2011,9,1331000,5000,1336000
Gambia,2011,10,563000,20000,583000
Gambia,2011,11,725000,11000,736000
Gambia,2011,12,407000,28000,435000
Gambia,2012,1,918000,0,918000
Gambia,2012,2,434000,11000,445000
Gambia,2012,3,724000,4000,728000
Gambia,2012,4,333000,44000,377000
Gambia,2012,5,1070000,45000,1115000
Gambia,2012,6,969000,4000,973000
Gambia,2012,7,967000,64000,1031000
Gambia,2012,8,609000,48000,657000
Gambia,2012,9,978000,11000,989000
Gambia,2012,10,780000,24000,804000
Gambia,2012,11,1134000,42000,1176000
Gambia,2012,12,996000,31000,1027000
Gambia,2013,1,539000,71000,610000
Gambia,2013,2,537000,43000,580000
Gambia,2013,3,735000,24000,759000
Gambia,2013,4,1102000,89000,1191000
Gambia,2013,5,610000,42000,652000
Gambia,2013,6,666000,86000,752000
Gambia,2013,7,845000,34000,879000
Gambia,2013,8,474000,47000,521000
Gambia,2013,9,1091000,45000,1136000
Gambia,2013,10,666000,47000,713000
Gambia,2013,11,606000,31000,637000
Gambia,2013,12,784000,0,784000
Gambia,2014,1,669000,56000,725000
Gambia,2014,2,441000,81000,522000
Gambia,2014,3,1099000,233000,1332000
Gambia,2014,4,686000,49000,735000
Gambia,2014,5,841000,147000,988000
Gambia,2014,6,470000,106000,576000
Gambia,2014,7,601000,105000,706000
Gambia,2014,8,761000,58000,819000
Gambia,2014,9,593000,66000,659000
Gambia,2014,10,864000,47000,911000
Gambia,2014,11,807000,30000,837000
Gambia,2014,12,519000,186000,705000
Gambia,2015,1,594000,83000,677000
Gambia,2015,2,1761000,13000,1774000
Gambia,2015,3,690000,121000,811000
Gambia,2015,4,754000,97000,851000
Gambia,2015,5,660000,29000,689000
Gambia,2015,6,611000,59000,670000
Gambia,2015,7,921000,74000,995000
Gambia,2015,8,626000,0,626000
Gambia,2015,9,730000,155000,885000
Gambia,2015,10,889000,44000,933000
Gambia,2015,11,766000,12000,778000
Gambia,2015,12,1144000,0,1144000
Gambia,2016,1,671000,9000,680000
Gambia,2016,2,833000,41000,874000
Gambia,2016,3,856000,8000,864000
Gambia,2016,4,669000,11000,680000
Gambia,2016,5,781000,0,781000
Gambia,2016,6,639000,29000,668000
Gambia,2016,7,839000,5000,844000
Gambia,2016,8,652000,12000,664000
Gambia,2016,9,454000,10000,464000
Gambia,2016,10,509000,5000,514000
Gambia,2016,11,790000,29000,819000
Gambia,2016,12,607000,5000,612000
Gambia,2017,1,253000,23000,276000
Gambia,2017,2,1241000,38000,1279000
Gambia,2017,3,916000,5000,921000
Gambia,2017,4,736000,6000,742000
Gambia,2017,5,804000,57000,861000
Gambia,2017,6,1015000,57000,1072000
Gambia,2017,7,955000,29000,984000
Gambia,2017,8,881000,40000,921000
Gambia,2017,9,565000,0,565000
Gambia,2017,10,902000,7000,909000
Gambia,2017,11,1204000,38000,1242000
Gambia,2017,12,1505000,3000,1508000
Gambia,2018,1,930000,63000,993000
Gambia,2018,2,1074000,24000,1098000
Gambia,2018,3,1114000,18000,1132000
Gambia,2018,4,757000,153000,910000
Gambia,2018,5,1048000,39000,1087000
Gambia,2018,6,811000,52000,863000
Gambia,2018,7,1459000,47000,1506000
Gambia,2018,8,955000,1000,956000
Gambia,2018,9,923000,33000,956000
Gambia,2018,10,1108000,1000,1109000
Gambia,2018,11,900000,22000,922000
Gambia,2018,12,775000,4000,779000
Gambia,2019,1,1130000,48000,1178000
Gambia,2019,2,1375000,39000,1414000
Gambia,2019,3,5980000,43000,6023000
Gambia,2019,4,1460000,15000,1475000
Gambia,2019,5,1251000,13000,1264000
Gambia,2019,6,1004000,310000,1314000
Gambia,2019,7,1718000,50000,1768000
Gambia,2019,8,1572000,24000,1596000
Gambia,2019,9,1401000,16000,1417000
Gambia,2019,10,1508000,32000,1540000
Gambia,2019,11,1250000,76000,1326000
Gambia,2019,12,869000,13000,882000
Gambia,2020,1,1126000,38000,1164000
Gambia,2020,2,1649000,31000,1680000
Gambia,2020,3,1164000,42000,1206000
Gambia,2020,4,1736000,9000,1745000
Gambia,2020,5,1114000,3000,1117000
Gambia,2020,6,1347000,58000,1405000
Gambia,2020,7,1436000,29000,1465000
Gambia,2020,8,1225000,8000,1233000
Gambia,2020,9,1615000,31000,1646000
Gambia,2020,10,1050000,6000,1056000
Gambia,2020,11,1141000,51000,1192000
Gambia,2020,12,1348000,21000,1369000
Gambia,2021,1,1005000,41000,1046000
Gambia,2021,2,956000,11000,967000
Gambia,2021,3,1603000,112000,1715000
Gambia,2021,4,1284000,12000,1296000
Gambia,2021,5,1067000,36000,1103000
Gambia,2021,6,1279000,15000,1294000
Gambia,2021,7,1280000,13000,1293000
Gambia,2021,8,1459000,65000,1524000
Gambia,2021,9,1610000,33000,1643000
Gambia,2021,10,2688000,28000,2716000
Gambia,2021,11,1700000,69000,1769000
Gambia,2021,12,859000,188000,1047000
Gambia,2022,1,1225000,76000,1301000
Gambia,2022,2,1498000,54000,1552000
Gambia,2022,3,1359000,36000,1395000
Gambia,2022,4,1626000,67000,1693000
Gambia,2022,5,1504000,79000,1583000
Gambia,2022,6,7192000,88000,7280000
Gambia,2022,7,1191000,39000,1230000
Gambia,2022,8,1139000,80000,1219000
Gambia,2022,9,1312000,33000,1345000
Gambia,2022,10,1174000,73000,1247000
Gambia,2022,11,2384000,80000,2464000
Gambia,2022,12,2043000,95000,2138000
Gambia,2023,1,1538000,54000,1592000
Gambia,2023,2,6418000,59000,6477000
Gambia,2023,3,1350000,48000,1398000
Gambia,2023,4,2055000,71000,2126000
Gambia,2023,5,1117000,44000,1161000
Gambia,2023,6,827000,354000,1181000
Gambia,2023,7,927000,30000,957000
Gambia,2023,8,1423000,38000,1461000
Gambia,2023,9,1171000,34000,1205000
Gambia,2023,10,1053000,30000,1083000
Gambia,2023,11,1736000,27000,1763000
Gambia,2023,12,1095000,54000,1149000
Gambia,2024,1,1203000,77000,1280000
Gambia,2024,2,1813000,25000,1838000
Gambia,2024,3,2106000,90000,2196000
Gambia,2024,4,1244000,47000,1291000
Gambia,2024,5,1347000,5000,1352000
Gambia,2024,6,4222000,67000,4289000
Gambia,2024,7,1198000,22000,1220000
Gambia,2024,8,2151000,19000,2170000
Gambia,2024,9,958000,10000,968000
Gambia,2024,10,1632000,33000,1665000
Gambia,2024,11,1894000,54000,1948000
Gambia,2024,12,791000,7000,798000
Georgien (ab 05/1992),2008,1,22226000,7328000,29554000
Georgien (ab 05/1992),2008,2,20508000,9894000,30402000
Georgien (ab 05/1992),2008,3,22579000,2678000,25257000
Georgien (ab 05/1992),2008,4,24620000,3650000,28270000
Georgien (ab 05/1992),2008,5,22942000,2853000,25795000
Georgien (ab 05/1992),2008,6,30564000,4098000,34662000
Georgien (ab 05/1992),2008,7,26882000,769000,27651000
Georgien (ab 05/1992),2008,8,18323000,1151000,19474000
Georgien (ab 05/1992),2008,9,17350000,1099000,18449000
Georgien (ab 05/1992),2008,10,19705000,1316000,21021000
Georgien (ab 05/1992),2008,11,18679000,2499000,21178000
Georgien (ab 05/1992),2008,12,20872000,1705000,22577000
Georgien (ab 05/1992),2009,1,9608000,871000,10479000
Georgien (ab 05/1992),2009,2,11742000,2746000,14488000
Georgien (ab 05/1992),2009,3,14757000,1716000,16473000
Georgien (ab 05/1992),2009,4,16017000,2353000,18370000
Georgien (ab 05/1992),2009,5,12758000,2792000,15550000
Georgien (ab 05/1992),2009,6,15258000,1595000,16853000
Georgien (ab 05/1992),2009,7,15103000,1013000,16116000
Georgien (ab 05/1992),2009,8,17435000,600000,18035000
Georgien (ab 05/1992),2009,9,14184000,1421000,15605000
Georgien (ab 05/1992),2009,10,19115000,3816000,22931000
Georgien (ab 05/1992),2009,11,17409000,2623000,20032000
Georgien (ab 05/1992),2009,12,18713000,1761000,20474000
Georgien (ab 05/1992),2010,1,10433000,3746000,14179000
Georgien (ab 05/1992),2010,2,14365000,1710000,16075000
Georgien (ab 05/1992),2010,3,24548000,3051000,27599000
Georgien (ab 05/1992),2010,4,18116000,1468000,19584000
Georgien (ab 05/1992),2010,5,17181000,1298000,18479000
Georgien (ab 05/1992),2010,6,23476000,12762000,36238000
Georgien (ab 05/1992),2010,7,21969000,2027000,23996000
Georgien (ab 05/1992),2010,8,16817000,8239000,25056000
Georgien (ab 05/1992),2010,9,22393000,2870000,25263000
Georgien (ab 05/1992),2010,10,21339000,8054000,29393000
Georgien (ab 05/1992),2010,11,26399000,7232000,33631000
Georgien (ab 05/1992),2010,12,25464000,6479000,31943000
Georgien (ab 05/1992),2011,1,15794000,6470000,22264000
Georgien (ab 05/1992),2011,2,20304000,7875000,28179000
Georgien (ab 05/1992),2011,3,23442000,5607000,29049000
Georgien (ab 05/1992),2011,4,21686000,14853000,36539000
Georgien (ab 05/1992),2011,5,23197000,52175000,75372000
Georgien (ab 05/1992),2011,6,25431000,2562000,27993000
Georgien (ab 05/1992),2011,7,29308000,5419000,34727000
Georgien (ab 05/1992),2011,8,25307000,1791000,27098000
Georgien (ab 05/1992),2011,9,29236000,5697000,34933000
Georgien (ab 05/1992),2011,10,38896000,9014000,47910000
Georgien (ab 05/1992),2011,11,38914000,23679000,62593000
Georgien (ab 05/1992),2011,12,45995000,9711000,55706000
Georgien (ab 05/1992),2012,1,23729000,7710000,31439000
Georgien (ab 05/1992),2012,2,31243000,21949000,53192000
Georgien (ab 05/1992),2012,3,51452000,8132000,59584000
Georgien (ab 05/1992),2012,4,24038000,3512000,27550000
Georgien (ab 05/1992),2012,5,33685000,4524000,38209000
Georgien (ab 05/1992),2012,6,38921000,2842000,41763000
Georgien (ab 05/1992),2012,7,39425000,2768000,42193000
Georgien (ab 05/1992),2012,8,38643000,52360000,91003000
Georgien (ab 05/1992),2012,9,32717000,5107000,37824000
Georgien (ab 05/1992),2012,10,29879000,68315000,98194000
Georgien (ab 05/1992),2012,11,32049000,9049000,41098000
Georgien (ab 05/1992),2012,12,27604000,2843000,30447000
Georgien (ab 05/1992),2013,1,23628000,11803000,35431000
Georgien (ab 05/1992),2013,2,23926000,3168000,27094000
Georgien (ab 05/1992),2013,3,25770000,6741000,32511000
Georgien (ab 05/1992),2013,4,26991000,4785000,31776000
Georgien (ab 05/1992),2013,5,24770000,3398000,28168000
Georgien (ab 05/1992),2013,6,29370000,4163000,33533000
Georgien (ab 05/1992),2013,7,29861000,19010000,48871000
Georgien (ab 05/1992),2013,8,30319000,4028000,34347000
Georgien (ab 05/1992),2013,9,29555000,11746000,41301000
Georgien (ab 05/1992),2013,10,28806000,36380000,65186000
Georgien (ab 05/1992),2013,11,32724000,12992000,45716000
Georgien (ab 05/1992),2013,12,25868000,9327000,35195000
Georgien (ab 05/1992),2014,1,25630000,5663000,31293000
Georgien (ab 05/1992),2014,2,35711000,6430000,42141000
Georgien (ab 05/1992),2014,3,28751000,5995000,34746000
Georgien (ab 05/1992),2014,4,24183000,4703000,28886000
Georgien (ab 05/1992),2014,5,27165000,23271000,50436000
Georgien (ab 05/1992),2014,6,27471000,7281000,34752000
Georgien (ab 05/1992),2014,7,41170000,4835000,46005000
Georgien (ab 05/1992),2014,8,33942000,10116000,44058000
Georgien (ab 05/1992),2014,9,32532000,9457000,41989000
Georgien (ab 05/1992),2014,10,40683000,7577000,48260000
Georgien (ab 05/1992),2014,11,27494000,6643000,34137000
Georgien (ab 05/1992),2014,12,29695000,6868000,36563000
Georgien (ab 05/1992),2015,1,24198000,7140000,31338000
Georgien (ab 05/1992),2015,2,28245000,10636000,38881000
Georgien (ab 05/1992),2015,3,29589000,6960000,36549000
Georgien (ab 05/1992),2015,4,30982000,6106000,37088000
Georgien (ab 05/1992),2015,5,26324000,5634000,31958000
Georgien (ab 05/1992),2015,6,34340000,7064000,41404000
Georgien (ab 05/1992),2015,7,34552000,4716000,39268000
Georgien (ab 05/1992),2015,8,31829000,4499000,36328000
Georgien (ab 05/1992),2015,9,26275000,9829000,36104000
Georgien (ab 05/1992),2015,10,35241000,12297000,47538000
Georgien (ab 05/1992),2015,11,32275000,12127000,44402000
Georgien (ab 05/1992),2015,12,24895000,5876000,30771000
Georgien (ab 05/1992),2016,1,19736000,3589000,23325000
Georgien (ab 05/1992),2016,2,23242000,6291000,29533000
Georgien (ab 05/1992),2016,3,27148000,3979000,31127000
Georgien (ab 05/1992),2016,4,23806000,5388000,29194000
Georgien (ab 05/1992),2016,5,23107000,5187000,28294000
Georgien (ab 05/1992),2016,6,31859000,4925000,36784000
Georgien (ab 05/1992),2016,7,30658000,7282000,37940000
Georgien (ab 05/1992),2016,8,35145000,7075000,42220000
Georgien (ab 05/1992),2016,9,27109000,10632000,37741000
Georgien (ab 05/1992),2016,10,29806000,11938000,41744000
Georgien (ab 05/1992),2016,11,37052000,14120000,51172000
Georgien (ab 05/1992),2016,12,24737000,10159000,34896000
Georgien (ab 05/1992),2017,1,24080000,6931000,31011000
Georgien (ab 05/1992),2017,2,25772000,3270000,29042000
Georgien (ab 05/1992),2017,3,31080000,12173000,43253000
Georgien (ab 05/1992),2017,4,24702000,6237000,30939000
Georgien (ab 05/1992),2017,5,31498000,5763000,37261000
Georgien (ab 05/1992),2017,6,32313000,4670000,36983000
Georgien (ab 05/1992),2017,7,31441000,7119000,38560000
Georgien (ab 05/1992),2017,8,28278000,2590000,30868000
Georgien (ab 05/1992),2017,9,29451000,3408000,32859000
Georgien (ab 05/1992),2017,10,29854000,8746000,38600000
Georgien (ab 05/1992),2017,11,29262000,9425000,38687000
Georgien (ab 05/1992),2017,12,25764000,4734000,30498000
Georgien (ab 05/1992),2018,1,23215000,4286000,27501000
Georgien (ab 05/1992),2018,2,26422000,3807000,30229000
Georgien (ab 05/1992),2018,3,34907000,11859000,46766000
Georgien (ab 05/1992),2018,4,33048000,9900000,42948000
Georgien (ab 05/1992),2018,5,29777000,3308000,33085000
Georgien (ab 05/1992),2018,6,31794000,4057000,35851000
Georgien (ab 05/1992),2018,7,31403000,4230000,35633000
Georgien (ab 05/1992),2018,8,28603000,8237000,36840000
Georgien (ab 05/1992),2018,9,29180000,6506000,35686000
Georgien (ab 05/1992),2018,10,30388000,5090000,35478000
Georgien (ab 05/1992),2018,11,33453000,6203000,39656000
Georgien (ab 05/1992),2018,12,26894000,5099000,31993000
Georgien (ab 05/1992),2019,1,26008000,5539000,31547000
Georgien (ab 05/1992),2019,2,25310000,5524000,30834000
Georgien (ab 05/1992),2019,3,52242000,4019000,56261000
Georgien (ab 05/1992),2019,4,29332000,4656000,33988000
Georgien (ab 05/1992),2019,5,32402000,4539000,36941000
Georgien (ab 05/1992),2019,6,31594000,4234000,35828000
Georgien (ab 05/1992),2019,7,36682000,4596000,41278000
Georgien (ab 05/1992),2019,8,32927000,3595000,36522000
Georgien (ab 05/1992),2019,9,34908000,4663000,39571000
Georgien (ab 05/1992),2019,10,37482000,6680000,44162000
Georgien (ab 05/1992),2019,11,33869000,7005000,40874000
Georgien (ab 05/1992),2019,12,30683000,4629000,35312000
Georgien (ab 05/1992),2020,1,30256000,5919000,36175000
Georgien (ab 05/1992),2020,2,33111000,3626000,36737000
Georgien (ab 05/1992),2020,3,29625000,5086000,34711000
Georgien (ab 05/1992),2020,4,26482000,3942000,30424000
Georgien (ab 05/1992),2020,5,17592000,6121000,23713000
Georgien (ab 05/1992),2020,6,23052000,3573000,26625000
Georgien (ab 05/1992),2020,7,28312000,3737000,32049000
Georgien (ab 05/1992),2020,8,24608000,4104000,28712000
Georgien (ab 05/1992),2020,9,26544000,9067000,35611000
Georgien (ab 05/1992),2020,10,27032000,10057000,37089000
Georgien (ab 05/1992),2020,11,26517000,9210000,35727000
Georgien (ab 05/1992),2020,12,22797000,9257000,32054000
Georgien (ab 05/1992),2021,1,20327000,6415000,26742000
Georgien (ab 05/1992),2021,2,25673000,6505000,32178000
Georgien (ab 05/1992),2021,3,31106000,7273000,38379000
Georgien (ab 05/1992),2021,4,29730000,6248000,35978000
Georgien (ab 05/1992),2021,5,24458000,6708000,31166000
Georgien (ab 05/1992),2021,6,33621000,7966000,41587000
Georgien (ab 05/1992),2021,7,30805000,7717000,38522000
Georgien (ab 05/1992),2021,8,37338000,6293000,43631000
Georgien (ab 05/1992),2021,9,38832000,7456000,46288000
Georgien (ab 05/1992),2021,10,38417000,11507000,49924000
Georgien (ab 05/1992),2021,11,37642000,10009000,47651000
Georgien (ab 05/1992),2021,12,32005000,11058000,43063000
Georgien (ab 05/1992),2022,1,27428000,7993000,35421000
Georgien (ab 05/1992),2022,2,32514000,7414000,39928000
Georgien (ab 05/1992),2022,3,36826000,10138000,46964000
Georgien (ab 05/1992),2022,4,41315000,8696000,50011000
Georgien (ab 05/1992),2022,5,35223000,8495000,43718000
Georgien (ab 05/1992),2022,6,42423000,9029000,51452000
Georgien (ab 05/1992),2022,7,48460000,6696000,55156000
Georgien (ab 05/1992),2022,8,54921000,10032000,64953000
Georgien (ab 05/1992),2022,9,69450000,6216000,75666000
Georgien (ab 05/1992),2022,10,63518000,8699000,72217000
Georgien (ab 05/1992),2022,11,69099000,9732000,78831000
Georgien (ab 05/1992),2022,12,62361000,9959000,72320000
Georgien (ab 05/1992),2023,1,50408000,7810000,58218000
Georgien (ab 05/1992),2023,2,60942000,9370000,70312000
Georgien (ab 05/1992),2023,3,75614000,9254000,84868000
Georgien (ab 05/1992),2023,4,61935000,8227000,70162000
Georgien (ab 05/1992),2023,5,69494000,6799000,76293000
Georgien (ab 05/1992),2023,6,68766000,8292000,77058000
Georgien (ab 05/1992),2023,7,62212000,6512000,68724000
Georgien (ab 05/1992),2023,8,73631000,4910000,78541000
Georgien (ab 05/1992),2023,9,65556000,4980000,70536000
Georgien (ab 05/1992),2023,10,69984000,6895000,76879000
Georgien (ab 05/1992),2023,11,81264000,8980000,90244000
Georgien (ab 05/1992),2023,12,75954000,17026000,92980000
Georgien (ab 05/1992),2024,1,57521000,6439000,63960000
Georgien (ab 05/1992),2024,2,77891000,6011000,83902000
Georgien (ab 05/1992),2024,3,94813000,7546000,102359000
Georgien (ab 05/1992),2024,4,74820000,7889000,82709000
Georgien (ab 05/1992),2024,5,79165000,7981000,87146000
Georgien (ab 05/1992),2024,6,86373000,6917000,93290000
Georgien (ab 05/1992),2024,7,102854000,8641000,111495000
Georgien (ab 05/1992),2024,8,108270000,7687000,115957000
Georgien (ab 05/1992),2024,9,93491000,5802000,99293000
Georgien (ab 05/1992),2024,10,93651000,6181000,99832000
Georgien (ab 05/1992),2024,11,95347000,7278000,102625000
Georgien (ab 05/1992),2024,12,66540000,6332000,72872000
Ghana,2008,1,17086000,7693000,24779000
Ghana,2008,2,13093000,9752000,22845000
Ghana,2008,3,14398000,6848000,21246000
Ghana,2008,4,12661000,9375000,22036000
Ghana,2008,5,12408000,5874000,18282000
Ghana,2008,6,14046000,7847000,21893000
Ghana,2008,7,23326000,8291000,31617000
Ghana,2008,8,21453000,11071000,32524000
Ghana,2008,9,16916000,6127000,23043000
Ghana,2008,10,16782000,10118000,26900000
Ghana,2008,11,17000000,9065000,26065000
Ghana,2008,12,13159000,6750000,19909000
Ghana,2009,1,17301000,7317000,24618000
Ghana,2009,2,14586000,8596000,23182000
Ghana,2009,3,11829000,11914000,23743000
Ghana,2009,4,13646000,11181000,24827000
Ghana,2009,5,11418000,10880000,22298000
Ghana,2009,6,16281000,8643000,24924000
Ghana,2009,7,33159000,10825000,43984000
Ghana,2009,8,17471000,6318000,23789000
Ghana,2009,9,16365000,7925000,24290000
Ghana,2009,10,17528000,7144000,24672000
Ghana,2009,11,19779000,10948000,30727000
Ghana,2009,12,20338000,8730000,29068000
Ghana,2010,1,14119000,8532000,22651000
Ghana,2010,2,10627000,9250000,19877000
Ghana,2010,3,19549000,13739000,33288000
Ghana,2010,4,16916000,12298000,29214000
Ghana,2010,5,16335000,13635000,29970000
Ghana,2010,6,16749000,14108000,30857000
Ghana,2010,7,18826000,10414000,29240000
Ghana,2010,8,22837000,9644000,32481000
Ghana,2010,9,20181000,16831000,37012000
Ghana,2010,10,16130000,14269000,30399000
Ghana,2010,11,19741000,12944000,32685000
Ghana,2010,12,16492000,12519000,29011000
Ghana,2011,1,17956000,11593000,29549000
Ghana,2011,2,17780000,10654000,28434000
Ghana,2011,3,24762000,12027000,36789000
Ghana,2011,4,16969000,14756000,31725000
Ghana,2011,5,19449000,15872000,35321000
Ghana,2011,6,20528000,11621000,32149000
Ghana,2011,7,22894000,6258000,29152000
Ghana,2011,8,22247000,11277000,33524000
Ghana,2011,9,27648000,9112000,36760000
Ghana,2011,10,21854000,16126000,37980000
Ghana,2011,11,24988000,10425000,35413000
Ghana,2011,12,39342000,8088000,47430000
Ghana,2012,1,28917000,15818000,44735000
Ghana,2012,2,21432000,19539000,40971000
Ghana,2012,3,29548000,51384000,80932000
Ghana,2012,4,21801000,14131000,35932000
Ghana,2012,5,24364000,16325000,40689000
Ghana,2012,6,27339000,12269000,39608000
Ghana,2012,7,47069000,15302000,62371000
Ghana,2012,8,28509000,19650000,48159000
Ghana,2012,9,23054000,18381000,41435000
Ghana,2012,10,28315000,16072000,44387000
Ghana,2012,11,26559000,125875000,152434000
Ghana,2012,12,21844000,10954000,32798000
Ghana,2013,1,19309000,17908000,37217000
Ghana,2013,2,20767000,14782000,35549000
Ghana,2013,3,22213000,16037000,38250000
Ghana,2013,4,27684000,21948000,49632000
Ghana,2013,5,49897000,13481000,63378000
Ghana,2013,6,25429000,15974000,41403000
Ghana,2013,7,32949000,79466000,112415000
Ghana,2013,8,19045000,76166000,95211000
Ghana,2013,9,22302000,71194000,93496000
Ghana,2013,10,21075000,13205000,34280000
Ghana,2013,11,20479000,18217000,38696000
Ghana,2013,12,30858000,12568000,43426000
Ghana,2014,1,20844000,15679000,36523000
Ghana,2014,2,15948000,20618000,36566000
Ghana,2014,3,25339000,17905000,43244000
Ghana,2014,4,30937000,11885000,42822000
Ghana,2014,5,37344000,16205000,53549000
Ghana,2014,6,14644000,14718000,29362000
Ghana,2014,7,16911000,15587000,32498000
Ghana,2014,8,15726000,15870000,31596000
Ghana,2014,9,15707000,19422000,35129000
Ghana,2014,10,24814000,25461000,50275000
Ghana,2014,11,21208000,17332000,38540000
Ghana,2014,12,24507000,14065000,38572000
Ghana,2015,1,28098000,20593000,48691000
Ghana,2015,2,31725000,19142000,50867000
Ghana,2015,3,18829000,22156000,40985000
Ghana,2015,4,18549000,25757000,44306000
Ghana,2015,5,22149000,17637000,39786000
Ghana,2015,6,19859000,23937000,43796000
Ghana,2015,7,23370000,23568000,46938000
Ghana,2015,8,14973000,23303000,38276000
Ghana,2015,9,19666000,18119000,37785000
Ghana,2015,10,20865000,21726000,42591000
Ghana,2015,11,20868000,29159000,50027000
Ghana,2015,12,24572000,27235000,51807000
Ghana,2016,1,17965000,15580000,33545000
Ghana,2016,2,29158000,39321000,68479000
Ghana,2016,3,31127000,17050000,48177000
Ghana,2016,4,22007000,14576000,36583000
Ghana,2016,5,35247000,26900000,62147000
Ghana,2016,6,35968000,28783000,64751000
Ghana,2016,7,22122000,17795000,39917000
Ghana,2016,8,23052000,13286000,36338000
Ghana,2016,9,19399000,24378000,43777000
Ghana,2016,10,19963000,24359000,44322000
Ghana,2016,11,23888000,17948000,41836000
Ghana,2016,12,21946000,41445000,63391000
Ghana,2017,1,16572000,13863000,30435000
Ghana,2017,2,17418000,19523000,36941000
Ghana,2017,3,26177000,13313000,39490000
Ghana,2017,4,20152000,10233000,30385000
Ghana,2017,5,24344000,15136000,39480000
Ghana,2017,6,28866000,16504000,45370000
Ghana,2017,7,17360000,15607000,32967000
Ghana,2017,8,20606000,24191000,44797000
Ghana,2017,9,29267000,15864000,45131000
Ghana,2017,10,19618000,32648000,52266000
Ghana,2017,11,21300000,19302000,40602000
Ghana,2017,12,23805000,19300000,43105000
Ghana,2018,1,20736000,24413000,45149000
Ghana,2018,2,19434000,20525000,39959000
Ghana,2018,3,19321000,16897000,36218000
Ghana,2018,4,14185000,21938000,36123000
Ghana,2018,5,20249000,17001000,37250000
Ghana,2018,6,20298000,21934000,42232000
Ghana,2018,7,24732000,28154000,52886000
Ghana,2018,8,18102000,83220000,101322000
Ghana,2018,9,23245000,27913000,51158000
Ghana,2018,10,17822000,83053000,100875000
Ghana,2018,11,18498000,22545000,41043000
Ghana,2018,12,13643000,27973000,41616000
Ghana,2019,1,13083000,14623000,27706000
Ghana,2019,2,19386000,15914000,35300000
Ghana,2019,3,17195000,23927000,41122000
Ghana,2019,4,25853000,20950000,46803000
Ghana,2019,5,25559000,27304000,52863000
Ghana,2019,6,19448000,18275000,37723000
Ghana,2019,7,23478000,17378000,40856000
Ghana,2019,8,15690000,19467000,35157000
Ghana,2019,9,19185000,80051000,99236000
Ghana,2019,10,22756000,17905000,40661000
Ghana,2019,11,19883000,21359000,41242000
Ghana,2019,12,18235000,16900000,35135000
Ghana,2020,1,14460000,22049000,36509000
Ghana,2020,2,20487000,16922000,37409000
Ghana,2020,3,26710000,29196000,55906000
Ghana,2020,4,19225000,22798000,42023000
Ghana,2020,5,15357000,22117000,37474000
Ghana,2020,6,20778000,24424000,45202000
Ghana,2020,7,20885000,27437000,48322000
Ghana,2020,8,22152000,21166000,43318000
Ghana,2020,9,29304000,19947000,49251000
Ghana,2020,10,22412000,24191000,46603000
Ghana,2020,11,24277000,21034000,45311000
Ghana,2020,12,23836000,46788000,70624000
Ghana,2021,1,21726000,24145000,45871000
Ghana,2021,2,37398000,17617000,55015000
Ghana,2021,3,35504000,23781000,59285000
Ghana,2021,4,31059000,22166000,53225000
Ghana,2021,5,21224000,28725000,49949000
Ghana,2021,6,34390000,26234000,60624000
Ghana,2021,7,31319000,26644000,57963000
Ghana,2021,8,25236000,22453000,47689000
Ghana,2021,9,29967000,22247000,52214000
Ghana,2021,10,30794000,36414000,67208000
Ghana,2021,11,38754000,25916000,64670000
Ghana,2021,12,21802000,8521000,30323000
Ghana,2022,1,27312000,31644000,58956000
Ghana,2022,2,21292000,18389000,39681000
Ghana,2022,3,21485000,25629000,47114000
Ghana,2022,4,19186000,27693000,46879000
Ghana,2022,5,28589000,66835000,95424000
Ghana,2022,6,31243000,38977000,70220000
Ghana,2022,7,22910000,26198000,49108000
Ghana,2022,8,22873000,21152000,44025000
Ghana,2022,9,25071000,21585000,46656000
Ghana,2022,10,20124000,21613000,41737000
Ghana,2022,11,23531000,99318000,122849000
Ghana,2022,12,28982000,27463000,56445000
Ghana,2023,1,19171000,18781000,37952000
Ghana,2023,2,19330000,19858000,39188000
Ghana,2023,3,21751000,28998000,50749000
Ghana,2023,4,20072000,21249000,41321000
Ghana,2023,5,24079000,14671000,38750000
Ghana,2023,6,26090000,16711000,42801000
Ghana,2023,7,20160000,19460000,39620000
Ghana,2023,8,19457000,19578000,39035000
Ghana,2023,9,21439000,22166000,43605000
Ghana,2023,10,18427000,22239000,40666000
Ghana,2023,11,19473000,23738000,43211000
Ghana,2023,12,22154000,14223000,36377000
Ghana,2024,1,27603000,15940000,43543000
Ghana,2024,2,18755000,27121000,45876000
Ghana,2024,3,17327000,21364000,38691000
Ghana,2024,4,20898000,31926000,52824000
Ghana,2024,5,25576000,19724000,45300000
Ghana,2024,6,25979000,11178000,37157000
Ghana,2024,7,25994000,64054000,90048000
Ghana,2024,8,22338000,36960000,59298000
Ghana,2024,9,29002000,20296000,49298000
Ghana,2024,10,35782000,19780000,55562000
Ghana,2024,11,25767000,32934000,58701000
Ghana,2024,12,22978000,26637000,49615000
Gibraltar,2008,1,4221000,33000,4254000
Gibraltar,2008,2,2621000,18000,2639000
Gibraltar,2008,3,2551000,2000,2553000
Gibraltar,2008,4,28391000,32000,28423000
Gibraltar,2008,5,3893000,4000,3897000
Gibraltar,2008,6,66154000,5000,66159000
Gibraltar,2008,7,20920000,7781000,28701000
Gibraltar,2008,8,1514000,29000,1543000
Gibraltar,2008,9,3411000,31000,3442000
Gibraltar,2008,10,24214000,34000,24248000
Gibraltar,2008,11,2453000,12000,2465000
Gibraltar,2008,12,1442000,3000,1445000
Gibraltar,2009,1,5092000,78000,5170000
Gibraltar,2009,2,3607000,99000,3706000
Gibraltar,2009,3,2856000,33000,2889000
Gibraltar,2009,4,637000,56000,693000
Gibraltar,2009,5,458000,11000,469000
Gibraltar,2009,6,6570000,9000,6579000
Gibraltar,2009,7,2384000,196000,2580000
Gibraltar,2009,8,2575000,15000,2590000
Gibraltar,2009,9,3508000,21000,3529000
Gibraltar,2009,10,2624000,152000,2776000
Gibraltar,2009,11,3272000,3000,3275000
Gibraltar,2009,12,1013000,119000,1132000
Gibraltar,2010,1,2708000,10000,2718000
Gibraltar,2010,2,3423000,8000,3431000
Gibraltar,2010,3,2951000,0,2951000
Gibraltar,2010,4,3309000,26000,3335000
Gibraltar,2010,5,3081000,12000,3093000
Gibraltar,2010,6,2959000,36000,2995000
Gibraltar,2010,7,2574000,33000,2607000
Gibraltar,2010,8,4099000,5000,4104000
Gibraltar,2010,9,4058000,0,4058000
Gibraltar,2010,10,87010000,9000,87019000
Gibraltar,2010,11,3039000,51000,3090000
Gibraltar,2010,12,2492000,35000,2527000
Gibraltar,2011,1,3049000,102000,3151000
Gibraltar,2011,2,3733000,0,3733000
Gibraltar,2011,3,66364000,4000,66368000
Gibraltar,2011,4,3075000,34000,3109000
Gibraltar,2011,5,3945000,9000,3954000
Gibraltar,2011,6,2524000,520000,3044000
Gibraltar,2011,7,3586000,310000,3896000
Gibraltar,2011,8,2878000,0,2878000
Gibraltar,2011,9,3165000,116000,3281000
Gibraltar,2011,10,2266000,17000,2283000
Gibraltar,2011,11,2767000,4000,2771000
Gibraltar,2011,12,2231000,18000,2249000
Gibraltar,2012,1,2393000,17000,2410000
Gibraltar,2012,2,1967000,0,1967000
Gibraltar,2012,3,886000,15000,901000
Gibraltar,2012,4,599000,17000,616000
Gibraltar,2012,5,918000,23000,941000
Gibraltar,2012,6,69100000,9000,69109000
Gibraltar,2012,7,1031000,3000,1034000
Gibraltar,2012,8,2019000,79000,2098000
Gibraltar,2012,9,1299000,8000,1307000
Gibraltar,2012,10,4997000,144000,5141000
Gibraltar,2012,11,827000,21000,848000
Gibraltar,2012,12,5204000,24000,5228000
Gibraltar,2013,1,902000,1000,903000
Gibraltar,2013,2,1552000,1000,1553000
Gibraltar,2013,3,2822000,8000,2830000
Gibraltar,2013,4,1172000,2000,1174000
Gibraltar,2013,5,746000,15000,761000
Gibraltar,2013,6,129426000,25000,129451000
Gibraltar,2013,7,910000,387000,1297000
Gibraltar,2013,8,7248000,14000,7262000
Gibraltar,2013,9,1481000,0,1481000
Gibraltar,2013,10,817000,96000,913000
Gibraltar,2013,11,1526000,7000,1533000
Gibraltar,2013,12,476000,174000,650000
Gibraltar,2014,1,7256000,1000,7257000
Gibraltar,2014,2,801000,32000,833000
Gibraltar,2014,3,521000,28000,549000
Gibraltar,2014,4,1138000,84000,1222000
Gibraltar,2014,5,845000,75000,920000
Gibraltar,2014,6,551000,20000,571000
Gibraltar,2014,7,1702000,110000,1812000
Gibraltar,2014,8,832000,91000,923000
Gibraltar,2014,9,12348000,129000,12477000
Gibraltar,2014,10,994000,4000,998000
Gibraltar,2014,11,18212000,1000,18213000
Gibraltar,2014,12,750000,15000,765000
Gibraltar,2015,1,1108000,67000,1175000
Gibraltar,2015,2,790000,1091000,1881000
Gibraltar,2015,3,3088000,32000,3120000
Gibraltar,2015,4,913000,19000,932000
Gibraltar,2015,5,1304000,30000,1334000
Gibraltar,2015,6,985000,36000,1021000
Gibraltar,2015,7,3549000,1512000,5061000
Gibraltar,2015,8,1534000,3000,1537000
Gibraltar,2015,9,1130000,12000,1142000
Gibraltar,2015,10,914000,17000,931000
Gibraltar,2015,11,1506000,147000,1653000
Gibraltar,2015,12,2626000,1000,2627000
Gibraltar,2016,1,1019000,22000,1041000
Gibraltar,2016,2,1090000,9000,1099000
Gibraltar,2016,3,1626000,18000,1644000
Gibraltar,2016,4,3838000,17000,3855000
Gibraltar,2016,5,1170000,94000,1264000
Gibraltar,2016,6,1396000,13000,1409000
Gibraltar,2016,7,1321000,242000,1563000
Gibraltar,2016,8,1447000,222000,1669000
Gibraltar,2016,9,1730000,54000,1784000
Gibraltar,2016,10,2231000,5000,2236000
Gibraltar,2016,11,2135000,4000,2139000
Gibraltar,2016,12,1330000,8000,1338000
Gibraltar,2017,1,1727000,8371000,10098000
Gibraltar,2017,2,1385000,8000,1393000
Gibraltar,2017,3,1503000,59692000,61195000
Gibraltar,2017,4,1590000,106000,1696000
Gibraltar,2017,5,187646000,105000,187751000
Gibraltar,2017,6,1643000,3000,1646000
Gibraltar,2017,7,5743000,18000,5761000
Gibraltar,2017,8,2277000,0,2277000
Gibraltar,2017,9,2464000,37000,2501000
Gibraltar,2017,10,1949000,63000,2012000
Gibraltar,2017,11,2489000,51000,2540000
Gibraltar,2017,12,2036000,13000,2049000
Gibraltar,2018,1,2182000,8000,2190000
Gibraltar,2018,2,1132000,9000,1141000
Gibraltar,2018,3,1632000,46000,1678000
Gibraltar,2018,4,1563000,13000,1576000
Gibraltar,2018,5,1601000,8000,1609000
Gibraltar,2018,6,2202000,14000,2216000
Gibraltar,2018,7,2041000,691000,2732000
Gibraltar,2018,8,1999000,4000,2003000
Gibraltar,2018,9,1986000,566000,2552000
Gibraltar,2018,10,3722000,577000,4299000
Gibraltar,2018,11,3857000,6000,3863000
Gibraltar,2018,12,3515000,306000,3821000
Gibraltar,2019,1,2627000,435000,3062000
Gibraltar,2019,2,1846000,816000,2662000
Gibraltar,2019,3,2555000,175000,2730000
Gibraltar,2019,4,1698000,500000,2198000
Gibraltar,2019,5,2110000,501000,2611000
Gibraltar,2019,6,2111000,1027000,3138000
Gibraltar,2019,7,1827000,306000,2133000
Gibraltar,2019,8,1922000,2157000,4079000
Gibraltar,2019,9,2390000,1230000,3620000
Gibraltar,2019,10,5705000,796000,6501000
Gibraltar,2019,11,1790000,2391000,4181000
Gibraltar,2019,12,3604000,386000,3990000
Gibraltar,2020,1,1629000,1089000,2718000
Gibraltar,2020,2,1533000,1027000,2560000
Gibraltar,2020,3,2335000,284000,2619000
Gibraltar,2020,4,836000,184000,1020000
Gibraltar,2020,5,873000,442000,1315000
Gibraltar,2020,6,1439000,1288000,2727000
Gibraltar,2020,7,1558000,443000,2001000
Gibraltar,2020,8,1583000,844000,2427000
Gibraltar,2020,9,1193000,1035000,2228000
Gibraltar,2020,10,1805000,694000,2499000
Gibraltar,2020,11,2322000,1730000,4052000
Gibraltar,2020,12,1620000,1636000,3256000
Gibraltar,2021,1,4238000,319000,4557000
Gibraltar,2021,2,1104000,12000,1116000
Gibraltar,2021,3,2105000,1049000,3154000
Gibraltar,2021,4,1614000,535000,2149000
Gibraltar,2021,5,8513000,1034000,9547000
Gibraltar,2021,6,1917000,79000,1996000
Gibraltar,2021,7,1735000,813000,2548000
Gibraltar,2021,8,1655000,3420000,5075000
Gibraltar,2021,9,1203000,9000,1212000
Gibraltar,2021,10,3393000,13000,3406000
Gibraltar,2021,11,1921000,8000,1929000
Gibraltar,2021,12,2121000,104000,2225000
Gibraltar,2022,1,3175000,4000,3179000
Gibraltar,2022,2,1244000,317000,1561000
Gibraltar,2022,3,6082000,257000,6339000
Gibraltar,2022,4,928000,1774000,2702000
Gibraltar,2022,5,2215000,11000,2226000
Gibraltar,2022,6,1510000,165000,1675000
Gibraltar,2022,7,31308000,42000,31350000
Gibraltar,2022,8,1716000,11000,1727000
Gibraltar,2022,9,1282000,29000,1311000
Gibraltar,2022,10,3044000,37000,3081000
Gibraltar,2022,11,2159000,35000,2194000
Gibraltar,2022,12,647000,34000,681000
Gibraltar,2023,1,2157000,25000,2182000
Gibraltar,2023,2,1728000,82000,1810000
Gibraltar,2023,3,2200000,50000,2250000
Gibraltar,2023,4,1457000,37000,1494000
Gibraltar,2023,5,2765000,8737000,11502000
Gibraltar,2023,6,1555000,105000,1660000
Gibraltar,2023,7,1635000,8000,1643000
Gibraltar,2023,8,1993000,18000,2011000
Gibraltar,2023,9,1780000,46000,1826000
Gibraltar,2023,10,3319000,27000,3346000
Gibraltar,2023,11,2432000,7000,2439000
Gibraltar,2023,12,780000,17000,797000
Gibraltar,2024,1,2103000,10000,2113000
Gibraltar,2024,2,1544000,280000,1824000
Gibraltar,2024,3,2182000,39000,2221000
Gibraltar,2024,4,23809000,64000,23873000
Gibraltar,2024,5,22476000,7000,22483000
Gibraltar,2024,6,4091000,50000,4141000
Gibraltar,2024,7,2094000,90000,2184000
Gibraltar,2024,8,2228000,60000,2288000
Gibraltar,2024,9,3410000,19000,3429000
Gibraltar,2024,10,1995000,52000,2047000
Gibraltar,2024,11,3231000,16000,3247000
Gibraltar,2024,12,1050000,20000,1070000
Grenada,2008,1,175000,13000,188000
Grenada,2008,2,91000,133000,224000
Grenada,2008,3,123000,15000,138000
Grenada,2008,4,300000,65000,365000
Grenada,2008,5,174000,55000,229000
Grenada,2008,6,223000,110000,333000
Grenada,2008,7,103000,169000,272000
Grenada,2008,8,64000,73000,137000
Grenada,2008,9,139000,56000,195000
Grenada,2008,10,242000,84000,326000
Grenada,2008,11,72000,75000,147000
Grenada,2008,12,324000,159000,483000
Grenada,2009,1,114000,1000,115000
Grenada,2009,2,36000,114000,150000
Grenada,2009,3,311000,12000,323000
Grenada,2009,4,231000,26000,257000
Grenada,2009,5,159000,92000,251000
Grenada,2009,6,124000,93000,217000
Grenada,2009,7,474000,148000,622000
Grenada,2009,8,47000,8000,55000
Grenada,2009,9,170000,82000,252000
Grenada,2009,10,72000,62000,134000
Grenada,2009,11,77000,0,77000
Grenada,2009,12,68000,72000,140000
Grenada,2010,1,57000,42000,99000
Grenada,2010,2,73000,70000,143000
Grenada,2010,3,177000,103000,280000
Grenada,2010,4,39000,75000,114000
Grenada,2010,5,87000,15000,102000
Grenada,2010,6,205000,19000,224000
Grenada,2010,7,244000,190000,434000
Grenada,2010,8,77000,104000,181000
Grenada,2010,9,201000,98000,299000
Grenada,2010,10,80000,176000,256000
Grenada,2010,11,92000,119000,211000
Grenada,2010,12,120000,51000,171000
Grenada,2011,1,32000,192000,224000
Grenada,2011,2,129000,187000,316000
Grenada,2011,3,323000,48000,371000
Grenada,2011,4,136000,3000,139000
Grenada,2011,5,76000,129000,205000
Grenada,2011,6,116000,204000,320000
Grenada,2011,7,150000,211000,361000
Grenada,2011,8,260000,303000,563000
Grenada,2011,9,163000,386000,549000
Grenada,2011,10,189000,172000,361000
Grenada,2011,11,167000,388000,555000
Grenada,2011,12,76000,174000,250000
Grenada,2012,1,183000,731000,914000
Grenada,2012,2,121000,442000,563000
Grenada,2012,3,93000,350000,443000
Grenada,2012,4,203000,46000,249000
Grenada,2012,5,356000,88000,444000
Grenada,2012,6,799000,159000,958000
Grenada,2012,7,195000,493000,688000
Grenada,2012,8,55000,59000,114000
Grenada,2012,9,310000,728000,1038000
Grenada,2012,10,128000,55000,183000
Grenada,2012,11,128000,84000,212000
Grenada,2012,12,97000,168000,265000
Grenada,2013,1,60000,791000,851000
Grenada,2013,2,17000,643000,660000
Grenada,2013,3,23000,335000,358000
Grenada,2013,4,367000,656000,1023000
Grenada,2013,5,193000,915000,1108000
Grenada,2013,6,66000,297000,363000
Grenada,2013,7,1083000,0,1083000
Grenada,2013,8,31000,70000,101000
Grenada,2013,9,54000,591000,645000
Grenada,2013,10,284000,822000,1106000
Grenada,2013,11,76000,109000,185000
Grenada,2013,12,102000,274000,376000
Grenada,2014,1,18000,424000,442000
Grenada,2014,2,61000,69000,130000
Grenada,2014,3,17000,18000,35000
Grenada,2014,4,123000,272000,395000
Grenada,2014,5,72000,1000,73000
Grenada,2014,6,48000,155000,203000
Grenada,2014,7,59000,367000,426000
Grenada,2014,8,55000,164000,219000
Grenada,2014,9,126000,146000,272000
Grenada,2014,10,180000,58000,238000
Grenada,2014,11,90000,418000,508000
Grenada,2014,12,132000,52000,184000
Grenada,2015,1,30000,8000,38000
Grenada,2015,2,54000,91000,145000
Grenada,2015,3,108000,212000,320000
Grenada,2015,4,93000,79000,172000
Grenada,2015,5,93000,72000,165000
Grenada,2015,6,85000,123000,208000
Grenada,2015,7,438000,164000,602000
Grenada,2015,8,130000,147000,277000
Grenada,2015,9,172000,109000,281000
Grenada,2015,10,241000,431000,672000
Grenada,2015,11,103000,122000,225000
Grenada,2015,12,191000,106000,297000
Grenada,2016,1,94000,120000,214000
Grenada,2016,2,177000,124000,301000
Grenada,2016,3,243000,160000,403000
Grenada,2016,4,128000,91000,219000
Grenada,2016,5,176000,349000,525000
Grenada,2016,6,31000,410000,441000
Grenada,2016,7,67000,125000,192000
Grenada,2016,8,110000,417000,527000
Grenada,2016,9,176000,114000,290000
Grenada,2016,10,331000,45000,376000
Grenada,2016,11,764000,206000,970000
Grenada,2016,12,90000,52000,142000
Grenada,2017,1,130000,195000,325000
Grenada,2017,2,172000,274000,446000
Grenada,2017,3,650000,360000,1010000
Grenada,2017,4,262000,194000,456000
Grenada,2017,5,280000,903000,1183000
Grenada,2017,6,314000,237000,551000
Grenada,2017,7,147000,429000,576000
Grenada,2017,8,233000,0,233000
Grenada,2017,9,90000,378000,468000
Grenada,2017,10,334000,32000,366000
Grenada,2017,11,1332000,146000,1478000
Grenada,2017,12,375000,54000,429000
Grenada,2018,1,268000,200000,468000
Grenada,2018,2,501000,456000,957000
Grenada,2018,3,387000,340000,727000
Grenada,2018,4,421000,180000,601000
Grenada,2018,5,532000,254000,786000
Grenada,2018,6,314000,252000,566000
Grenada,2018,7,227000,93000,320000
Grenada,2018,8,145000,159000,304000
Grenada,2018,9,314000,101000,415000
Grenada,2018,10,299000,639000,938000
Grenada,2018,11,201000,108000,309000
Grenada,2018,12,150000,88000,238000
Grenada,2019,1,165000,0,165000
Grenada,2019,2,91000,18000,109000
Grenada,2019,3,42000,30000,72000
Grenada,2019,4,264000,100000,364000
Grenada,2019,5,697000,161000,858000
Grenada,2019,6,331000,191000,522000
Grenada,2019,7,135000,136000,271000
Grenada,2019,8,70000,226000,296000
Grenada,2019,9,393000,473000,866000
Grenada,2019,10,498000,67000,565000
Grenada,2019,11,166000,75000,241000
Grenada,2019,12,224000,166000,390000
Grenada,2020,1,362000,28000,390000
Grenada,2020,2,585000,151000,736000
Grenada,2020,3,604000,84000,688000
Grenada,2020,4,219000,146000,365000
Grenada,2020,5,412000,117000,529000
Grenada,2020,6,495000,100000,595000
Grenada,2020,7,152000,79000,231000
Grenada,2020,8,123000,140000,263000
Grenada,2020,9,91000,74000,165000
Grenada,2020,10,421000,83000,504000
Grenada,2020,11,157000,53000,210000
Grenada,2020,12,286000,4000,290000
Grenada,2021,1,214000,304000,518000
Grenada,2021,2,212000,99000,311000
Grenada,2021,3,110000,10000,120000
Grenada,2021,4,118000,421000,539000
Grenada,2021,5,540000,229000,769000
Grenada,2021,6,275000,118000,393000
Grenada,2021,7,339000,120000,459000
Grenada,2021,8,99000,129000,228000
Grenada,2021,9,123000,172000,295000
Grenada,2021,10,167000,183000,350000
Grenada,2021,11,248000,17000,265000
Grenada,2021,12,168000,92000,260000
Grenada,2022,1,363000,142000,505000
Grenada,2022,2,125000,266000,391000
Grenada,2022,3,157000,53000,210000
Grenada,2022,4,65000,28000,93000
Grenada,2022,5,283000,82000,365000
Grenada,2022,6,475000,222000,697000
Grenada,2022,7,477000,49000,526000
Grenada,2022,8,326000,35000,361000
Grenada,2022,9,173000,101000,274000
Grenada,2022,10,287000,38000,325000
Grenada,2022,11,642000,10000,652000
Grenada,2022,12,221000,48000,269000
Grenada,2023,1,244000,260000,504000
Grenada,2023,2,142000,155000,297000
Grenada,2023,3,318000,113000,431000
Grenada,2023,4,271000,70000,341000
Grenada,2023,5,354000,406000,760000
Grenada,2023,6,142000,21000,163000
Grenada,2023,7,832000,118000,950000
Grenada,2023,8,323000,93000,416000
Grenada,2023,9,200000,36000,236000
Grenada,2023,10,205000,67000,272000
Grenada,2023,11,511000,144000,655000
Grenada,2023,12,342000,164000,506000
Grenada,2024,1,1071000,89000,1160000
Grenada,2024,2,159000,148000,307000
Grenada,2024,3,180000,75000,255000
Grenada,2024,4,404000,170000,574000
Grenada,2024,5,300000,64000,364000
Grenada,2024,6,514000,127000,641000
Grenada,2024,7,171000,14000,185000
Grenada,2024,8,230000,23000,253000
Grenada,2024,9,865000,163000,1028000
Grenada,2024,10,745000,96000,841000
Grenada,2024,11,55000,13000,68000
Grenada,2024,12,161000,46000,207000
Griechenland,2008,1,662449000,146572000,809021000
Griechenland,2008,2,645434000,156251000,801685000
Griechenland,2008,3,648365000,199509000,847874000
Griechenland,2008,4,695069000,223262000,918331000
Griechenland,2008,5,660347000,151481000,811828000
Griechenland,2008,6,741384000,171049000,912433000
Griechenland,2008,7,706805000,198494000,905299000
Griechenland,2008,8,555236000,156531000,711767000
Griechenland,2008,9,726375000,161534000,887909000
Griechenland,2008,10,730371000,155089000,885460000
Griechenland,2008,11,685310000,150510000,835820000
Griechenland,2008,12,535524000,152974000,688498000
Griechenland,2009,1,523233000,129075000,652308000
Griechenland,2009,2,481710000,127538000,609248000
Griechenland,2009,3,602722000,152039000,754761000
Griechenland,2009,4,514196000,146803000,660999000
Griechenland,2009,5,473749000,141817000,615566000
Griechenland,2009,6,591364000,152355000,743719000
Griechenland,2009,7,658856000,155038000,813894000
Griechenland,2009,8,483608000,135633000,619241000
Griechenland,2009,9,558791000,143436000,702227000
Griechenland,2009,10,651131000,160003000,811134000
Griechenland,2009,11,574669000,144303000,718972000
Griechenland,2009,12,493184000,138031000,631215000
Griechenland,2010,1,451565000,139444000,591009000
Griechenland,2010,2,461558000,152739000,614297000
Griechenland,2010,3,554175000,166196000,720371000
Griechenland,2010,4,423994000,161417000,585411000
Griechenland,2010,5,453805000,155792000,609597000
Griechenland,2010,6,438365000,175223000,613588000
Griechenland,2010,7,427662000,167305000,594967000
Griechenland,2010,8,386543000,139002000,525545000
Griechenland,2010,9,532573000,166405000,698978000
Griechenland,2010,10,458307000,175846000,634153000
Griechenland,2010,11,816534000,150167000,966701000
Griechenland,2010,12,440844000,162179000,603023000
Griechenland,2011,1,412204000,140230000,552434000
Griechenland,2011,2,425106000,162227000,587333000
Griechenland,2011,3,481607000,157874000,639481000
Griechenland,2011,4,404640000,171462000,576102000
Griechenland,2011,5,450281000,179099000,629380000
Griechenland,2011,6,461493000,162125000,623618000
Griechenland,2011,7,427284000,165620000,592904000
Griechenland,2011,8,386162000,145308000,531470000
Griechenland,2011,9,463535000,147737000,611272000
Griechenland,2011,10,405131000,196332000,601463000
Griechenland,2011,11,402752000,161605000,564357000
Griechenland,2011,12,352901000,152699000,505600000
Griechenland,2012,1,400017000,141800000,541817000
Griechenland,2012,2,390752000,136153000,526905000
Griechenland,2012,3,399256000,163462000,562718000
Griechenland,2012,4,373353000,155055000,528408000
Griechenland,2012,5,423209000,158500000,581709000
Griechenland,2012,6,398906000,152105000,551011000
Griechenland,2012,7,423118000,157852000,580970000
Griechenland,2012,8,378944000,136631000,515575000
Griechenland,2012,9,379214000,161696000,540910000
Griechenland,2012,10,398327000,163179000,561506000
Griechenland,2012,11,422876000,150880000,573756000
Griechenland,2012,12,349655000,136290000,485945000
Griechenland,2013,1,417285000,150598000,567883000
Griechenland,2013,2,373016000,132996000,506012000
Griechenland,2013,3,377870000,147675000,525545000
Griechenland,2013,4,395283000,159945000,555228000
Griechenland,2013,5,385466000,162670000,548136000
Griechenland,2013,6,449025000,157335000,606360000
Griechenland,2013,7,447839000,159382000,607221000
Griechenland,2013,8,350604000,135024000,485628000
Griechenland,2013,9,390000000,137743000,527743000
Griechenland,2013,10,414512000,175912000,590424000
Griechenland,2013,11,413513000,128471000,541984000
Griechenland,2013,12,313599000,138544000,452143000
Griechenland,2014,1,430476000,141032000,571508000
Griechenland,2014,2,393165000,132092000,525257000
Griechenland,2014,3,375064000,147445000,522509000
Griechenland,2014,4,393930000,143482000,537412000
Griechenland,2014,5,383169000,150023000,533192000
Griechenland,2014,6,408037000,158924000,566961000
Griechenland,2014,7,431606000,159298000,590904000
Griechenland,2014,8,322570000,141227000,463797000
Griechenland,2014,9,395268000,140414000,535682000
Griechenland,2014,10,493191000,161800000,654991000
Griechenland,2014,11,400673000,135434000,536107000
Griechenland,2014,12,426865000,135262000,562127000
Griechenland,2015,1,404078000,135032000,539110000
Griechenland,2015,2,407975000,137946000,545921000
Griechenland,2015,3,433187000,162371000,595558000
Griechenland,2015,4,381921000,150532000,532453000
Griechenland,2015,5,415448000,155758000,571206000
Griechenland,2015,6,409466000,163500000,572966000
Griechenland,2015,7,318893000,161830000,480723000
Griechenland,2015,8,286061000,145151000,431212000
Griechenland,2015,9,410106000,166199000,576305000
Griechenland,2015,10,399726000,159324000,559050000
Griechenland,2015,11,429644000,153107000,582751000
Griechenland,2015,12,369992000,150698000,520690000
Griechenland,2016,1,376655000,138317000,514972000
Griechenland,2016,2,413706000,151762000,565468000
Griechenland,2016,3,431725000,172057000,603782000
Griechenland,2016,4,445161000,175198000,620359000
Griechenland,2016,5,401722000,146451000,548173000
Griechenland,2016,6,444706000,176655000,621361000
Griechenland,2016,7,410455000,174551000,585006000
Griechenland,2016,8,350888000,156467000,507355000
Griechenland,2016,9,430729000,171562000,602291000
Griechenland,2016,10,397984000,148560000,546544000
Griechenland,2016,11,458540000,157004000,615544000
Griechenland,2016,12,401314000,143194000,544508000
Griechenland,2017,1,469220000,145330000,614550000
Griechenland,2017,2,411734000,149672000,561406000
Griechenland,2017,3,455604000,161433000,617037000
Griechenland,2017,4,396640000,173145000,569785000
Griechenland,2017,5,432674000,162243000,594917000
Griechenland,2017,6,449283000,163681000,612964000
Griechenland,2017,7,441828000,176706000,618534000
Griechenland,2017,8,380545000,152720000,533265000
Griechenland,2017,9,471183000,168798000,639981000
Griechenland,2017,10,426247000,178109000,604356000
Griechenland,2017,11,469137000,157285000,626422000
Griechenland,2017,12,423588000,148801000,572389000
Griechenland,2018,1,472268000,155687000,627955000
Griechenland,2018,2,470337000,149830000,620167000
Griechenland,2018,3,475041000,168384000,643425000
Griechenland,2018,4,429677000,184108000,613785000
Griechenland,2018,5,510900000,180049000,690949000
Griechenland,2018,6,522219000,164933000,687152000
Griechenland,2018,7,473847000,188380000,662227000
Griechenland,2018,8,417288000,157564000,574852000
Griechenland,2018,9,507755000,156819000,664574000
Griechenland,2018,10,505405000,163274000,668679000
Griechenland,2018,11,522680000,170882000,693562000
Griechenland,2018,12,440526000,136905000,577431000
Griechenland,2019,1,533536000,159358000,692894000
Griechenland,2019,2,570213000,150652000,720865000
Griechenland,2019,3,562635000,176634000,739269000
Griechenland,2019,4,456829000,183935000,640764000
Griechenland,2019,5,581327000,165086000,746413000
Griechenland,2019,6,483201000,177173000,660374000
Griechenland,2019,7,534050000,208031000,742081000
Griechenland,2019,8,454786000,160271000,615057000
Griechenland,2019,9,475024000,181986000,657010000
Griechenland,2019,10,537619000,181863000,719482000
Griechenland,2019,11,489524000,197913000,687437000
Griechenland,2019,12,398066000,182173000,580239000
Griechenland,2020,1,535975000,169835000,705810000
Griechenland,2020,2,521133000,180661000,701794000
Griechenland,2020,3,483093000,183767000,666860000
Griechenland,2020,4,409538000,207114000,616652000
Griechenland,2020,5,412641000,173408000,586049000
Griechenland,2020,6,517655000,205131000,722786000
Griechenland,2020,7,474692000,204451000,679143000
Griechenland,2020,8,441596000,175965000,617561000
Griechenland,2020,9,588234000,189141000,777375000
Griechenland,2020,10,595139000,208409000,803548000
Griechenland,2020,11,559548000,173856000,733404000
Griechenland,2020,12,515637000,169505000,685142000
Griechenland,2021,1,539695000,192945000,732640000
Griechenland,2021,2,513667000,226131000,739798000
Griechenland,2021,3,639474000,247704000,887178000
Griechenland,2021,4,539465000,226144000,765609000
Griechenland,2021,5,520192000,252435000,772627000
Griechenland,2021,6,627930000,249309000,877239000
Griechenland,2021,7,625175000,262658000,887833000
Griechenland,2021,8,561218000,217584000,778802000
Griechenland,2021,9,683809000,202518000,886327000
Griechenland,2021,10,580869000,243529000,824398000
Griechenland,2021,11,693803000,262877000,956680000
Griechenland,2021,12,597238000,207848000,805086000
Griechenland,2022,1,627063000,238228000,865291000
Griechenland,2022,2,602695000,215890000,818585000
Griechenland,2022,3,804518000,291261000,1095779000
Griechenland,2022,4,540752000,253258000,794010000
Griechenland,2022,5,686537000,270700000,957237000
Griechenland,2022,6,814805000,281452000,1096257000
Griechenland,2022,7,722195000,271132000,993327000
Griechenland,2022,8,677665000,232312000,909977000
Griechenland,2022,9,939655000,250049000,1189704000
Griechenland,2022,10,695779000,256431000,952210000
Griechenland,2022,11,720134000,259375000,979509000
Griechenland,2022,12,717640000,249539000,967179000
Griechenland,2023,1,732619000,250724000,983343000
Griechenland,2023,2,710698000,277370000,988068000
Griechenland,2023,3,813651000,323106000,1136757000
Griechenland,2023,4,607247000,258161000,865408000
Griechenland,2023,5,660692000,295054000,955746000
Griechenland,2023,6,740749000,304051000,1044800000
Griechenland,2023,7,681237000,289299000,970536000
Griechenland,2023,8,641573000,217705000,859278000
Griechenland,2023,9,651541000,247178000,898719000
Griechenland,2023,10,703024000,260755000,963779000
Griechenland,2023,11,873396000,276203000,1149599000
Griechenland,2023,12,519317000,256418000,775735000
Griechenland,2024,1,751231000,273176000,1024407000
Griechenland,2024,2,722977000,280342000,1003319000
Griechenland,2024,3,708014000,344979000,1052993000
Griechenland,2024,4,808180000,337319000,1145499000
Griechenland,2024,5,803989000,311353000,1115342000
Griechenland,2024,6,671245000,293884000,965129000
Griechenland,2024,7,738722000,332208000,1070930000
Griechenland,2024,8,596339000,240409000,836748000
Griechenland,2024,9,710960000,275859000,986819000
Griechenland,2024,10,734127000,256909000,991036000
Griechenland,2024,11,800129000,242277000,1042406000
Griechenland,2024,12,637259000,255812000,893071000
Grönland,2008,1,115000,1822000,1937000
Grönland,2008,2,140000,1520000,1660000
Grönland,2008,3,140000,1218000,1358000
Grönland,2008,4,389000,1720000,2109000
Grönland,2008,5,291000,1727000,2018000
Grönland,2008,6,216000,1766000,1982000
Grönland,2008,7,1553000,1220000,2773000
Grönland,2008,8,418000,1774000,2192000
Grönland,2008,9,241000,1851000,2092000
Grönland,2008,10,168000,3393000,3561000
Grönland,2008,11,142000,1346000,1488000
Grönland,2008,12,407000,1528000,1935000
Grönland,2009,1,151000,916000,1067000
Grönland,2009,2,130000,1071000,1201000
Grönland,2009,3,186000,1386000,1572000
Grönland,2009,4,5395000,1643000,7038000
Grönland,2009,5,1901000,1863000,3764000
Grönland,2009,6,208000,1215000,1423000
Grönland,2009,7,189000,1469000,1658000
Grönland,2009,8,299000,942000,1241000
Grönland,2009,9,169000,1668000,1837000
Grönland,2009,10,187000,1094000,1281000
Grönland,2009,11,93000,1257000,1350000
Grönland,2009,12,66000,990000,1056000
Grönland,2010,1,556000,1022000,1578000
Grönland,2010,2,144000,1033000,1177000
Grönland,2010,3,321000,1026000,1347000
Grönland,2010,4,86000,681000,767000
Grönland,2010,5,265000,903000,1168000
Grönland,2010,6,445000,613000,1058000
Grönland,2010,7,224000,850000,1074000
Grönland,2010,8,568000,1090000,1658000
Grönland,2010,9,119000,3355000,3474000
Grönland,2010,10,209000,1097000,1306000
Grönland,2010,11,110000,1362000,1472000
Grönland,2010,12,54000,1195000,1249000
Grönland,2011,1,50000,884000,934000
Grönland,2011,2,188000,181000,369000
Grönland,2011,3,226000,2314000,2540000
Grönland,2011,4,716000,846000,1562000
Grönland,2011,5,282000,766000,1048000
Grönland,2011,6,183000,896000,1079000
Grönland,2011,7,183000,937000,1120000
Grönland,2011,8,260000,1106000,1366000
Grönland,2011,9,132000,1451000,1583000
Grönland,2011,10,1757000,1149000,2906000
Grönland,2011,11,109000,1248000,1357000
Grönland,2011,12,32000,1314000,1346000
Grönland,2012,1,125000,1009000,1134000
Grönland,2012,2,198000,2717000,2915000
Grönland,2012,3,160000,800000,960000
Grönland,2012,4,244000,911000,1155000
Grönland,2012,5,1664000,717000,2381000
Grönland,2012,6,139000,1305000,1444000
Grönland,2012,7,310000,1407000,1717000
Grönland,2012,8,941000,1358000,2299000
Grönland,2012,9,327000,787000,1114000
Grönland,2012,10,293000,1002000,1295000
Grönland,2012,11,193000,1170000,1363000
Grönland,2012,12,87000,937000,1024000
Grönland,2013,1,131000,1066000,1197000
Grönland,2013,2,393000,1474000,1867000
Grönland,2013,3,367000,1562000,1929000
Grönland,2013,4,423000,1163000,1586000
Grönland,2013,5,382000,3664000,4046000
Grönland,2013,6,399000,5559000,5958000
Grönland,2013,7,903000,4702000,5605000
Grönland,2013,8,345000,2087000,2432000
Grönland,2013,9,364000,1664000,2028000
Grönland,2013,10,300000,1795000,2095000
Grönland,2013,11,628000,1715000,2343000
Grönland,2013,12,172000,1435000,1607000
Grönland,2014,1,313000,1641000,1954000
Grönland,2014,2,402000,830000,1232000
Grönland,2014,3,427000,979000,1406000
Grönland,2014,4,379000,1459000,1838000
Grönland,2014,5,452000,2156000,2608000
Grönland,2014,6,414000,4279000,4693000
Grönland,2014,7,610000,2488000,3098000
Grönland,2014,8,328000,1209000,1537000
Grönland,2014,9,595000,1461000,2056000
Grönland,2014,10,905000,1257000,2162000
Grönland,2014,11,472000,1724000,2196000
Grönland,2014,12,447000,1397000,1844000
Grönland,2015,1,533000,1716000,2249000
Grönland,2015,2,487000,1383000,1870000
Grönland,2015,3,608000,1345000,1953000
Grönland,2015,4,5085000,625000,5710000
Grönland,2015,5,345000,224000,569000
Grönland,2015,6,834000,3107000,3941000
Grönland,2015,7,688000,2405000,3093000
Grönland,2015,8,524000,1776000,2300000
Grönland,2015,9,530000,1496000,2026000
Grönland,2015,10,662000,1231000,1893000
Grönland,2015,11,793000,1757000,2550000
Grönland,2015,12,359000,1622000,1981000
Grönland,2016,1,548000,1649000,2197000
Grönland,2016,2,606000,1445000,2051000
Grönland,2016,3,2470000,914000,3384000
Grönland,2016,4,631000,978000,1609000
Grönland,2016,5,675000,1228000,1903000
Grönland,2016,6,711000,2403000,3114000
Grönland,2016,7,810000,3554000,4364000
Grönland,2016,8,1340000,1615000,2955000
Grönland,2016,9,7571000,1175000,8746000
Grönland,2016,10,616000,1410000,2026000
Grönland,2016,11,548000,1463000,2011000
Grönland,2016,12,468000,1166000,1634000
Grönland,2017,1,905000,836000,1741000
Grönland,2017,2,512000,736000,1248000
Grönland,2017,3,694000,153000,847000
Grönland,2017,4,692000,1959000,2651000
Grönland,2017,5,575000,496000,1071000
Grönland,2017,6,954000,1205000,2159000
Grönland,2017,7,892000,2908000,3800000
Grönland,2017,8,1026000,2835000,3861000
Grönland,2017,9,931000,1024000,1955000
Grönland,2017,10,603000,1455000,2058000
Grönland,2017,11,755000,450000,1205000
Grönland,2017,12,654000,548000,1202000
Grönland,2018,1,798000,221000,1019000
Grönland,2018,2,638000,69000,707000
Grönland,2018,3,515000,57000,572000
Grönland,2018,4,723000,127000,850000
Grönland,2018,5,1082000,1037000,2119000
Grönland,2018,6,772000,4059000,4831000
Grönland,2018,7,1200000,1589000,2789000
Grönland,2018,8,1227000,1591000,2818000
Grönland,2018,9,537000,582000,1119000
Grönland,2018,10,980000,769000,1749000
Grönland,2018,11,660000,416000,1076000
Grönland,2018,12,501000,106000,607000
Grönland,2019,1,626000,451000,1077000
Grönland,2019,2,528000,149000,677000
Grönland,2019,3,847000,67000,914000
Grönland,2019,4,933000,185000,1118000
Grönland,2019,5,1118000,546000,1664000
Grönland,2019,6,639000,3668000,4307000
Grönland,2019,7,791000,2557000,3348000
Grönland,2019,8,869000,315000,1184000
Grönland,2019,9,769000,152000,921000
Grönland,2019,10,899000,821000,1720000
Grönland,2019,11,4906000,563000,5469000
Grönland,2019,12,469000,693000,1162000
Grönland,2020,1,800000,227000,1027000
Grönland,2020,2,2766000,6787000,9553000
Grönland,2020,3,730000,1874000,2604000
Grönland,2020,4,721000,2852000,3573000
Grönland,2020,5,836000,2491000,3327000
Grönland,2020,6,1016000,7719000,8735000
Grönland,2020,7,1207000,71000,1278000
Grönland,2020,8,1085000,7696000,8781000
Grönland,2020,9,536000,543000,1079000
Grönland,2020,10,981000,7667000,8648000
Grönland,2020,11,526000,946000,1472000
Grönland,2020,12,380000,6840000,7220000
Grönland,2021,1,691000,489000,1180000
Grönland,2021,2,761000,6428000,7189000
Grönland,2021,3,2070000,3486000,5556000
Grönland,2021,4,597000,2260000,2857000
Grönland,2021,5,832000,4176000,5008000
Grönland,2021,6,711000,5353000,6064000
Grönland,2021,7,1277000,3408000,4685000
Grönland,2021,8,1017000,3469000,4486000
Grönland,2021,9,909000,3947000,4856000
Grönland,2021,10,825000,4611000,5436000
Grönland,2021,11,585000,4022000,4607000
Grönland,2021,12,540000,3517000,4057000
Grönland,2022,1,723000,3910000,4633000
Grönland,2022,2,633000,2960000,3593000
Grönland,2022,3,830000,3361000,4191000
Grönland,2022,4,529000,2620000,3149000
Grönland,2022,5,1036000,3830000,4866000
Grönland,2022,6,1967000,5878000,7845000
Grönland,2022,7,988000,2922000,3910000
Grönland,2022,8,2369000,3645000,6014000
Grönland,2022,9,1135000,3155000,4290000
Grönland,2022,10,1086000,3071000,4157000
Grönland,2022,11,2127000,4340000,6467000
Grönland,2022,12,1091000,4197000,5288000
Grönland,2023,1,663000,2740000,3403000
Grönland,2023,2,556000,3123000,3679000
Grönland,2023,3,658000,3925000,4583000
Grönland,2023,4,374000,3006000,3380000
Grönland,2023,5,739000,3355000,4094000
Grönland,2023,6,1278000,8924000,10202000
Grönland,2023,7,1989000,3127000,5116000
Grönland,2023,8,1351000,4094000,5445000
Grönland,2023,9,788000,2917000,3705000
Grönland,2023,10,1107000,3328000,4435000
Grönland,2023,11,1673000,3297000,4970000
Grönland,2023,12,870000,3679000,4549000
Grönland,2024,1,878000,2730000,3608000
Grönland,2024,2,1013000,3562000,4575000
Grönland,2024,3,328000,2446000,2774000
Grönland,2024,4,1010000,3404000,4414000
Grönland,2024,5,2118000,4240000,6358000
Grönland,2024,6,1754000,6983000,8737000
Grönland,2024,7,817000,2869000,3686000
Grönland,2024,8,2458000,3077000,5535000
Grönland,2024,9,2271000,2465000,4736000
Grönland,2024,10,2026000,3106000,5132000
Grönland,2024,11,997000,856000,1853000
Grönland,2024,12,804000,5255000,6059000
Guadeloupe (bis 1996),2008,1,0,0,0
Guadeloupe (bis 1996),2008,2,0,0,0
Guadeloupe (bis 1996),2008,3,0,0,0
Guadeloupe (bis 1996),2008,4,0,0,0
Guadeloupe (bis 1996),2008,5,0,0,0
Guadeloupe (bis 1996),2008,6,0,0,0
Guadeloupe (bis 1996),2008,7,0,0,0
Guadeloupe (bis 1996),2008,8,0,0,0
Guadeloupe (bis 1996),2008,9,0,0,0
Guadeloupe (bis 1996),2008,10,0,0,0
Guadeloupe (bis 1996),2008,11,0,0,0
Guadeloupe (bis 1996),2008,12,0,0,0
Guadeloupe (bis 1996),2009,1,0,0,0
Guadeloupe (bis 1996),2009,2,0,0,0
Guadeloupe (bis 1996),2009,3,0,0,0
Guadeloupe (bis 1996),2009,4,0,0,0
Guadeloupe (bis 1996),2009,5,0,0,0
Guadeloupe (bis 1996),2009,6,0,0,0
Guadeloupe (bis 1996),2009,7,0,0,0
Guadeloupe (bis 1996),2009,8,0,0,0
Guadeloupe (bis 1996),2009,9,0,0,0
Guadeloupe (bis 1996),2009,10,0,0,0
Guadeloupe (bis 1996),2009,11,0,0,0
Guadeloupe (bis 1996),2009,12,0,0,0
Guadeloupe (bis 1996),2010,1,0,0,0
Guadeloupe (bis 1996),2010,2,0,0,0
Guadeloupe (bis 1996),2010,3,0,0,0
Guadeloupe (bis 1996),2010,4,0,0,0
Guadeloupe (bis 1996),2010,5,0,0,0
Guadeloupe (bis 1996),2010,6,0,0,0
Guadeloupe (bis 1996),2010,7,0,0,0
Guadeloupe (bis 1996),2010,8,0,0,0
Guadeloupe (bis 1996),2010,9,0,0,0
Guadeloupe (bis 1996),2010,10,0,0,0
Guadeloupe (bis 1996),2010,11,0,0,0
Guadeloupe (bis 1996),2010,12,0,0,0
Guadeloupe (bis 1996),2011,1,0,0,0
Guadeloupe (bis 1996),2011,2,0,0,0
Guadeloupe (bis 1996),2011,3,0,0,0
Guadeloupe (bis 1996),2011,4,0,0,0
Guadeloupe (bis 1996),2011,5,0,0,0
Guadeloupe (bis 1996),2011,6,0,0,0
Guadeloupe (bis 1996),2011,7,0,0,0
Guadeloupe (bis 1996),2011,8,0,0,0
Guadeloupe (bis 1996),2011,9,0,0,0
Guadeloupe (bis 1996),2011,10,0,0,0
Guadeloupe (bis 1996),2011,11,0,0,0
Guadeloupe (bis 1996),2011,12,0,0,0
Guadeloupe (bis 1996),2012,1,0,0,0
Guadeloupe (bis 1996),2012,2,0,0,0
Guadeloupe (bis 1996),2012,3,0,0,0
Guadeloupe (bis 1996),2012,4,0,0,0
Guadeloupe (bis 1996),2012,5,0,0,0
Guadeloupe (bis 1996),2012,6,0,0,0
Guadeloupe (bis 1996),2012,7,0,0,0
Guadeloupe (bis 1996),2012,8,0,0,0
Guadeloupe (bis 1996),2012,9,0,0,0
Guadeloupe (bis 1996),2012,10,0,0,0
Guadeloupe (bis 1996),2012,11,0,0,0
Guadeloupe (bis 1996),2012,12,0,0,0
Guadeloupe (bis 1996),2013,1,0,0,0
Guadeloupe (bis 1996),2013,2,0,0,0
Guadeloupe (bis 1996),2013,3,0,0,0
Guadeloupe (bis 1996),2013,4,0,0,0
Guadeloupe (bis 1996),2013,5,0,0,0
Guadeloupe (bis 1996),2013,6,0,0,0
Guadeloupe (bis 1996),2013,7,0,0,0
Guadeloupe (bis 1996),2013,8,0,0,0
Guadeloupe (bis 1996),2013,9,0,0,0
Guadeloupe (bis 1996),2013,10,0,0,0
Guadeloupe (bis 1996),2013,11,0,0,0
Guadeloupe (bis 1996),2013,12,0,0,0
Guadeloupe (bis 1996),2014,1,0,0,0
Guadeloupe (bis 1996),2014,2,0,0,0
Guadeloupe (bis 1996),2014,3,0,0,0
Guadeloupe (bis 1996),2014,4,0,0,0
Guadeloupe (bis 1996),2014,5,0,0,0
Guadeloupe (bis 1996),2014,6,0,0,0
Guadeloupe (bis 1996),2014,7,0,0,0
Guadeloupe (bis 1996),2014,8,0,0,0
Guadeloupe (bis 1996),2014,9,0,0,0
Guadeloupe (bis 1996),2014,10,0,0,0
Guadeloupe (bis 1996),2014,11,0,0,0
Guadeloupe (bis 1996),2014,12,0,0,0
Guadeloupe (bis 1996),2015,1,0,0,0
Guadeloupe (bis 1996),2015,2,0,0,0
Guadeloupe (bis 1996),2015,3,0,0,0
Guadeloupe (bis 1996),2015,4,0,0,0
Guadeloupe (bis 1996),2015,5,0,0,0
Guadeloupe (bis 1996),2015,6,0,0,0
Guadeloupe (bis 1996),2015,7,0,0,0
Guadeloupe (bis 1996),2015,8,0,0,0
Guadeloupe (bis 1996),2015,9,0,0,0
Guadeloupe (bis 1996),2015,10,0,0,0
Guadeloupe (bis 1996),2015,11,0,0,0
Guadeloupe (bis 1996),2015,12,0,0,0
Guadeloupe (bis 1996),2016,1,0,0,0
Guadeloupe (bis 1996),2016,2,0,0,0
Guadeloupe (bis 1996),2016,3,0,0,0
Guadeloupe (bis 1996),2016,4,0,0,0
Guadeloupe (bis 1996),2016,5,0,0,0
Guadeloupe (bis 1996),2016,6,0,0,0
Guadeloupe (bis 1996),2016,7,0,0,0
Guadeloupe (bis 1996),2016,8,0,0,0
Guadeloupe (bis 1996),2016,9,0,0,0
Guadeloupe (bis 1996),2016,10,0,0,0
Guadeloupe (bis 1996),2016,11,0,0,0
Guadeloupe (bis 1996),2016,12,0,0,0
Guadeloupe (bis 1996),2017,1,0,0,0
Guadeloupe (bis 1996),2017,2,0,0,0
Guadeloupe (bis 1996),2017,3,0,0,0
Guadeloupe (bis 1996),2017,4,0,0,0
Guadeloupe (bis 1996),2017,5,0,0,0
Guadeloupe (bis 1996),2017,6,0,0,0
Guadeloupe (bis 1996),2017,7,0,0,0
Guadeloupe (bis 1996),2017,8,0,0,0
Guadeloupe (bis 1996),2017,9,0,0,0
Guadeloupe (bis 1996),2017,10,0,0,0
Guadeloupe (bis 1996),2017,11,0,0,0
Guadeloupe (bis 1996),2017,12,0,0,0
Guadeloupe (bis 1996),2018,1,0,0,0
Guadeloupe (bis 1996),2018,2,0,0,0
Guadeloupe (bis 1996),2018,3,0,0,0
Guadeloupe (bis 1996),2018,4,0,0,0
Guadeloupe (bis 1996),2018,5,0,0,0
Guadeloupe (bis 1996),2018,6,0,0,0
Guadeloupe (bis 1996),2018,7,0,0,0
Guadeloupe (bis 1996),2018,8,0,0,0
Guadeloupe (bis 1996),2018,9,0,0,0
Guadeloupe (bis 1996),2018,10,0,0,0
Guadeloupe (bis 1996),2018,11,0,0,0
Guadeloupe (bis 1996),2018,12,0,0,0
Guadeloupe (bis 1996),2019,1,0,0,0
Guadeloupe (bis 1996),2019,2,0,0,0
Guadeloupe (bis 1996),2019,3,0,0,0
Guadeloupe (bis 1996),2019,4,0,0,0
Guadeloupe (bis 1996),2019,5,0,0,0
Guadeloupe (bis 1996),2019,6,0,0,0
Guadeloupe (bis 1996),2019,7,0,0,0
Guadeloupe (bis 1996),2019,8,0,0,0
Guadeloupe (bis 1996),2019,9,0,0,0
Guadeloupe (bis 1996),2019,10,0,0,0
Guadeloupe (bis 1996),2019,11,0,0,0
Guadeloupe (bis 1996),2019,12,0,0,0
Guadeloupe (bis 1996),2020,1,0,0,0
Guadeloupe (bis 1996),2020,2,0,0,0
Guadeloupe (bis 1996),2020,3,0,0,0
Guadeloupe (bis 1996),2020,4,0,0,0
Guadeloupe (bis 1996),2020,5,0,0,0
Guadeloupe (bis 1996),2020,6,0,0,0
Guadeloupe (bis 1996),2020,7,0,0,0
Guadeloupe (bis 1996),2020,8,0,0,0
Guadeloupe (bis 1996),2020,9,0,0,0
Guadeloupe (bis 1996),2020,10,0,0,0
Guadeloupe (bis 1996),2020,11,0,0,0
Guadeloupe (bis 1996),2020,12,0,0,0
Guadeloupe (bis 1996),2021,1,0,0,0
Guadeloupe (bis 1996),2021,2,0,0,0
Guadeloupe (bis 1996),2021,3,0,0,0
Guadeloupe (bis 1996),2021,4,0,0,0
Guadeloupe (bis 1996),2021,5,0,0,0
Guadeloupe (bis 1996),2021,6,0,0,0
Guadeloupe (bis 1996),2021,7,0,0,0
Guadeloupe (bis 1996),2021,8,0,0,0
Guadeloupe (bis 1996),2021,9,0,0,0
Guadeloupe (bis 1996),2021,10,0,0,0
Guadeloupe (bis 1996),2021,11,0,0,0
Guadeloupe (bis 1996),2021,12,0,0,0
Guadeloupe (bis 1996),2022,1,0,0,0
Guadeloupe (bis 1996),2022,2,0,0,0
Guadeloupe (bis 1996),2022,3,0,0,0
Guadeloupe (bis 1996),2022,4,0,0,0
Guadeloupe (bis 1996),2022,5,0,0,0
Guadeloupe (bis 1996),2022,6,0,0,0
Guadeloupe (bis 1996),2022,7,0,0,0
Guadeloupe (bis 1996),2022,8,0,0,0
Guadeloupe (bis 1996),2022,9,0,0,0
Guadeloupe (bis 1996),2022,10,0,0,0
Guadeloupe (bis 1996),2022,11,0,0,0
Guadeloupe (bis 1996),2022,12,0,0,0
Guadeloupe (bis 1996),2023,1,0,0,0
Guadeloupe (bis 1996),2023,2,0,0,0
Guadeloupe (bis 1996),2023,3,0,0,0
Guadeloupe (bis 1996),2023,4,0,0,0
Guadeloupe (bis 1996),2023,5,0,0,0
Guadeloupe (bis 1996),2023,6,0,0,0
Guadeloupe (bis 1996),2023,7,0,0,0
Guadeloupe (bis 1996),2023,8,0,0,0
Guadeloupe (bis 1996),2023,9,0,0,0
Guadeloupe (bis 1996),2023,10,0,0,0
Guadeloupe (bis 1996),2023,11,0,0,0
Guadeloupe (bis 1996),2023,12,0,0,0
Guadeloupe (bis 1996),2024,1,0,0,0
Guadeloupe (bis 1996),2024,2,0,0,0
Guadeloupe (bis 1996),2024,3,0,0,0
Guadeloupe (bis 1996),2024,4,0,0,0
Guadeloupe (bis 1996),2024,5,0,0,0
Guadeloupe (bis 1996),2024,6,0,0,0
Guadeloupe (bis 1996),2024,7,0,0,0
Guadeloupe (bis 1996),2024,8,0,0,0
Guadeloupe (bis 1996),2024,9,0,0,0
Guadeloupe (bis 1996),2024,10,0,0,0
Guadeloupe (bis 1996),2024,11,0,0,0
Guadeloupe (bis 1996),2024,12,0,0,0
Guam (ab 2001),2008,1,996000,0,996000
Guam (ab 2001),2008,2,291000,0,291000
Guam (ab 2001),2008,3,187000,0,187000
Guam (ab 2001),2008,4,197000,0,197000
Guam (ab 2001),2008,5,263000,13000,276000
Guam (ab 2001),2008,6,470000,2000,472000
Guam (ab 2001),2008,7,281000,11000,292000
Guam (ab 2001),2008,8,314000,8000,322000
Guam (ab 2001),2008,9,14000,2000,16000
Guam (ab 2001),2008,10,37000,0,37000
Guam (ab 2001),2008,11,253000,15000,268000
Guam (ab 2001),2008,12,142000,3000,145000
Guam (ab 2001),2009,1,546000,8000,554000
Guam (ab 2001),2009,2,57000,19000,76000
Guam (ab 2001),2009,3,254000,19000,273000
Guam (ab 2001),2009,4,87000,3000,90000
Guam (ab 2001),2009,5,44000,0,44000
Guam (ab 2001),2009,6,213000,0,213000
Guam (ab 2001),2009,7,522000,0,522000
Guam (ab 2001),2009,8,172000,15000,187000
Guam (ab 2001),2009,9,625000,0,625000
Guam (ab 2001),2009,10,187000,0,187000
Guam (ab 2001),2009,11,253000,0,253000
Guam (ab 2001),2009,12,387000,0,387000
Guam (ab 2001),2010,1,118000,0,118000
Guam (ab 2001),2010,2,209000,0,209000
Guam (ab 2001),2010,3,68000,0,68000
Guam (ab 2001),2010,4,555000,0,555000
Guam (ab 2001),2010,5,2063000,0,2063000
Guam (ab 2001),2010,6,153000,0,153000
Guam (ab 2001),2010,7,2123000,0,2123000
Guam (ab 2001),2010,8,242000,0,242000
Guam (ab 2001),2010,9,134000,0,134000
Guam (ab 2001),2010,10,333000,0,333000
Guam (ab 2001),2010,11,662000,5000,667000
Guam (ab 2001),2010,12,202000,0,202000
Guam (ab 2001),2011,1,383000,0,383000
Guam (ab 2001),2011,2,192000,24000,216000
Guam (ab 2001),2011,3,704000,0,704000
Guam (ab 2001),2011,4,254000,0,254000
Guam (ab 2001),2011,5,228000,0,228000
Guam (ab 2001),2011,6,371000,0,371000
Guam (ab 2001),2011,7,212000,0,212000
Guam (ab 2001),2011,8,138000,0,138000
Guam (ab 2001),2011,9,183000,0,183000
Guam (ab 2001),2011,10,128000,0,128000
Guam (ab 2001),2011,11,199000,0,199000
Guam (ab 2001),2011,12,264000,0,264000
Guam (ab 2001),2012,1,186000,0,186000
Guam (ab 2001),2012,2,326000,0,326000
Guam (ab 2001),2012,3,111000,0,111000
Guam (ab 2001),2012,4,205000,0,205000
Guam (ab 2001),2012,5,229000,0,229000
Guam (ab 2001),2012,6,408000,0,408000
Guam (ab 2001),2012,7,423000,0,423000
Guam (ab 2001),2012,8,511000,0,511000
Guam (ab 2001),2012,9,147000,0,147000
Guam (ab 2001),2012,10,217000,0,217000
Guam (ab 2001),2012,11,232000,0,232000
Guam (ab 2001),2012,12,383000,0,383000
Guam (ab 2001),2013,1,111000,0,111000
Guam (ab 2001),2013,2,158000,0,158000
Guam (ab 2001),2013,3,121000,0,121000
Guam (ab 2001),2013,4,533000,181000,714000
Guam (ab 2001),2013,5,265000,0,265000
Guam (ab 2001),2013,6,276000,0,276000
Guam (ab 2001),2013,7,270000,0,270000
Guam (ab 2001),2013,8,1267000,0,1267000
Guam (ab 2001),2013,9,165000,0,165000
Guam (ab 2001),2013,10,964000,0,964000
Guam (ab 2001),2013,11,382000,43000,425000
Guam (ab 2001),2013,12,267000,0,267000
Guam (ab 2001),2014,1,92000,15000,107000
Guam (ab 2001),2014,2,370000,0,370000
Guam (ab 2001),2014,3,38000,5000,43000
Guam (ab 2001),2014,4,515000,0,515000
Guam (ab 2001),2014,5,102000,0,102000
Guam (ab 2001),2014,6,207000,1000,208000
Guam (ab 2001),2014,7,167000,0,167000
Guam (ab 2001),2014,8,509000,17000,526000
Guam (ab 2001),2014,9,9000,0,9000
Guam (ab 2001),2014,10,470000,0,470000
Guam (ab 2001),2014,11,212000,0,212000
Guam (ab 2001),2014,12,153000,0,153000
Guam (ab 2001),2015,1,159000,0,159000
Guam (ab 2001),2015,2,629000,13000,642000
Guam (ab 2001),2015,3,307000,0,307000
Guam (ab 2001),2015,4,430000,0,430000
Guam (ab 2001),2015,5,71000,0,71000
Guam (ab 2001),2015,6,444000,6000,450000
Guam (ab 2001),2015,7,320000,0,320000
Guam (ab 2001),2015,8,116000,0,116000
Guam (ab 2001),2015,9,188000,2000,190000
Guam (ab 2001),2015,10,288000,0,288000
Guam (ab 2001),2015,11,150000,0,150000
Guam (ab 2001),2015,12,558000,11000,569000
Guam (ab 2001),2016,1,198000,93000,291000
Guam (ab 2001),2016,2,99000,26000,125000
Guam (ab 2001),2016,3,1400000,10000,1410000
Guam (ab 2001),2016,4,69000,0,69000
Guam (ab 2001),2016,5,75000,0,75000
Guam (ab 2001),2016,6,660000,0,660000
Guam (ab 2001),2016,7,109000,0,109000
Guam (ab 2001),2016,8,469000,0,469000
Guam (ab 2001),2016,9,290000,0,290000
Guam (ab 2001),2016,10,1203000,0,1203000
Guam (ab 2001),2016,11,115000,0,115000
Guam (ab 2001),2016,12,307000,0,307000
Guam (ab 2001),2017,1,401000,79000,480000
Guam (ab 2001),2017,2,16000,0,16000
Guam (ab 2001),2017,3,235000,21000,256000
Guam (ab 2001),2017,4,187000,0,187000
Guam (ab 2001),2017,5,401000,0,401000
Guam (ab 2001),2017,6,49000,0,49000
Guam (ab 2001),2017,7,485000,0,485000
Guam (ab 2001),2017,8,1396000,0,1396000
Guam (ab 2001),2017,9,540000,4000,544000
Guam (ab 2001),2017,10,185000,0,185000
Guam (ab 2001),2017,11,457000,0,457000
Guam (ab 2001),2017,12,40000,0,40000
Guam (ab 2001),2018,1,160000,0,160000
Guam (ab 2001),2018,2,239000,0,239000
Guam (ab 2001),2018,3,107000,0,107000
Guam (ab 2001),2018,4,1310000,0,1310000
Guam (ab 2001),2018,5,291000,6000,297000
Guam (ab 2001),2018,6,846000,1000,847000
Guam (ab 2001),2018,7,1060000,0,1060000
Guam (ab 2001),2018,8,96000,0,96000
Guam (ab 2001),2018,9,680000,0,680000
Guam (ab 2001),2018,10,425000,0,425000
Guam (ab 2001),2018,11,474000,0,474000
Guam (ab 2001),2018,12,326000,0,326000
Guam (ab 2001),2019,1,528000,0,528000
Guam (ab 2001),2019,2,100000,0,100000
Guam (ab 2001),2019,3,332000,0,332000
Guam (ab 2001),2019,4,440000,0,440000
Guam (ab 2001),2019,5,660000,1000,661000
Guam (ab 2001),2019,6,684000,0,684000
Guam (ab 2001),2019,7,580000,0,580000
Guam (ab 2001),2019,8,854000,1000,855000
Guam (ab 2001),2019,9,589000,0,589000
Guam (ab 2001),2019,10,510000,0,510000
Guam (ab 2001),2019,11,338000,0,338000
Guam (ab 2001),2019,12,625000,0,625000
Guam (ab 2001),2020,1,270000,0,270000
Guam (ab 2001),2020,2,218000,1000,219000
Guam (ab 2001),2020,3,638000,0,638000
Guam (ab 2001),2020,4,193000,0,193000
Guam (ab 2001),2020,5,17000,1000,18000
Guam (ab 2001),2020,6,408000,0,408000
Guam (ab 2001),2020,7,760000,0,760000
Guam (ab 2001),2020,8,216000,0,216000
Guam (ab 2001),2020,9,247000,46000,293000
Guam (ab 2001),2020,10,88000,0,88000
Guam (ab 2001),2020,11,137000,0,137000
Guam (ab 2001),2020,12,419000,1000,420000
Guam (ab 2001),2021,1,1182000,0,1182000
Guam (ab 2001),2021,2,1708000,28000,1736000
Guam (ab 2001),2021,3,386000,1000,387000
Guam (ab 2001),2021,4,878000,1000,879000
Guam (ab 2001),2021,5,290000,0,290000
Guam (ab 2001),2021,6,105000,0,105000
Guam (ab 2001),2021,7,1150000,0,1150000
Guam (ab 2001),2021,8,489000,0,489000
Guam (ab 2001),2021,9,780000,0,780000
Guam (ab 2001),2021,10,234000,0,234000
Guam (ab 2001),2021,11,716000,4000,720000
Guam (ab 2001),2021,12,1272000,1000,1273000
Guam (ab 2001),2022,1,456000,0,456000
Guam (ab 2001),2022,2,868000,1000,869000
Guam (ab 2001),2022,3,300000,2000,302000
Guam (ab 2001),2022,4,175000,0,175000
Guam (ab 2001),2022,5,354000,1000,355000
Guam (ab 2001),2022,6,419000,0,419000
Guam (ab 2001),2022,7,718000,7000,725000
Guam (ab 2001),2022,8,577000,0,577000
Guam (ab 2001),2022,9,1748000,0,1748000
Guam (ab 2001),2022,10,849000,0,849000
Guam (ab 2001),2022,11,52000,0,52000
Guam (ab 2001),2022,12,424000,0,424000
Guam (ab 2001),2023,1,2995000,0,2995000
Guam (ab 2001),2023,2,717000,0,717000
Guam (ab 2001),2023,3,1074000,0,1074000
Guam (ab 2001),2023,4,490000,0,490000
Guam (ab 2001),2023,5,1036000,8000,1044000
Guam (ab 2001),2023,6,692000,0,692000
Guam (ab 2001),2023,7,1487000,0,1487000
Guam (ab 2001),2023,8,499000,0,499000
Guam (ab 2001),2023,9,504000,0,504000
Guam (ab 2001),2023,10,373000,0,373000
Guam (ab 2001),2023,11,541000,0,541000
Guam (ab 2001),2023,12,16000,0,16000
Guam (ab 2001),2024,1,258000,0,258000
Guam (ab 2001),2024,2,1760000,0,1760000
Guam (ab 2001),2024,3,542000,0,542000
Guam (ab 2001),2024,4,451000,0,451000
Guam (ab 2001),2024,5,360000,38000,398000
Guam (ab 2001),2024,6,506000,62000,568000
Guam (ab 2001),2024,7,669000,3000,672000
Guam (ab 2001),2024,8,181000,2000,183000
Guam (ab 2001),2024,9,859000,0,859000
Guam (ab 2001),2024,10,34000,0,34000
Guam (ab 2001),2024,11,1162000,0,1162000
Guam (ab 2001),2024,12,296000,0,296000
Guatemala,2008,1,14234000,6054000,20288000
Guatemala,2008,2,9989000,5243000,15232000
Guatemala,2008,3,9616000,6388000,16004000
Guatemala,2008,4,12039000,9507000,21546000
Guatemala,2008,5,11535000,4768000,16303000
Guatemala,2008,6,11117000,7811000,18928000
Guatemala,2008,7,13010000,5663000,18673000
Guatemala,2008,8,11697000,10119000,21816000
Guatemala,2008,9,8801000,7069000,15870000
Guatemala,2008,10,12115000,5027000,17142000
Guatemala,2008,11,16659000,4275000,20934000
Guatemala,2008,12,12143000,3729000,15872000
Guatemala,2009,1,10977000,5519000,16496000
Guatemala,2009,2,8284000,4748000,13032000
Guatemala,2009,3,12259000,7332000,19591000
Guatemala,2009,4,14921000,6048000,20969000
Guatemala,2009,5,7802000,5618000,13420000
Guatemala,2009,6,11013000,5169000,16182000
Guatemala,2009,7,10881000,6029000,16910000
Guatemala,2009,8,8932000,4900000,13832000
Guatemala,2009,9,7886000,5745000,13631000
Guatemala,2009,10,11299000,4675000,15974000
Guatemala,2009,11,10266000,3596000,13862000
Guatemala,2009,12,21287000,4259000,25546000
Guatemala,2010,1,10932000,10536000,21468000
Guatemala,2010,2,12491000,4098000,16589000
Guatemala,2010,3,13972000,7716000,21688000
Guatemala,2010,4,13623000,7138000,20761000
Guatemala,2010,5,18474000,8420000,26894000
Guatemala,2010,6,21809000,11804000,33613000
Guatemala,2010,7,16540000,7222000,23762000
Guatemala,2010,8,18978000,8734000,27712000
Guatemala,2010,9,17106000,7053000,24159000
Guatemala,2010,10,11150000,3104000,14254000
Guatemala,2010,11,13456000,4542000,17998000
Guatemala,2010,12,13193000,3863000,17056000
Guatemala,2011,1,23318000,7752000,31070000
Guatemala,2011,2,14492000,10015000,24507000
Guatemala,2011,3,14885000,12081000,26966000
Guatemala,2011,4,15466000,15100000,30566000
Guatemala,2011,5,21298000,13255000,34553000
Guatemala,2011,6,14148000,12817000,26965000
Guatemala,2011,7,19183000,7020000,26203000
Guatemala,2011,8,16557000,8878000,25435000
Guatemala,2011,9,13349000,3585000,16934000
Guatemala,2011,10,14329000,3494000,17823000
Guatemala,2011,11,16772000,4393000,21165000
Guatemala,2011,12,17552000,6442000,23994000
Guatemala,2012,1,14350000,9713000,24063000
Guatemala,2012,2,16014000,6608000,22622000
Guatemala,2012,3,18292000,11639000,29931000
Guatemala,2012,4,14580000,17503000,32083000
Guatemala,2012,5,19921000,13081000,33002000
Guatemala,2012,6,18278000,10716000,28994000
Guatemala,2012,7,18104000,8439000,26543000
Guatemala,2012,8,17165000,15540000,32705000
Guatemala,2012,9,17335000,6577000,23912000
Guatemala,2012,10,16119000,6340000,22459000
Guatemala,2012,11,16459000,5724000,22183000
Guatemala,2012,12,15356000,5263000,20619000
Guatemala,2013,1,16536000,6265000,22801000
Guatemala,2013,2,14730000,5926000,20656000
Guatemala,2013,3,16382000,7630000,24012000
Guatemala,2013,4,16855000,12017000,28872000
Guatemala,2013,5,15411000,14328000,29739000
Guatemala,2013,6,18572000,8544000,27116000
Guatemala,2013,7,19572000,6809000,26381000
Guatemala,2013,8,15922000,5934000,21856000
Guatemala,2013,9,21662000,8038000,29700000
Guatemala,2013,10,16774000,11436000,28210000
Guatemala,2013,11,15854000,5503000,21357000
Guatemala,2013,12,17647000,10549000,28196000
Guatemala,2014,1,12642000,4369000,17011000
Guatemala,2014,2,16078000,4404000,20482000
Guatemala,2014,3,15577000,6509000,22086000
Guatemala,2014,4,15417000,9208000,24625000
Guatemala,2014,5,13637000,8536000,22173000
Guatemala,2014,6,16342000,10699000,27041000
Guatemala,2014,7,29764000,14510000,44274000
Guatemala,2014,8,17012000,15436000,32448000
Guatemala,2014,9,16277000,7240000,23517000
Guatemala,2014,10,18611000,15224000,33835000
Guatemala,2014,11,18947000,12895000,31842000
Guatemala,2014,12,18744000,12854000,31598000
Guatemala,2015,1,16598000,10592000,27190000
Guatemala,2015,2,17209000,8900000,26109000
Guatemala,2015,3,23021000,11052000,34073000
Guatemala,2015,4,22479000,9109000,31588000
Guatemala,2015,5,18886000,8155000,27041000
Guatemala,2015,6,20409000,12548000,32957000
Guatemala,2015,7,23161000,9154000,32315000
Guatemala,2015,8,22047000,8579000,30626000
Guatemala,2015,9,25723000,7274000,32997000
Guatemala,2015,10,19027000,10560000,29587000
Guatemala,2015,11,16599000,16148000,32747000
Guatemala,2015,12,15547000,5862000,21409000
Guatemala,2016,1,16385000,4064000,20449000
Guatemala,2016,2,20304000,9780000,30084000
Guatemala,2016,3,20823000,7962000,28785000
Guatemala,2016,4,20867000,9139000,30006000
Guatemala,2016,5,20010000,16221000,36231000
Guatemala,2016,6,19763000,9840000,29603000
Guatemala,2016,7,22229000,18488000,40717000
Guatemala,2016,8,25224000,8324000,33548000
Guatemala,2016,9,24210000,18346000,42556000
Guatemala,2016,10,20639000,20371000,41010000
Guatemala,2016,11,18551000,17130000,35681000
Guatemala,2016,12,29526000,6034000,35560000
Guatemala,2017,1,22298000,15865000,38163000
Guatemala,2017,2,23168000,11111000,34279000
Guatemala,2017,3,27300000,12379000,39679000
Guatemala,2017,4,22640000,11004000,33644000
Guatemala,2017,5,24407000,11656000,36063000
Guatemala,2017,6,21753000,10966000,32719000
Guatemala,2017,7,23751000,8026000,31777000
Guatemala,2017,8,27455000,15063000,42518000
Guatemala,2017,9,29497000,14454000,43951000
Guatemala,2017,10,23995000,9164000,33159000
Guatemala,2017,11,25842000,9321000,35163000
Guatemala,2017,12,22402000,5710000,28112000
Guatemala,2018,1,19827000,3788000,23615000
Guatemala,2018,2,20957000,6990000,27947000
Guatemala,2018,3,24027000,7906000,31933000
Guatemala,2018,4,19446000,8468000,27914000
Guatemala,2018,5,22158000,8947000,31105000
Guatemala,2018,6,23672000,11031000,34703000
Guatemala,2018,7,26570000,12408000,38978000
Guatemala,2018,8,23580000,7989000,31569000
Guatemala,2018,9,22774000,8375000,31149000
Guatemala,2018,10,30655000,9969000,40624000
Guatemala,2018,11,28499000,18485000,46984000
Guatemala,2018,12,20532000,8982000,29514000
Guatemala,2019,1,23802000,6709000,30511000
Guatemala,2019,2,20307000,8145000,28452000
Guatemala,2019,3,22979000,12065000,35044000
Guatemala,2019,4,22898000,13662000,36560000
Guatemala,2019,5,27977000,15395000,43372000
Guatemala,2019,6,19403000,11447000,30850000
Guatemala,2019,7,30773000,10557000,41330000
Guatemala,2019,8,26019000,10777000,36796000
Guatemala,2019,9,21119000,12811000,33930000
Guatemala,2019,10,29724000,9250000,38974000
Guatemala,2019,11,21831000,9749000,31580000
Guatemala,2019,12,17007000,8576000,25583000
Guatemala,2020,1,21567000,9476000,31043000
Guatemala,2020,2,18666000,8990000,27656000
Guatemala,2020,3,24139000,11030000,35169000
Guatemala,2020,4,23901000,13713000,37614000
Guatemala,2020,5,16539000,10693000,27232000
Guatemala,2020,6,20194000,11063000,31257000
Guatemala,2020,7,20526000,12386000,32912000
Guatemala,2020,8,13119000,9089000,22208000
Guatemala,2020,9,17747000,8112000,25859000
Guatemala,2020,10,20974000,12928000,33902000
Guatemala,2020,11,18649000,14009000,32658000
Guatemala,2020,12,22810000,13379000,36189000
Guatemala,2021,1,15441000,8909000,24350000
Guatemala,2021,2,16944000,8447000,25391000
Guatemala,2021,3,22440000,10869000,33309000
Guatemala,2021,4,17119000,9833000,26952000
Guatemala,2021,5,25781000,11802000,37583000
Guatemala,2021,6,18200000,14748000,32948000
Guatemala,2021,7,29349000,16110000,45459000
Guatemala,2021,8,22323000,15739000,38062000
Guatemala,2021,9,23333000,16121000,39454000
Guatemala,2021,10,21171000,23333000,44504000
Guatemala,2021,11,22492000,27892000,50384000
Guatemala,2021,12,21883000,22066000,43949000
Guatemala,2022,1,29711000,17488000,47199000
Guatemala,2022,2,20929000,12211000,33140000
Guatemala,2022,3,26505000,12605000,39110000
Guatemala,2022,4,20852000,32226000,53078000
Guatemala,2022,5,36332000,24529000,60861000
Guatemala,2022,6,29362000,17682000,47044000
Guatemala,2022,7,27646000,12805000,40451000
Guatemala,2022,8,27305000,36862000,64167000
Guatemala,2022,9,34120000,28299000,62419000
Guatemala,2022,10,25397000,37712000,63109000
Guatemala,2022,11,25193000,20460000,45653000
Guatemala,2022,12,26558000,30960000,57518000
Guatemala,2023,1,24783000,20301000,45084000
Guatemala,2023,2,26962000,9366000,36328000
Guatemala,2023,3,31227000,17680000,48907000
Guatemala,2023,4,21056000,28520000,49576000
Guatemala,2023,5,26586000,30739000,57325000
Guatemala,2023,6,64317000,23768000,88085000
Guatemala,2023,7,53904000,10829000,64733000
Guatemala,2023,8,33594000,20615000,54209000
Guatemala,2023,9,43661000,20540000,64201000
Guatemala,2023,10,31190000,27491000,58681000
Guatemala,2023,11,27200000,30348000,57548000
Guatemala,2023,12,25970000,19977000,45947000
Guatemala,2024,1,26841000,20739000,47580000
Guatemala,2024,2,40794000,18589000,59383000
Guatemala,2024,3,37260000,16312000,53572000
Guatemala,2024,4,32136000,23053000,55189000
Guatemala,2024,5,39489000,16183000,55672000
Guatemala,2024,6,30252000,13132000,43384000
Guatemala,2024,7,38035000,17876000,55911000
Guatemala,2024,8,36328000,20422000,56750000
Guatemala,2024,9,56779000,22980000,79759000
Guatemala,2024,10,45204000,10492000,55696000
Guatemala,2024,11,37905000,25379000,63284000
Guatemala,2024,12,58376000,9977000,68353000
Guinea,2008,1,2695000,10836000,13531000
Guinea,2008,2,2827000,10940000,13767000
Guinea,2008,3,2348000,9194000,11542000
Guinea,2008,4,2743000,10180000,12923000
Guinea,2008,5,1893000,13004000,14897000
Guinea,2008,6,2288000,6951000,9239000
Guinea,2008,7,2619000,11798000,14417000
Guinea,2008,8,4050000,6337000,10387000
Guinea,2008,9,1391000,6024000,7415000
Guinea,2008,10,6534000,6380000,12914000
Guinea,2008,11,2612000,12588000,15200000
Guinea,2008,12,2370000,7361000,9731000
Guinea,2009,1,3440000,9340000,12780000
Guinea,2009,2,1946000,10953000,12899000
Guinea,2009,3,3353000,7612000,10965000
Guinea,2009,4,1805000,4043000,5848000
Guinea,2009,5,2581000,6316000,8897000
Guinea,2009,6,1899000,6433000,8332000
Guinea,2009,7,2147000,6909000,9056000
Guinea,2009,8,1657000,3250000,4907000
Guinea,2009,9,1109000,6515000,7624000
Guinea,2009,10,2191000,8613000,10804000
Guinea,2009,11,2173000,6346000,8519000
Guinea,2009,12,1772000,5750000,7522000
Guinea,2010,1,1845000,8107000,9952000
Guinea,2010,2,1411000,4361000,5772000
Guinea,2010,3,2464000,3113000,5577000
Guinea,2010,4,1614000,3104000,4718000
Guinea,2010,5,3349000,7027000,10376000
Guinea,2010,6,2306000,5339000,7645000
Guinea,2010,7,1905000,6358000,8263000
Guinea,2010,8,2302000,9935000,12237000
Guinea,2010,9,1739000,3489000,5228000
Guinea,2010,10,1523000,3020000,4543000
Guinea,2010,11,1487000,7036000,8523000
Guinea,2010,12,2542000,5922000,8464000
Guinea,2011,1,950000,8552000,9502000
Guinea,2011,2,1671000,6587000,8258000
Guinea,2011,3,1462000,7291000,8753000
Guinea,2011,4,2581000,9703000,12284000
Guinea,2011,5,1542000,11207000,12749000
Guinea,2011,6,2211000,6260000,8471000
Guinea,2011,7,1779000,7154000,8933000
Guinea,2011,8,1633000,8567000,10200000
Guinea,2011,9,2351000,7578000,9929000
Guinea,2011,10,1539000,6992000,8531000
Guinea,2011,11,2266000,5880000,8146000
Guinea,2011,12,2986000,5630000,8616000
Guinea,2012,1,1806000,7220000,9026000
Guinea,2012,2,1426000,8992000,10418000
Guinea,2012,3,3249000,12703000,15952000
Guinea,2012,4,6663000,8693000,15356000
Guinea,2012,5,3305000,9023000,12328000
Guinea,2012,6,15281000,6185000,21466000
Guinea,2012,7,1747000,10998000,12745000
Guinea,2012,8,2409000,9395000,11804000
Guinea,2012,9,2938000,11864000,14802000
Guinea,2012,10,6343000,5661000,12004000
Guinea,2012,11,2675000,6103000,8778000
Guinea,2012,12,7483000,5237000,12720000
Guinea,2013,1,1900000,6158000,8058000
Guinea,2013,2,1890000,3490000,5380000
Guinea,2013,3,2991000,7862000,10853000
Guinea,2013,4,2061000,10195000,12256000
Guinea,2013,5,2364000,8278000,10642000
Guinea,2013,6,2149000,4889000,7038000
Guinea,2013,7,3548000,10759000,14307000
Guinea,2013,8,1270000,10176000,11446000
Guinea,2013,9,7404000,7442000,14846000
Guinea,2013,10,2503000,514000,3017000
Guinea,2013,11,1025000,4665000,5690000
Guinea,2013,12,2124000,9387000,11511000
Guinea,2014,1,1592000,7988000,9580000
Guinea,2014,2,1825000,3989000,5814000
Guinea,2014,3,1617000,7830000,9447000
Guinea,2014,4,2540000,8416000,10956000
Guinea,2014,5,1237000,10348000,11585000
Guinea,2014,6,3497000,5754000,9251000
Guinea,2014,7,3909000,5696000,9605000
Guinea,2014,8,1560000,9753000,11313000
Guinea,2014,9,2145000,9199000,11344000
Guinea,2014,10,2119000,10470000,12589000
Guinea,2014,11,2466000,6929000,9395000
Guinea,2014,12,3020000,10457000,13477000
Guinea,2015,1,6994000,9003000,15997000
Guinea,2015,2,3197000,12063000,15260000
Guinea,2015,3,5460000,14661000,20121000
Guinea,2015,4,14501000,13781000,28282000
Guinea,2015,5,2615000,10260000,12875000
Guinea,2015,6,10148000,11850000,21998000
Guinea,2015,7,6894000,10975000,17869000
Guinea,2015,8,2381000,11411000,13792000
Guinea,2015,9,10277000,9686000,19963000
Guinea,2015,10,10612000,12478000,23090000
Guinea,2015,11,8555000,10264000,18819000
Guinea,2015,12,5481000,8212000,13693000
Guinea,2016,1,7773000,9271000,17044000
Guinea,2016,2,2663000,10166000,12829000
Guinea,2016,3,4598000,11015000,15613000
Guinea,2016,4,7699000,11428000,19127000
Guinea,2016,5,9927000,11777000,21704000
Guinea,2016,6,7255000,1333000,8588000
Guinea,2016,7,12124000,2829000,14953000
Guinea,2016,8,2966000,13226000,16192000
Guinea,2016,9,12859000,6941000,19800000
Guinea,2016,10,2651000,5803000,8454000
Guinea,2016,11,7899000,6809000,14708000
Guinea,2016,12,10126000,4550000,14676000
Guinea,2017,1,8711000,8280000,16991000
Guinea,2017,2,4957000,6769000,11726000
Guinea,2017,3,10986000,6141000,17127000
Guinea,2017,4,12309000,10069000,22378000
Guinea,2017,5,5994000,6498000,12492000
Guinea,2017,6,16845000,10131000,26976000
Guinea,2017,7,8371000,8009000,16380000
Guinea,2017,8,20650000,6857000,27507000
Guinea,2017,9,2207000,2638000,4845000
Guinea,2017,10,11562000,5675000,17237000
Guinea,2017,11,8384000,12730000,21114000
Guinea,2017,12,11383000,1627000,13010000
Guinea,2018,1,12278000,9280000,21558000
Guinea,2018,2,3575000,5126000,8701000
Guinea,2018,3,12675000,9635000,22310000
Guinea,2018,4,4719000,8853000,13572000
Guinea,2018,5,14151000,9150000,23301000
Guinea,2018,6,6802000,9845000,16647000
Guinea,2018,7,11108000,10416000,21524000
Guinea,2018,8,2365000,8415000,10780000
Guinea,2018,9,6205000,10564000,16769000
Guinea,2018,10,24273000,10043000,34316000
Guinea,2018,11,7340000,5796000,13136000
Guinea,2018,12,9607000,235000,9842000
Guinea,2019,1,8536000,5727000,14263000
Guinea,2019,2,14999000,6097000,21096000
Guinea,2019,3,9134000,13971000,23105000
Guinea,2019,4,11918000,12270000,24188000
Guinea,2019,5,19451000,8072000,27523000
Guinea,2019,6,5313000,7696000,13009000
Guinea,2019,7,17340000,10895000,28235000
Guinea,2019,8,9809000,9274000,19083000
Guinea,2019,9,12687000,11852000,24539000
Guinea,2019,10,11066000,11014000,22080000
Guinea,2019,11,7948000,4034000,11982000
Guinea,2019,12,20791000,13730000,34521000
Guinea,2020,1,4097000,7788000,11885000
Guinea,2020,2,16519000,2790000,19309000
Guinea,2020,3,5732000,13312000,19044000
Guinea,2020,4,14040000,11305000,25345000
Guinea,2020,5,11869000,12864000,24733000
Guinea,2020,6,12154000,14782000,26936000
Guinea,2020,7,4548000,11837000,16385000
Guinea,2020,8,5153000,8070000,13223000
Guinea,2020,9,10201000,6342000,16543000
Guinea,2020,10,5680000,5761000,11441000
Guinea,2020,11,11860000,9666000,21526000
Guinea,2020,12,10981000,25359000,36340000
Guinea,2021,1,4452000,1874000,6326000
Guinea,2021,2,4251000,61000,4312000
Guinea,2021,3,13911000,3267000,17178000
Guinea,2021,4,4106000,8725000,12831000
Guinea,2021,5,12919000,12644000,25563000
Guinea,2021,6,7029000,9369000,16398000
Guinea,2021,7,11196000,5018000,16214000
Guinea,2021,8,13871000,11764000,25635000
Guinea,2021,9,12567000,10627000,23194000
Guinea,2021,10,3221000,13063000,16284000
Guinea,2021,11,13954000,10613000,24567000
Guinea,2021,12,13743000,7993000,21736000
Guinea,2022,1,7563000,10749000,18312000
Guinea,2022,2,8246000,14267000,22513000
Guinea,2022,3,21756000,15409000,37165000
Guinea,2022,4,4468000,9675000,14143000
Guinea,2022,5,25549000,14894000,40443000
Guinea,2022,6,4689000,16432000,21121000
Guinea,2022,7,22899000,7223000,30122000
Guinea,2022,8,27796000,20696000,48492000
Guinea,2022,9,4646000,16761000,21407000
Guinea,2022,10,19183000,12260000,31443000
Guinea,2022,11,16088000,17174000,33262000
Guinea,2022,12,26724000,7768000,34492000
Guinea,2023,1,6581000,8046000,14627000
Guinea,2023,2,23731000,11588000,35319000
Guinea,2023,3,15251000,7920000,23171000
Guinea,2023,4,11495000,4554000,16049000
Guinea,2023,5,22782000,945000,23727000
Guinea,2023,6,12405000,1442000,13847000
Guinea,2023,7,9452000,3793000,13245000
Guinea,2023,8,17152000,2905000,20057000
Guinea,2023,9,24334000,6721000,31055000
Guinea,2023,10,16430000,3157000,19587000
Guinea,2023,11,16942000,6834000,23776000
Guinea,2023,12,12510000,3147000,15657000
Guinea,2024,1,8992000,9484000,18476000
Guinea,2024,2,12929000,10752000,23681000
Guinea,2024,3,6370000,5835000,12205000
Guinea,2024,4,12607000,12049000,24656000
Guinea,2024,5,20548000,6887000,27435000
Guinea,2024,6,8610000,13268000,21878000
Guinea,2024,7,20954000,16335000,37289000
Guinea,2024,8,9789000,17144000,26933000
Guinea,2024,9,11389000,9225000,20614000
Guinea,2024,10,20117000,9830000,29947000
Guinea,2024,11,29382000,9161000,38543000
Guinea,2024,12,11571000,10440000,22011000
Guinea-Bissau,2008,1,87000,2000,89000
Guinea-Bissau,2008,2,49000,0,49000
Guinea-Bissau,2008,3,297000,0,297000
Guinea-Bissau,2008,4,465000,0,465000
Guinea-Bissau,2008,5,124000,0,124000
Guinea-Bissau,2008,6,274000,0,274000
Guinea-Bissau,2008,7,640000,0,640000
Guinea-Bissau,2008,8,46000,0,46000
Guinea-Bissau,2008,9,20000,64000,84000
Guinea-Bissau,2008,10,176000,0,176000
Guinea-Bissau,2008,11,126000,0,126000
Guinea-Bissau,2008,12,294000,0,294000
Guinea-Bissau,2009,1,135000,0,135000
Guinea-Bissau,2009,2,104000,0,104000
Guinea-Bissau,2009,3,28000,0,28000
Guinea-Bissau,2009,4,56000,0,56000
Guinea-Bissau,2009,5,65000,0,65000
Guinea-Bissau,2009,6,109000,0,109000
Guinea-Bissau,2009,7,142000,0,142000
Guinea-Bissau,2009,8,63000,0,63000
Guinea-Bissau,2009,9,170000,0,170000
Guinea-Bissau,2009,10,276000,0,276000
Guinea-Bissau,2009,11,86000,0,86000
Guinea-Bissau,2009,12,248000,0,248000
Guinea-Bissau,2010,1,218000,0,218000
Guinea-Bissau,2010,2,138000,0,138000
Guinea-Bissau,2010,3,100000,0,100000
Guinea-Bissau,2010,4,322000,0,322000
Guinea-Bissau,2010,5,165000,0,165000
Guinea-Bissau,2010,6,81000,214000,295000
Guinea-Bissau,2010,7,75000,0,75000
Guinea-Bissau,2010,8,111000,0,111000
Guinea-Bissau,2010,9,65000,0,65000
Guinea-Bissau,2010,10,75000,4000,79000
Guinea-Bissau,2010,11,575000,0,575000
Guinea-Bissau,2010,12,228000,0,228000
Guinea-Bissau,2011,1,396000,0,396000
Guinea-Bissau,2011,2,3323000,0,3323000
Guinea-Bissau,2011,3,85000,0,85000
Guinea-Bissau,2011,4,51000,2000,53000
Guinea-Bissau,2011,5,30000,0,30000
Guinea-Bissau,2011,6,55000,0,55000
Guinea-Bissau,2011,7,34000,0,34000
Guinea-Bissau,2011,8,154000,0,154000
Guinea-Bissau,2011,9,130000,0,130000
Guinea-Bissau,2011,10,67000,0,67000
Guinea-Bissau,2011,11,341000,0,341000
Guinea-Bissau,2011,12,102000,0,102000
Guinea-Bissau,2012,1,105000,0,105000
Guinea-Bissau,2012,2,85000,0,85000
Guinea-Bissau,2012,3,107000,0,107000
Guinea-Bissau,2012,4,129000,0,129000
Guinea-Bissau,2012,5,77000,0,77000
Guinea-Bissau,2012,6,31000,0,31000
Guinea-Bissau,2012,7,310000,0,310000
Guinea-Bissau,2012,8,104000,0,104000
Guinea-Bissau,2012,9,89000,0,89000
Guinea-Bissau,2012,10,146000,0,146000
Guinea-Bissau,2012,11,63000,0,63000
Guinea-Bissau,2012,12,144000,0,144000
Guinea-Bissau,2013,1,257000,0,257000
Guinea-Bissau,2013,2,68000,0,68000
Guinea-Bissau,2013,3,56000,0,56000
Guinea-Bissau,2013,4,157000,0,157000
Guinea-Bissau,2013,5,393000,0,393000
Guinea-Bissau,2013,6,57000,0,57000
Guinea-Bissau,2013,7,71000,0,71000
Guinea-Bissau,2013,8,162000,0,162000
Guinea-Bissau,2013,9,120000,0,120000
Guinea-Bissau,2013,10,69000,0,69000
Guinea-Bissau,2013,11,166000,0,166000
Guinea-Bissau,2013,12,116000,0,116000
Guinea-Bissau,2014,1,75000,0,75000
Guinea-Bissau,2014,2,87000,0,87000
Guinea-Bissau,2014,3,346000,0,346000
Guinea-Bissau,2014,4,35000,0,35000
Guinea-Bissau,2014,5,347000,0,347000
Guinea-Bissau,2014,6,110000,0,110000
Guinea-Bissau,2014,7,95000,0,95000
Guinea-Bissau,2014,8,181000,0,181000
Guinea-Bissau,2014,9,532000,0,532000
Guinea-Bissau,2014,10,337000,0,337000
Guinea-Bissau,2014,11,226000,0,226000
Guinea-Bissau,2014,12,167000,0,167000
Guinea-Bissau,2015,1,47000,0,47000
Guinea-Bissau,2015,2,147000,39000,186000
Guinea-Bissau,2015,3,124000,0,124000
Guinea-Bissau,2015,4,214000,0,214000
Guinea-Bissau,2015,5,200000,0,200000
Guinea-Bissau,2015,6,464000,0,464000
Guinea-Bissau,2015,7,236000,0,236000
Guinea-Bissau,2015,8,122000,0,122000
Guinea-Bissau,2015,9,262000,0,262000
Guinea-Bissau,2015,10,315000,0,315000
Guinea-Bissau,2015,11,171000,0,171000
Guinea-Bissau,2015,12,240000,1000,241000
Guinea-Bissau,2016,1,80000,0,80000
Guinea-Bissau,2016,2,131000,0,131000
Guinea-Bissau,2016,3,157000,0,157000
Guinea-Bissau,2016,4,237000,0,237000
Guinea-Bissau,2016,5,157000,0,157000
Guinea-Bissau,2016,6,167000,0,167000
Guinea-Bissau,2016,7,193000,0,193000
Guinea-Bissau,2016,8,211000,0,211000
Guinea-Bissau,2016,9,506000,0,506000
Guinea-Bissau,2016,10,634000,0,634000
Guinea-Bissau,2016,11,370000,0,370000
Guinea-Bissau,2016,12,271000,0,271000
Guinea-Bissau,2017,1,178000,0,178000
Guinea-Bissau,2017,2,298000,0,298000
Guinea-Bissau,2017,3,462000,0,462000
Guinea-Bissau,2017,4,381000,0,381000
Guinea-Bissau,2017,5,266000,0,266000
Guinea-Bissau,2017,6,377000,0,377000
Guinea-Bissau,2017,7,457000,0,457000
Guinea-Bissau,2017,8,206000,0,206000
Guinea-Bissau,2017,9,291000,0,291000
Guinea-Bissau,2017,10,398000,0,398000
Guinea-Bissau,2017,11,866000,0,866000
Guinea-Bissau,2017,12,467000,0,467000
Guinea-Bissau,2018,1,120000,0,120000
Guinea-Bissau,2018,2,301000,22000,323000
Guinea-Bissau,2018,3,285000,0,285000
Guinea-Bissau,2018,4,312000,0,312000
Guinea-Bissau,2018,5,403000,0,403000
Guinea-Bissau,2018,6,145000,0,145000
Guinea-Bissau,2018,7,128000,0,128000
Guinea-Bissau,2018,8,216000,105000,321000
Guinea-Bissau,2018,9,276000,0,276000
Guinea-Bissau,2018,10,210000,2000,212000
Guinea-Bissau,2018,11,238000,0,238000
Guinea-Bissau,2018,12,106000,0,106000
Guinea-Bissau,2019,1,228000,0,228000
Guinea-Bissau,2019,2,292000,0,292000
Guinea-Bissau,2019,3,171000,0,171000
Guinea-Bissau,2019,4,178000,0,178000
Guinea-Bissau,2019,5,185000,0,185000
Guinea-Bissau,2019,6,101000,0,101000
Guinea-Bissau,2019,7,592000,0,592000
Guinea-Bissau,2019,8,143000,0,143000
Guinea-Bissau,2019,9,209000,0,209000
Guinea-Bissau,2019,10,162000,0,162000
Guinea-Bissau,2019,11,237000,2000,239000
Guinea-Bissau,2019,12,239000,0,239000
Guinea-Bissau,2020,1,213000,0,213000
Guinea-Bissau,2020,2,194000,0,194000
Guinea-Bissau,2020,3,127000,0,127000
Guinea-Bissau,2020,4,404000,0,404000
Guinea-Bissau,2020,5,172000,0,172000
Guinea-Bissau,2020,6,193000,0,193000
Guinea-Bissau,2020,7,466000,0,466000
Guinea-Bissau,2020,8,237000,0,237000
Guinea-Bissau,2020,9,260000,0,260000
Guinea-Bissau,2020,10,219000,0,219000
Guinea-Bissau,2020,11,225000,0,225000
Guinea-Bissau,2020,12,159000,0,159000
Guinea-Bissau,2021,1,675000,0,675000
Guinea-Bissau,2021,2,398000,62000,460000
Guinea-Bissau,2021,3,428000,0,428000
Guinea-Bissau,2021,4,222000,0,222000
Guinea-Bissau,2021,5,416000,0,416000
Guinea-Bissau,2021,6,239000,0,239000
Guinea-Bissau,2021,7,233000,0,233000
Guinea-Bissau,2021,8,240000,0,240000
Guinea-Bissau,2021,9,258000,2000,260000
Guinea-Bissau,2021,10,178000,0,178000
Guinea-Bissau,2021,11,413000,0,413000
Guinea-Bissau,2021,12,307000,0,307000
Guinea-Bissau,2022,1,227000,0,227000
Guinea-Bissau,2022,2,360000,0,360000
Guinea-Bissau,2022,3,118000,0,118000
Guinea-Bissau,2022,4,165000,0,165000
Guinea-Bissau,2022,5,329000,709000,1038000
Guinea-Bissau,2022,6,203000,0,203000
Guinea-Bissau,2022,7,122000,0,122000
Guinea-Bissau,2022,8,186000,0,186000
Guinea-Bissau,2022,9,333000,0,333000
Guinea-Bissau,2022,10,224000,0,224000
Guinea-Bissau,2022,11,430000,0,430000
Guinea-Bissau,2022,12,285000,0,285000
Guinea-Bissau,2023,1,203000,0,203000
Guinea-Bissau,2023,2,128000,0,128000
Guinea-Bissau,2023,3,211000,135000,346000
Guinea-Bissau,2023,4,204000,198000,402000
Guinea-Bissau,2023,5,537000,0,537000
Guinea-Bissau,2023,6,80000,0,80000
Guinea-Bissau,2023,7,226000,0,226000
Guinea-Bissau,2023,8,162000,0,162000
Guinea-Bissau,2023,9,179000,0,179000
Guinea-Bissau,2023,10,363000,0,363000
Guinea-Bissau,2023,11,756000,0,756000
Guinea-Bissau,2023,12,372000,0,372000
Guinea-Bissau,2024,1,183000,0,183000
Guinea-Bissau,2024,2,277000,0,277000
Guinea-Bissau,2024,3,259000,0,259000
Guinea-Bissau,2024,4,310000,0,310000
Guinea-Bissau,2024,5,296000,186000,482000
Guinea-Bissau,2024,6,293000,0,293000
Guinea-Bissau,2024,7,290000,223000,513000
Guinea-Bissau,2024,8,225000,1000,226000
Guinea-Bissau,2024,9,473000,0,473000
Guinea-Bissau,2024,10,1000000,0,1000000
Guinea-Bissau,2024,11,205000,0,205000
Guinea-Bissau,2024,12,415000,2000,417000
Guyana,2008,1,454000,1696000,2150000
Guyana,2008,2,275000,766000,1041000
Guyana,2008,3,158000,669000,827000
Guyana,2008,4,2565000,544000,3109000
Guyana,2008,5,2567000,40000,2607000
Guyana,2008,6,907000,980000,1887000
Guyana,2008,7,382000,662000,1044000
Guyana,2008,8,468000,49000,517000
Guyana,2008,9,86000,789000,875000
Guyana,2008,10,1318000,1142000,2460000
Guyana,2008,11,133000,1462000,1595000
Guyana,2008,12,1834000,1384000,3218000
Guyana,2009,1,136000,724000,860000
Guyana,2009,2,83000,846000,929000
Guyana,2009,3,313000,481000,794000
Guyana,2009,4,374000,101000,475000
Guyana,2009,5,237000,46000,283000
Guyana,2009,6,309000,709000,1018000
Guyana,2009,7,504000,107000,611000
Guyana,2009,8,300000,600000,900000
Guyana,2009,9,110000,633000,743000
Guyana,2009,10,395000,344000,739000
Guyana,2009,11,6361000,1251000,7612000
Guyana,2009,12,249000,832000,1081000
Guyana,2010,1,400000,2270000,2670000
Guyana,2010,2,586000,1261000,1847000
Guyana,2010,3,464000,1201000,1665000
Guyana,2010,4,253000,536000,789000
Guyana,2010,5,283000,886000,1169000
Guyana,2010,6,350000,332000,682000
Guyana,2010,7,767000,440000,1207000
Guyana,2010,8,216000,262000,478000
Guyana,2010,9,175000,657000,832000
Guyana,2010,10,298000,824000,1122000
Guyana,2010,11,933000,694000,1627000
Guyana,2010,12,204000,591000,795000
Guyana,2011,1,169000,286000,455000
Guyana,2011,2,682000,549000,1231000
Guyana,2011,3,393000,603000,996000
Guyana,2011,4,2482000,1289000,3771000
Guyana,2011,5,2295000,1290000,3585000
Guyana,2011,6,617000,652000,1269000
Guyana,2011,7,264000,273000,537000
Guyana,2011,8,355000,657000,1012000
Guyana,2011,9,449000,306000,755000
Guyana,2011,10,1068000,567000,1635000
Guyana,2011,11,246000,930000,1176000
Guyana,2011,12,369000,430000,799000
Guyana,2012,1,243000,2057000,2300000
Guyana,2012,2,962000,599000,1561000
Guyana,2012,3,570000,608000,1178000
Guyana,2012,4,405000,1297000,1702000
Guyana,2012,5,1010000,1225000,2235000
Guyana,2012,6,1463000,1517000,2980000
Guyana,2012,7,633000,697000,1330000
Guyana,2012,8,468000,3184000,3652000
Guyana,2012,9,444000,496000,940000
Guyana,2012,10,889000,108000,997000
Guyana,2012,11,1937000,1134000,3071000
Guyana,2012,12,2107000,999000,3106000
Guyana,2013,1,2444000,1023000,3467000
Guyana,2013,2,676000,223000,899000
Guyana,2013,3,976000,1048000,2024000
Guyana,2013,4,412000,648000,1060000
Guyana,2013,5,1157000,872000,2029000
Guyana,2013,6,525000,696000,1221000
Guyana,2013,7,2765000,574000,3339000
Guyana,2013,8,460000,392000,852000
Guyana,2013,9,279000,690000,969000
Guyana,2013,10,679000,2057000,2736000
Guyana,2013,11,303000,684000,987000
Guyana,2013,12,176000,962000,1138000
Guyana,2014,1,365000,640000,1005000
Guyana,2014,2,295000,460000,755000
Guyana,2014,3,254000,1220000,1474000
Guyana,2014,4,867000,501000,1368000
Guyana,2014,5,332000,984000,1316000
Guyana,2014,6,165000,770000,935000
Guyana,2014,7,702000,532000,1234000
Guyana,2014,8,176000,1074000,1250000
Guyana,2014,9,517000,908000,1425000
Guyana,2014,10,264000,2094000,2358000
Guyana,2014,11,493000,638000,1131000
Guyana,2014,12,240000,380000,620000
Guyana,2015,1,464000,363000,827000
Guyana,2015,2,356000,1715000,2071000
Guyana,2015,3,587000,391000,978000
Guyana,2015,4,1207000,964000,2171000
Guyana,2015,5,670000,930000,1600000
Guyana,2015,6,1495000,450000,1945000
Guyana,2015,7,1621000,1042000,2663000
Guyana,2015,8,778000,1017000,1795000
Guyana,2015,9,339000,460000,799000
Guyana,2015,10,382000,814000,1196000
Guyana,2015,11,786000,1075000,1861000
Guyana,2015,12,673000,1223000,1896000
Guyana,2016,1,501000,601000,1102000
Guyana,2016,2,230000,688000,918000
Guyana,2016,3,417000,918000,1335000
Guyana,2016,4,373000,251000,624000
Guyana,2016,5,318000,638000,956000
Guyana,2016,6,1141000,299000,1440000
Guyana,2016,7,716000,791000,1507000
Guyana,2016,8,994000,1462000,2456000
Guyana,2016,9,568000,777000,1345000
Guyana,2016,10,725000,351000,1076000
Guyana,2016,11,616000,813000,1429000
Guyana,2016,12,355000,370000,725000
Guyana,2017,1,508000,205000,713000
Guyana,2017,2,540000,1007000,1547000
Guyana,2017,3,2590000,933000,3523000
Guyana,2017,4,1038000,1085000,2123000
Guyana,2017,5,899000,366000,1265000
Guyana,2017,6,707000,1488000,2195000
Guyana,2017,7,496000,974000,1470000
Guyana,2017,8,621000,1535000,2156000
Guyana,2017,9,1076000,778000,1854000
Guyana,2017,10,996000,193000,1189000
Guyana,2017,11,1246000,370000,1616000
Guyana,2017,12,678000,1471000,2149000
Guyana,2018,1,513000,515000,1028000
Guyana,2018,2,927000,139000,1066000
Guyana,2018,3,958000,692000,1650000
Guyana,2018,4,813000,526000,1339000
Guyana,2018,5,1085000,2080000,3165000
Guyana,2018,6,1060000,550000,1610000
Guyana,2018,7,743000,717000,1460000
Guyana,2018,8,659000,1309000,1968000
Guyana,2018,9,805000,1124000,1929000
Guyana,2018,10,839000,642000,1481000
Guyana,2018,11,857000,1142000,1999000
Guyana,2018,12,551000,3984000,4535000
Guyana,2019,1,1291000,2143000,3434000
Guyana,2019,2,765000,736000,1501000
Guyana,2019,3,805000,210000,1015000
Guyana,2019,4,662000,1368000,2030000
Guyana,2019,5,915000,263000,1178000
Guyana,2019,6,842000,1508000,2350000
Guyana,2019,7,1231000,285000,1516000
Guyana,2019,8,1326000,1365000,2691000
Guyana,2019,9,1027000,456000,1483000
Guyana,2019,10,718000,130000,848000
Guyana,2019,11,779000,1152000,1931000
Guyana,2019,12,639000,596000,1235000
Guyana,2020,1,790000,790000,1580000
Guyana,2020,2,1124000,441000,1565000
Guyana,2020,3,1099000,123000,1222000
Guyana,2020,4,1024000,786000,1810000
Guyana,2020,5,2372000,430000,2802000
Guyana,2020,6,965000,942000,1907000
Guyana,2020,7,1054000,275000,1329000
Guyana,2020,8,586000,710000,1296000
Guyana,2020,9,941000,485000,1426000
Guyana,2020,10,755000,24215000,24970000
Guyana,2020,11,1071000,14008000,15079000
Guyana,2020,12,811000,1078000,1889000
Guyana,2021,1,1230000,1021000,2251000
Guyana,2021,2,1790000,1670000,3460000
Guyana,2021,3,928000,1149000,2077000
Guyana,2021,4,1802000,1404000,3206000
Guyana,2021,5,3362000,1583000,4945000
Guyana,2021,6,1047000,765000,1812000
Guyana,2021,7,1199000,1027000,2226000
Guyana,2021,8,788000,307000,1095000
Guyana,2021,9,1724000,1630000,3354000
Guyana,2021,10,3677000,1191000,4868000
Guyana,2021,11,1720000,7657000,9377000
Guyana,2021,12,1279000,4139000,5418000
Guyana,2022,1,3423000,18027000,21450000
Guyana,2022,2,2574000,490000,3064000
Guyana,2022,3,1971000,2262000,4233000
Guyana,2022,4,1213000,1538000,2751000
Guyana,2022,5,2155000,111000,2266000
Guyana,2022,6,2575000,1023000,3598000
Guyana,2022,7,2652000,183598000,186250000
Guyana,2022,8,2808000,270355000,273163000
Guyana,2022,9,2029000,102767000,104796000
Guyana,2022,10,1995000,254754000,256749000
Guyana,2022,11,2707000,81700000,84407000
Guyana,2022,12,1275000,162101000,163376000
Guyana,2023,1,2118000,129283000,131401000
Guyana,2023,2,3577000,83201000,86778000
Guyana,2023,3,2158000,172097000,174255000
Guyana,2023,4,2229000,112100000,114329000
Guyana,2023,5,2539000,61820000,64359000
Guyana,2023,6,2255000,137271000,139526000
Guyana,2023,7,2640000,61944000,64584000
Guyana,2023,8,3605000,80548000,84153000
Guyana,2023,9,5362000,59089000,64451000
Guyana,2023,10,3566000,80063000,83629000
Guyana,2023,11,2332000,93600000,95932000
Guyana,2023,12,1380000,150246000,151626000
Guyana,2024,1,1704000,153591000,155295000
Guyana,2024,2,1840000,254595000,256435000
Guyana,2024,3,3231000,388726000,391957000
Guyana,2024,4,2246000,190701000,192947000
Guyana,2024,5,2120000,198879000,200999000
Guyana,2024,6,1457000,201906000,203363000
Guyana,2024,7,6893000,209114000,216007000
Guyana,2024,8,2271000,85771000,88042000
Guyana,2024,9,7458000,200347000,207805000
Guyana,2024,10,3235000,148612000,151847000
Guyana,2024,11,6153000,7686000,13839000
Guyana,2024,12,1444000,365788000,367232000
Haiti,2008,1,1108000,66000,1174000
Haiti,2008,2,818000,21000,839000
Haiti,2008,3,743000,272000,1015000
Haiti,2008,4,435000,87000,522000
Haiti,2008,5,497000,132000,629000
Haiti,2008,6,685000,55000,740000
Haiti,2008,7,401000,159000,560000
Haiti,2008,8,2634000,70000,2704000
Haiti,2008,9,855000,54000,909000
Haiti,2008,10,979000,63000,1042000
Haiti,2008,11,1014000,131000,1145000
Haiti,2008,12,805000,22000,827000
Haiti,2009,1,648000,52000,700000
Haiti,2009,2,1291000,115000,1406000
Haiti,2009,3,804000,494000,1298000
Haiti,2009,4,677000,24000,701000
Haiti,2009,5,440000,206000,646000
Haiti,2009,6,921000,170000,1091000
Haiti,2009,7,683000,181000,864000
Haiti,2009,8,336000,308000,644000
Haiti,2009,9,614000,254000,868000
Haiti,2009,10,575000,116000,691000
Haiti,2009,11,529000,500000,1029000
Haiti,2009,12,1391000,759000,2150000
Haiti,2010,1,3104000,307000,3411000
Haiti,2010,2,1884000,83000,1967000
Haiti,2010,3,1235000,172000,1407000
Haiti,2010,4,1163000,63000,1226000
Haiti,2010,5,1013000,2874000,3887000
Haiti,2010,6,1482000,498000,1980000
Haiti,2010,7,848000,359000,1207000
Haiti,2010,8,3534000,2809000,6343000
Haiti,2010,9,8239000,270000,8509000
Haiti,2010,10,1646000,769000,2415000
Haiti,2010,11,1359000,354000,1713000
Haiti,2010,12,1365000,159000,1524000
Haiti,2011,1,884000,319000,1203000
Haiti,2011,2,478000,110000,588000
Haiti,2011,3,1444000,308000,1752000
Haiti,2011,4,1191000,510000,1701000
Haiti,2011,5,1819000,672000,2491000
Haiti,2011,6,1642000,450000,2092000
Haiti,2011,7,1348000,387000,1735000
Haiti,2011,8,568000,214000,782000
Haiti,2011,9,1518000,562000,2080000
Haiti,2011,10,2385000,206000,2591000
Haiti,2011,11,778000,276000,1054000
Haiti,2011,12,1756000,426000,2182000
Haiti,2012,1,643000,93000,736000
Haiti,2012,2,984000,561000,1545000
Haiti,2012,3,1056000,103000,1159000
Haiti,2012,4,1137000,330000,1467000
Haiti,2012,5,788000,71000,859000
Haiti,2012,6,829000,563000,1392000
Haiti,2012,7,915000,423000,1338000
Haiti,2012,8,527000,358000,885000
Haiti,2012,9,545000,140000,685000
Haiti,2012,10,1253000,421000,1674000
Haiti,2012,11,622000,91000,713000
Haiti,2012,12,392000,99000,491000
Haiti,2013,1,1003000,517000,1520000
Haiti,2013,2,1899000,169000,2068000
Haiti,2013,3,1965000,616000,2581000
Haiti,2013,4,551000,664000,1215000
Haiti,2013,5,537000,422000,959000
Haiti,2013,6,1171000,486000,1657000
Haiti,2013,7,827000,218000,1045000
Haiti,2013,8,639000,414000,1053000
Haiti,2013,9,1769000,143000,1912000
Haiti,2013,10,6900000,363000,7263000
Haiti,2013,11,725000,275000,1000000
Haiti,2013,12,1008000,344000,1352000
Haiti,2014,1,321000,643000,964000
Haiti,2014,2,1285000,145000,1430000
Haiti,2014,3,1777000,190000,1967000
Haiti,2014,4,1093000,136000,1229000
Haiti,2014,5,1807000,122000,1929000
Haiti,2014,6,1155000,251000,1406000
Haiti,2014,7,1858000,478000,2336000
Haiti,2014,8,1980000,51000,2031000
Haiti,2014,9,1965000,76000,2041000
Haiti,2014,10,2874000,121000,2995000
Haiti,2014,11,1467000,218000,1685000
Haiti,2014,12,1612000,205000,1817000
Haiti,2015,1,1801000,105000,1906000
Haiti,2015,2,1123000,146000,1269000
Haiti,2015,3,950000,279000,1229000
Haiti,2015,4,6824000,305000,7129000
Haiti,2015,5,1500000,125000,1625000
Haiti,2015,6,1305000,198000,1503000
Haiti,2015,7,2097000,209000,2306000
Haiti,2015,8,5503000,384000,5887000
Haiti,2015,9,4648000,190000,4838000
Haiti,2015,10,2186000,139000,2325000
Haiti,2015,11,820000,106000,926000
Haiti,2015,12,2260000,389000,2649000
Haiti,2016,1,857000,121000,978000
Haiti,2016,2,859000,180000,1039000
Haiti,2016,3,1756000,110000,1866000
Haiti,2016,4,967000,290000,1257000
Haiti,2016,5,1559000,547000,2106000
Haiti,2016,6,2113000,293000,2406000
Haiti,2016,7,1833000,94000,1927000
Haiti,2016,8,1376000,151000,1527000
Haiti,2016,9,1238000,193000,1431000
Haiti,2016,10,1596000,191000,1787000
Haiti,2016,11,8237000,253000,8490000
Haiti,2016,12,793000,85000,878000
Haiti,2017,1,1508000,294000,1802000
Haiti,2017,2,1144000,374000,1518000
Haiti,2017,3,2375000,165000,2540000
Haiti,2017,4,1655000,420000,2075000
Haiti,2017,5,1786000,177000,1963000
Haiti,2017,6,6507000,54000,6561000
Haiti,2017,7,1810000,429000,2239000
Haiti,2017,8,2050000,380000,2430000
Haiti,2017,9,1541000,275000,1816000
Haiti,2017,10,2245000,214000,2459000
Haiti,2017,11,2156000,115000,2271000
Haiti,2017,12,1587000,285000,1872000
Haiti,2018,1,1207000,56000,1263000
Haiti,2018,2,4882000,268000,5150000
Haiti,2018,3,4042000,666000,4708000
Haiti,2018,4,3588000,243000,3831000
Haiti,2018,5,2612000,447000,3059000
Haiti,2018,6,2182000,87000,2269000
Haiti,2018,7,2104000,546000,2650000
Haiti,2018,8,7706000,290000,7996000
Haiti,2018,9,1587000,36000,1623000
Haiti,2018,10,1972000,156000,2128000
Haiti,2018,11,2308000,59000,2367000
Haiti,2018,12,4283000,232000,4515000
Haiti,2019,1,2646000,94000,2740000
Haiti,2019,2,1327000,329000,1656000
Haiti,2019,3,6487000,242000,6729000
Haiti,2019,4,782000,244000,1026000
Haiti,2019,5,1226000,170000,1396000
Haiti,2019,6,2437000,207000,2644000
Haiti,2019,7,1222000,272000,1494000
Haiti,2019,8,8645000,1113000,9758000
Haiti,2019,9,783000,401000,1184000
Haiti,2019,10,1141000,171000,1312000
Haiti,2019,11,833000,129000,962000
Haiti,2019,12,681000,194000,875000
Haiti,2020,1,3129000,215000,3344000
Haiti,2020,2,1143000,547000,1690000
Haiti,2020,3,1563000,484000,2047000
Haiti,2020,4,2442000,28000,2470000
Haiti,2020,5,648000,173000,821000
Haiti,2020,6,2552000,76000,2628000
Haiti,2020,7,2393000,395000,2788000
Haiti,2020,8,1161000,77000,1238000
Haiti,2020,9,2194000,141000,2335000
Haiti,2020,10,1999000,279000,2278000
Haiti,2020,11,9717000,177000,9894000
Haiti,2020,12,9054000,70000,9124000
Haiti,2021,1,1301000,160000,1461000
Haiti,2021,2,1465000,470000,1935000
Haiti,2021,3,8781000,83000,8864000
Haiti,2021,4,1999000,150000,2149000
Haiti,2021,5,1494000,183000,1677000
Haiti,2021,6,1419000,194000,1613000
Haiti,2021,7,1701000,260000,1961000
Haiti,2021,8,11171000,231000,11402000
Haiti,2021,9,7503000,122000,7625000
Haiti,2021,10,1206000,321000,1527000
Haiti,2021,11,2099000,271000,2370000
Haiti,2021,12,1560000,242000,1802000
Haiti,2022,1,1434000,161000,1595000
Haiti,2022,2,1268000,69000,1337000
Haiti,2022,3,2419000,108000,2527000
Haiti,2022,4,1863000,496000,2359000
Haiti,2022,5,1269000,333000,1602000
Haiti,2022,6,2680000,294000,2974000
Haiti,2022,7,2513000,288000,2801000
Haiti,2022,8,1151000,210000,1361000
Haiti,2022,9,1116000,351000,1467000
Haiti,2022,10,394000,164000,558000
Haiti,2022,11,760000,160000,920000
Haiti,2022,12,868000,110000,978000
Haiti,2023,1,2389000,186000,2575000
Haiti,2023,2,2322000,272000,2594000
Haiti,2023,3,1421000,173000,1594000
Haiti,2023,4,2454000,301000,2755000
Haiti,2023,5,789000,267000,1056000
Haiti,2023,6,1237000,120000,1357000
Haiti,2023,7,1071000,267000,1338000
Haiti,2023,8,2997000,290000,3287000
Haiti,2023,9,4659000,331000,4990000
Haiti,2023,10,42373000,116000,42489000
Haiti,2023,11,1157000,236000,1393000
Haiti,2023,12,7945000,213000,8158000
Haiti,2024,1,806000,285000,1091000
Haiti,2024,2,1264000,167000,1431000
Haiti,2024,3,450000,204000,654000
Haiti,2024,4,9000,376000,385000
Haiti,2024,5,490000,85000,575000
Haiti,2024,6,6884000,516000,7400000
Haiti,2024,7,1229000,74000,1303000
Haiti,2024,8,2465000,446000,2911000
Haiti,2024,9,2020000,99000,2119000
Haiti,2024,10,1319000,288000,1607000
Haiti,2024,11,570000,235000,805000
Haiti,2024,12,6706000,195000,6901000
Heard und McDonaldinseln (ab 2001),2008,1,0,0,0
Heard und McDonaldinseln (ab 2001),2008,2,0,0,0
Heard und McDonaldinseln (ab 2001),2008,3,5000,0,5000
Heard und McDonaldinseln (ab 2001),2008,4,0,0,0
Heard und McDonaldinseln (ab 2001),2008,5,0,0,0
Heard und McDonaldinseln (ab 2001),2008,6,2000,0,2000
Heard und McDonaldinseln (ab 2001),2008,7,0,0,0
Heard und McDonaldinseln (ab 2001),2008,8,0,0,0
Heard und McDonaldinseln (ab 2001),2008,9,0,0,0
Heard und McDonaldinseln (ab 2001),2008,10,0,0,0
Heard und McDonaldinseln (ab 2001),2008,11,0,0,0
Heard und McDonaldinseln (ab 2001),2008,12,0,0,0
Heard und McDonaldinseln (ab 2001),2009,1,0,0,0
Heard und McDonaldinseln (ab 2001),2009,2,0,0,0
Heard und McDonaldinseln (ab 2001),2009,3,0,0,0
Heard und McDonaldinseln (ab 2001),2009,4,5000,0,5000
Heard und McDonaldinseln (ab 2001),2009,5,0,0,0
Heard und McDonaldinseln (ab 2001),2009,6,0,0,0
Heard und McDonaldinseln (ab 2001),2009,7,0,0,0
Heard und McDonaldinseln (ab 2001),2009,8,0,0,0
Heard und McDonaldinseln (ab 2001),2009,9,1000,0,1000
Heard und McDonaldinseln (ab 2001),2009,10,0,0,0
Heard und McDonaldinseln (ab 2001),2009,11,0,0,0
Heard und McDonaldinseln (ab 2001),2009,12,0,0,0
Heard und McDonaldinseln (ab 2001),2010,1,0,0,0
Heard und McDonaldinseln (ab 2001),2010,2,0,0,0
Heard und McDonaldinseln (ab 2001),2010,3,0,0,0
Heard und McDonaldinseln (ab 2001),2010,4,0,0,0
Heard und McDonaldinseln (ab 2001),2010,5,0,0,0
Heard und McDonaldinseln (ab 2001),2010,6,0,0,0
Heard und McDonaldinseln (ab 2001),2010,7,0,0,0
Heard und McDonaldinseln (ab 2001),2010,8,0,0,0
Heard und McDonaldinseln (ab 2001),2010,9,0,0,0
Heard und McDonaldinseln (ab 2001),2010,10,0,0,0
Heard und McDonaldinseln (ab 2001),2010,11,0,0,0
Heard und McDonaldinseln (ab 2001),2010,12,0,0,0
Heard und McDonaldinseln (ab 2001),2011,1,0,0,0
Heard und McDonaldinseln (ab 2001),2011,2,0,0,0
Heard und McDonaldinseln (ab 2001),2011,3,0,0,0
Heard und McDonaldinseln (ab 2001),2011,4,0,0,0
Heard und McDonaldinseln (ab 2001),2011,5,0,0,0
Heard und McDonaldinseln (ab 2001),2011,6,0,0,0
Heard und McDonaldinseln (ab 2001),2011,7,0,0,0
Heard und McDonaldinseln (ab 2001),2011,8,0,0,0
Heard und McDonaldinseln (ab 2001),2011,9,0,0,0
Heard und McDonaldinseln (ab 2001),2011,10,0,0,0
Heard und McDonaldinseln (ab 2001),2011,11,0,0,0
Heard und McDonaldinseln (ab 2001),2011,12,0,0,0
Heard und McDonaldinseln (ab 2001),2012,1,0,0,0
Heard und McDonaldinseln (ab 2001),2012,2,0,0,0
Heard und McDonaldinseln (ab 2001),2012,3,0,0,0
Heard und McDonaldinseln (ab 2001),2012,4,0,0,0
Heard und McDonaldinseln (ab 2001),2012,5,0,0,0
Heard und McDonaldinseln (ab 2001),2012,6,0,0,0
Heard und McDonaldinseln (ab 2001),2012,7,0,0,0
Heard und McDonaldinseln (ab 2001),2012,8,0,0,0
Heard und McDonaldinseln (ab 2001),2012,9,0,0,0
Heard und McDonaldinseln (ab 2001),2012,10,0,0,0
Heard und McDonaldinseln (ab 2001),2012,11,0,0,0
Heard und McDonaldinseln (ab 2001),2012,12,0,0,0
Heard und McDonaldinseln (ab 2001),2013,1,0,0,0
Heard und McDonaldinseln (ab 2001),2013,2,0,0,0
Heard und McDonaldinseln (ab 2001),2013,3,0,0,0
Heard und McDonaldinseln (ab 2001),2013,4,0,0,0
Heard und McDonaldinseln (ab 2001),2013,5,0,0,0
Heard und McDonaldinseln (ab 2001),2013,6,0,0,0
Heard und McDonaldinseln (ab 2001),2013,7,0,0,0
Heard und McDonaldinseln (ab 2001),2013,8,0,0,0
Heard und McDonaldinseln (ab 2001),2013,9,0,0,0
Heard und McDonaldinseln (ab 2001),2013,10,0,0,0
Heard und McDonaldinseln (ab 2001),2013,11,0,0,0
Heard und McDonaldinseln (ab 2001),2013,12,0,0,0
Heard und McDonaldinseln (ab 2001),2014,1,0,0,0
Heard und McDonaldinseln (ab 2001),2014,2,0,0,0
Heard und McDonaldinseln (ab 2001),2014,3,0,0,0
Heard und McDonaldinseln (ab 2001),2014,4,0,0,0
Heard und McDonaldinseln (ab 2001),2014,5,0,0,0
Heard und McDonaldinseln (ab 2001),2014,6,0,0,0
Heard und McDonaldinseln (ab 2001),2014,7,0,0,0
Heard und McDonaldinseln (ab 2001),2014,8,0,0,0
Heard und McDonaldinseln (ab 2001),2014,9,0,0,0
Heard und McDonaldinseln (ab 2001),2014,10,0,0,0
Heard und McDonaldinseln (ab 2001),2014,11,0,0,0
Heard und McDonaldinseln (ab 2001),2014,12,0,0,0
Heard und McDonaldinseln (ab 2001),2015,1,0,0,0
Heard und McDonaldinseln (ab 2001),2015,2,0,0,0
Heard und McDonaldinseln (ab 2001),2015,3,0,0,0
Heard und McDonaldinseln (ab 2001),2015,4,0,0,0
Heard und McDonaldinseln (ab 2001),2015,5,0,0,0
Heard und McDonaldinseln (ab 2001),2015,6,0,0,0
Heard und McDonaldinseln (ab 2001),2015,7,0,0,0
Heard und McDonaldinseln (ab 2001),2015,8,0,0,0
Heard und McDonaldinseln (ab 2001),2015,9,0,0,0
Heard und McDonaldinseln (ab 2001),2015,10,0,0,0
Heard und McDonaldinseln (ab 2001),2015,11,0,0,0
Heard und McDonaldinseln (ab 2001),2015,12,0,0,0
Heard und McDonaldinseln (ab 2001),2016,1,0,0,0
Heard und McDonaldinseln (ab 2001),2016,2,0,0,0
Heard und McDonaldinseln (ab 2001),2016,3,0,0,0
Heard und McDonaldinseln (ab 2001),2016,4,0,0,0
Heard und McDonaldinseln (ab 2001),2016,5,0,0,0
Heard und McDonaldinseln (ab 2001),2016,6,0,0,0
Heard und McDonaldinseln (ab 2001),2016,7,0,0,0
Heard und McDonaldinseln (ab 2001),2016,8,0,0,0
Heard und McDonaldinseln (ab 2001),2016,9,0,0,0
Heard und McDonaldinseln (ab 2001),2016,10,0,0,0
Heard und McDonaldinseln (ab 2001),2016,11,0,0,0
Heard und McDonaldinseln (ab 2001),2016,12,0,0,0
Heard und McDonaldinseln (ab 2001),2017,1,0,0,0
Heard und McDonaldinseln (ab 2001),2017,2,0,0,0
Heard und McDonaldinseln (ab 2001),2017,3,0,0,0
Heard und McDonaldinseln (ab 2001),2017,4,0,0,0
Heard und McDonaldinseln (ab 2001),2017,5,0,0,0
Heard und McDonaldinseln (ab 2001),2017,6,0,0,0
Heard und McDonaldinseln (ab 2001),2017,7,0,0,0
Heard und McDonaldinseln (ab 2001),2017,8,0,0,0
Heard und McDonaldinseln (ab 2001),2017,9,0,0,0
Heard und McDonaldinseln (ab 2001),2017,10,0,0,0
Heard und McDonaldinseln (ab 2001),2017,11,0,0,0
Heard und McDonaldinseln (ab 2001),2017,12,0,0,0
Heard und McDonaldinseln (ab 2001),2018,1,0,0,0
Heard und McDonaldinseln (ab 2001),2018,2,0,0,0
Heard und McDonaldinseln (ab 2001),2018,3,0,0,0
Heard und McDonaldinseln (ab 2001),2018,4,0,0,0
Heard und McDonaldinseln (ab 2001),2018,5,11000,0,11000
Heard und McDonaldinseln (ab 2001),2018,6,0,0,0
Heard und McDonaldinseln (ab 2001),2018,7,27000,0,27000
Heard und McDonaldinseln (ab 2001),2018,8,0,0,0
Heard und McDonaldinseln (ab 2001),2018,9,0,0,0
Heard und McDonaldinseln (ab 2001),2018,10,0,0,0
Heard und McDonaldinseln (ab 2001),2018,11,1000,0,1000
Heard und McDonaldinseln (ab 2001),2018,12,1000,0,1000
Heard und McDonaldinseln (ab 2001),2019,1,3000,0,3000
Heard und McDonaldinseln (ab 2001),2019,2,7000,0,7000
Heard und McDonaldinseln (ab 2001),2019,3,4000,0,4000
Heard und McDonaldinseln (ab 2001),2019,4,4000,0,4000
Heard und McDonaldinseln (ab 2001),2019,5,0,0,0
Heard und McDonaldinseln (ab 2001),2019,6,2000,0,2000
Heard und McDonaldinseln (ab 2001),2019,7,3000,0,3000
Heard und McDonaldinseln (ab 2001),2019,8,2000,0,2000
Heard und McDonaldinseln (ab 2001),2019,9,1000,0,1000
Heard und McDonaldinseln (ab 2001),2019,10,0,0,0
Heard und McDonaldinseln (ab 2001),2019,11,0,0,0
Heard und McDonaldinseln (ab 2001),2019,12,2000,0,2000
Heard und McDonaldinseln (ab 2001),2020,1,3000,0,3000
Heard und McDonaldinseln (ab 2001),2020,2,2000,0,2000
Heard und McDonaldinseln (ab 2001),2020,3,2000,0,2000
Heard und McDonaldinseln (ab 2001),2020,4,2000,0,2000
Heard und McDonaldinseln (ab 2001),2020,5,0,0,0
Heard und McDonaldinseln (ab 2001),2020,6,0,0,0
Heard und McDonaldinseln (ab 2001),2020,7,2000,0,2000
Heard und McDonaldinseln (ab 2001),2020,8,5000,0,5000
Heard und McDonaldinseln (ab 2001),2020,9,0,0,0
Heard und McDonaldinseln (ab 2001),2020,10,0,0,0
Heard und McDonaldinseln (ab 2001),2020,11,0,0,0
Heard und McDonaldinseln (ab 2001),2020,12,0,0,0
Heard und McDonaldinseln (ab 2001),2021,1,0,0,0
Heard und McDonaldinseln (ab 2001),2021,2,1000,0,1000
Heard und McDonaldinseln (ab 2001),2021,3,0,0,0
Heard und McDonaldinseln (ab 2001),2021,4,0,0,0
Heard und McDonaldinseln (ab 2001),2021,5,0,0,0
Heard und McDonaldinseln (ab 2001),2021,6,8000,0,8000
Heard und McDonaldinseln (ab 2001),2021,7,1000,0,1000
Heard und McDonaldinseln (ab 2001),2021,8,0,0,0
Heard und McDonaldinseln (ab 2001),2021,9,1000,0,1000
Heard und McDonaldinseln (ab 2001),2021,10,0,0,0
Heard und McDonaldinseln (ab 2001),2021,11,0,0,0
Heard und McDonaldinseln (ab 2001),2021,12,0,0,0
Heard und McDonaldinseln (ab 2001),2022,1,25000,0,25000
Heard und McDonaldinseln (ab 2001),2022,2,0,0,0
Heard und McDonaldinseln (ab 2001),2022,3,0,0,0
Heard und McDonaldinseln (ab 2001),2022,4,0,0,0
Heard und McDonaldinseln (ab 2001),2022,5,0,0,0
Heard und McDonaldinseln (ab 2001),2022,6,0,0,0
Heard und McDonaldinseln (ab 2001),2022,7,0,0,0
Heard und McDonaldinseln (ab 2001),2022,8,0,0,0
Heard und McDonaldinseln (ab 2001),2022,9,0,0,0
Heard und McDonaldinseln (ab 2001),2022,10,0,0,0
Heard und McDonaldinseln (ab 2001),2022,11,0,0,0
Heard und McDonaldinseln (ab 2001),2022,12,0,0,0
Heard und McDonaldinseln (ab 2001),2023,1,0,0,0
Heard und McDonaldinseln (ab 2001),2023,2,11000,0,11000
Heard und McDonaldinseln (ab 2001),2023,3,0,0,0
Heard und McDonaldinseln (ab 2001),2023,4,0,0,0
Heard und McDonaldinseln (ab 2001),2023,5,0,0,0
Heard und McDonaldinseln (ab 2001),2023,6,0,0,0
Heard und McDonaldinseln (ab 2001),2023,7,0,0,0
Heard und McDonaldinseln (ab 2001),2023,8,0,0,0
Heard und McDonaldinseln (ab 2001),2023,9,0,0,0
Heard und McDonaldinseln (ab 2001),2023,10,0,0,0
Heard und McDonaldinseln (ab 2001),2023,11,0,0,0
Heard und McDonaldinseln (ab 2001),2023,12,0,0,0
Heard und McDonaldinseln (ab 2001),2024,1,0,0,0
Heard und McDonaldinseln (ab 2001),2024,2,0,0,0
Heard und McDonaldinseln (ab 2001),2024,3,0,0,0
Heard und McDonaldinseln (ab 2001),2024,4,0,0,0
Heard und McDonaldinseln (ab 2001),2024,5,0,0,0
Heard und McDonaldinseln (ab 2001),2024,6,0,0,0
Heard und McDonaldinseln (ab 2001),2024,7,0,0,0
Heard und McDonaldinseln (ab 2001),2024,8,0,0,0
Heard und McDonaldinseln (ab 2001),2024,9,0,0,0
Heard und McDonaldinseln (ab 2001),2024,10,0,0,0
Heard und McDonaldinseln (ab 2001),2024,11,0,0,0
Heard und McDonaldinseln (ab 2001),2024,12,0,0,0
Heiliger Stuhl (Vatikanstadt),2008,1,330000,14000,344000
Heiliger Stuhl (Vatikanstadt),2008,2,129000,83000,212000
Heiliger Stuhl (Vatikanstadt),2008,3,168000,15000,183000
Heiliger Stuhl (Vatikanstadt),2008,4,112000,142000,254000
Heiliger Stuhl (Vatikanstadt),2008,5,454000,51000,505000
Heiliger Stuhl (Vatikanstadt),2008,6,149000,74000,223000
Heiliger Stuhl (Vatikanstadt),2008,7,87000,212000,299000
Heiliger Stuhl (Vatikanstadt),2008,8,99000,228000,327000
Heiliger Stuhl (Vatikanstadt),2008,9,1150000,77000,1227000
Heiliger Stuhl (Vatikanstadt),2008,10,215000,66000,281000
Heiliger Stuhl (Vatikanstadt),2008,11,456000,37000,493000
Heiliger Stuhl (Vatikanstadt),2008,12,168000,9000,177000
Heiliger Stuhl (Vatikanstadt),2009,1,229000,83000,312000
Heiliger Stuhl (Vatikanstadt),2009,2,541000,76000,617000
Heiliger Stuhl (Vatikanstadt),2009,3,52000,174000,226000
Heiliger Stuhl (Vatikanstadt),2009,4,97000,564000,661000
Heiliger Stuhl (Vatikanstadt),2009,5,72000,164000,236000
Heiliger Stuhl (Vatikanstadt),2009,6,138000,141000,279000
Heiliger Stuhl (Vatikanstadt),2009,7,533000,285000,818000
Heiliger Stuhl (Vatikanstadt),2009,8,63000,46000,109000
Heiliger Stuhl (Vatikanstadt),2009,9,133000,42000,175000
Heiliger Stuhl (Vatikanstadt),2009,10,146000,9000,155000
Heiliger Stuhl (Vatikanstadt),2009,11,99000,200000,299000
Heiliger Stuhl (Vatikanstadt),2009,12,43000,48000,91000
Heiliger Stuhl (Vatikanstadt),2010,1,51000,77000,128000
Heiliger Stuhl (Vatikanstadt),2010,2,20000,150000,170000
Heiliger Stuhl (Vatikanstadt),2010,3,71000,153000,224000
Heiliger Stuhl (Vatikanstadt),2010,4,9000,34000,43000
Heiliger Stuhl (Vatikanstadt),2010,5,60000,242000,302000
Heiliger Stuhl (Vatikanstadt),2010,6,39000,265000,304000
Heiliger Stuhl (Vatikanstadt),2010,7,91000,234000,325000
Heiliger Stuhl (Vatikanstadt),2010,8,19000,158000,177000
Heiliger Stuhl (Vatikanstadt),2010,9,47000,52000,99000
Heiliger Stuhl (Vatikanstadt),2010,10,65000,406000,471000
Heiliger Stuhl (Vatikanstadt),2010,11,55000,176000,231000
Heiliger Stuhl (Vatikanstadt),2010,12,33000,415000,448000
Heiliger Stuhl (Vatikanstadt),2011,1,30000,101000,131000
Heiliger Stuhl (Vatikanstadt),2011,2,10000,150000,160000
Heiliger Stuhl (Vatikanstadt),2011,3,21000,175000,196000
Heiliger Stuhl (Vatikanstadt),2011,4,14000,192000,206000
Heiliger Stuhl (Vatikanstadt),2011,5,1242000,247000,1489000
Heiliger Stuhl (Vatikanstadt),2011,6,45000,230000,275000
Heiliger Stuhl (Vatikanstadt),2011,7,74000,205000,279000
Heiliger Stuhl (Vatikanstadt),2011,8,66000,426000,492000
Heiliger Stuhl (Vatikanstadt),2011,9,41000,68000,109000
Heiliger Stuhl (Vatikanstadt),2011,10,57000,81000,138000
Heiliger Stuhl (Vatikanstadt),2011,11,114000,208000,322000
Heiliger Stuhl (Vatikanstadt),2011,12,200000,322000,522000
Heiliger Stuhl (Vatikanstadt),2012,1,162000,41000,203000
Heiliger Stuhl (Vatikanstadt),2012,2,62000,112000,174000
Heiliger Stuhl (Vatikanstadt),2012,3,123000,151000,274000
Heiliger Stuhl (Vatikanstadt),2012,4,83000,2427000,2510000
Heiliger Stuhl (Vatikanstadt),2012,5,156000,110000,266000
Heiliger Stuhl (Vatikanstadt),2012,6,179000,411000,590000
Heiliger Stuhl (Vatikanstadt),2012,7,372000,159000,531000
Heiliger Stuhl (Vatikanstadt),2012,8,85000,216000,301000
Heiliger Stuhl (Vatikanstadt),2012,9,118000,73000,191000
Heiliger Stuhl (Vatikanstadt),2012,10,105000,93000,198000
Heiliger Stuhl (Vatikanstadt),2012,11,104000,162000,266000
Heiliger Stuhl (Vatikanstadt),2012,12,152000,609000,761000
Heiliger Stuhl (Vatikanstadt),2013,1,173000,476000,649000
Heiliger Stuhl (Vatikanstadt),2013,2,65000,80000,145000
Heiliger Stuhl (Vatikanstadt),2013,3,181000,75000,256000
Heiliger Stuhl (Vatikanstadt),2013,4,72000,251000,323000
Heiliger Stuhl (Vatikanstadt),2013,5,166000,183000,349000
Heiliger Stuhl (Vatikanstadt),2013,6,75000,367000,442000
Heiliger Stuhl (Vatikanstadt),2013,7,235000,568000,803000
Heiliger Stuhl (Vatikanstadt),2013,8,149000,257000,406000
Heiliger Stuhl (Vatikanstadt),2013,9,76000,275000,351000
Heiliger Stuhl (Vatikanstadt),2013,10,130000,362000,492000
Heiliger Stuhl (Vatikanstadt),2013,11,161000,531000,692000
Heiliger Stuhl (Vatikanstadt),2013,12,137000,482000,619000
Heiliger Stuhl (Vatikanstadt),2014,1,164000,285000,449000
Heiliger Stuhl (Vatikanstadt),2014,2,146000,176000,322000
Heiliger Stuhl (Vatikanstadt),2014,3,178000,347000,525000
Heiliger Stuhl (Vatikanstadt),2014,4,188000,703000,891000
Heiliger Stuhl (Vatikanstadt),2014,5,205000,504000,709000
Heiliger Stuhl (Vatikanstadt),2014,6,106000,354000,460000
Heiliger Stuhl (Vatikanstadt),2014,7,422000,657000,1079000
Heiliger Stuhl (Vatikanstadt),2014,8,75000,169000,244000
Heiliger Stuhl (Vatikanstadt),2014,9,216000,143000,359000
Heiliger Stuhl (Vatikanstadt),2014,10,191000,55000,246000
Heiliger Stuhl (Vatikanstadt),2014,11,138000,321000,459000
Heiliger Stuhl (Vatikanstadt),2014,12,178000,197000,375000
Heiliger Stuhl (Vatikanstadt),2015,1,172000,93000,265000
Heiliger Stuhl (Vatikanstadt),2015,2,121000,68000,189000
Heiliger Stuhl (Vatikanstadt),2015,3,229000,102000,331000
Heiliger Stuhl (Vatikanstadt),2015,4,134000,362000,496000
Heiliger Stuhl (Vatikanstadt),2015,5,141000,242000,383000
Heiliger Stuhl (Vatikanstadt),2015,6,142000,98000,240000
Heiliger Stuhl (Vatikanstadt),2015,7,183000,115000,298000
Heiliger Stuhl (Vatikanstadt),2015,8,274000,78000,352000
Heiliger Stuhl (Vatikanstadt),2015,9,132000,59000,191000
Heiliger Stuhl (Vatikanstadt),2015,10,138000,177000,315000
Heiliger Stuhl (Vatikanstadt),2015,11,233000,306000,539000
Heiliger Stuhl (Vatikanstadt),2015,12,344000,65000,409000
Heiliger Stuhl (Vatikanstadt),2016,1,163000,80000,243000
Heiliger Stuhl (Vatikanstadt),2016,2,212000,60000,272000
Heiliger Stuhl (Vatikanstadt),2016,3,43000,233000,276000
Heiliger Stuhl (Vatikanstadt),2016,4,272000,253000,525000
Heiliger Stuhl (Vatikanstadt),2016,5,214000,139000,353000
Heiliger Stuhl (Vatikanstadt),2016,6,258000,100000,358000
Heiliger Stuhl (Vatikanstadt),2016,7,365000,194000,559000
Heiliger Stuhl (Vatikanstadt),2016,8,170000,86000,256000
Heiliger Stuhl (Vatikanstadt),2016,9,258000,80000,338000
Heiliger Stuhl (Vatikanstadt),2016,10,265000,43000,308000
Heiliger Stuhl (Vatikanstadt),2016,11,122000,288000,410000
Heiliger Stuhl (Vatikanstadt),2016,12,526000,44000,570000
Heiliger Stuhl (Vatikanstadt),2017,1,300000,32000,332000
Heiliger Stuhl (Vatikanstadt),2017,2,171000,83000,254000
Heiliger Stuhl (Vatikanstadt),2017,3,202000,136000,338000
Heiliger Stuhl (Vatikanstadt),2017,4,135000,10000,145000
Heiliger Stuhl (Vatikanstadt),2017,5,222000,39000,261000
Heiliger Stuhl (Vatikanstadt),2017,6,155000,196000,351000
Heiliger Stuhl (Vatikanstadt),2017,7,377000,125000,502000
Heiliger Stuhl (Vatikanstadt),2017,8,251000,38000,289000
Heiliger Stuhl (Vatikanstadt),2017,9,124000,73000,197000
Heiliger Stuhl (Vatikanstadt),2017,10,562000,199000,761000
Heiliger Stuhl (Vatikanstadt),2017,11,209000,171000,380000
Heiliger Stuhl (Vatikanstadt),2017,12,219000,171000,390000
Heiliger Stuhl (Vatikanstadt),2018,1,155000,58000,213000
Heiliger Stuhl (Vatikanstadt),2018,2,631000,165000,796000
Heiliger Stuhl (Vatikanstadt),2018,3,116000,251000,367000
Heiliger Stuhl (Vatikanstadt),2018,4,123000,216000,339000
Heiliger Stuhl (Vatikanstadt),2018,5,529000,195000,724000
Heiliger Stuhl (Vatikanstadt),2018,6,179000,191000,370000
Heiliger Stuhl (Vatikanstadt),2018,7,449000,141000,590000
Heiliger Stuhl (Vatikanstadt),2018,8,78000,72000,150000
Heiliger Stuhl (Vatikanstadt),2018,9,228000,92000,320000
Heiliger Stuhl (Vatikanstadt),2018,10,134000,130000,264000
Heiliger Stuhl (Vatikanstadt),2018,11,182000,157000,339000
Heiliger Stuhl (Vatikanstadt),2018,12,160000,163000,323000
Heiliger Stuhl (Vatikanstadt),2019,1,123000,100000,223000
Heiliger Stuhl (Vatikanstadt),2019,2,127000,104000,231000
Heiliger Stuhl (Vatikanstadt),2019,3,185000,186000,371000
Heiliger Stuhl (Vatikanstadt),2019,4,292000,161000,453000
Heiliger Stuhl (Vatikanstadt),2019,5,158000,104000,262000
Heiliger Stuhl (Vatikanstadt),2019,6,140000,112000,252000
Heiliger Stuhl (Vatikanstadt),2019,7,396000,105000,501000
Heiliger Stuhl (Vatikanstadt),2019,8,70000,56000,126000
Heiliger Stuhl (Vatikanstadt),2019,9,147000,60000,207000
Heiliger Stuhl (Vatikanstadt),2019,10,309000,165000,474000
Heiliger Stuhl (Vatikanstadt),2019,11,278000,170000,448000
Heiliger Stuhl (Vatikanstadt),2019,12,161000,107000,268000
Heiliger Stuhl (Vatikanstadt),2020,1,125000,63000,188000
Heiliger Stuhl (Vatikanstadt),2020,2,177000,74000,251000
Heiliger Stuhl (Vatikanstadt),2020,3,247000,43000,290000
Heiliger Stuhl (Vatikanstadt),2020,4,35000,15000,50000
Heiliger Stuhl (Vatikanstadt),2020,5,131000,78000,209000
Heiliger Stuhl (Vatikanstadt),2020,6,143000,211000,354000
Heiliger Stuhl (Vatikanstadt),2020,7,322000,161000,483000
Heiliger Stuhl (Vatikanstadt),2020,8,67000,103000,170000
Heiliger Stuhl (Vatikanstadt),2020,9,84000,115000,199000
Heiliger Stuhl (Vatikanstadt),2020,10,96000,67000,163000
Heiliger Stuhl (Vatikanstadt),2020,11,153000,134000,287000
Heiliger Stuhl (Vatikanstadt),2020,12,244000,61000,305000
Heiliger Stuhl (Vatikanstadt),2021,1,41000,81000,122000
Heiliger Stuhl (Vatikanstadt),2021,2,148000,117000,265000
Heiliger Stuhl (Vatikanstadt),2021,3,193000,77000,270000
Heiliger Stuhl (Vatikanstadt),2021,4,112000,109000,221000
Heiliger Stuhl (Vatikanstadt),2021,5,229000,149000,378000
Heiliger Stuhl (Vatikanstadt),2021,6,212000,142000,354000
Heiliger Stuhl (Vatikanstadt),2021,7,107000,139000,246000
Heiliger Stuhl (Vatikanstadt),2021,8,158000,89000,247000
Heiliger Stuhl (Vatikanstadt),2021,9,163000,104000,267000
Heiliger Stuhl (Vatikanstadt),2021,10,100000,65000,165000
Heiliger Stuhl (Vatikanstadt),2021,11,90000,116000,206000
Heiliger Stuhl (Vatikanstadt),2021,12,253000,102000,355000
Heiliger Stuhl (Vatikanstadt),2022,1,74000,97000,171000
Heiliger Stuhl (Vatikanstadt),2022,2,51000,104000,155000
Heiliger Stuhl (Vatikanstadt),2022,3,78000,106000,184000
Heiliger Stuhl (Vatikanstadt),2022,4,311000,15000,326000
Heiliger Stuhl (Vatikanstadt),2022,5,44000,145000,189000
Heiliger Stuhl (Vatikanstadt),2022,6,38000,171000,209000
Heiliger Stuhl (Vatikanstadt),2022,7,37000,164000,201000
Heiliger Stuhl (Vatikanstadt),2022,8,42000,74000,116000
Heiliger Stuhl (Vatikanstadt),2022,9,51000,122000,173000
Heiliger Stuhl (Vatikanstadt),2022,10,49000,192000,241000
Heiliger Stuhl (Vatikanstadt),2022,11,100000,155000,255000
Heiliger Stuhl (Vatikanstadt),2022,12,692000,172000,864000
Heiliger Stuhl (Vatikanstadt),2023,1,167000,61000,228000
Heiliger Stuhl (Vatikanstadt),2023,2,23000,149000,172000
Heiliger Stuhl (Vatikanstadt),2023,3,49000,81000,130000
Heiliger Stuhl (Vatikanstadt),2023,4,76000,82000,158000
Heiliger Stuhl (Vatikanstadt),2023,5,33000,144000,177000
Heiliger Stuhl (Vatikanstadt),2023,6,149000,114000,263000
Heiliger Stuhl (Vatikanstadt),2023,7,240000,120000,360000
Heiliger Stuhl (Vatikanstadt),2023,8,30000,173000,203000
Heiliger Stuhl (Vatikanstadt),2023,9,37000,89000,126000
Heiliger Stuhl (Vatikanstadt),2023,10,39000,119000,158000
Heiliger Stuhl (Vatikanstadt),2023,11,117000,166000,283000
Heiliger Stuhl (Vatikanstadt),2023,12,133000,83000,216000
Heiliger Stuhl (Vatikanstadt),2024,1,23000,127000,150000
Heiliger Stuhl (Vatikanstadt),2024,2,34000,344000,378000
Heiliger Stuhl (Vatikanstadt),2024,3,2407000,138000,2545000
Heiliger Stuhl (Vatikanstadt),2024,4,150000,127000,277000
Heiliger Stuhl (Vatikanstadt),2024,5,48000,165000,213000
Heiliger Stuhl (Vatikanstadt),2024,6,44000,153000,197000
Heiliger Stuhl (Vatikanstadt),2024,7,58000,211000,269000
Heiliger Stuhl (Vatikanstadt),2024,8,36000,71000,107000
Heiliger Stuhl (Vatikanstadt),2024,9,23000,94000,117000
Heiliger Stuhl (Vatikanstadt),2024,10,69000,11000,80000
Heiliger Stuhl (Vatikanstadt),2024,11,129000,39000,168000
Heiliger Stuhl (Vatikanstadt),2024,12,15000,10000,25000
Hohe See (ab 2013),2008,1,0,0,0
Hohe See (ab 2013),2008,2,0,0,0
Hohe See (ab 2013),2008,3,0,0,0
Hohe See (ab 2013),2008,4,0,0,0
Hohe See (ab 2013),2008,5,0,0,0
Hohe See (ab 2013),2008,6,0,0,0
Hohe See (ab 2013),2008,7,0,0,0
Hohe See (ab 2013),2008,8,0,0,0
Hohe See (ab 2013),2008,9,0,0,0
Hohe See (ab 2013),2008,10,0,0,0
Hohe See (ab 2013),2008,11,0,0,0
Hohe See (ab 2013),2008,12,0,0,0
Hohe See (ab 2013),2009,1,0,0,0
Hohe See (ab 2013),2009,2,0,0,0
Hohe See (ab 2013),2009,3,0,0,0
Hohe See (ab 2013),2009,4,0,0,0
Hohe See (ab 2013),2009,5,0,0,0
Hohe See (ab 2013),2009,6,0,0,0
Hohe See (ab 2013),2009,7,0,0,0
Hohe See (ab 2013),2009,8,0,0,0
Hohe See (ab 2013),2009,9,0,0,0
Hohe See (ab 2013),2009,10,0,0,0
Hohe See (ab 2013),2009,11,0,0,0
Hohe See (ab 2013),2009,12,0,0,0
Hohe See (ab 2013),2010,1,0,0,0
Hohe See (ab 2013),2010,2,0,0,0
Hohe See (ab 2013),2010,3,0,0,0
Hohe See (ab 2013),2010,4,0,0,0
Hohe See (ab 2013),2010,5,0,0,0
Hohe See (ab 2013),2010,6,0,0,0
Hohe See (ab 2013),2010,7,0,0,0
Hohe See (ab 2013),2010,8,0,0,0
Hohe See (ab 2013),2010,9,0,0,0
Hohe See (ab 2013),2010,10,0,0,0
Hohe See (ab 2013),2010,11,0,0,0
Hohe See (ab 2013),2010,12,0,0,0
Hohe See (ab 2013),2011,1,0,0,0
Hohe See (ab 2013),2011,2,0,0,0
Hohe See (ab 2013),2011,3,0,0,0
Hohe See (ab 2013),2011,4,0,0,0
Hohe See (ab 2013),2011,5,0,0,0
Hohe See (ab 2013),2011,6,0,0,0
Hohe See (ab 2013),2011,7,0,0,0
Hohe See (ab 2013),2011,8,0,0,0
Hohe See (ab 2013),2011,9,0,0,0
Hohe See (ab 2013),2011,10,0,0,0
Hohe See (ab 2013),2011,11,0,0,0
Hohe See (ab 2013),2011,12,0,0,0
Hohe See (ab 2013),2012,1,0,0,0
Hohe See (ab 2013),2012,2,0,0,0
Hohe See (ab 2013),2012,3,0,0,0
Hohe See (ab 2013),2012,4,0,0,0
Hohe See (ab 2013),2012,5,0,0,0
Hohe See (ab 2013),2012,6,0,0,0
Hohe See (ab 2013),2012,7,0,0,0
Hohe See (ab 2013),2012,8,0,0,0
Hohe See (ab 2013),2012,9,0,0,0
Hohe See (ab 2013),2012,10,0,0,0
Hohe See (ab 2013),2012,11,0,0,0
Hohe See (ab 2013),2012,12,0,0,0
Hohe See (ab 2013),2013,1,0,0,0
Hohe See (ab 2013),2013,2,0,0,0
Hohe See (ab 2013),2013,3,0,0,0
Hohe See (ab 2013),2013,4,0,0,0
Hohe See (ab 2013),2013,5,0,0,0
Hohe See (ab 2013),2013,6,0,0,0
Hohe See (ab 2013),2013,7,26000,0,26000
Hohe See (ab 2013),2013,8,16000,0,16000
Hohe See (ab 2013),2013,9,0,0,0
Hohe See (ab 2013),2013,10,3462000,0,3462000
Hohe See (ab 2013),2013,11,0,0,0
Hohe See (ab 2013),2013,12,25000,0,25000
Hohe See (ab 2013),2014,1,16000,0,16000
Hohe See (ab 2013),2014,2,60000,0,60000
Hohe See (ab 2013),2014,3,108000,0,108000
Hohe See (ab 2013),2014,4,757000,0,757000
Hohe See (ab 2013),2014,5,162000,0,162000
Hohe See (ab 2013),2014,6,11278000,0,11278000
Hohe See (ab 2013),2014,7,330000,0,330000
Hohe See (ab 2013),2014,8,752000,0,752000
Hohe See (ab 2013),2014,9,563000,0,563000
Hohe See (ab 2013),2014,10,2153000,0,2153000
Hohe See (ab 2013),2014,11,669000,0,669000
Hohe See (ab 2013),2014,12,309000,0,309000
Hohe See (ab 2013),2015,1,283000,0,283000
Hohe See (ab 2013),2015,2,327000,0,327000
Hohe See (ab 2013),2015,3,200000,0,200000
Hohe See (ab 2013),2015,4,28000,0,28000
Hohe See (ab 2013),2015,5,0,0,0
Hohe See (ab 2013),2015,6,0,13000,13000
Hohe See (ab 2013),2015,7,0,0,0
Hohe See (ab 2013),2015,8,772000,140000,912000
Hohe See (ab 2013),2015,9,0,273000,273000
Hohe See (ab 2013),2015,10,49000,166000,215000
Hohe See (ab 2013),2015,11,0,164000,164000
Hohe See (ab 2013),2015,12,0,744000,744000
Hohe See (ab 2013),2016,1,1000,0,1000
Hohe See (ab 2013),2016,2,10000,0,10000
Hohe See (ab 2013),2016,3,302000,34000,336000
Hohe See (ab 2013),2016,4,0,1000,1000
Hohe See (ab 2013),2016,5,0,0,0
Hohe See (ab 2013),2016,6,0,0,0
Hohe See (ab 2013),2016,7,0,0,0
Hohe See (ab 2013),2016,8,12000,0,12000
Hohe See (ab 2013),2016,9,8194000,2000,8196000
Hohe See (ab 2013),2016,10,4197000,0,4197000
Hohe See (ab 2013),2016,11,2731000,0,2731000
Hohe See (ab 2013),2016,12,0,1000,1000
Hohe See (ab 2013),2017,1,136000,7000,143000
Hohe See (ab 2013),2017,2,585000,0,585000
Hohe See (ab 2013),2017,3,2015000,0,2015000
Hohe See (ab 2013),2017,4,1098000,0,1098000
Hohe See (ab 2013),2017,5,0,0,0
Hohe See (ab 2013),2017,6,0,71000,71000
Hohe See (ab 2013),2017,7,0,0,0
Hohe See (ab 2013),2017,8,82000,18000,100000
Hohe See (ab 2013),2017,9,50000,14000,64000
Hohe See (ab 2013),2017,10,3000,172000,175000
Hohe See (ab 2013),2017,11,0,725000,725000
Hohe See (ab 2013),2017,12,0,0,0
Hohe See (ab 2013),2018,1,11000,4000,15000
Hohe See (ab 2013),2018,2,11000,75000,86000
Hohe See (ab 2013),2018,3,6000,30000,36000
Hohe See (ab 2013),2018,4,0,1000,1000
Hohe See (ab 2013),2018,5,0,0,0
Hohe See (ab 2013),2018,6,39000,44000,83000
Hohe See (ab 2013),2018,7,0,257000,257000
Hohe See (ab 2013),2018,8,2000,201000,203000
Hohe See (ab 2013),2018,9,9000,2000,11000
Hohe See (ab 2013),2018,10,635000,0,635000
Hohe See (ab 2013),2018,11,16000,1000,17000
Hohe See (ab 2013),2018,12,0,0,0
Hohe See (ab 2013),2019,1,3000,30000,33000
Hohe See (ab 2013),2019,2,18000,193000,211000
Hohe See (ab 2013),2019,3,22000,0,22000
Hohe See (ab 2013),2019,4,0,25000,25000
Hohe See (ab 2013),2019,5,0,16000,16000
Hohe See (ab 2013),2019,6,0,2000,2000
Hohe See (ab 2013),2019,7,1000,20000,21000
Hohe See (ab 2013),2019,8,7000,5000,12000
Hohe See (ab 2013),2019,9,0,5000,5000
Hohe See (ab 2013),2019,10,0,1000,1000
Hohe See (ab 2013),2019,11,65000,28000,93000
Hohe See (ab 2013),2019,12,0,0,0
Hohe See (ab 2013),2020,1,39000,23000,62000
Hohe See (ab 2013),2020,2,403000,12000,415000
Hohe See (ab 2013),2020,3,124000,80000,204000
Hohe See (ab 2013),2020,4,18469000,1000,18470000
Hohe See (ab 2013),2020,5,20000,9000,29000
Hohe See (ab 2013),2020,6,35000,3000,38000
Hohe See (ab 2013),2020,7,229000,11000,240000
Hohe See (ab 2013),2020,8,51000,181000,232000
Hohe See (ab 2013),2020,9,708000,363000,1071000
Hohe See (ab 2013),2020,10,360000,85000,445000
Hohe See (ab 2013),2020,11,344000,448000,792000
Hohe See (ab 2013),2020,12,491000,33000,524000
Hohe See (ab 2013),2021,1,95000,5000,100000
Hohe See (ab 2013),2021,2,61000,17000,78000
Hohe See (ab 2013),2021,3,225000,2000,227000
Hohe See (ab 2013),2021,4,23000,27000,50000
Hohe See (ab 2013),2021,5,15000,206000,221000
Hohe See (ab 2013),2021,6,1621000,6000,1627000
Hohe See (ab 2013),2021,7,96000,431000,527000
Hohe See (ab 2013),2021,8,134000,32000,166000
Hohe See (ab 2013),2021,9,94000,8000,102000
Hohe See (ab 2013),2021,10,12000,75000,87000
Hohe See (ab 2013),2021,11,0,2000,2000
Hohe See (ab 2013),2021,12,383000,53000,436000
Hohe See (ab 2013),2022,1,0,50000,50000
Hohe See (ab 2013),2022,2,18000,10000,28000
Hohe See (ab 2013),2022,3,1213000,170000,1383000
Hohe See (ab 2013),2022,4,1659000,169000,1828000
Hohe See (ab 2013),2022,5,60000,22000,82000
Hohe See (ab 2013),2022,6,1953000,1000,1954000
Hohe See (ab 2013),2022,7,16000,19000,35000
Hohe See (ab 2013),2022,8,0,11000,11000
Hohe See (ab 2013),2022,9,1000,60000,61000
Hohe See (ab 2013),2022,10,34000,17000,51000
Hohe See (ab 2013),2022,11,0,14000,14000
Hohe See (ab 2013),2022,12,4000,6000,10000
Hohe See (ab 2013),2023,1,10000,50000,60000
Hohe See (ab 2013),2023,2,0,63000,63000
Hohe See (ab 2013),2023,3,9000,283000,292000
Hohe See (ab 2013),2023,4,0,116000,116000
Hohe See (ab 2013),2023,5,15000,226000,241000
Hohe See (ab 2013),2023,6,293000,199000,492000
Hohe See (ab 2013),2023,7,3000,296000,299000
Hohe See (ab 2013),2023,8,1666000,800000,2466000
Hohe See (ab 2013),2023,9,4000,400000,404000
Hohe See (ab 2013),2023,10,0,1119000,1119000
Hohe See (ab 2013),2023,11,49000,464000,513000
Hohe See (ab 2013),2023,12,31000,509000,540000
Hohe See (ab 2013),2024,1,1000,349000,350000
Hohe See (ab 2013),2024,2,0,526000,526000
Hohe See (ab 2013),2024,3,66000,543000,609000
Hohe See (ab 2013),2024,4,56000,385000,441000
Hohe See (ab 2013),2024,5,81000,811000,892000
Hohe See (ab 2013),2024,6,481000,529000,1010000
Hohe See (ab 2013),2024,7,380000,435000,815000
Hohe See (ab 2013),2024,8,130000,639000,769000
Hohe See (ab 2013),2024,9,40000,511000,551000
Hohe See (ab 2013),2024,10,50000,567000,617000
Hohe See (ab 2013),2024,11,192000,212000,404000
Hohe See (ab 2013),2024,12,0,236000,236000
Honduras,2008,1,7576000,11067000,18643000
Honduras,2008,2,6890000,14209000,21099000
Honduras,2008,3,6497000,15036000,21533000
Honduras,2008,4,12336000,20653000,32989000
Honduras,2008,5,6177000,15531000,21708000
Honduras,2008,6,12423000,19110000,31533000
Honduras,2008,7,5700000,15177000,20877000
Honduras,2008,8,8101000,10899000,19000000
Honduras,2008,9,6053000,10084000,16137000
Honduras,2008,10,4774000,10237000,15011000
Honduras,2008,11,7079000,7645000,14724000
Honduras,2008,12,4181000,8455000,12636000
Honduras,2009,1,5082000,7498000,12580000
Honduras,2009,2,4771000,11235000,16006000
Honduras,2009,3,6793000,22663000,29456000
Honduras,2009,4,3634000,18997000,22631000
Honduras,2009,5,3290000,18165000,21455000
Honduras,2009,6,4713000,21819000,26532000
Honduras,2009,7,5361000,14706000,20067000
Honduras,2009,8,7095000,18511000,25606000
Honduras,2009,9,3218000,17547000,20765000
Honduras,2009,10,4057000,16395000,20452000
Honduras,2009,11,4351000,9789000,14140000
Honduras,2009,12,4133000,12125000,16258000
Honduras,2010,1,4768000,11420000,16188000
Honduras,2010,2,3960000,22565000,26525000
Honduras,2010,3,6908000,23058000,29966000
Honduras,2010,4,4480000,25888000,30368000
Honduras,2010,5,6945000,24465000,31410000
Honduras,2010,6,6799000,35586000,42385000
Honduras,2010,7,6434000,28172000,34606000
Honduras,2010,8,12879000,14995000,27874000
Honduras,2010,9,5806000,7320000,13126000
Honduras,2010,10,9538000,9609000,19147000
Honduras,2010,11,10706000,6617000,17323000
Honduras,2010,12,10780000,6810000,17590000
Honduras,2011,1,7804000,20235000,28039000
Honduras,2011,2,5927000,33177000,39104000
Honduras,2011,3,12594000,50576000,63170000
Honduras,2011,4,7273000,44270000,51543000
Honduras,2011,5,7447000,45313000,52760000
Honduras,2011,6,10208000,45170000,55378000
Honduras,2011,7,10314000,34781000,45095000
Honduras,2011,8,7403000,30650000,38053000
Honduras,2011,9,14552000,18287000,32839000
Honduras,2011,10,10472000,10896000,21368000
Honduras,2011,11,13048000,10647000,23695000
Honduras,2011,12,10837000,13426000,24263000
Honduras,2012,1,8575000,29628000,38203000
Honduras,2012,2,12742000,40810000,53552000
Honduras,2012,3,12039000,67317000,79356000
Honduras,2012,4,6458000,61726000,68184000
Honduras,2012,5,9788000,52064000,61852000
Honduras,2012,6,9507000,46899000,56406000
Honduras,2012,7,10613000,46726000,57339000
Honduras,2012,8,16749000,33841000,50590000
Honduras,2012,9,10628000,28936000,39564000
Honduras,2012,10,11735000,10413000,22148000
Honduras,2012,11,14713000,10574000,25287000
Honduras,2012,12,14503000,22035000,36538000
Honduras,2013,1,8306000,23436000,31742000
Honduras,2013,2,11475000,41302000,52777000
Honduras,2013,3,8013000,39613000,47626000
Honduras,2013,4,11525000,33561000,45086000
Honduras,2013,5,10504000,34412000,44916000
Honduras,2013,6,9701000,32288000,41989000
Honduras,2013,7,10627000,21965000,32592000
Honduras,2013,8,9554000,16250000,25804000
Honduras,2013,9,11241000,10054000,21295000
Honduras,2013,10,7539000,7105000,14644000
Honduras,2013,11,8912000,5141000,14053000
Honduras,2013,12,9595000,5140000,14735000
Honduras,2014,1,8757000,21349000,30106000
Honduras,2014,2,9058000,21308000,30366000
Honduras,2014,3,8741000,39603000,48344000
Honduras,2014,4,9444000,38147000,47591000
Honduras,2014,5,9177000,37712000,46889000
Honduras,2014,6,12828000,39573000,52401000
Honduras,2014,7,11479000,40519000,51998000
Honduras,2014,8,8439000,32700000,41139000
Honduras,2014,9,10533000,23251000,33784000
Honduras,2014,10,10303000,20885000,31188000
Honduras,2014,11,15199000,9057000,24256000
Honduras,2014,12,12159000,10362000,22521000
Honduras,2015,1,11055000,29199000,40254000
Honduras,2015,2,9667000,43156000,52823000
Honduras,2015,3,11509000,50055000,61564000
Honduras,2015,4,14563000,47595000,62158000
Honduras,2015,5,10639000,46861000,57500000
Honduras,2015,6,13711000,61640000,75351000
Honduras,2015,7,9955000,31700000,41655000
Honduras,2015,8,9176000,24091000,33267000
Honduras,2015,9,14580000,22204000,36784000
Honduras,2015,10,13405000,17148000,30553000
Honduras,2015,11,11048000,22481000,33529000
Honduras,2015,12,11043000,17034000,28077000
Honduras,2016,1,9081000,20912000,29993000
Honduras,2016,2,9669000,41055000,50724000
Honduras,2016,3,8189000,43295000,51484000
Honduras,2016,4,10090000,40200000,50290000
Honduras,2016,5,11043000,37388000,48431000
Honduras,2016,6,11250000,42491000,53741000
Honduras,2016,7,9524000,34844000,44368000
Honduras,2016,8,11319000,40160000,51479000
Honduras,2016,9,10524000,21071000,31595000
Honduras,2016,10,9889000,27698000,37587000
Honduras,2016,11,9587000,20688000,30275000
Honduras,2016,12,11785000,26628000,38413000
Honduras,2017,1,8905000,29305000,38210000
Honduras,2017,2,9782000,55066000,64848000
Honduras,2017,3,11084000,44803000,55887000
Honduras,2017,4,9531000,52287000,61818000
Honduras,2017,5,8785000,47927000,56712000
Honduras,2017,6,13713000,59483000,73196000
Honduras,2017,7,9784000,42749000,52533000
Honduras,2017,8,9752000,36228000,45980000
Honduras,2017,9,11914000,20520000,32434000
Honduras,2017,10,8971000,19741000,28712000
Honduras,2017,11,10814000,26759000,37573000
Honduras,2017,12,8243000,15297000,23540000
Honduras,2018,1,9740000,34052000,43792000
Honduras,2018,2,16649000,30567000,47216000
Honduras,2018,3,20026000,32041000,52067000
Honduras,2018,4,9058000,41049000,50107000
Honduras,2018,5,10176000,35174000,45350000
Honduras,2018,6,11235000,37634000,48869000
Honduras,2018,7,21346000,36909000,58255000
Honduras,2018,8,13810000,35511000,49321000
Honduras,2018,9,9565000,16329000,25894000
Honduras,2018,10,14372000,11704000,26076000
Honduras,2018,11,12147000,20875000,33022000
Honduras,2018,12,15258000,11643000,26901000
Honduras,2019,1,11223000,15475000,26698000
Honduras,2019,2,11770000,21216000,32986000
Honduras,2019,3,10348000,38691000,49039000
Honduras,2019,4,13719000,38401000,52120000
Honduras,2019,5,12774000,40183000,52957000
Honduras,2019,6,13289000,36296000,49585000
Honduras,2019,7,11996000,32835000,44831000
Honduras,2019,8,11911000,21977000,33888000
Honduras,2019,9,12180000,23292000,35472000
Honduras,2019,10,14927000,14245000,29172000
Honduras,2019,11,9505000,13558000,23063000
Honduras,2019,12,9888000,12568000,22456000
Honduras,2020,1,10529000,21881000,32410000
Honduras,2020,2,7986000,39705000,47691000
Honduras,2020,3,9591000,46639000,56230000
Honduras,2020,4,9768000,43613000,53381000
Honduras,2020,5,4501000,41955000,46456000
Honduras,2020,6,5790000,49877000,55667000
Honduras,2020,7,6815000,26868000,33683000
Honduras,2020,8,7527000,17331000,24858000
Honduras,2020,9,8404000,17813000,26217000
Honduras,2020,10,10563000,22246000,32809000
Honduras,2020,11,10343000,11016000,21359000
Honduras,2020,12,9737000,12144000,21881000
Honduras,2021,1,8885000,14762000,23647000
Honduras,2021,2,16330000,20976000,37306000
Honduras,2021,3,13410000,31964000,45374000
Honduras,2021,4,17784000,42062000,59846000
Honduras,2021,5,21857000,36753000,58610000
Honduras,2021,6,11127000,42683000,53810000
Honduras,2021,7,16695000,35343000,52038000
Honduras,2021,8,10215000,35920000,46135000
Honduras,2021,9,17066000,34775000,51841000
Honduras,2021,10,11161000,30812000,41973000
Honduras,2021,11,18901000,24192000,43093000
Honduras,2021,12,14657000,20544000,35201000
Honduras,2022,1,10911000,36782000,47693000
Honduras,2022,2,14091000,38489000,52580000
Honduras,2022,3,14570000,57351000,71921000
Honduras,2022,4,15172000,65607000,80779000
Honduras,2022,5,20339000,67848000,88187000
Honduras,2022,6,13109000,43527000,56636000
Honduras,2022,7,18130000,60869000,78999000
Honduras,2022,8,17249000,57282000,74531000
Honduras,2022,9,16370000,38947000,55317000
Honduras,2022,10,13120000,35356000,48476000
Honduras,2022,11,21200000,36154000,57354000
Honduras,2022,12,10803000,12785000,23588000
Honduras,2023,1,19385000,34278000,53663000
Honduras,2023,2,17281000,36384000,53665000
Honduras,2023,3,17712000,48222000,65934000
Honduras,2023,4,15990000,49646000,65636000
Honduras,2023,5,20590000,55532000,76122000
Honduras,2023,6,22245000,58259000,80504000
Honduras,2023,7,18197000,40791000,58988000
Honduras,2023,8,28193000,28506000,56699000
Honduras,2023,9,21195000,27563000,48758000
Honduras,2023,10,14753000,16432000,31185000
Honduras,2023,11,21395000,20595000,41990000
Honduras,2023,12,23533000,12783000,36316000
Honduras,2024,1,21397000,19920000,41317000
Honduras,2024,2,16760000,29219000,45979000
Honduras,2024,3,22368000,33310000,55678000
Honduras,2024,4,22261000,55539000,77800000
Honduras,2024,5,24496000,36438000,60934000
Honduras,2024,6,18896000,43126000,62022000
Honduras,2024,7,29779000,36042000,65821000
Honduras,2024,8,23078000,27153000,50231000
Honduras,2024,9,31747000,24146000,55893000
Honduras,2024,10,26589000,23711000,50300000
Honduras,2024,11,12100000,16781000,28881000
Honduras,2024,12,46834000,16695000,63529000
Hongkong,2008,1,426459000,171932000,598391000
Hongkong,2008,2,385778000,132169000,517947000
Hongkong,2008,3,361202000,132879000,494081000
Hongkong,2008,4,400001000,121296000,521297000
Hongkong,2008,5,382691000,138140000,520831000
Hongkong,2008,6,410598000,123701000,534299000
Hongkong,2008,7,409212000,140213000,549425000
Hongkong,2008,8,333979000,146298000,480277000
Hongkong,2008,9,381311000,158191000,539502000
Hongkong,2008,10,375040000,192292000,567332000
Hongkong,2008,11,307933000,155031000,462964000
Hongkong,2008,12,271653000,137204000,408857000
Hongkong,2009,1,265944000,130178000,396122000
Hongkong,2009,2,281025000,94467000,375492000
Hongkong,2009,3,339148000,122675000,461823000
Hongkong,2009,4,323949000,103229000,427178000
Hongkong,2009,5,313616000,84604000,398220000
Hongkong,2009,6,323391000,84799000,408190000
Hongkong,2009,7,406479000,90117000,496596000
Hongkong,2009,8,312686000,86821000,399507000
Hongkong,2009,9,404700000,107371000,512071000
Hongkong,2009,10,360828000,112425000,473253000
Hongkong,2009,11,371280000,108495000,479775000
Hongkong,2009,12,377363000,95163000,472526000
Hongkong,2010,1,341325000,105892000,447217000
Hongkong,2010,2,394911000,89923000,484834000
Hongkong,2010,3,506051000,135030000,641081000
Hongkong,2010,4,450943000,94904000,545847000
Hongkong,2010,5,468816000,160231000,629047000
Hongkong,2010,6,504652000,130342000,634994000
Hongkong,2010,7,495234000,142268000,637502000
Hongkong,2010,8,455558000,130999000,586557000
Hongkong,2010,9,516759000,157091000,673850000
Hongkong,2010,10,459814000,154763000,614577000
Hongkong,2010,11,514023000,145876000,659899000
Hongkong,2010,12,476601000,119326000,595927000
Hongkong,2011,1,405759000,143871000,549630000
Hongkong,2011,2,478920000,115636000,594556000
Hongkong,2011,3,561418000,138909000,700327000
Hongkong,2011,4,461771000,111445000,573216000
Hongkong,2011,5,528549000,136039000,664588000
Hongkong,2011,6,482407000,152962000,635369000
Hongkong,2011,7,540646000,135088000,675734000
Hongkong,2011,8,492375000,218147000,710522000
Hongkong,2011,9,541870000,152199000,694069000
Hongkong,2011,10,459178000,136232000,595410000
Hongkong,2011,11,468528000,118027000,586555000
Hongkong,2011,12,476079000,120629000,596708000
Hongkong,2012,1,406711000,130301000,537012000
Hongkong,2012,2,504396000,108384000,612780000
Hongkong,2012,3,553794000,118572000,672366000
Hongkong,2012,4,466650000,110437000,577087000
Hongkong,2012,5,502507000,120385000,622892000
Hongkong,2012,6,508979000,149351000,658330000
Hongkong,2012,7,506794000,130080000,636874000
Hongkong,2012,8,509976000,138119000,648095000
Hongkong,2012,9,482981000,151367000,634348000
Hongkong,2012,10,481198000,168638000,649836000
Hongkong,2012,11,575944000,126292000,702236000
Hongkong,2012,12,436796000,117526000,554322000
Hongkong,2013,1,481277000,128973000,610250000
Hongkong,2013,2,403880000,100115000,503995000
Hongkong,2013,3,493233000,137259000,630492000
Hongkong,2013,4,517430000,115360000,632790000
Hongkong,2013,5,462612000,114250000,576862000
Hongkong,2013,6,479307000,112578000,591885000
Hongkong,2013,7,495204000,141210000,636414000
Hongkong,2013,8,446808000,115787000,562595000
Hongkong,2013,9,490991000,230175000,721166000
Hongkong,2013,10,445625000,139513000,585138000
Hongkong,2013,11,492411000,114699000,607110000
Hongkong,2013,12,412036000,96828000,508864000
Hongkong,2014,1,429185000,133080000,562265000
Hongkong,2014,2,427970000,90750000,518720000
Hongkong,2014,3,568520000,155373000,723893000
Hongkong,2014,4,458107000,106442000,564549000
Hongkong,2014,5,467557000,107863000,575420000
Hongkong,2014,6,511469000,135893000,647362000
Hongkong,2014,7,596158000,133466000,729624000
Hongkong,2014,8,480973000,120039000,601012000
Hongkong,2014,9,526208000,144604000,670812000
Hongkong,2014,10,504508000,132848000,637356000
Hongkong,2014,11,446228000,123808000,570036000
Hongkong,2014,12,458582000,129708000,588290000
Hongkong,2015,1,423617000,150014000,573631000
Hongkong,2015,2,418062000,128910000,546972000
Hongkong,2015,3,504700000,160280000,664980000
Hongkong,2015,4,502349000,118699000,621048000
Hongkong,2015,5,463811000,123541000,587352000
Hongkong,2015,6,551876000,144025000,695901000
Hongkong,2015,7,523334000,149895000,673229000
Hongkong,2015,8,451069000,143687000,594756000
Hongkong,2015,9,539491000,175103000,714594000
Hongkong,2015,10,519841000,159888000,679729000
Hongkong,2015,11,492498000,144852000,637350000
Hongkong,2015,12,463799000,130621000,594420000
Hongkong,2016,1,400583000,175133000,575716000
Hongkong,2016,2,445062000,118495000,563557000
Hongkong,2016,3,477896000,137519000,615415000
Hongkong,2016,4,603088000,102701000,705789000
Hongkong,2016,5,427813000,117541000,545354000
Hongkong,2016,6,487910000,146864000,634774000
Hongkong,2016,7,460073000,112414000,572487000
Hongkong,2016,8,607145000,129083000,736228000
Hongkong,2016,9,504087000,141618000,645705000
Hongkong,2016,10,1237831000,131035000,1368866000
Hongkong,2016,11,562057000,126310000,688367000
Hongkong,2016,12,538328000,119475000,657803000
Hongkong,2017,1,433515000,137654000,571169000
Hongkong,2017,2,498350000,101634000,599984000
Hongkong,2017,3,613771000,118492000,732263000
Hongkong,2017,4,439547000,99238000,538785000
Hongkong,2017,5,495077000,114074000,609151000
Hongkong,2017,6,576034000,105473000,681507000
Hongkong,2017,7,484363000,98948000,583311000
Hongkong,2017,8,477892000,108364000,586256000
Hongkong,2017,9,1229537000,117873000,1347410000
Hongkong,2017,10,512247000,100278000,612525000
Hongkong,2017,11,535503000,102084000,637587000
Hongkong,2017,12,570032000,97379000,667411000
Hongkong,2018,1,458027000,123493000,581520000
Hongkong,2018,2,457607000,98855000,556462000
Hongkong,2018,3,555303000,123757000,679060000
Hongkong,2018,4,478663000,109297000,587960000
Hongkong,2018,5,477345000,114782000,592127000
Hongkong,2018,6,576797000,116303000,693100000
Hongkong,2018,7,514204000,125851000,640055000
Hongkong,2018,8,548027000,115295000,663322000
Hongkong,2018,9,548484000,196976000,745460000
Hongkong,2018,10,515306000,145598000,660904000
Hongkong,2018,11,511467000,107161000,618628000
Hongkong,2018,12,422648000,85812000,508460000
Hongkong,2019,1,488059000,142511000,630570000
Hongkong,2019,2,448035000,96776000,544811000
Hongkong,2019,3,625953000,125859000,751812000
Hongkong,2019,4,498072000,111100000,609172000
Hongkong,2019,5,505868000,104106000,609974000
Hongkong,2019,6,463633000,104400000,568033000
Hongkong,2019,7,503973000,113143000,617116000
Hongkong,2019,8,480655000,110956000,591611000
Hongkong,2019,9,474061000,115894000,589955000
Hongkong,2019,10,493492000,109251000,602743000
Hongkong,2019,11,463521000,101963000,565484000
Hongkong,2019,12,444177000,94718000,538895000
Hongkong,2020,1,406549000,119849000,526398000
Hongkong,2020,2,451618000,76936000,528554000
Hongkong,2020,3,441291000,331956000,773247000
Hongkong,2020,4,439160000,193229000,632389000
Hongkong,2020,5,350802000,118602000,469404000
Hongkong,2020,6,388421000,131807000,520228000
Hongkong,2020,7,557986000,100497000,658483000
Hongkong,2020,8,444706000,126075000,570781000
Hongkong,2020,9,534963000,103700000,638663000
Hongkong,2020,10,540605000,100421000,641026000
Hongkong,2020,11,559566000,100594000,660160000
Hongkong,2020,12,439245000,97446000,536691000
Hongkong,2021,1,430950000,116659000,547609000
Hongkong,2021,2,414969000,93887000,508856000
Hongkong,2021,3,530637000,130511000,661148000
Hongkong,2021,4,422478000,100908000,523386000
Hongkong,2021,5,429459000,109867000,539326000
Hongkong,2021,6,461765000,114164000,575929000
Hongkong,2021,7,512630000,107257000,619887000
Hongkong,2021,8,450805000,125132000,575937000
Hongkong,2021,9,473551000,126541000,600092000
Hongkong,2021,10,455111000,151958000,607069000
Hongkong,2021,11,493845000,120917000,614762000
Hongkong,2021,12,458629000,138367000,596996000
Hongkong,2022,1,407206000,137301000,544507000
Hongkong,2022,2,433951000,114339000,548290000
Hongkong,2022,3,671477000,114420000,785897000
Hongkong,2022,4,477155000,116174000,593329000
Hongkong,2022,5,633649000,135324000,768973000
Hongkong,2022,6,705904000,140389000,846293000
Hongkong,2022,7,532824000,121145000,653969000
Hongkong,2022,8,520839000,125617000,646456000
Hongkong,2022,9,528527000,135079000,663606000
Hongkong,2022,10,447599000,123221000,570820000
Hongkong,2022,11,525479000,143593000,669072000
Hongkong,2022,12,479528000,94134000,573662000
Hongkong,2023,1,360391000,94008000,454399000
Hongkong,2023,2,655011000,86351000,741362000
Hongkong,2023,3,745898000,139783000,885681000
Hongkong,2023,4,496653000,94258000,590911000
Hongkong,2023,5,463183000,102815000,565998000
Hongkong,2023,6,604446000,119182000,723628000
Hongkong,2023,7,441140000,106199000,547339000
Hongkong,2023,8,536113000,93975000,630088000
Hongkong,2023,9,521714000,111188000,632902000
Hongkong,2023,10,433965000,110436000,544401000
Hongkong,2023,11,553365000,90346000,643711000
Hongkong,2023,12,444591000,77823000,522414000
Hongkong,2024,1,422595000,79891000,502486000
Hongkong,2024,2,535910000,77367000,613277000
Hongkong,2024,3,436010000,92939000,528949000
Hongkong,2024,4,449167000,78555000,527722000
Hongkong,2024,5,416776000,94199000,510975000
Hongkong,2024,6,481560000,93476000,575036000
Hongkong,2024,7,457782000,88165000,545947000
Hongkong,2024,8,436640000,72411000,509051000
Hongkong,2024,9,550002000,85825000,635827000
Hongkong,2024,10,519836000,163841000,683677000
Hongkong,2024,11,431969000,125889000,557858000
Hongkong,2024,12,584126000,72715000,656841000
Indien,2008,1,643097000,456674000,1099771000
Indien,2008,2,694545000,457297000,1151842000
Indien,2008,3,612063000,431202000,1043265000
Indien,2008,4,709788000,468945000,1178733000
Indien,2008,5,707363000,390414000,1097777000
Indien,2008,6,729580000,432170000,1161750000
Indien,2008,7,704082000,470862000,1174944000
Indien,2008,8,666396000,431826000,1098222000
Indien,2008,9,696119000,466507000,1162626000
Indien,2008,10,720809000,484512000,1205321000
Indien,2008,11,560583000,409192000,969775000
Indien,2008,12,747290000,381589000,1128879000
Indien,2009,1,543408000,486732000,1030140000
Indien,2009,2,603736000,427033000,1030769000
Indien,2009,3,658961000,517050000,1176011000
Indien,2009,4,609314000,495636000,1104950000
Indien,2009,5,566708000,392800000,959508000
Indien,2009,6,631621000,401468000,1033089000
Indien,2009,7,774343000,411547000,1185890000
Indien,2009,8,701838000,369725000,1071563000
Indien,2009,9,652536000,430308000,1082844000
Indien,2009,10,673772000,412752000,1086524000
Indien,2009,11,760486000,392715000,1153201000
Indien,2009,12,917633000,360853000,1278486000
Indien,2010,1,636021000,440070000,1076091000
Indien,2010,2,721747000,420325000,1142072000
Indien,2010,3,762612000,558512000,1321124000
Indien,2010,4,697259000,498055000,1195314000
Indien,2010,5,688498000,491257000,1179755000
Indien,2010,6,806063000,502153000,1308216000
Indien,2010,7,749675000,522626000,1272301000
Indien,2010,8,810191000,540451000,1350642000
Indien,2010,9,813526000,584037000,1397563000
Indien,2010,10,836782000,574647000,1411429000
Indien,2010,11,855963000,607766000,1463729000
Indien,2010,12,903408000,500729000,1404137000
Indien,2011,1,754230000,643808000,1398038000
Indien,2011,2,901843000,606455000,1508298000
Indien,2011,3,988713000,726321000,1715034000
Indien,2011,4,772845000,613630000,1386475000
Indien,2011,5,882667000,721120000,1603787000
Indien,2011,6,869285000,630033000,1499318000
Indien,2011,7,867936000,594839000,1462775000
Indien,2011,8,941717000,653140000,1594857000
Indien,2011,9,985917000,606745000,1592662000
Indien,2011,10,883361000,603452000,1486813000
Indien,2011,11,900424000,616984000,1517408000
Indien,2011,12,1106634000,519563000,1626197000
Indien,2012,1,870964000,671427000,1542391000
Indien,2012,2,928427000,611951000,1540378000
Indien,2012,3,1053160000,653679000,1706839000
Indien,2012,4,761121000,561497000,1322618000
Indien,2012,5,868455000,567821000,1436276000
Indien,2012,6,805721000,566957000,1372678000
Indien,2012,7,940398000,632330000,1572728000
Indien,2012,8,890477000,634207000,1524684000
Indien,2012,9,810665000,525514000,1336179000
Indien,2012,10,862278000,576101000,1438379000
Indien,2012,11,792363000,562507000,1354870000
Indien,2012,12,836982000,458408000,1295390000
Indien,2013,1,832302000,632121000,1464423000
Indien,2013,2,762294000,578173000,1340467000
Indien,2013,3,784229000,618886000,1403115000
Indien,2013,4,865589000,643360000,1508949000
Indien,2013,5,749732000,605340000,1355072000
Indien,2013,6,785191000,565082000,1350273000
Indien,2013,7,789395000,593710000,1383105000
Indien,2013,8,659896000,597941000,1257837000
Indien,2013,9,724678000,578366000,1303044000
Indien,2013,10,798762000,568790000,1367552000
Indien,2013,11,636750000,529401000,1166151000
Indien,2013,12,757674000,457186000,1214860000
Indien,2014,1,719384000,636093000,1355477000
Indien,2014,2,691222000,568774000,1259996000
Indien,2014,3,698049000,643026000,1341075000
Indien,2014,4,641084000,610444000,1251528000
Indien,2014,5,682898000,579228000,1262126000
Indien,2014,6,681658000,585107000,1266765000
Indien,2014,7,866560000,631357000,1497917000
Indien,2014,8,756565000,595704000,1352269000
Indien,2014,9,832361000,604878000,1437239000
Indien,2014,10,788017000,601444000,1389461000
Indien,2014,11,755284000,528835000,1284119000
Indien,2014,12,780879000,502180000,1283059000
Indien,2015,1,754083000,677326000,1431409000
Indien,2015,2,824136000,626137000,1450273000
Indien,2015,3,939002000,710791000,1649793000
Indien,2015,4,778711000,687964000,1466675000
Indien,2015,5,750390000,604226000,1354616000
Indien,2015,6,845138000,642235000,1487373000
Indien,2015,7,946244000,658264000,1604508000
Indien,2015,8,759886000,630357000,1390243000
Indien,2015,9,773879000,614222000,1388101000
Indien,2015,10,752713000,614032000,1366745000
Indien,2015,11,771772000,577210000,1348982000
Indien,2015,12,838309000,541266000,1379575000
Indien,2016,1,604533000,640259000,1244792000
Indien,2016,2,793124000,661226000,1454350000
Indien,2016,3,863851000,696054000,1559905000
Indien,2016,4,800600000,687053000,1487653000
Indien,2016,5,785693000,624002000,1409695000
Indien,2016,6,875010000,636387000,1511397000
Indien,2016,7,828296000,625196000,1453492000
Indien,2016,8,826353000,660482000,1486835000
Indien,2016,9,811154000,642843000,1453997000
Indien,2016,10,800602000,611606000,1412208000
Indien,2016,11,829608000,617806000,1447414000
Indien,2016,12,964896000,549946000,1514842000
Indien,2017,1,818012000,685770000,1503782000
Indien,2017,2,841434000,690939000,1532373000
Indien,2017,3,1025956000,787191000,1813147000
Indien,2017,4,742106000,708950000,1451056000
Indien,2017,5,989498000,816981000,1806479000
Indien,2017,6,889607000,719836000,1609443000
Indien,2017,7,793115000,690726000,1483841000
Indien,2017,8,869781000,734291000,1604072000
Indien,2017,9,831471000,682217000,1513688000
Indien,2017,10,799698000,685147000,1484845000
Indien,2017,11,1135201000,713533000,1848734000
Indien,2017,12,947260000,573508000,1520768000
Indien,2018,1,858734000,766740000,1625474000
Indien,2018,2,854275000,726554000,1580829000
Indien,2018,3,936163000,745810000,1681973000
Indien,2018,4,1018914000,804232000,1823146000
Indien,2018,5,964062000,743897000,1707959000
Indien,2018,6,1084803000,738793000,1823596000
Indien,2018,7,1120246000,786038000,1906284000
Indien,2018,8,1166407000,756558000,1922965000
Indien,2018,9,1297001000,747198000,2044199000
Indien,2018,10,1188617000,775662000,1964279000
Indien,2018,11,994868000,757145000,1752013000
Indien,2018,12,1014960000,577665000,1592625000
Indien,2019,1,910126000,844909000,1755035000
Indien,2019,2,932515000,776284000,1708799000
Indien,2019,3,972911000,888247000,1861158000
Indien,2019,4,995043000,831858000,1826901000
Indien,2019,5,1168904000,836770000,2005674000
Indien,2019,6,831973000,718755000,1550728000
Indien,2019,7,955752000,831087000,1786839000
Indien,2019,8,785480000,779676000,1565156000
Indien,2019,9,989732000,757149000,1746881000
Indien,2019,10,953708000,756905000,1710613000
Indien,2019,11,1075415000,770551000,1845966000
Indien,2019,12,1351750000,604226000,1955976000
Indien,2020,1,804687000,958646000,1763333000
Indien,2020,2,1084965000,726727000,1811692000
Indien,2020,3,918431000,862906000,1781337000
Indien,2020,4,456355000,685838000,1142193000
Indien,2020,5,533334000,413205000,946539000
Indien,2020,6,913011000,596581000,1509592000
Indien,2020,7,950624000,746890000,1697514000
Indien,2020,8,600410000,769157000,1369567000
Indien,2020,9,1230213000,811751000,2041964000
Indien,2020,10,1020897000,841439000,1862336000
Indien,2020,11,1077860000,822229000,1900089000
Indien,2020,12,1067399000,672414000,1739813000
Indien,2021,1,722492000,829489000,1551981000
Indien,2021,2,990325000,867994000,1858319000
Indien,2021,3,1312531000,908482000,2221013000
Indien,2021,4,1047841000,978002000,2025843000
Indien,2021,5,808541000,922925000,1731466000
Indien,2021,6,933812000,830335000,1764147000
Indien,2021,7,919918000,931356000,1851274000
Indien,2021,8,1011786000,779640000,1791426000
Indien,2021,9,1122754000,924696000,2047450000
Indien,2021,10,997899000,1055836000,2053735000
Indien,2021,11,1194358000,965095000,2159453000
Indien,2021,12,1367240000,884703000,2251943000
Indien,2022,1,960746000,1124283000,2085029000
Indien,2022,2,1127346000,1035546000,2162892000
Indien,2022,3,1189266000,1318763000,2508029000
Indien,2022,4,1150557000,1203693000,2354250000
Indien,2022,5,1385391000,1379711000,2765102000
Indien,2022,6,1352534000,1196342000,2548876000
Indien,2022,7,1039238000,1325062000,2364300000
Indien,2022,8,1104827000,1599955000,2704782000
Indien,2022,9,1423305000,1324691000,2747996000
Indien,2022,10,1210051000,1267002000,2477053000
Indien,2022,11,1507533000,1301311000,2808844000
Indien,2022,12,1426721000,1013562000,2440283000
Indien,2023,1,1290414000,1318219000,2608633000
Indien,2023,2,1368115000,1163245000,2531360000
Indien,2023,3,1582367000,1386875000,2969242000
Indien,2023,4,1200764000,1206801000,2407565000
Indien,2023,5,1623640000,1234455000,2858095000
Indien,2023,6,1468945000,1272162000,2741107000
Indien,2023,7,1354409000,1111749000,2466158000
Indien,2023,8,1427047000,1153182000,2580229000
Indien,2023,9,1253102000,1111106000,2364208000
Indien,2023,10,1360723000,1110873000,2471596000
Indien,2023,11,1310941000,1137136000,2448077000
Indien,2023,12,1266742000,1061211000,2327953000
Indien,2024,1,1045398000,1083165000,2128563000
Indien,2024,2,1268825000,1037289000,2306114000
Indien,2024,3,1234215000,1165208000,2399423000
Indien,2024,4,1247717000,1300855000,2548572000
Indien,2024,5,1247318000,1229028000,2476346000
Indien,2024,6,1363147000,1162007000,2525154000
Indien,2024,7,1583836000,1269270000,2853106000
Indien,2024,8,1575647000,1049907000,2625554000
Indien,2024,9,1628216000,1060237000,2688453000
Indien,2024,10,1412701000,1294111000,2706812000
Indien,2024,11,1584600000,1391022000,2975622000
Indien,2024,12,1739148000,963210000,2702358000
Indonesien,2008,1,127195000,257804000,384999000
Indonesien,2008,2,131373000,245089000,376462000
Indonesien,2008,3,145107000,281531000,426638000
Indonesien,2008,4,155540000,284164000,439704000
Indonesien,2008,5,128474000,278441000,406915000
Indonesien,2008,6,194390000,226708000,421098000
Indonesien,2008,7,187385000,249010000,436395000
Indonesien,2008,8,144531000,254471000,399002000
Indonesien,2008,9,140470000,259771000,400241000
Indonesien,2008,10,158817000,304951000,463768000
Indonesien,2008,11,121899000,271621000,393520000
Indonesien,2008,12,131896000,228720000,360616000
Indonesien,2009,1,113023000,262895000,375918000
Indonesien,2009,2,117171000,212748000,329919000
Indonesien,2009,3,116450000,229476000,345926000
Indonesien,2009,4,115476000,217183000,332659000
Indonesien,2009,5,109455000,209283000,318738000
Indonesien,2009,6,135890000,202726000,338616000
Indonesien,2009,7,148527000,209956000,358483000
Indonesien,2009,8,113878000,276469000,390347000
Indonesien,2009,9,107939000,264536000,372475000
Indonesien,2009,10,123210000,236941000,360151000
Indonesien,2009,11,149971000,213187000,363158000
Indonesien,2009,12,150459000,192215000,342674000
Indonesien,2010,1,121685000,252299000,373984000
Indonesien,2010,2,137068000,270611000,407679000
Indonesien,2010,3,188469000,295876000,484345000
Indonesien,2010,4,157089000,280591000,437680000
Indonesien,2010,5,132019000,254309000,386328000
Indonesien,2010,6,182321000,317031000,499352000
Indonesien,2010,7,169830000,342398000,512228000
Indonesien,2010,8,190765000,325292000,516057000
Indonesien,2010,9,190625000,332854000,523479000
Indonesien,2010,10,181825000,278192000,460017000
Indonesien,2010,11,179420000,334612000,514032000
Indonesien,2010,12,177800000,334110000,511910000
Indonesien,2011,1,149227000,403094000,552321000
Indonesien,2011,2,168373000,373202000,541575000
Indonesien,2011,3,182745000,430532000,613277000
Indonesien,2011,4,186696000,298125000,484821000
Indonesien,2011,5,196090000,352332000,548422000
Indonesien,2011,6,164573000,359553000,524126000
Indonesien,2011,7,165212000,356788000,522000000
Indonesien,2011,8,178387000,431140000,609527000
Indonesien,2011,9,180076000,331132000,511208000
Indonesien,2011,10,165891000,297332000,463223000
Indonesien,2011,11,180489000,293987000,474476000
Indonesien,2011,12,210932000,308736000,519668000
Indonesien,2012,1,179245000,342561000,521806000
Indonesien,2012,2,237799000,355947000,593746000
Indonesien,2012,3,231542000,344409000,575951000
Indonesien,2012,4,258679000,290780000,549459000
Indonesien,2012,5,218980000,314344000,533324000
Indonesien,2012,6,298586000,304393000,602979000
Indonesien,2012,7,254160000,327955000,582115000
Indonesien,2012,8,254738000,318030000,572768000
Indonesien,2012,9,253320000,346765000,600085000
Indonesien,2012,10,319276000,391209000,710485000
Indonesien,2012,11,338064000,294824000,632888000
Indonesien,2012,12,368151000,323388000,691539000
Indonesien,2013,1,287192000,337818000,625010000
Indonesien,2013,2,268706000,316833000,585539000
Indonesien,2013,3,300436000,271869000,572305000
Indonesien,2013,4,374419000,347673000,722092000
Indonesien,2013,5,301483000,290331000,591814000
Indonesien,2013,6,182510000,285870000,468380000
Indonesien,2013,7,234748000,293800000,528548000
Indonesien,2013,8,200512000,323453000,523965000
Indonesien,2013,9,284655000,284976000,569631000
Indonesien,2013,10,211199000,313121000,524320000
Indonesien,2013,11,222257000,285297000,507554000
Indonesien,2013,12,256266000,226893000,483159000
Indonesien,2014,1,177912000,331299000,509211000
Indonesien,2014,2,200462000,295279000,495741000
Indonesien,2014,3,245277000,312611000,557888000
Indonesien,2014,4,239490000,276948000,516438000
Indonesien,2014,5,218550000,279115000,497665000
Indonesien,2014,6,190945000,279123000,470068000
Indonesien,2014,7,212680000,296200000,508880000
Indonesien,2014,8,335928000,338123000,674051000
Indonesien,2014,9,267981000,300630000,568611000
Indonesien,2014,10,231441000,333778000,565219000
Indonesien,2014,11,293947000,286911000,580858000
Indonesien,2014,12,336107000,271120000,607227000
Indonesien,2015,1,205458000,332518000,537976000
Indonesien,2015,2,211820000,309924000,521744000
Indonesien,2015,3,233695000,356868000,590563000
Indonesien,2015,4,205984000,316465000,522449000
Indonesien,2015,5,236218000,287676000,523894000
Indonesien,2015,6,218875000,400241000,619116000
Indonesien,2015,7,272248000,344605000,616853000
Indonesien,2015,8,196923000,326334000,523257000
Indonesien,2015,9,196175000,333783000,529958000
Indonesien,2015,10,211340000,319310000,530650000
Indonesien,2015,11,245175000,309543000,554718000
Indonesien,2015,12,220981000,313402000,534383000
Indonesien,2016,1,160368000,362266000,522634000
Indonesien,2016,2,166748000,333166000,499914000
Indonesien,2016,3,204113000,344927000,549040000
Indonesien,2016,4,203842000,325046000,528888000
Indonesien,2016,5,175611000,303111000,478722000
Indonesien,2016,6,214961000,320011000,534972000
Indonesien,2016,7,211300000,299084000,510384000
Indonesien,2016,8,225499000,283271000,508770000
Indonesien,2016,9,198624000,319184000,517808000
Indonesien,2016,10,183612000,321046000,504658000
Indonesien,2016,11,231513000,323659000,555172000
Indonesien,2016,12,246561000,315306000,561867000
Indonesien,2017,1,171066000,351165000,522231000
Indonesien,2017,2,214161000,304732000,518893000
Indonesien,2017,3,342605000,399694000,742299000
Indonesien,2017,4,169666000,305494000,475160000
Indonesien,2017,5,193245000,367295000,560540000
Indonesien,2017,6,195192000,320302000,515494000
Indonesien,2017,7,205426000,320882000,526308000
Indonesien,2017,8,224992000,308608000,533600000
Indonesien,2017,9,240080000,302861000,542941000
Indonesien,2017,10,235187000,329301000,564488000
Indonesien,2017,11,249941000,345896000,595837000
Indonesien,2017,12,251690000,289553000,541243000
Indonesien,2018,1,366192000,342201000,708393000
Indonesien,2018,2,213408000,270480000,483888000
Indonesien,2018,3,272870000,327497000,600367000
Indonesien,2018,4,197366000,340448000,537814000
Indonesien,2018,5,221130000,300433000,521563000
Indonesien,2018,6,207740000,297861000,505601000
Indonesien,2018,7,234817000,376773000,611590000
Indonesien,2018,8,288940000,306111000,595051000
Indonesien,2018,9,205926000,304250000,510176000
Indonesien,2018,10,207706000,320759000,528465000
Indonesien,2018,11,216758000,345882000,562640000
Indonesien,2018,12,231141000,273366000,504507000
Indonesien,2019,1,210766000,337427000,548193000
Indonesien,2019,2,185816000,295882000,481698000
Indonesien,2019,3,221634000,293637000,515271000
Indonesien,2019,4,240518000,314805000,555323000
Indonesien,2019,5,221787000,287897000,509684000
Indonesien,2019,6,258035000,258289000,516324000
Indonesien,2019,7,264077000,287293000,551370000
Indonesien,2019,8,205036000,299550000,504586000
Indonesien,2019,9,198620000,292571000,491191000
Indonesien,2019,10,234255000,328830000,563085000
Indonesien,2019,11,215887000,316249000,532136000
Indonesien,2019,12,310143000,243072000,553215000
Indonesien,2020,1,181565000,360281000,541846000
Indonesien,2020,2,175740000,267695000,443435000
Indonesien,2020,3,196312000,358402000,554714000
Indonesien,2020,4,180915000,255032000,435947000
Indonesien,2020,5,153478000,308748000,462226000
Indonesien,2020,6,185113000,247802000,432915000
Indonesien,2020,7,178304000,270137000,448441000
Indonesien,2020,8,153514000,351189000,504703000
Indonesien,2020,9,161452000,282004000,443456000
Indonesien,2020,10,183771000,288753000,472524000
Indonesien,2020,11,191703000,249531000,441234000
Indonesien,2020,12,159266000,305739000,465005000
Indonesien,2021,1,169858000,341605000,511463000
Indonesien,2021,2,189610000,257937000,447547000
Indonesien,2021,3,171592000,324881000,496473000
Indonesien,2021,4,171227000,352947000,524174000
Indonesien,2021,5,149591000,304126000,453717000
Indonesien,2021,6,157256000,369961000,527217000
Indonesien,2021,7,222002000,321414000,543416000
Indonesien,2021,8,192537000,290324000,482861000
Indonesien,2021,9,230330000,368054000,598384000
Indonesien,2021,10,230941000,336323000,567264000
Indonesien,2021,11,324159000,438446000,762605000
Indonesien,2021,12,268303000,375469000,643772000
Indonesien,2022,1,255186000,387371000,642557000
Indonesien,2022,2,198605000,366281000,564886000
Indonesien,2022,3,232172000,503068000,735240000
Indonesien,2022,4,174688000,448655000,623343000
Indonesien,2022,5,204535000,474181000,678716000
Indonesien,2022,6,275024000,437629000,712653000
Indonesien,2022,7,205890000,383935000,589825000
Indonesien,2022,8,274924000,502360000,777284000
Indonesien,2022,9,268735000,580020000,848755000
Indonesien,2022,10,252831000,468649000,721480000
Indonesien,2022,11,358452000,548668000,907120000
Indonesien,2022,12,346506000,392014000,738520000
Indonesien,2023,1,260580000,491032000,751612000
Indonesien,2023,2,214414000,395468000,609882000
Indonesien,2023,3,362135000,499157000,861292000
Indonesien,2023,4,320114000,341539000,661653000
Indonesien,2023,5,258961000,338279000,597240000
Indonesien,2023,6,457519000,394235000,851754000
Indonesien,2023,7,280373000,395766000,676139000
Indonesien,2023,8,260419000,307145000,567564000
Indonesien,2023,9,214724000,317186000,531910000
Indonesien,2023,10,279820000,368290000,648110000
Indonesien,2023,11,263932000,341028000,604960000
Indonesien,2023,12,218334000,293010000,511344000
Indonesien,2024,1,204377000,267296000,471673000
Indonesien,2024,2,187289000,386316000,573605000
Indonesien,2024,3,218566000,312113000,530679000
Indonesien,2024,4,192343000,434723000,627066000
Indonesien,2024,5,297451000,341201000,638652000
Indonesien,2024,6,252072000,309073000,561145000
Indonesien,2024,7,273633000,369498000,643131000
Indonesien,2024,8,296717000,419956000,716673000
Indonesien,2024,9,239783000,388807000,628590000
Indonesien,2024,10,223332000,373877000,597209000
Indonesien,2024,11,267405000,449026000,716431000
Indonesien,2024,12,202069000,366816000,568885000
Irak,2008,1,38474000,25085000,63559000
Irak,2008,2,29023000,71000,29094000
Irak,2008,3,18884000,52000,18936000
Irak,2008,4,21564000,232000,21796000
Irak,2008,5,21759000,52000,21811000
Irak,2008,6,23900000,18293000,42193000
Irak,2008,7,21690000,11802000,33492000
Irak,2008,8,22924000,7335000,30259000
Irak,2008,9,23174000,36384000,59558000
Irak,2008,10,22074000,29546000,51620000
Irak,2008,11,21417000,6299000,27716000
Irak,2008,12,39613000,3228000,42841000
Irak,2009,1,31160000,1393000,32553000
Irak,2009,2,40197000,272000,40469000
Irak,2009,3,48924000,175000,49099000
Irak,2009,4,29174000,9751000,38925000
Irak,2009,5,91348000,14070000,105418000
Irak,2009,6,59087000,4222000,63309000
Irak,2009,7,34196000,17903000,52099000
Irak,2009,8,33433000,17878000,51311000
Irak,2009,9,45505000,9779000,55284000
Irak,2009,10,51996000,119000,52115000
Irak,2009,11,66743000,8606000,75349000
Irak,2009,12,68832000,44000,68876000
Irak,2010,1,47664000,177000,47841000
Irak,2010,2,43512000,123000,43635000
Irak,2010,3,61631000,23848000,85479000
Irak,2010,4,47978000,21115000,69093000
Irak,2010,5,46151000,6025000,52176000
Irak,2010,6,50381000,15603000,65984000
Irak,2010,7,144209000,25099000,169308000
Irak,2010,8,117948000,28885000,146833000
Irak,2010,9,155269000,17115000,172384000
Irak,2010,10,42814000,119000,42933000
Irak,2010,11,50696000,22666000,73362000
Irak,2010,12,90886000,8000,90894000
Irak,2011,1,89790000,350000,90140000
Irak,2011,2,57823000,943000,58766000
Irak,2011,3,99665000,1233000,100898000
Irak,2011,4,47688000,353000,48041000
Irak,2011,5,90033000,46994000,137027000
Irak,2011,6,72519000,40364000,112883000
Irak,2011,7,57313000,78402000,135715000
Irak,2011,8,94478000,30872000,125350000
Irak,2011,9,137172000,31603000,168775000
Irak,2011,10,106721000,50559000,157280000
Irak,2011,11,129492000,27553000,157045000
Irak,2011,12,142853000,50792000,193645000
Irak,2012,1,68778000,26831000,95609000
Irak,2012,2,58124000,40663000,98787000
Irak,2012,3,166090000,20800000,186890000
Irak,2012,4,62120000,39504000,101624000
Irak,2012,5,109558000,17646000,127204000
Irak,2012,6,87568000,216000,87784000
Irak,2012,7,99490000,29224000,128714000
Irak,2012,8,163435000,148407000,311842000
Irak,2012,9,116627000,99143000,215770000
Irak,2012,10,79765000,48668000,128433000
Irak,2012,11,98915000,20208000,119123000
Irak,2012,12,158892000,24270000,183162000
Irak,2013,1,130855000,623000,131478000
Irak,2013,2,94026000,36707000,130733000
Irak,2013,3,181386000,3491000,184877000
Irak,2013,4,114553000,8787000,123340000
Irak,2013,5,170057000,23407000,193464000
Irak,2013,6,93780000,25865000,119645000
Irak,2013,7,94955000,46576000,141531000
Irak,2013,8,101016000,28861000,129877000
Irak,2013,9,94757000,49843000,144600000
Irak,2013,10,67187000,145733000,212920000
Irak,2013,11,111471000,30115000,141586000
Irak,2013,12,134362000,45051000,179413000
Irak,2014,1,70328000,27103000,97431000
Irak,2014,2,105444000,53006000,158450000
Irak,2014,3,97991000,153000,98144000
Irak,2014,4,128342000,22576000,150918000
Irak,2014,5,91478000,31313000,122791000
Irak,2014,6,96231000,3727000,99958000
Irak,2014,7,89488000,38794000,128282000
Irak,2014,8,61208000,43494000,104702000
Irak,2014,9,90772000,41181000,131953000
Irak,2014,10,125194000,53707000,178901000
Irak,2014,11,84886000,63093000,147979000
Irak,2014,12,108439000,59897000,168336000
Irak,2015,1,94642000,4708000,99350000
Irak,2015,2,76418000,8274000,84692000
Irak,2015,3,105756000,138000,105894000
Irak,2015,4,95832000,649000,96481000
Irak,2015,5,56074000,12472000,68546000
Irak,2015,6,131014000,43512000,174526000
Irak,2015,7,82228000,10221000,92449000
Irak,2015,8,62638000,50098000,112736000
Irak,2015,9,61885000,89254000,151139000
Irak,2015,10,60179000,67226000,127405000
Irak,2015,11,75055000,65558000,140613000
Irak,2015,12,91263000,97701000,188964000
Irak,2016,1,51060000,44795000,95855000
Irak,2016,2,59782000,34132000,93914000
Irak,2016,3,58554000,18931000,77485000
Irak,2016,4,59985000,26713000,86698000
Irak,2016,5,51976000,83822000,135798000
Irak,2016,6,64390000,30488000,94878000
Irak,2016,7,45084000,38730000,83814000
Irak,2016,8,45666000,41356000,87022000
Irak,2016,9,61455000,78119000,139574000
Irak,2016,10,52299000,89874000,142173000
Irak,2016,11,70690000,80490000,151180000
Irak,2016,12,78486000,16535000,95021000
Irak,2017,1,40675000,24622000,65297000
Irak,2017,2,51752000,6213000,57965000
Irak,2017,3,71474000,49830000,121304000
Irak,2017,4,41728000,87890000,129618000
Irak,2017,5,72390000,56347000,128737000
Irak,2017,6,58717000,133352000,192069000
Irak,2017,7,41220000,148053000,189273000
Irak,2017,8,49630000,108105000,157735000
Irak,2017,9,55671000,126131000,181802000
Irak,2017,10,57294000,114818000,172112000
Irak,2017,11,60866000,67367000,128233000
Irak,2017,12,63310000,34067000,97377000
Irak,2018,1,44239000,89883000,134122000
Irak,2018,2,43144000,47877000,91021000
Irak,2018,3,49709000,60311000,110020000
Irak,2018,4,51142000,138913000,190055000
Irak,2018,5,64989000,109276000,174265000
Irak,2018,6,56677000,75376000,132053000
Irak,2018,7,48349000,177273000,225622000
Irak,2018,8,61031000,120646000,181677000
Irak,2018,9,73688000,107302000,180990000
Irak,2018,10,79802000,45413000,125215000
Irak,2018,11,69835000,58129000,127964000
Irak,2018,12,76458000,35524000,111982000
Irak,2019,1,49844000,263000,50107000
Irak,2019,2,69308000,634000,69942000
Irak,2019,3,113790000,33862000,147652000
Irak,2019,4,64780000,16593000,81373000
Irak,2019,5,59753000,36759000,96512000
Irak,2019,6,69393000,60774000,130167000
Irak,2019,7,77586000,88863000,166449000
Irak,2019,8,125036000,137203000,262239000
Irak,2019,9,98517000,76159000,174676000
Irak,2019,10,96721000,66333000,163054000
Irak,2019,11,85914000,62997000,148911000
Irak,2019,12,75170000,82952000,158122000
Irak,2020,1,52462000,4524000,56986000
Irak,2020,2,57219000,454000,57673000
Irak,2020,3,110154000,103000,110257000
Irak,2020,4,67028000,4215000,71243000
Irak,2020,5,69911000,19910000,89821000
Irak,2020,6,58662000,29113000,87775000
Irak,2020,7,58630000,58343000,116973000
Irak,2020,8,66271000,87326000,153597000
Irak,2020,9,85380000,42235000,127615000
Irak,2020,10,79469000,75549000,155018000
Irak,2020,11,78538000,40283000,118821000
Irak,2020,12,123471000,38518000,161989000
Irak,2021,1,79694000,10604000,90298000
Irak,2021,2,63136000,6907000,70043000
Irak,2021,3,93595000,49340000,142935000
Irak,2021,4,82754000,71820000,154574000
Irak,2021,5,56484000,89253000,145737000
Irak,2021,6,59989000,75051000,135040000
Irak,2021,7,70649000,129254000,199903000
Irak,2021,8,60669000,85556000,146225000
Irak,2021,9,101700000,136571000,238271000
Irak,2021,10,60833000,92032000,152865000
Irak,2021,11,81991000,102533000,184524000
Irak,2021,12,77876000,85896000,163772000
Irak,2022,1,78469000,51141000,129610000
Irak,2022,2,55893000,70246000,126139000
Irak,2022,3,99408000,100534000,199942000
Irak,2022,4,65518000,155371000,220889000
Irak,2022,5,82483000,214333000,296816000
Irak,2022,6,111239000,315545000,426784000
Irak,2022,7,78271000,232978000,311249000
Irak,2022,8,106864000,225244000,332108000
Irak,2022,9,94094000,239395000,333489000
Irak,2022,10,84641000,214807000,299448000
Irak,2022,11,101885000,253017000,354902000
Irak,2022,12,109961000,114431000,224392000
Irak,2023,1,76436000,36055000,112491000
Irak,2023,2,82849000,70888000,153737000
Irak,2023,3,97704000,231580000,329284000
Irak,2023,4,96356000,92536000,188892000
Irak,2023,5,95897000,109084000,204981000
Irak,2023,6,95922000,186181000,282103000
Irak,2023,7,98604000,62125000,160729000
Irak,2023,8,93846000,214461000,308307000
Irak,2023,9,116633000,227936000,344569000
Irak,2023,10,116538000,140022000,256560000
Irak,2023,11,108329000,157315000,265644000
Irak,2023,12,107944000,43091000,151035000
Irak,2024,1,95978000,13609000,109587000
Irak,2024,2,91468000,16700000,108168000
Irak,2024,3,98638000,204276000,302914000
Irak,2024,4,130601000,215984000,346585000
Irak,2024,5,103870000,178429000,282299000
Irak,2024,6,98895000,244156000,343051000
Irak,2024,7,87664000,175194000,262858000
Irak,2024,8,120715000,257391000,378106000
Irak,2024,9,131045000,138911000,269956000
Irak,2024,10,129806000,145495000,275301000
Irak,2024,11,110891000,123517000,234408000
Irak,2024,12,112709000,44732000,157441000
Irland,2008,1,532652000,1345012000,1877664000
Irland,2008,2,535968000,1461161000,1997129000
Irland,2008,3,533964000,1267000000,1800964000
Irland,2008,4,503473000,1371637000,1875110000
Irland,2008,5,457018000,1198779000,1655797000
Irland,2008,6,489408000,1366078000,1855486000
Irland,2008,7,499771000,1428976000,1928747000
Irland,2008,8,436551000,1193001000,1629552000
Irland,2008,9,397168000,1502397000,1899565000
Irland,2008,10,366038000,1465145000,1831183000
Irland,2008,11,386387000,1268630000,1655017000
Irland,2008,12,397788000,1263876000,1661664000
Irland,2009,1,338078000,1252531000,1590609000
Irland,2009,2,327689000,1070641000,1398330000
Irland,2009,3,315258000,1218955000,1534213000
Irland,2009,4,273997000,1130591000,1404588000
Irland,2009,5,292184000,994907000,1287091000
Irland,2009,6,289480000,1064006000,1353486000
Irland,2009,7,301637000,1225381000,1527018000
Irland,2009,8,275295000,1093186000,1368481000
Irland,2009,9,291230000,1206516000,1497746000
Irland,2009,10,312152000,1284038000,1596190000
Irland,2009,11,302140000,1177735000,1479875000
Irland,2009,12,336407000,1096569000,1432976000
Irland,2010,1,289500000,1129859000,1419359000
Irland,2010,2,356120000,1237681000,1593801000
Irland,2010,3,399774000,1194445000,1594219000
Irland,2010,4,305850000,1034842000,1340692000
Irland,2010,5,368929000,1009037000,1377966000
Irland,2010,6,328632000,1000142000,1328774000
Irland,2010,7,355320000,1213171000,1568491000
Irland,2010,8,330811000,1040737000,1371548000
Irland,2010,9,327109000,1053527000,1380636000
Irland,2010,10,320556000,1224982000,1545538000
Irland,2010,11,395659000,1244329000,1639988000
Irland,2010,12,376273000,1172970000,1549243000
Irland,2011,1,411579000,1031856000,1443435000
Irland,2011,2,359044000,1000655000,1359699000
Irland,2011,3,415053000,1216291000,1631344000
Irland,2011,4,357978000,987921000,1345899000
Irland,2011,5,374695000,1013675000,1388370000
Irland,2011,6,388764000,982616000,1371380000
Irland,2011,7,328921000,930728000,1259649000
Irland,2011,8,308526000,1041084000,1349610000
Irland,2011,9,351743000,963159000,1314902000
Irland,2011,10,355051000,1041166000,1396217000
Irland,2011,11,387209000,1168050000,1555259000
Irland,2011,12,433705000,956803000,1390508000
Irland,2012,1,368294000,839338000,1207632000
Irland,2012,2,404571000,777727000,1182298000
Irland,2012,3,460041000,1215212000,1675253000
Irland,2012,4,344984000,694258000,1039242000
Irland,2012,5,341499000,729186000,1070685000
Irland,2012,6,357778000,813564000,1171342000
Irland,2012,7,379073000,851117000,1230190000
Irland,2012,8,410380000,775925000,1186305000
Irland,2012,9,355600000,896619000,1252219000
Irland,2012,10,398259000,689786000,1088045000
Irland,2012,11,440027000,932501000,1372528000
Irland,2012,12,397956000,877987000,1275943000
Irland,2013,1,460593000,655614000,1116207000
Irland,2013,2,490714000,671024000,1161738000
Irland,2013,3,502306000,805753000,1308059000
Irland,2013,4,496027000,767406000,1263433000
Irland,2013,5,390850000,817579000,1208429000
Irland,2013,6,451468000,562171000,1013639000
Irland,2013,7,388703000,924372000,1313075000
Irland,2013,8,430652000,613489000,1044141000
Irland,2013,9,417196000,831974000,1249170000
Irland,2013,10,497266000,703603000,1200869000
Irland,2013,11,461903000,751122000,1213025000
Irland,2013,12,473455000,676634000,1150089000
Irland,2014,1,478636000,697035000,1175671000
Irland,2014,2,418731000,763318000,1182049000
Irland,2014,3,440521000,778669000,1219190000
Irland,2014,4,450569000,682382000,1132951000
Irland,2014,5,452577000,758627000,1211204000
Irland,2014,6,405105000,696838000,1101943000
Irland,2014,7,407989000,609295000,1017284000
Irland,2014,8,399302000,829996000,1229298000
Irland,2014,9,375438000,772595000,1148033000
Irland,2014,10,417567000,733225000,1150792000
Irland,2014,11,484821000,824117000,1308938000
Irland,2014,12,478533000,723992000,1202525000
Irland,2015,1,461076000,753533000,1214609000
Irland,2015,2,473401000,873410000,1346811000
Irland,2015,3,581193000,814410000,1395603000
Irland,2015,4,452469000,995492000,1447961000
Irland,2015,5,443064000,917777000,1360841000
Irland,2015,6,473154000,1087027000,1560181000
Irland,2015,7,524405000,1023620000,1548025000
Irland,2015,8,452931000,874638000,1327569000
Irland,2015,9,455653000,813053000,1268706000
Irland,2015,10,517426000,845934000,1363360000
Irland,2015,11,539941000,958620000,1498561000
Irland,2015,12,482473000,867026000,1349499000
Irland,2016,1,484149000,949454000,1433603000
Irland,2016,2,507480000,1087322000,1594802000
Irland,2016,3,545948000,1197353000,1743301000
Irland,2016,4,507706000,1008872000,1516578000
Irland,2016,5,508215000,844199000,1352414000
Irland,2016,6,527116000,995367000,1522483000
Irland,2016,7,452348000,970203000,1422551000
Irland,2016,8,411078000,865091000,1276169000
Irland,2016,9,482964000,934914000,1417878000
Irland,2016,10,447617000,898883000,1346500000
Irland,2016,11,537747000,1060746000,1598493000
Irland,2016,12,430999000,1019033000,1450032000
Irland,2017,1,617158000,910810000,1527968000
Irland,2017,2,546247000,867809000,1414056000
Irland,2017,3,610910000,1051589000,1662499000
Irland,2017,4,637026000,816128000,1453154000
Irland,2017,5,518750000,1080268000,1599018000
Irland,2017,6,556785000,963794000,1520579000
Irland,2017,7,627060000,889505000,1516565000
Irland,2017,8,763496000,874760000,1638256000
Irland,2017,9,735772000,1014804000,1750576000
Irland,2017,10,752151000,962027000,1714178000
Irland,2017,11,722816000,1050914000,1773730000
Irland,2017,12,763668000,1197654000,1961322000
Irland,2018,1,757614000,951186000,1708800000
Irland,2018,2,937532000,948884000,1886416000
Irland,2018,3,1012574000,888984000,1901558000
Irland,2018,4,959399000,879175000,1838574000
Irland,2018,5,897880000,1147726000,2045606000
Irland,2018,6,1278119000,1487787000,2765906000
Irland,2018,7,1082727000,1206404000,2289131000
Irland,2018,8,1346225000,1447174000,2793399000
Irland,2018,9,1304102000,1280379000,2584481000
Irland,2018,10,671716000,994467000,1666183000
Irland,2018,11,660802000,1099991000,1760793000
Irland,2018,12,571177000,1250843000,1822020000
Irland,2019,1,620865000,1659107000,2279972000
Irland,2019,2,729607000,1529370000,2258977000
Irland,2019,3,841445000,1182601000,2024046000
Irland,2019,4,653773000,2072788000,2726561000
Irland,2019,5,566109000,1965183000,2531292000
Irland,2019,6,584272000,1426330000,2010602000
Irland,2019,7,641024000,1706271000,2347295000
Irland,2019,8,672013000,1277439000,1949452000
Irland,2019,9,621899000,868400000,1490299000
Irland,2019,10,787455000,1884517000,2671972000
Irland,2019,11,679609000,1633976000,2313585000
Irland,2019,12,590738000,1175297000,1766035000
Irland,2020,1,635076000,1785779000,2420855000
Irland,2020,2,732603000,1329690000,2062293000
Irland,2020,3,702336000,1989701000,2692037000
Irland,2020,4,507356000,1609517000,2116873000
Irland,2020,5,439867000,1607020000,2046887000
Irland,2020,6,543749000,2265868000,2809617000
Irland,2020,7,636439000,1477937000,2114376000
Irland,2020,8,552621000,2061522000,2614143000
Irland,2020,9,982415000,2139596000,3122011000
Irland,2020,10,612171000,1626762000,2238933000
Irland,2020,11,683148000,1358612000,2041760000
Irland,2020,12,693666000,1875143000,2568809000
Irland,2021,1,615554000,1220818000,1836372000
Irland,2021,2,580959000,1603210000,2184169000
Irland,2021,3,804878000,2252212000,3057090000
Irland,2021,4,667724000,1419075000,2086799000
Irland,2021,5,644832000,2237317000,2882149000
Irland,2021,6,696437000,2025875000,2722312000
Irland,2021,7,647604000,1604762000,2252366000
Irland,2021,8,556464000,1888569000,2445033000
Irland,2021,9,617809000,1704363000,2322172000
Irland,2021,10,655192000,1969717000,2624909000
Irland,2021,11,682721000,1630888000,2313609000
Irland,2021,12,642799000,1616285000,2259084000
Irland,2022,1,779595000,2146247000,2925842000
Irland,2022,2,760154000,2760431000,3520585000
Irland,2022,3,887155000,2779065000,3666220000
Irland,2022,4,747542000,2856226000,3603768000
Irland,2022,5,1395540000,2322350000,3717890000
Irland,2022,6,831762000,2104430000,2936192000
Irland,2022,7,716144000,1733738000,2449882000
Irland,2022,8,856123000,3036459000,3892582000
Irland,2022,9,1521981000,2880461000,4402442000
Irland,2022,10,783672000,2010468000,2794140000
Irland,2022,11,876570000,1692926000,2569496000
Irland,2022,12,759652000,2293472000,3053124000
Irland,2023,1,869560000,2554192000,3423752000
Irland,2023,2,792357000,2798342000,3590699000
Irland,2023,3,890693000,2380745000,3271438000
Irland,2023,4,680903000,1463353000,2144256000
Irland,2023,5,903723000,2040622000,2944345000
Irland,2023,6,889571000,1822244000,2711815000
Irland,2023,7,799710000,2886946000,3686656000
Irland,2023,8,737809000,1564240000,2302049000
Irland,2023,9,768426000,2482268000,3250694000
Irland,2023,10,767647000,2150786000,2918433000
Irland,2023,11,838450000,2108204000,2946654000
Irland,2023,12,755643000,1363085000,2118728000
Irland,2024,1,899297000,2263340000,3162637000
Irland,2024,2,821833000,2058776000,2880609000
Irland,2024,3,847666000,2234522000,3082188000
Irland,2024,4,836090000,2336238000,3172328000
Irland,2024,5,805682000,1882422000,2688104000
Irland,2024,6,842045000,1503209000,2345254000
Irland,2024,7,830385000,3060057000,3890442000
Irland,2024,8,749276000,1948234000,2697510000
Irland,2024,9,780778000,1735508000,2516286000
Irland,2024,10,793909000,2246840000,3040749000
Irland,2024,11,821862000,1735619000,2557481000
Irland,2024,12,919351000,1476513000,2395864000
Islamische Republik Iran,2008,1,364199000,41108000,405307000
Islamische Republik Iran,2008,2,341013000,34124000,375137000
Islamische Republik Iran,2008,3,320723000,36606000,357329000
Islamische Republik Iran,2008,4,328798000,24708000,353506000
Islamische Republik Iran,2008,5,245627000,38857000,284484000
Islamische Republik Iran,2008,6,308671000,42683000,351354000
Islamische Republik Iran,2008,7,305593000,78707000,384300000
Islamische Republik Iran,2008,8,240591000,72979000,313570000
Islamische Republik Iran,2008,9,349102000,67031000,416133000
Islamische Republik Iran,2008,10,391382000,56854000,448236000
Islamische Republik Iran,2008,11,385231000,57181000,442412000
Islamische Republik Iran,2008,12,340933000,42436000,383369000
Islamische Republik Iran,2009,1,258212000,30831000,289043000
Islamische Republik Iran,2009,2,278655000,23930000,302585000
Islamische Republik Iran,2009,3,268171000,24503000,292674000
Islamische Republik Iran,2009,4,302441000,25488000,327929000
Islamische Republik Iran,2009,5,280056000,20649000,300705000
Islamische Republik Iran,2009,6,321565000,20700000,342265000
Islamische Republik Iran,2009,7,352203000,54496000,406699000
Islamische Republik Iran,2009,8,318457000,71794000,390251000
Islamische Republik Iran,2009,9,327318000,97296000,424614000
Islamische Republik Iran,2009,10,305590000,39942000,345532000
Islamische Republik Iran,2009,11,360746000,49973000,410719000
Islamische Republik Iran,2009,12,410113000,80651000,490764000
Islamische Republik Iran,2010,1,243637000,39080000,282717000
Islamische Republik Iran,2010,2,303128000,70406000,373534000
Islamische Republik Iran,2010,3,382545000,52593000,435138000
Islamische Republik Iran,2010,4,309458000,49741000,359199000
Islamische Republik Iran,2010,5,294269000,27143000,321412000
Islamische Republik Iran,2010,6,318056000,41709000,359765000
Islamische Republik Iran,2010,7,368016000,103364000,471380000
Islamische Republik Iran,2010,8,316387000,149552000,465939000
Islamische Republik Iran,2010,9,369488000,99161000,468649000
Islamische Republik Iran,2010,10,255278000,58874000,314152000
Islamische Republik Iran,2010,11,294660000,116297000,410957000
Islamische Republik Iran,2010,12,335044000,110119000,445163000
Islamische Republik Iran,2011,1,251769000,54402000,306171000
Islamische Republik Iran,2011,2,289216000,52262000,341478000
Islamische Republik Iran,2011,3,224336000,56458000,280794000
Islamische Republik Iran,2011,4,235928000,72390000,308318000
Islamische Republik Iran,2011,5,250525000,69216000,319741000
Islamische Republik Iran,2011,6,249217000,112913000,362130000
Islamische Republik Iran,2011,7,260115000,63667000,323782000
Islamische Republik Iran,2011,8,301429000,68582000,370011000
Islamische Republik Iran,2011,9,226267000,39651000,265918000
Islamische Republik Iran,2011,10,237080000,42691000,279771000
Islamische Republik Iran,2011,11,271820000,88612000,360432000
Islamische Republik Iran,2011,12,284989000,68294000,353283000
Islamische Republik Iran,2012,1,201771000,67977000,269748000
Islamische Republik Iran,2012,2,197845000,26131000,223976000
Islamische Republik Iran,2012,3,179421000,31608000,211029000
Islamische Republik Iran,2012,4,197958000,25644000,223602000
Islamische Republik Iran,2012,5,181116000,23894000,205010000
Islamische Republik Iran,2012,6,202156000,37006000,239162000
Islamische Republik Iran,2012,7,191689000,18443000,210132000
Islamische Republik Iran,2012,8,231298000,18410000,249708000
Islamische Republik Iran,2012,9,200645000,19448000,220093000
Islamische Republik Iran,2012,10,331116000,24155000,355271000
Islamische Republik Iran,2012,11,192432000,22474000,214906000
Islamische Republik Iran,2012,12,216390000,23917000,240307000
Islamische Republik Iran,2013,1,148541000,32220000,180761000
Islamische Republik Iran,2013,2,202267000,23705000,225972000
Islamische Republik Iran,2013,3,191834000,24228000,216062000
Islamische Republik Iran,2013,4,118188000,24920000,143108000
Islamische Republik Iran,2013,5,150780000,20819000,171599000
Islamische Republik Iran,2013,6,109167000,18565000,127732000
Islamische Republik Iran,2013,7,120157000,24185000,144342000
Islamische Republik Iran,2013,8,136557000,18506000,155063000
Islamische Republik Iran,2013,9,121865000,17755000,139620000
Islamische Republik Iran,2013,10,147484000,23265000,170749000
Islamische Republik Iran,2013,11,197597000,18737000,216334000
Islamische Republik Iran,2013,12,196810000,27100000,223910000
Islamische Republik Iran,2014,1,150993000,34162000,185155000
Islamische Republik Iran,2014,2,186467000,30324000,216791000
Islamische Republik Iran,2014,3,202263000,25582000,227845000
Islamische Republik Iran,2014,4,265909000,21995000,287904000
Islamische Republik Iran,2014,5,239157000,23076000,262233000
Islamische Republik Iran,2014,6,206374000,20399000,226773000
Islamische Republik Iran,2014,7,137744000,22064000,159808000
Islamische Republik Iran,2014,8,184150000,17396000,201546000
Islamische Republik Iran,2014,9,203287000,24352000,227639000
Islamische Republik Iran,2014,10,230930000,26301000,257231000
Islamische Republik Iran,2014,11,178167000,22427000,200594000
Islamische Republik Iran,2014,12,195391000,27791000,223182000
Islamische Republik Iran,2015,1,140224000,37345000,177569000
Islamische Republik Iran,2015,2,150761000,36153000,186914000
Islamische Republik Iran,2015,3,172752000,37616000,210368000
Islamische Republik Iran,2015,4,153437000,22548000,175985000
Islamische Republik Iran,2015,5,195136000,26469000,221605000
Islamische Republik Iran,2015,6,164012000,31305000,195317000
Islamische Republik Iran,2015,7,190139000,20999000,211138000
Islamische Republik Iran,2015,8,149432000,19705000,169137000
Islamische Republik Iran,2015,9,139965000,21976000,161941000
Islamische Republik Iran,2015,10,158511000,22986000,181497000
Islamische Republik Iran,2015,11,198140000,29856000,227996000
Islamische Republik Iran,2015,12,239140000,25737000,264877000
Islamische Republik Iran,2016,1,155650000,30195000,185845000
Islamische Republik Iran,2016,2,166310000,31480000,197790000
Islamische Republik Iran,2016,3,173260000,33157000,206417000
Islamische Republik Iran,2016,4,183466000,24027000,207493000
Islamische Republik Iran,2016,5,206098000,23792000,229890000
Islamische Republik Iran,2016,6,240222000,24458000,264680000
Islamische Republik Iran,2016,7,177306000,23793000,201099000
Islamische Republik Iran,2016,8,196205000,23790000,219995000
Islamische Republik Iran,2016,9,248599000,26247000,274846000
Islamische Republik Iran,2016,10,229610000,22604000,252214000
Islamische Republik Iran,2016,11,265828000,24512000,290340000
Islamische Republik Iran,2016,12,328233000,25701000,353934000
Islamische Republik Iran,2017,1,196655000,29235000,225890000
Islamische Republik Iran,2017,2,242667000,39941000,282608000
Islamische Republik Iran,2017,3,261413000,42806000,304219000
Islamische Republik Iran,2017,4,177052000,22830000,199882000
Islamische Republik Iran,2017,5,250698000,27123000,277821000
Islamische Republik Iran,2017,6,266687000,39421000,306108000
Islamische Republik Iran,2017,7,235614000,30859000,266473000
Islamische Republik Iran,2017,8,248080000,29784000,277864000
Islamische Republik Iran,2017,9,258814000,46903000,305717000
Islamische Republik Iran,2017,10,214766000,27504000,242270000
Islamische Republik Iran,2017,11,295291000,51709000,347000000
Islamische Republik Iran,2017,12,321499000,25512000,347011000
Islamische Republik Iran,2018,1,260653000,41615000,302268000
Islamische Republik Iran,2018,2,213900000,29954000,243854000
Islamische Republik Iran,2018,3,209730000,32508000,242238000
Islamische Republik Iran,2018,4,203879000,26312000,230191000
Islamische Republik Iran,2018,5,205763000,22752000,228515000
Islamische Republik Iran,2018,6,222883000,42053000,264936000
Islamische Republik Iran,2018,7,234303000,104893000,339196000
Islamische Republik Iran,2018,8,247783000,37742000,285525000
Islamische Republik Iran,2018,9,224677000,31636000,256313000
Islamische Republik Iran,2018,10,398658000,30195000,428853000
Islamische Republik Iran,2018,11,165890000,20956000,186846000
Islamische Republik Iran,2018,12,108936000,20201000,129137000
Islamische Republik Iran,2019,1,101630000,22780000,124410000
Islamische Republik Iran,2019,2,118885000,18512000,137397000
Islamische Republik Iran,2019,3,116367000,19497000,135864000
Islamische Republik Iran,2019,4,87115000,19217000,106332000
Islamische Republik Iran,2019,5,117244000,14396000,131640000
Islamische Republik Iran,2019,6,119474000,15369000,134843000
Islamische Republik Iran,2019,7,164262000,19397000,183659000
Islamische Republik Iran,2019,8,142230000,15081000,157311000
Islamische Republik Iran,2019,9,129929000,10253000,140182000
Islamische Republik Iran,2019,10,116367000,19406000,135773000
Islamische Republik Iran,2019,11,131993000,17629000,149622000
Islamische Republik Iran,2019,12,166248000,15757000,182005000
Islamische Republik Iran,2020,1,114388000,30796000,145184000
Islamische Republik Iran,2020,2,132704000,21189000,153893000
Islamische Republik Iran,2020,3,165531000,18323000,183854000
Islamische Republik Iran,2020,4,134694000,6942000,141636000
Islamische Republik Iran,2020,5,146495000,12967000,159462000
Islamische Republik Iran,2020,6,107428000,47536000,154964000
Islamische Republik Iran,2020,7,118181000,34370000,152551000
Islamische Republik Iran,2020,8,84682000,18945000,103627000
Islamische Republik Iran,2020,9,98280000,20952000,119232000
Islamische Republik Iran,2020,10,116568000,20126000,136694000
Islamische Republik Iran,2020,11,144651000,21288000,165939000
Islamische Republik Iran,2020,12,178704000,21637000,200341000
Islamische Republik Iran,2021,1,95272000,18166000,113438000
Islamische Republik Iran,2021,2,138263000,24469000,162732000
Islamische Republik Iran,2021,3,124764000,31566000,156330000
Islamische Republik Iran,2021,4,124972000,23945000,148917000
Islamische Republik Iran,2021,5,125732000,23699000,149431000
Islamische Republik Iran,2021,6,137673000,24384000,162057000
Islamische Republik Iran,2021,7,103562000,32881000,136443000
Islamische Republik Iran,2021,8,84668000,29299000,113967000
Islamische Republik Iran,2021,9,113237000,22244000,135481000
Islamische Republik Iran,2021,10,112341000,31412000,143753000
Islamische Republik Iran,2021,11,143147000,23725000,166872000
Islamische Republik Iran,2021,12,136911000,27849000,164760000
Islamische Republik Iran,2022,1,108425000,25194000,133619000
Islamische Republik Iran,2022,2,149582000,34357000,183939000
Islamische Republik Iran,2022,3,158669000,34162000,192831000
Islamische Republik Iran,2022,4,115195000,21644000,136839000
Islamische Republik Iran,2022,5,115461000,23891000,139352000
Islamische Republik Iran,2022,6,150082000,21095000,171177000
Islamische Republik Iran,2022,7,88449000,26890000,115339000
Islamische Republik Iran,2022,8,137543000,20341000,157884000
Islamische Republik Iran,2022,9,243467000,23186000,266653000
Islamische Republik Iran,2022,10,101651000,21582000,123233000
Islamische Republik Iran,2022,11,100205000,26360000,126565000
Islamische Republik Iran,2022,12,114705000,20355000,135060000
Islamische Republik Iran,2023,1,100680000,27870000,128550000
Islamische Republik Iran,2023,2,96739000,19619000,116358000
Islamische Republik Iran,2023,3,92152000,32099000,124251000
Islamische Republik Iran,2023,4,83723000,17284000,101007000
Islamische Republik Iran,2023,5,86938000,19659000,106597000
Islamische Republik Iran,2023,6,106901000,18435000,125336000
Islamische Republik Iran,2023,7,96180000,17834000,114014000
Islamische Republik Iran,2023,8,101272000,22817000,124089000
Islamische Republik Iran,2023,9,122097000,15420000,137517000
Islamische Republik Iran,2023,10,101636000,11999000,113635000
Islamische Republik Iran,2023,11,102094000,20214000,122308000
Islamische Republik Iran,2023,12,111342000,23607000,134949000
Islamische Republik Iran,2024,1,100366000,21460000,121826000
Islamische Republik Iran,2024,2,142428000,20292000,162720000
Islamische Republik Iran,2024,3,103345000,20269000,123614000
Islamische Republik Iran,2024,4,85351000,22332000,107683000
Islamische Republik Iran,2024,5,94824000,16631000,111455000
Islamische Republik Iran,2024,6,111744000,15692000,127436000
Islamische Republik Iran,2024,7,119094000,22444000,141538000
Islamische Republik Iran,2024,8,126394000,18888000,145282000
Islamische Republik Iran,2024,9,100232000,11888000,112120000
Islamische Republik Iran,2024,10,76559000,14978000,91537000
Islamische Republik Iran,2024,11,101209000,23112000,124321000
Islamische Republik Iran,2024,12,116099000,17359000,133458000
Island,2008,1,43063000,46664000,89727000
Island,2008,2,47665000,43467000,91132000
Island,2008,3,43390000,42176000,85566000
Island,2008,4,37462000,47650000,85112000
Island,2008,5,34846000,48902000,83748000
Island,2008,6,39209000,47777000,86986000
Island,2008,7,33024000,60710000,93734000
Island,2008,8,32532000,48141000,80673000
Island,2008,9,27652000,52292000,79944000
Island,2008,10,22485000,42133000,64618000
Island,2008,11,15649000,47166000,62815000
Island,2008,12,13653000,31369000,45022000
Island,2009,1,14935000,17328000,32263000
Island,2009,2,15162000,28299000,43461000
Island,2009,3,17568000,31853000,49421000
Island,2009,4,15238000,27423000,42661000
Island,2009,5,17665000,39414000,57079000
Island,2009,6,22813000,37160000,59973000
Island,2009,7,23535000,38382000,61917000
Island,2009,8,19224000,54535000,73759000
Island,2009,9,21737000,46405000,68142000
Island,2009,10,18990000,53694000,72684000
Island,2009,11,19754000,56780000,76534000
Island,2009,12,15184000,38684000,53868000
Island,2010,1,18435000,48328000,66763000
Island,2010,2,22889000,52600000,75489000
Island,2010,3,31364000,67170000,98534000
Island,2010,4,20274000,64685000,84959000
Island,2010,5,23710000,59317000,83027000
Island,2010,6,23601000,60355000,83956000
Island,2010,7,22445000,71423000,93868000
Island,2010,8,19867000,62236000,82103000
Island,2010,9,24548000,53886000,78434000
Island,2010,10,24897000,50150000,75047000
Island,2010,11,22391000,66301000,88692000
Island,2010,12,20076000,59698000,79774000
Island,2011,1,28418000,61311000,89729000
Island,2011,2,21582000,62865000,84447000
Island,2011,3,26647000,62245000,88892000
Island,2011,4,23739000,87747000,111486000
Island,2011,5,31503000,78111000,109614000
Island,2011,6,29758000,71632000,101390000
Island,2011,7,26394000,64392000,90786000
Island,2011,8,26628000,65741000,92369000
Island,2011,9,26780000,65335000,92115000
Island,2011,10,24477000,56006000,80483000
Island,2011,11,24134000,54380000,78514000
Island,2011,12,19517000,44355000,63872000
Island,2012,1,28509000,42341000,70850000
Island,2012,2,25447000,51502000,76949000
Island,2012,3,29962000,71937000,101899000
Island,2012,4,24873000,53698000,78571000
Island,2012,5,32818000,55164000,87982000
Island,2012,6,32134000,59481000,91615000
Island,2012,7,25205000,43639000,68844000
Island,2012,8,26985000,51023000,78008000
Island,2012,9,26636000,43057000,69693000
Island,2012,10,31650000,56447000,88097000
Island,2012,11,28216000,39405000,67621000
Island,2012,12,20041000,40678000,60719000
Island,2013,1,23973000,54746000,78719000
Island,2013,2,25281000,45950000,71231000
Island,2013,3,28057000,48764000,76821000
Island,2013,4,29515000,58711000,88226000
Island,2013,5,33131000,59621000,92752000
Island,2013,6,29943000,56613000,86556000
Island,2013,7,24865000,41591000,66456000
Island,2013,8,24816000,40033000,64849000
Island,2013,9,22112000,39842000,61954000
Island,2013,10,27003000,44642000,71645000
Island,2013,11,21456000,52732000,74188000
Island,2013,12,20492000,27783000,48275000
Island,2014,1,21824000,56843000,78667000
Island,2014,2,23672000,49864000,73536000
Island,2014,3,24432000,43706000,68138000
Island,2014,4,28757000,33479000,62236000
Island,2014,5,27397000,46404000,73801000
Island,2014,6,25414000,32084000,57498000
Island,2014,7,29401000,35529000,64930000
Island,2014,8,23572000,31635000,55207000
Island,2014,9,27679000,34402000,62081000
Island,2014,10,27210000,39301000,66511000
Island,2014,11,27251000,42341000,69592000
Island,2014,12,20548000,28749000,49297000
Island,2015,1,22411000,38988000,61399000
Island,2015,2,26814000,54174000,80988000
Island,2015,3,34454000,40785000,75239000
Island,2015,4,35275000,52604000,87879000
Island,2015,5,30760000,50761000,81521000
Island,2015,6,37703000,38973000,76676000
Island,2015,7,39964000,39933000,79897000
Island,2015,8,27727000,30894000,58621000
Island,2015,9,31922000,38810000,70732000
Island,2015,10,36265000,44490000,80755000
Island,2015,11,41730000,34841000,76571000
Island,2015,12,27370000,30341000,57711000
Island,2016,1,29809000,32845000,62654000
Island,2016,2,37229000,36142000,73371000
Island,2016,3,47122000,37042000,84164000
Island,2016,4,46436000,34814000,81250000
Island,2016,5,45429000,37629000,83058000
Island,2016,6,49400000,39981000,89381000
Island,2016,7,40287000,34641000,74928000
Island,2016,8,95002000,34512000,129514000
Island,2016,9,38393000,39390000,77783000
Island,2016,10,37030000,35882000,72912000
Island,2016,11,106796000,39416000,146212000
Island,2016,12,40249000,29788000,70037000
Island,2017,1,37564000,31980000,69544000
Island,2017,2,50361000,30066000,80427000
Island,2017,3,65717000,35941000,101658000
Island,2017,4,54011000,37664000,91675000
Island,2017,5,75402000,34057000,109459000
Island,2017,6,57858000,43158000,101016000
Island,2017,7,51297000,38973000,90270000
Island,2017,8,54568000,40603000,95171000
Island,2017,9,57325000,30279000,87604000
Island,2017,10,43904000,40236000,84140000
Island,2017,11,55004000,45430000,100434000
Island,2017,12,37818000,29502000,67320000
Island,2018,1,46848000,45147000,91995000
Island,2018,2,98350000,39654000,138004000
Island,2018,3,50485000,39156000,89641000
Island,2018,4,102777000,40558000,143335000
Island,2018,5,52643000,41730000,94373000
Island,2018,6,119712000,38600000,158312000
Island,2018,7,53567000,39806000,93373000
Island,2018,8,44141000,30404000,74545000
Island,2018,9,39544000,37782000,77326000
Island,2018,10,42377000,46134000,88511000
Island,2018,11,39417000,51716000,91133000
Island,2018,12,26994000,33096000,60090000
Island,2019,1,40806000,45440000,86246000
Island,2019,2,39111000,54895000,94006000
Island,2019,3,39947000,45466000,85413000
Island,2019,4,41547000,39964000,81511000
Island,2019,5,43326000,63784000,107110000
Island,2019,6,45601000,38589000,84190000
Island,2019,7,45170000,39326000,84496000
Island,2019,8,41300000,34342000,75642000
Island,2019,9,39277000,52395000,91672000
Island,2019,10,40948000,40931000,81879000
Island,2019,11,35778000,42406000,78184000
Island,2019,12,27876000,31042000,58918000
Island,2020,1,36286000,42869000,79155000
Island,2020,2,37204000,47265000,84469000
Island,2020,3,37685000,48187000,85872000
Island,2020,4,27669000,34426000,62095000
Island,2020,5,32847000,26949000,59796000
Island,2020,6,38587000,29564000,68151000
Island,2020,7,38864000,24492000,63356000
Island,2020,8,31963000,26617000,58580000
Island,2020,9,36385000,31579000,67964000
Island,2020,10,37441000,37880000,75321000
Island,2020,11,34423000,41715000,76138000
Island,2020,12,29816000,31544000,61360000
Island,2021,1,34590000,37770000,72360000
Island,2021,2,37597000,44592000,82189000
Island,2021,3,44415000,46891000,91306000
Island,2021,4,39608000,52876000,92484000
Island,2021,5,43970000,52339000,96309000
Island,2021,6,57443000,60472000,117915000
Island,2021,7,56282000,41136000,97418000
Island,2021,8,50898000,61782000,112680000
Island,2021,9,52391000,51433000,103824000
Island,2021,10,53127000,51666000,104793000
Island,2021,11,50651000,56235000,106886000
Island,2021,12,41819000,47692000,89511000
Island,2022,1,56112000,84963000,141075000
Island,2022,2,48914000,60799000,109713000
Island,2022,3,59830000,88329000,148159000
Island,2022,4,55891000,78828000,134719000
Island,2022,5,57313000,74315000,131628000
Island,2022,6,69667000,87890000,157557000
Island,2022,7,51253000,74465000,125718000
Island,2022,8,49723000,76157000,125880000
Island,2022,9,63583000,83677000,147260000
Island,2022,10,55382000,86713000,142095000
Island,2022,11,62272000,68913000,131185000
Island,2022,12,43647000,48068000,91715000
Island,2023,1,58092000,89147000,147239000
Island,2023,2,58039000,69793000,127832000
Island,2023,3,74457000,82978000,157435000
Island,2023,4,64659000,60023000,124682000
Island,2023,5,144800000,81134000,225934000
Island,2023,6,61546000,72516000,134062000
Island,2023,7,49673000,58954000,108627000
Island,2023,8,53904000,71589000,125493000
Island,2023,9,60176000,63083000,123259000
Island,2023,10,54377000,59504000,113881000
Island,2023,11,55808000,64045000,119853000
Island,2023,12,35030000,43201000,78231000
Island,2024,1,44240000,63026000,107266000
Island,2024,2,53422000,64613000,118035000
Island,2024,3,54757000,56516000,111273000
Island,2024,4,55059000,50805000,105864000
Island,2024,5,50440000,68202000,118642000
Island,2024,6,54718000,71968000,126686000
Island,2024,7,54600000,51852000,106452000
Island,2024,8,48064000,74015000,122079000
Island,2024,9,56171000,59056000,115227000
Island,2024,10,55228000,57999000,113227000
Island,2024,11,47855000,58051000,105906000
Island,2024,12,114895000,48575000,163470000
Israel,2008,1,245530000,163136000,408666000
Israel,2008,2,226200000,133940000,360140000
Israel,2008,3,235966000,146711000,382677000
Israel,2008,4,243922000,147663000,391585000
Israel,2008,5,210696000,111404000,322100000
Israel,2008,6,219530000,124200000,343730000
Israel,2008,7,229179000,159440000,388619000
Israel,2008,8,206845000,106019000,312864000
Israel,2008,9,237639000,119000000,356639000
Israel,2008,10,213445000,112099000,325544000
Israel,2008,11,222289000,117568000,339857000
Israel,2008,12,211046000,109744000,320790000
Israel,2009,1,175166000,131841000,307007000
Israel,2009,2,170757000,122337000,293094000
Israel,2009,3,178795000,126664000,305459000
Israel,2009,4,168176000,117939000,286115000
Israel,2009,5,163512000,108986000,272498000
Israel,2009,6,188333000,105262000,293595000
Israel,2009,7,321754000,93139000,414893000
Israel,2009,8,185396000,117920000,303316000
Israel,2009,9,192303000,96535000,288838000
Israel,2009,10,197066000,116369000,313435000
Israel,2009,11,236908000,107677000,344585000
Israel,2009,12,251039000,105109000,356148000
Israel,2010,1,200440000,119140000,319580000
Israel,2010,2,211673000,129619000,341292000
Israel,2010,3,281423000,163075000,444498000
Israel,2010,4,226264000,124076000,350340000
Israel,2010,5,221363000,139997000,361360000
Israel,2010,6,256073000,141370000,397443000
Israel,2010,7,249440000,152877000,402317000
Israel,2010,8,241313000,151918000,393231000
Israel,2010,9,238960000,123372000,362332000
Israel,2010,10,243494000,135467000,378961000
Israel,2010,11,249737000,153019000,402756000
Israel,2010,12,258868000,158006000,416874000
Israel,2011,1,249492000,150881000,400373000
Israel,2011,2,291371000,176112000,467483000
Israel,2011,3,304183000,184018000,488201000
Israel,2011,4,254799000,163088000,417887000
Israel,2011,5,281460000,150903000,432363000
Israel,2011,6,257860000,146399000,404259000
Israel,2011,7,301017000,152695000,453712000
Israel,2011,8,287962000,171077000,459039000
Israel,2011,9,295416000,162540000,457956000
Israel,2011,10,272840000,116237000,389077000
Israel,2011,11,303197000,152842000,456039000
Israel,2011,12,331990000,155204000,487194000
Israel,2012,1,286913000,152433000,439346000
Israel,2012,2,366323000,133906000,500229000
Israel,2012,3,333932000,167001000,500933000
Israel,2012,4,314753000,145518000,460271000
Israel,2012,5,302451000,130087000,432538000
Israel,2012,6,307632000,146847000,454479000
Israel,2012,7,330703000,142936000,473639000
Israel,2012,8,299324000,137498000,436822000
Israel,2012,9,298833000,122810000,421643000
Israel,2012,10,278876000,121790000,400666000
Israel,2012,11,280872000,156233000,437105000
Israel,2012,12,261205000,125260000,386465000
Israel,2013,1,244952000,160243000,405195000
Israel,2013,2,290585000,133938000,424523000
Israel,2013,3,313816000,158741000,472557000
Israel,2013,4,298386000,138414000,436800000
Israel,2013,5,285491000,135125000,420616000
Israel,2013,6,298573000,136695000,435268000
Israel,2013,7,306124000,166800000,472924000
Israel,2013,8,277560000,121392000,398952000
Israel,2013,9,264642000,121374000,386016000
Israel,2013,10,302132000,121388000,423520000
Israel,2013,11,422875000,137370000,560245000
Israel,2013,12,287042000,129011000,416053000
Israel,2014,1,269890000,148773000,418663000
Israel,2014,2,327971000,135876000,463847000
Israel,2014,3,306308000,157334000,463642000
Israel,2014,4,290468000,129487000,419955000
Israel,2014,5,272097000,134103000,406200000
Israel,2014,6,270304000,145649000,415953000
Israel,2014,7,914112000,138972000,1053084000
Israel,2014,8,244981000,132671000,377652000
Israel,2014,9,310865000,144288000,455153000
Israel,2014,10,277096000,134772000,411868000
Israel,2014,11,263291000,133027000,396318000
Israel,2014,12,294712000,134948000,429660000
Israel,2015,1,257024000,170363000,427387000
Israel,2015,2,310196000,128779000,438975000
Israel,2015,3,351506000,169537000,521043000
Israel,2015,4,312573000,172375000,484948000
Israel,2015,5,285338000,143663000,429001000
Israel,2015,6,333265000,147028000,480293000
Israel,2015,7,357958000,154952000,512910000
Israel,2015,8,272944000,140692000,413636000
Israel,2015,9,295437000,124568000,420005000
Israel,2015,10,286237000,128043000,414280000
Israel,2015,11,661615000,137989000,799604000
Israel,2015,12,335340000,144363000,479703000
Israel,2016,1,293309000,151784000,445093000
Israel,2016,2,355672000,156686000,512358000
Israel,2016,3,369071000,157102000,526173000
Israel,2016,4,340521000,143780000,484301000
Israel,2016,5,285166000,141389000,426555000
Israel,2016,6,344949000,160997000,505946000
Israel,2016,7,317674000,138533000,456207000
Israel,2016,8,321723000,148602000,470325000
Israel,2016,9,332078000,140232000,472310000
Israel,2016,10,290157000,122754000,412911000
Israel,2016,11,372993000,137468000,510461000
Israel,2016,12,380966000,150276000,531242000
Israel,2017,1,317233000,181553000,498786000
Israel,2017,2,360310000,162554000,522864000
Israel,2017,3,418941000,166570000,585511000
Israel,2017,4,317868000,144374000,462242000
Israel,2017,5,367580000,193955000,561535000
Israel,2017,6,365683000,162814000,528497000
Israel,2017,7,359717000,170342000,530059000
Israel,2017,8,392687000,158046000,550733000
Israel,2017,9,355615000,143403000,499018000
Israel,2017,10,329074000,147290000,476364000
Israel,2017,11,392629000,180807000,573436000
Israel,2017,12,367587000,159861000,527448000
Israel,2018,1,355420000,188647000,544067000
Israel,2018,2,396715000,162064000,558779000
Israel,2018,3,385415000,183258000,568673000
Israel,2018,4,347981000,179984000,527965000
Israel,2018,5,366945000,154936000,521881000
Israel,2018,6,400014000,172243000,572257000
Israel,2018,7,396998000,188761000,585759000
Israel,2018,8,379788000,154283000,534071000
Israel,2018,9,317615000,134648000,452263000
Israel,2018,10,350152000,175842000,525994000
Israel,2018,11,435837000,174480000,610317000
Israel,2018,12,440220000,156636000,596856000
Israel,2019,1,363581000,203148000,566729000
Israel,2019,2,373727000,181166000,554893000
Israel,2019,3,401742000,192850000,594592000
Israel,2019,4,381806000,196302000,578108000
Israel,2019,5,419693000,194325000,614018000
Israel,2019,6,440082000,189102000,629184000
Israel,2019,7,391024000,198882000,589906000
Israel,2019,8,372051000,181027000,553078000
Israel,2019,9,353148000,154950000,508098000
Israel,2019,10,403966000,154673000,558639000
Israel,2019,11,401124000,185639000,586763000
Israel,2019,12,364037000,184237000,548274000
Israel,2020,1,368094000,223198000,591292000
Israel,2020,2,388690000,187401000,576091000
Israel,2020,3,386150000,195739000,581889000
Israel,2020,4,295832000,181412000,477244000
Israel,2020,5,308270000,168377000,476647000
Israel,2020,6,325652000,211591000,537243000
Israel,2020,7,333282000,175531000,508813000
Israel,2020,8,311099000,168819000,479918000
Israel,2020,9,353376000,171194000,524570000
Israel,2020,10,534854000,172105000,706959000
Israel,2020,11,430079000,162649000,592728000
Israel,2020,12,397355000,227079000,624434000
Israel,2021,1,338856000,202241000,541097000
Israel,2021,2,414392000,200478000,614870000
Israel,2021,3,455821000,225303000,681124000
Israel,2021,4,368403000,221872000,590275000
Israel,2021,5,522673000,217798000,740471000
Israel,2021,6,400207000,200668000,600875000
Israel,2021,7,578062000,205973000,784035000
Israel,2021,8,521114000,176568000,697682000
Israel,2021,9,387372000,162932000,550304000
Israel,2021,10,419539000,182536000,602075000
Israel,2021,11,471729000,210963000,682692000
Israel,2021,12,464793000,220164000,684957000
Israel,2022,1,432639000,201848000,634487000
Israel,2022,2,519029000,205070000,724099000
Israel,2022,3,589263000,233169000,822432000
Israel,2022,4,468206000,212068000,680274000
Israel,2022,5,476424000,219062000,695486000
Israel,2022,6,538977000,222976000,761953000
Israel,2022,7,434995000,221095000,656090000
Israel,2022,8,494906000,250200000,745106000
Israel,2022,9,491160000,222305000,713465000
Israel,2022,10,426879000,207729000,634608000
Israel,2022,11,513288000,247989000,761277000
Israel,2022,12,508627000,238080000,746707000
Israel,2023,1,470509000,232501000,703010000
Israel,2023,2,472567000,217736000,690303000
Israel,2023,3,560948000,269857000,830805000
Israel,2023,4,403527000,247206000,650733000
Israel,2023,5,435855000,233839000,669694000
Israel,2023,6,482072000,233077000,715149000
Israel,2023,7,396198000,251666000,647864000
Israel,2023,8,407970000,232779000,640749000
Israel,2023,9,441243000,201761000,643004000
Israel,2023,10,390370000,222022000,612392000
Israel,2023,11,465387000,253030000,718417000
Israel,2023,12,355587000,212776000,568363000
Israel,2024,1,456904000,261667000,718571000
Israel,2024,2,418759000,239291000,658050000
Israel,2024,3,457702000,253047000,710749000
Israel,2024,4,428413000,257927000,686340000
Israel,2024,5,439974000,221956000,661930000
Israel,2024,6,427095000,230610000,657705000
Israel,2024,7,434919000,230116000,665035000
Israel,2024,8,438671000,222363000,661034000
Israel,2024,9,463440000,223033000,686473000
Israel,2024,10,394099000,358470000,752569000
Israel,2024,11,443515000,213829000,657344000
Israel,2024,12,457293000,246228000,703521000
Italien,2008,1,5333535000,3772621000,9106156000
Italien,2008,2,5302834000,3748767000,9051601000
Italien,2008,3,5333491000,4134795000,9468286000
Italien,2008,4,5812111000,4166763000,9978874000
Italien,2008,5,5181991000,4023323000,9205314000
Italien,2008,6,5592630000,4143328000,9735958000
Italien,2008,7,5438476000,4443919000,9882395000
Italien,2008,8,3797359000,3225544000,7022903000
Italien,2008,9,5711917000,4233668000,9945585000
Italien,2008,10,5733411000,4193261000,9926672000
Italien,2008,11,4852330000,3575736000,8428066000
Italien,2008,12,3924669000,3180124000,7104793000
Italien,2009,1,4234933000,3047842000,7282775000
Italien,2009,2,4014214000,3144177000,7158391000
Italien,2009,3,4848009000,3526882000,8374891000
Italien,2009,4,4089712000,3209140000,7298852000
Italien,2009,5,3854104000,2989737000,6843841000
Italien,2009,6,4204361000,2921624000,7125985000
Italien,2009,7,4476513000,3333805000,7810318000
Italien,2009,8,2847496000,2450117000,5297613000
Italien,2009,9,4615308000,3099505000,7714813000
Italien,2009,10,4675242000,3317801000,7993043000
Italien,2009,11,4679505000,3236143000,7915648000
Italien,2009,12,4080130000,2920052000,7000182000
Italien,2010,1,4102567000,2752805000,6855372000
Italien,2010,2,4642149000,3142860000,7785009000
Italien,2010,3,5103182000,3714471000,8817653000
Italien,2010,4,4565081000,3440354000,8005435000
Italien,2010,5,4785316000,3802165000,8587481000
Italien,2010,6,5313922000,3629755000,8943677000
Italien,2010,7,5025187000,3881680000,8906867000
Italien,2010,8,3549687000,2968082000,6517769000
Italien,2010,9,5378550000,3584912000,8963462000
Italien,2010,10,5586712000,3831535000,9418247000
Italien,2010,11,5525889000,3725593000,9251482000
Italien,2010,12,5010454000,3503151000,8513605000
Italien,2011,1,4919465000,3394419000,8313884000
Italien,2011,2,5132194000,3960148000,9092342000
Italien,2011,3,6209215000,4388948000,10598163000
Italien,2011,4,5196874000,4133210000,9330084000
Italien,2011,5,5502303000,4216259000,9718562000
Italien,2011,6,5582945000,4231441000,9814386000
Italien,2011,7,5163677000,4264737000,9428414000
Italien,2011,8,3961490000,3418952000,7380442000
Italien,2011,9,5559592000,4023552000,9583144000
Italien,2011,10,5177226000,4088246000,9265472000
Italien,2011,11,5358281000,3959215000,9317496000
Italien,2011,12,4280330000,3764399000,8044729000
Italien,2012,1,4721795000,3663110000,8384905000
Italien,2012,2,4962414000,4135400000,9097814000
Italien,2012,3,5142712000,4476590000,9619302000
Italien,2012,4,4764035000,3957436000,8721471000
Italien,2012,5,5179970000,4310765000,9490735000
Italien,2012,6,4783645000,4233021000,9016666000
Italien,2012,7,4701287000,4465236000,9166523000
Italien,2012,8,3512607000,3335263000,6847870000
Italien,2012,9,4501255000,3764351000,8265606000
Italien,2012,10,4870531000,4272560000,9143091000
Italien,2012,11,4540487000,3965192000,8505679000
Italien,2012,12,3823120000,3367098000,7190218000
Italien,2013,1,4691362000,3680306000,8371668000
Italien,2013,2,4428050000,3862707000,8290757000
Italien,2013,3,4685517000,4068601000,8754118000
Italien,2013,4,4648197000,3876251000,8524448000
Italien,2013,5,4468816000,4091211000,8560027000
Italien,2013,6,4610376000,4046800000,8657176000
Italien,2013,7,4622475000,4395990000,9018465000
Italien,2013,8,3335331000,3205240000,6540571000
Italien,2013,9,4697111000,3876175000,8573286000
Italien,2013,10,4797565000,4329811000,9127376000
Italien,2013,11,4533249000,3883311000,8416560000
Italien,2013,12,3693740000,3594473000,7288213000
Italien,2014,1,4711206000,3885894000,8597100000
Italien,2014,2,4562599000,4225092000,8787691000
Italien,2014,3,4646842000,4192291000,8839133000
Italien,2014,4,4512110000,4067620000,8579730000
Italien,2014,5,4548078000,4052681000,8600759000
Italien,2014,6,4692196000,4269469000,8961665000
Italien,2014,7,4861094000,4524066000,9385160000
Italien,2014,8,3259283000,3254927000,6514210000
Italien,2014,9,5028726000,4061989000,9090715000
Italien,2014,10,4918878000,4391093000,9309971000
Italien,2014,11,4603030000,3968372000,8571402000
Italien,2014,12,3895939000,3628477000,7524416000
Italien,2015,1,4476004000,3575134000,8051138000
Italien,2015,2,4709129000,3961101000,8670230000
Italien,2015,3,5285359000,4358401000,9643760000
Italien,2015,4,4784068000,4171789000,8955857000
Italien,2015,5,4872919000,4102570000,8975489000
Italien,2015,6,5399050000,4256884000,9655934000
Italien,2015,7,5284558000,4728997000,10013555000
Italien,2015,8,3376591000,3346669000,6723260000
Italien,2015,9,5254319000,4163003000,9417322000
Italien,2015,10,5230623000,4400804000,9631427000
Italien,2015,11,5185584000,4337150000,9522734000
Italien,2015,12,4129014000,3635634000,7764648000
Italien,2016,1,4804746000,3806717000,8611463000
Italien,2016,2,5096107000,4302308000,9398415000
Italien,2016,3,5431055000,4420884000,9851939000
Italien,2016,4,5277846000,4344569000,9622415000
Italien,2016,5,5072552000,4383335000,9455887000
Italien,2016,6,5467951000,4512370000,9980321000
Italien,2016,7,5240032000,4608812000,9848844000
Italien,2016,8,3889903000,3770345000,7660248000
Italien,2016,9,5487409000,4419698000,9907107000
Italien,2016,10,5379615000,4440726000,9820341000
Italien,2016,11,5545944000,4615221000,10161165000
Italien,2016,12,4571711000,4112289000,8684000000
Italien,2017,1,5070726000,4154817000,9225543000
Italien,2017,2,5347923000,4412354000,9760277000
Italien,2017,3,5970931000,4849227000,10820158000
Italien,2017,4,5168815000,4479408000,9648223000
Italien,2017,5,5758682000,4917475000,10676157000
Italien,2017,6,5690261000,4692888000,10383149000
Italien,2017,7,5563086000,4881469000,10444555000
Italien,2017,8,4226256000,3985478000,8211734000
Italien,2017,9,5842486000,4549633000,10392119000
Italien,2017,10,5664155000,4905874000,10570029000
Italien,2017,11,6059235000,4940969000,11000204000
Italien,2017,12,5059101000,4572099000,9631200000
Italien,2018,1,5772257000,4643173000,10415430000
Italien,2018,2,5779074000,4971361000,10750435000
Italien,2018,3,6219782000,4955470000,11175252000
Italien,2018,4,5789973000,5022937000,10812910000
Italien,2018,5,5964959000,5209553000,11174512000
Italien,2018,6,6155258000,5685585000,11840843000
Italien,2018,7,5999770000,5588281000,11588051000
Italien,2018,8,4390039000,4471354000,8861393000
Italien,2018,9,5744891000,5182373000,10927264000
Italien,2018,10,7116004000,5318377000,12434381000
Italien,2018,11,6144663000,5018751000,11163414000
Italien,2018,12,4736717000,4155489000,8892206000
Italien,2019,1,5761764000,4485562000,10247326000
Italien,2019,2,5719273000,4716423000,10435696000
Italien,2019,3,6277923000,5044407000,11322330000
Italien,2019,4,5570836000,4769427000,10340263000
Italien,2019,5,5952264000,4851730000,10803994000
Italien,2019,6,5761315000,5118302000,10879617000
Italien,2019,7,5870462000,5129636000,11000098000
Italien,2019,8,4204360000,4007394000,8211754000
Italien,2019,9,5973158000,4818764000,10791922000
Italien,2019,10,6099504000,4994314000,11093818000
Italien,2019,11,5808187000,4891318000,10699505000
Italien,2019,12,4887660000,4272999000,9160659000
Italien,2020,1,5654878000,4354676000,10009554000
Italien,2020,2,5717648000,4987676000,10705324000
Italien,2020,3,5114486000,4729040000,9843526000
Italien,2020,4,3309186000,3198742000,6507928000
Italien,2020,5,4474513000,3920892000,8395405000
Italien,2020,6,4778556000,4357271000,9135827000
Italien,2020,7,5474595000,4647090000,10121685000
Italien,2020,8,3927998000,4097557000,8025555000
Italien,2020,9,5699678000,4799098000,10498776000
Italien,2020,10,5859662000,5070061000,10929723000
Italien,2020,11,5867121000,5381849000,11248970000
Italien,2020,12,4755690000,4361565000,9117255000
Italien,2021,1,5425376000,4469711000,9895087000
Italien,2021,2,5910341000,5255503000,11165844000
Italien,2021,3,6930040000,5959722000,12889762000
Italien,2021,4,6168090000,5277470000,11445560000
Italien,2021,5,6186761000,5594561000,11781322000
Italien,2021,6,6557272000,5656150000,12213422000
Italien,2021,7,6691315000,5741238000,12432553000
Italien,2021,8,4690545000,4520047000,9210592000
Italien,2021,9,6584344000,5474852000,12059196000
Italien,2021,10,7664900000,5836223000,13501123000
Italien,2021,11,6668745000,6103655000,12772400000
Italien,2021,12,6048220000,5499634000,11547854000
Italien,2022,1,6622755000,5083333000,11706088000
Italien,2022,2,7112054000,5954763000,13066817000
Italien,2022,3,8215323000,6902176000,15117499000
Italien,2022,4,7662979000,5811570000,13474549000
Italien,2022,5,8657029000,6670133000,15327162000
Italien,2022,6,7483620000,6461256000,13944876000
Italien,2022,7,7262540000,6321637000,13584177000
Italien,2022,8,5828646000,5100921000,10929567000
Italien,2022,9,8091324000,6355788000,14447112000
Italien,2022,10,7608938000,6427405000,14036343000
Italien,2022,11,7761493000,6566514000,14328007000
Italien,2022,12,6842459000,5615189000,12457648000
Italien,2023,1,7898946000,5468464000,13367410000
Italien,2023,2,7722279000,5959913000,13682192000
Italien,2023,3,8514403000,7122366000,15636769000
Italien,2023,4,6222269000,5541415000,11763684000
Italien,2023,5,7239405000,6450606000,13690011000
Italien,2023,6,7625026000,6481764000,14106790000
Italien,2023,7,6956119000,6303741000,13259860000
Italien,2023,8,5306456000,4757074000,10063530000
Italien,2023,9,7189657000,5958914000,13148571000
Italien,2023,10,7097533000,6100432000,13197965000
Italien,2023,11,7785974000,6132129000,13918103000
Italien,2023,12,5845363000,5046580000,10891943000
Italien,2024,1,7319366000,5668285000,12987651000
Italien,2024,2,7099538000,5823297000,12922835000
Italien,2024,3,7379025000,5881493000,13260518000
Italien,2024,4,6832920000,5953823000,12786743000
Italien,2024,5,6896422000,5757380000,12653802000
Italien,2024,6,6768824000,5737796000,12506620000
Italien,2024,7,7056602000,6306643000,13363245000
Italien,2024,8,5288211000,4550242000,9838453000
Italien,2024,9,6971287000,5741351000,12712638000
Italien,2024,10,7121526000,6008307000,13129833000
Italien,2024,11,6637907000,5592987000,12230894000
Italien,2024,12,5728267000,5249676000,10977943000
Jamaika,2008,1,2570000,11269000,13839000
Jamaika,2008,2,2765000,15955000,18720000
Jamaika,2008,3,3223000,15714000,18937000
Jamaika,2008,4,1948000,7212000,9160000
Jamaika,2008,5,1946000,18316000,20262000
Jamaika,2008,6,2441000,6733000,9174000
Jamaika,2008,7,1353000,10893000,12246000
Jamaika,2008,8,2109000,8160000,10269000
Jamaika,2008,9,1816000,6229000,8045000
Jamaika,2008,10,3524000,15177000,18701000
Jamaika,2008,11,2890000,8073000,10963000
Jamaika,2008,12,2088000,4084000,6172000
Jamaika,2009,1,1798000,5787000,7585000
Jamaika,2009,2,1310000,206000,1516000
Jamaika,2009,3,1380000,8934000,10314000
Jamaika,2009,4,1989000,200000,2189000
Jamaika,2009,5,1850000,108000,1958000
Jamaika,2009,6,2243000,315000,2558000
Jamaika,2009,7,2192000,323000,2515000
Jamaika,2009,8,1459000,561000,2020000
Jamaika,2009,9,1712000,222000,1934000
Jamaika,2009,10,2008000,3078000,5086000
Jamaika,2009,11,2253000,5850000,8103000
Jamaika,2009,12,1849000,403000,2252000
Jamaika,2010,1,1762000,559000,2321000
Jamaika,2010,2,1815000,258000,2073000
Jamaika,2010,3,1816000,6304000,8120000
Jamaika,2010,4,1963000,332000,2295000
Jamaika,2010,5,2004000,338000,2342000
Jamaika,2010,6,2724000,668000,3392000
Jamaika,2010,7,1998000,4676000,6674000
Jamaika,2010,8,2551000,12606000,15157000
Jamaika,2010,9,1948000,165000,2113000
Jamaika,2010,10,2638000,13456000,16094000
Jamaika,2010,11,2243000,518000,2761000
Jamaika,2010,12,1852000,282000,2134000
Jamaika,2011,1,2157000,19715000,21872000
Jamaika,2011,2,2452000,9471000,11923000
Jamaika,2011,3,2672000,2086000,4758000
Jamaika,2011,4,4283000,2230000,6513000
Jamaika,2011,5,2321000,1360000,3681000
Jamaika,2011,6,1583000,1223000,2806000
Jamaika,2011,7,3659000,188000,3847000
Jamaika,2011,8,2274000,17941000,20215000
Jamaika,2011,9,2966000,416000,3382000
Jamaika,2011,10,2207000,763000,2970000
Jamaika,2011,11,3070000,744000,3814000
Jamaika,2011,12,3297000,661000,3958000
Jamaika,2012,1,2130000,153000,2283000
Jamaika,2012,2,3473000,6794000,10267000
Jamaika,2012,3,3390000,333000,3723000
Jamaika,2012,4,3890000,86000,3976000
Jamaika,2012,5,2608000,1901000,4509000
Jamaika,2012,6,2881000,487000,3368000
Jamaika,2012,7,4223000,335000,4558000
Jamaika,2012,8,3051000,343000,3394000
Jamaika,2012,9,3472000,1830000,5302000
Jamaika,2012,10,3480000,2891000,6371000
Jamaika,2012,11,3155000,378000,3533000
Jamaika,2012,12,4507000,3985000,8492000
Jamaika,2013,1,2840000,15605000,18445000
Jamaika,2013,2,3364000,3142000,6506000
Jamaika,2013,3,3187000,7095000,10282000
Jamaika,2013,4,4024000,4205000,8229000
Jamaika,2013,5,3754000,967000,4721000
Jamaika,2013,6,2941000,3059000,6000000
Jamaika,2013,7,3088000,6544000,9632000
Jamaika,2013,8,2981000,15781000,18762000
Jamaika,2013,9,2432000,3937000,6369000
Jamaika,2013,10,7686000,6004000,13690000
Jamaika,2013,11,3362000,2413000,5775000
Jamaika,2013,12,2980000,7545000,10525000
Jamaika,2014,1,2995000,6018000,9013000
Jamaika,2014,2,2579000,6838000,9417000
Jamaika,2014,3,2579000,3505000,6084000
Jamaika,2014,4,3511000,3136000,6647000
Jamaika,2014,5,3028000,1243000,4271000
Jamaika,2014,6,2325000,1041000,3366000
Jamaika,2014,7,3601000,7356000,10957000
Jamaika,2014,8,3001000,2612000,5613000
Jamaika,2014,9,3579000,510000,4089000
Jamaika,2014,10,4434000,1915000,6349000
Jamaika,2014,11,2938000,9076000,12014000
Jamaika,2014,12,3504000,318000,3822000
Jamaika,2015,1,2345000,12029000,14374000
Jamaika,2015,2,3705000,6575000,10280000
Jamaika,2015,3,3818000,1872000,5690000
Jamaika,2015,4,2557000,2468000,5025000
Jamaika,2015,5,4132000,4696000,8828000
Jamaika,2015,6,5950000,5674000,11624000
Jamaika,2015,7,5285000,5708000,10993000
Jamaika,2015,8,4417000,3800000,8217000
Jamaika,2015,9,3847000,1930000,5777000
Jamaika,2015,10,7744000,4305000,12049000
Jamaika,2015,11,4352000,3171000,7523000
Jamaika,2015,12,5068000,2357000,7425000
Jamaika,2016,1,2069000,1845000,3914000
Jamaika,2016,2,6099000,9967000,16066000
Jamaika,2016,3,10098000,1578000,11676000
Jamaika,2016,4,7271000,20165000,27436000
Jamaika,2016,5,4391000,16307000,20698000
Jamaika,2016,6,5302000,3470000,8772000
Jamaika,2016,7,4362000,15583000,19945000
Jamaika,2016,8,4080000,5754000,9834000
Jamaika,2016,9,7916000,13530000,21446000
Jamaika,2016,10,7034000,3986000,11020000
Jamaika,2016,11,7665000,6734000,14399000
Jamaika,2016,12,3722000,3115000,6837000
Jamaika,2017,1,3175000,10234000,13409000
Jamaika,2017,2,3479000,1939000,5418000
Jamaika,2017,3,11384000,7922000,19306000
Jamaika,2017,4,4235000,11699000,15934000
Jamaika,2017,5,10418000,14031000,24449000
Jamaika,2017,6,4983000,11280000,16263000
Jamaika,2017,7,6343000,13502000,19845000
Jamaika,2017,8,4563000,6360000,10923000
Jamaika,2017,9,6125000,16650000,22775000
Jamaika,2017,10,5095000,12764000,17859000
Jamaika,2017,11,4119000,12194000,16313000
Jamaika,2017,12,3676000,14815000,18491000
Jamaika,2018,1,5575000,16802000,22377000
Jamaika,2018,2,4237000,3873000,8110000
Jamaika,2018,3,7952000,14494000,22446000
Jamaika,2018,4,16362000,11526000,27888000
Jamaika,2018,5,6489000,10272000,16761000
Jamaika,2018,6,8149000,7800000,15949000
Jamaika,2018,7,15241000,15517000,30758000
Jamaika,2018,8,8861000,3752000,12613000
Jamaika,2018,9,5147000,10748000,15895000
Jamaika,2018,10,6969000,6683000,13652000
Jamaika,2018,11,9159000,10940000,20099000
Jamaika,2018,12,5506000,2471000,7977000
Jamaika,2019,1,5574000,26100000,31674000
Jamaika,2019,2,4172000,8245000,12417000
Jamaika,2019,3,4648000,5133000,9781000
Jamaika,2019,4,7841000,29436000,37277000
Jamaika,2019,5,4237000,10114000,14351000
Jamaika,2019,6,5859000,11864000,17723000
Jamaika,2019,7,5593000,11587000,17180000
Jamaika,2019,8,4963000,16170000,21133000
Jamaika,2019,9,5507000,9416000,14923000
Jamaika,2019,10,5918000,18498000,24416000
Jamaika,2019,11,5051000,15501000,20552000
Jamaika,2019,12,3627000,8738000,12365000
Jamaika,2020,1,5087000,8282000,13369000
Jamaika,2020,2,4296000,4952000,9248000
Jamaika,2020,3,5664000,1081000,6745000
Jamaika,2020,4,3570000,3735000,7305000
Jamaika,2020,5,3519000,4219000,7738000
Jamaika,2020,6,3436000,2422000,5858000
Jamaika,2020,7,5332000,2278000,7610000
Jamaika,2020,8,2744000,1594000,4338000
Jamaika,2020,9,3845000,1301000,5146000
Jamaika,2020,10,6173000,2675000,8848000
Jamaika,2020,11,3891000,2208000,6099000
Jamaika,2020,12,4260000,4743000,9003000
Jamaika,2021,1,2898000,1867000,4765000
Jamaika,2021,2,2963000,2503000,5466000
Jamaika,2021,3,4403000,2357000,6760000
Jamaika,2021,4,2612000,5424000,8036000
Jamaika,2021,5,3357000,2123000,5480000
Jamaika,2021,6,3297000,867000,4164000
Jamaika,2021,7,3606000,2396000,6002000
Jamaika,2021,8,7049000,3783000,10832000
Jamaika,2021,9,4369000,2280000,6649000
Jamaika,2021,10,3657000,2104000,5761000
Jamaika,2021,11,4352000,981000,5333000
Jamaika,2021,12,3913000,1898000,5811000
Jamaika,2022,1,4112000,440000,4552000
Jamaika,2022,2,6290000,345000,6635000
Jamaika,2022,3,7979000,954000,8933000
Jamaika,2022,4,6886000,954000,7840000
Jamaika,2022,5,8664000,1274000,9938000
Jamaika,2022,6,5529000,944000,6473000
Jamaika,2022,7,4133000,553000,4686000
Jamaika,2022,8,4105000,640000,4745000
Jamaika,2022,9,5167000,946000,6113000
Jamaika,2022,10,6407000,712000,7119000
Jamaika,2022,11,5692000,1078000,6770000
Jamaika,2022,12,5072000,1504000,6576000
Jamaika,2023,1,3890000,535000,4425000
Jamaika,2023,2,5768000,492000,6260000
Jamaika,2023,3,5794000,818000,6612000
Jamaika,2023,4,4321000,531000,4852000
Jamaika,2023,5,5015000,769000,5784000
Jamaika,2023,6,22000000,597000,22597000
Jamaika,2023,7,4717000,314000,5031000
Jamaika,2023,8,5352000,986000,6338000
Jamaika,2023,9,4961000,633000,5594000
Jamaika,2023,10,7081000,388000,7469000
Jamaika,2023,11,7958000,597000,8555000
Jamaika,2023,12,4608000,254000,4862000
Jamaika,2024,1,4822000,680000,5502000
Jamaika,2024,2,5560000,246000,5806000
Jamaika,2024,3,7545000,437000,7982000
Jamaika,2024,4,7514000,241000,7755000
Jamaika,2024,5,4658000,578000,5236000
Jamaika,2024,6,4724000,498000,5222000
Jamaika,2024,7,12286000,876000,13162000
Jamaika,2024,8,3486000,524000,4010000
Jamaika,2024,9,6291000,768000,7059000
Jamaika,2024,10,7181000,960000,8141000
Jamaika,2024,11,3884000,714000,4598000
Jamaika,2024,12,3690000,259000,3949000
Japan,2008,1,1208380000,1936967000,3145347000
Japan,2008,2,1126830000,1984148000,3110978000
Japan,2008,3,1027330000,2120347000,3147677000
Japan,2008,4,1094614000,2051367000,3145981000
Japan,2008,5,965793000,1753167000,2718960000
Japan,2008,6,1056257000,1881147000,2937404000
Japan,2008,7,1102997000,1805768000,2908765000
Japan,2008,8,972541000,1817245000,2789786000
Japan,2008,9,1125948000,1992488000,3118436000
Japan,2008,10,1086603000,1950543000,3037146000
Japan,2008,11,991371000,2081939000,3073310000
Japan,2008,12,973054000,1754662000,2727716000
Japan,2009,1,810094000,1650823000,2460917000
Japan,2009,2,919310000,1653503000,2572813000
Japan,2009,3,920880000,1726073000,2646953000
Japan,2009,4,790798000,1477607000,2268405000
Japan,2009,5,783487000,1409186000,2192673000
Japan,2009,6,908631000,1506461000,2415092000
Japan,2009,7,1063491000,1479616000,2543107000
Japan,2009,8,814316000,1427815000,2242131000
Japan,2009,9,985403000,1686654000,2672057000
Japan,2009,10,935501000,1650874000,2586375000
Japan,2009,11,989737000,1719687000,2709424000
Japan,2009,12,953496000,1557772000,2511268000
Japan,2010,1,1005015000,1613912000,2618927000
Japan,2010,2,975983000,1504250000,2480233000
Japan,2010,3,1168243000,2260155000,3428398000
Japan,2010,4,992717000,1757648000,2750365000
Japan,2010,5,1033922000,1835933000,2869855000
Japan,2010,6,1113995000,1989993000,3103988000
Japan,2010,7,1208811000,1846707000,3055518000
Japan,2010,8,1008696000,1810102000,2818798000
Japan,2010,9,1198396000,2045204000,3243600000
Japan,2010,10,1209995000,2017867000,3227862000
Japan,2010,11,1135008000,2099703000,3234711000
Japan,2010,12,1098664000,1693877000,2792541000
Japan,2011,1,1172115000,1984643000,3156758000
Japan,2011,2,1207809000,1758594000,2966403000
Japan,2011,3,1265400000,2235201000,3500601000
Japan,2011,4,1072312000,1954106000,3026418000
Japan,2011,5,1130430000,1907382000,3037812000
Japan,2011,6,1129642000,1857074000,2986716000
Japan,2011,7,1288263000,1941820000,3230083000
Japan,2011,8,1250873000,1967701000,3218574000
Japan,2011,9,1497586000,1973502000,3471088000
Japan,2011,10,1446248000,2076067000,3522315000
Japan,2011,11,1363584000,2074357000,3437941000
Japan,2011,12,1291137000,1864656000,3155793000
Japan,2012,1,1406334000,1878868000,3285202000
Japan,2012,2,1416295000,1826716000,3243011000
Japan,2012,3,1494793000,2010722000,3505515000
Japan,2012,4,1258933000,1749698000,3008631000
Japan,2012,5,1332254000,1935596000,3267850000
Japan,2012,6,1469325000,1807792000,3277117000
Japan,2012,7,1632049000,1835987000,3468036000
Japan,2012,8,1431842000,1741783000,3173625000
Japan,2012,9,1499867000,1890403000,3390270000
Japan,2012,10,1565199000,1862959000,3428158000
Japan,2012,11,1430721000,1924528000,3355249000
Japan,2012,12,1200226000,1445229000,2645455000
Japan,2013,1,1422330000,1719106000,3141436000
Japan,2013,2,1276925000,1510535000,2787460000
Japan,2013,3,1331991000,1735162000,3067153000
Japan,2013,4,1391804000,1698786000,3090590000
Japan,2013,5,1210058000,1504822000,2714880000
Japan,2013,6,1323252000,1610145000,2933397000
Japan,2013,7,1529584000,1648444000,3178028000
Japan,2013,8,1470069000,1535087000,3005156000
Japan,2013,9,1586061000,1722233000,3308294000
Japan,2013,10,1585455000,1676375000,3261830000
Japan,2013,11,1511191000,1707178000,3218369000
Japan,2013,12,1437170000,1423738000,2860908000
Japan,2014,1,1604449000,1623368000,3227817000
Japan,2014,2,1361303000,1485496000,2846799000
Japan,2014,3,1361001000,1713705000,3074706000
Japan,2014,4,1295667000,1604523000,2900190000
Japan,2014,5,1251695000,1549869000,2801564000
Japan,2014,6,1324940000,1552098000,2877038000
Japan,2014,7,1621630000,1711762000,3333392000
Japan,2014,8,1247611000,1466638000,2714249000
Japan,2014,9,1602926000,1721420000,3324346000
Japan,2014,10,1579645000,1721534000,3301179000
Japan,2014,11,1344434000,1452809000,2797243000
Japan,2014,12,1314525000,1403404000,2717929000
Japan,2015,1,1382686000,1512211000,2894897000
Japan,2015,2,1389015000,1585655000,2974670000
Japan,2015,3,1504652000,1868447000,3373099000
Japan,2015,4,1305651000,1678745000,2984396000
Japan,2015,5,1164159000,1654414000,2818573000
Japan,2015,6,1451414000,1696258000,3147672000
Japan,2015,7,1634853000,1703433000,3338286000
Japan,2015,8,1277570000,1588700000,2866270000
Japan,2015,9,1510383000,1673089000,3183472000
Japan,2015,10,1536490000,1866742000,3403232000
Japan,2015,11,1450617000,1705598000,3156215000
Japan,2015,12,1360374000,1647101000,3007475000
Japan,2016,1,1274688000,1684993000,2959681000
Japan,2016,2,1401228000,1715708000,3116936000
Japan,2016,3,1546522000,1962156000,3508678000
Japan,2016,4,1463743000,1856507000,3320250000
Japan,2016,5,1353892000,1769825000,3123717000
Japan,2016,6,1523089000,1885003000,3408092000
Japan,2016,7,1582106000,1703972000,3286078000
Japan,2016,8,1623137000,1906310000,3529447000
Japan,2016,9,1633904000,1920663000,3554567000
Japan,2016,10,1603808000,1865851000,3469659000
Japan,2016,11,1731585000,1923465000,3655050000
Japan,2016,12,1569631000,1727757000,3297388000
Japan,2017,1,1576308000,1947779000,3524087000
Japan,2017,2,1519358000,1839889000,3359247000
Japan,2017,3,1842833000,2131400000,3974233000
Japan,2017,4,1472983000,1871464000,3344447000
Japan,2017,5,1558306000,2104705000,3663011000
Japan,2017,6,1531626000,1803366000,3334992000
Japan,2017,7,1812363000,1803524000,3615887000
Japan,2017,8,1638929000,1918099000,3557028000
Japan,2017,9,1764039000,1969491000,3733530000
Japan,2017,10,1558432000,1893239000,3451671000
Japan,2017,11,1650747000,1970193000,3620940000
Japan,2017,12,1619765000,1702339000,3322104000
Japan,2018,1,1605640000,2093244000,3698884000
Japan,2018,2,1536407000,1860282000,3396689000
Japan,2018,3,1844975000,2007901000,3852876000
Japan,2018,4,1426904000,2023892000,3450796000
Japan,2018,5,1580254000,1914097000,3494351000
Japan,2018,6,1661767000,2035310000,3697077000
Japan,2018,7,2000452000,2012554000,4013006000
Japan,2018,8,1771840000,2000020000,3771860000
Japan,2018,9,1877169000,1944606000,3821775000
Japan,2018,10,1721652000,2108637000,3830289000
Japan,2018,11,1746976000,2076832000,3823808000
Japan,2018,12,1661546000,1632758000,3294304000
Japan,2019,1,1961100000,2077117000,4038217000
Japan,2019,2,1644970000,1927321000,3572291000
Japan,2019,3,1830015000,2011822000,3841837000
Japan,2019,4,1642109000,2102266000,3744375000
Japan,2019,5,1658324000,2099733000,3758057000
Japan,2019,6,1597607000,1834366000,3431973000
Japan,2019,7,2045467000,2014945000,4060412000
Japan,2019,8,1579785000,1914667000,3494452000
Japan,2019,9,1865241000,2109498000,3974739000
Japan,2019,10,1917243000,2163434000,4080677000
Japan,2019,11,1596147000,2018396000,3614543000
Japan,2019,12,1323832000,1630885000,2954717000
Japan,2020,1,1634241000,2127658000,3761899000
Japan,2020,2,1648720000,1822224000,3470944000
Japan,2020,3,1601199000,2108356000,3709555000
Japan,2020,4,1128417000,1643464000,2771881000
Japan,2020,5,1423991000,1417950000,2841941000
Japan,2020,6,1291294000,1691287000,2982581000
Japan,2020,7,1449373000,1714424000,3163797000
Japan,2020,8,1146434000,1550542000,2696976000
Japan,2020,9,1471264000,1685574000,3156838000
Japan,2020,10,1474905000,1939891000,3414796000
Japan,2020,11,1597881000,1969582000,3567463000
Japan,2020,12,1527886000,1756245000,3284131000
Japan,2021,1,1469729000,1798117000,3267846000
Japan,2021,2,1435782000,1678281000,3114063000
Japan,2021,3,1673737000,1884222000,3557959000
Japan,2021,4,1547685000,2070273000,3617958000
Japan,2021,5,1310135000,1951411000,3261546000
Japan,2021,6,1400315000,2031679000,3431994000
Japan,2021,7,1435131000,1939274000,3374405000
Japan,2021,8,1563230000,1920961000,3484191000
Japan,2021,9,1637286000,2109403000,3746689000
Japan,2021,10,1574056000,2053213000,3627269000
Japan,2021,11,1693850000,2160069000,3853919000
Japan,2021,12,1504083000,1880526000,3384609000
Japan,2022,1,1557201000,1886542000,3443743000
Japan,2022,2,1736102000,1934438000,3670540000
Japan,2022,3,1915319000,2156807000,4072126000
Japan,2022,4,1623134000,2039108000,3662242000
Japan,2022,5,1680232000,2253024000,3933256000
Japan,2022,6,1644217000,2057471000,3701688000
Japan,2022,7,1578722000,1972885000,3551607000
Japan,2022,8,1683423000,2134040000,3817463000
Japan,2022,9,1805322000,2303274000,4108596000
Japan,2022,10,1849641000,2262246000,4111887000
Japan,2022,11,1766221000,2458933000,4225154000
Japan,2022,12,1671632000,1961497000,3633129000
Japan,2023,1,1649856000,2176589000,3826445000
Japan,2023,2,1747795000,2027467000,3775262000
Japan,2023,3,1942114000,2424945000,4367059000
Japan,2023,4,1536960000,2094665000,3631625000
Japan,2023,5,1660030000,2086675000,3746705000
Japan,2023,6,1801842000,2336275000,4138117000
Japan,2023,7,1756038000,2058585000,3814623000
Japan,2023,8,1569477000,2087329000,3656806000
Japan,2023,9,1633040000,2251829000,3884869000
Japan,2023,10,1743371000,2180921000,3924292000
Japan,2023,11,1670622000,2080479000,3751101000
Japan,2023,12,1526654000,1762340000,3288994000
Japan,2024,1,1813268000,1936183000,3749451000
Japan,2024,2,1757240000,1935736000,3692976000
Japan,2024,3,1588677000,2069084000,3657761000
Japan,2024,4,1513496000,2081587000,3595083000
Japan,2024,5,1480225000,1791066000,3271291000
Japan,2024,6,1693368000,1722348000,3415716000
Japan,2024,7,1997563000,1869249000,3866812000
Japan,2024,8,2314776000,1749856000,4064632000
Japan,2024,9,1559546000,1913973000,3473519000
Japan,2024,10,1867303000,2010659000,3877962000
Japan,2024,11,2523843000,1829415000,4353258000
Japan,2024,12,1442039000,1836557000,3278596000
Jemen,2008,1,23936000,298000,24234000
Jemen,2008,2,23404000,574000,23978000
Jemen,2008,3,10088000,2812000,12900000
Jemen,2008,4,25225000,174000,25399000
Jemen,2008,5,12365000,202000,12567000
Jemen,2008,6,17219000,96000,17315000
Jemen,2008,7,12246000,1753000,13999000
Jemen,2008,8,13398000,62000,13460000
Jemen,2008,9,37113000,143000,37256000
Jemen,2008,10,16138000,282000,16420000
Jemen,2008,11,12688000,127000,12815000
Jemen,2008,12,20761000,162000,20923000
Jemen,2009,1,18166000,197000,18363000
Jemen,2009,2,18228000,174000,18402000
Jemen,2009,3,30506000,633000,31139000
Jemen,2009,4,14947000,163000,15110000
Jemen,2009,5,19008000,183000,19191000
Jemen,2009,6,13913000,261000,14174000
Jemen,2009,7,13383000,289000,13672000
Jemen,2009,8,17681000,178000,17859000
Jemen,2009,9,14110000,115000,14225000
Jemen,2009,10,9050000,2716000,11766000
Jemen,2009,11,13899000,74000,13973000
Jemen,2009,12,17572000,55000,17627000
Jemen,2010,1,7265000,128000,7393000
Jemen,2010,2,10814000,339000,11153000
Jemen,2010,3,11051000,83000,11134000
Jemen,2010,4,25879000,306000,26185000
Jemen,2010,5,15030000,402000,15432000
Jemen,2010,6,18825000,276000,19101000
Jemen,2010,7,13958000,150000,14108000
Jemen,2010,8,15444000,143000,15587000
Jemen,2010,9,14331000,27000,14358000
Jemen,2010,10,9531000,2253000,11784000
Jemen,2010,11,10565000,89000,10654000
Jemen,2010,12,25630000,109000,25739000
Jemen,2011,1,6891000,90000,6981000
Jemen,2011,2,8713000,240000,8953000
Jemen,2011,3,11653000,209000,11862000
Jemen,2011,4,6808000,517000,7325000
Jemen,2011,5,9656000,180000,9836000
Jemen,2011,6,5838000,329000,6167000
Jemen,2011,7,9364000,28000,9392000
Jemen,2011,8,7478000,172000,7650000
Jemen,2011,9,8380000,26000,8406000
Jemen,2011,10,5822000,461000,6283000
Jemen,2011,11,5495000,348000,5843000
Jemen,2011,12,7138000,355000,7493000
Jemen,2012,1,7111000,312000,7423000
Jemen,2012,2,19208000,178000,19386000
Jemen,2012,3,7637000,430000,8067000
Jemen,2012,4,8643000,478000,9121000
Jemen,2012,5,8759000,289000,9048000
Jemen,2012,6,10750000,787000,11537000
Jemen,2012,7,9774000,549000,10323000
Jemen,2012,8,10056000,777000,10833000
Jemen,2012,9,6950000,729000,7679000
Jemen,2012,10,17867000,530000,18397000
Jemen,2012,11,7803000,602000,8405000
Jemen,2012,12,13953000,677000,14630000
Jemen,2013,1,11058000,366000,11424000
Jemen,2013,2,11325000,536000,11861000
Jemen,2013,3,11309000,528000,11837000
Jemen,2013,4,26546000,142000,26688000
Jemen,2013,5,12765000,432000,13197000
Jemen,2013,6,27410000,53000,27463000
Jemen,2013,7,16272000,846000,17118000
Jemen,2013,8,10513000,65000,10578000
Jemen,2013,9,42190000,166000,42356000
Jemen,2013,10,13201000,104000,13305000
Jemen,2013,11,49251000,362000,49613000
Jemen,2013,12,12472000,308000,12780000
Jemen,2014,1,9504000,844000,10348000
Jemen,2014,2,22707000,564000,23271000
Jemen,2014,3,13720000,48000,13768000
Jemen,2014,4,13803000,296000,14099000
Jemen,2014,5,29703000,960000,30663000
Jemen,2014,6,11773000,524000,12297000
Jemen,2014,7,14265000,17000,14282000
Jemen,2014,8,11977000,341000,12318000
Jemen,2014,9,19765000,31000,19796000
Jemen,2014,10,8035000,904000,8939000
Jemen,2014,11,22099000,314000,22413000
Jemen,2014,12,27373000,80000,27453000
Jemen,2015,1,18427000,791000,19218000
Jemen,2015,2,23708000,315000,24023000
Jemen,2015,3,33062000,328000,33390000
Jemen,2015,4,681000,128000,809000
Jemen,2015,5,485000,113000,598000
Jemen,2015,6,25776000,491000,26267000
Jemen,2015,7,13907000,9000,13916000
Jemen,2015,8,4546000,10000,4556000
Jemen,2015,9,3628000,87000,3715000
Jemen,2015,10,4662000,25000,4687000
Jemen,2015,11,6869000,11000,6880000
Jemen,2015,12,7103000,0,7103000
Jemen,2016,1,15523000,0,15523000
Jemen,2016,2,5649000,19000,5668000
Jemen,2016,3,21662000,2000,21664000
Jemen,2016,4,7755000,0,7755000
Jemen,2016,5,13589000,1000,13590000
Jemen,2016,6,7430000,431000,7861000
Jemen,2016,7,4440000,217000,4657000
Jemen,2016,8,5459000,158000,5617000
Jemen,2016,9,5128000,6000,5134000
Jemen,2016,10,9364000,228000,9592000
Jemen,2016,11,6232000,131000,6363000
Jemen,2016,12,6656000,1096000,7752000
Jemen,2017,1,10806000,115000,10921000
Jemen,2017,2,5299000,123000,5422000
Jemen,2017,3,7277000,385000,7662000
Jemen,2017,4,7888000,720000,8608000
Jemen,2017,5,5829000,209000,6038000
Jemen,2017,6,3584000,501000,4085000
Jemen,2017,7,7310000,143000,7453000
Jemen,2017,8,5423000,66000,5489000
Jemen,2017,9,3102000,194000,3296000
Jemen,2017,10,8971000,662000,9633000
Jemen,2017,11,6701000,169000,6870000
Jemen,2017,12,7005000,148000,7153000
Jemen,2018,1,5172000,466000,5638000
Jemen,2018,2,3974000,130000,4104000
Jemen,2018,3,5555000,25000,5580000
Jemen,2018,4,4236000,136000,4372000
Jemen,2018,5,4235000,6000,4241000
Jemen,2018,6,4626000,297000,4923000
Jemen,2018,7,3987000,168000,4155000
Jemen,2018,8,4702000,59000,4761000
Jemen,2018,9,3308000,14000,3322000
Jemen,2018,10,5137000,678000,5815000
Jemen,2018,11,5510000,139000,5649000
Jemen,2018,12,7448000,119000,7567000
Jemen,2019,1,7288000,280000,7568000
Jemen,2019,2,4618000,7000,4625000
Jemen,2019,3,7297000,64000,7361000
Jemen,2019,4,10620000,13423000,24043000
Jemen,2019,5,6436000,517000,6953000
Jemen,2019,6,5676000,6599000,12275000
Jemen,2019,7,8615000,8258000,16873000
Jemen,2019,8,9075000,263000,9338000
Jemen,2019,9,8526000,133000,8659000
Jemen,2019,10,6899000,38000,6937000
Jemen,2019,11,5715000,458000,6173000
Jemen,2019,12,7473000,69000,7542000
Jemen,2020,1,7671000,200000,7871000
Jemen,2020,2,3836000,443000,4279000
Jemen,2020,3,7540000,285000,7825000
Jemen,2020,4,14070000,353000,14423000
Jemen,2020,5,5152000,455000,5607000
Jemen,2020,6,6966000,689000,7655000
Jemen,2020,7,5193000,356000,5549000
Jemen,2020,8,8416000,189000,8605000
Jemen,2020,9,6693000,6192000,12885000
Jemen,2020,10,10829000,2646000,13475000
Jemen,2020,11,8656000,235000,8891000
Jemen,2020,12,6365000,397000,6762000
Jemen,2021,1,5396000,461000,5857000
Jemen,2021,2,8625000,0,8625000
Jemen,2021,3,9344000,12313000,21657000
Jemen,2021,4,9297000,9534000,18831000
Jemen,2021,5,4800000,3817000,8617000
Jemen,2021,6,8442000,16475000,24917000
Jemen,2021,7,5842000,392000,6234000
Jemen,2021,8,6607000,13316000,19923000
Jemen,2021,9,8381000,13783000,22164000
Jemen,2021,10,8155000,15650000,23805000
Jemen,2021,11,8055000,47000,8102000
Jemen,2021,12,10688000,470000,11158000
Jemen,2022,1,7160000,217000,7377000
Jemen,2022,2,6231000,595000,6826000
Jemen,2022,3,9557000,9000,9566000
Jemen,2022,4,6116000,342000,6458000
Jemen,2022,5,7811000,46000,7857000
Jemen,2022,6,11128000,42000,11170000
Jemen,2022,7,6132000,0,6132000
Jemen,2022,8,8608000,43000,8651000
Jemen,2022,9,6456000,157000,6613000
Jemen,2022,10,13196000,0,13196000
Jemen,2022,11,10680000,394000,11074000
Jemen,2022,12,10128000,0,10128000
Jemen,2023,1,8888000,37000,8925000
Jemen,2023,2,7780000,76000,7856000
Jemen,2023,3,7725000,4000,7729000
Jemen,2023,4,5410000,13000,5423000
Jemen,2023,5,7068000,39000,7107000
Jemen,2023,6,9986000,95000,10081000
Jemen,2023,7,8918000,249000,9167000
Jemen,2023,8,8838000,22000,8860000
Jemen,2023,9,10652000,9000,10661000
Jemen,2023,10,5177000,106000,5283000
Jemen,2023,11,9353000,83000,9436000
Jemen,2023,12,4725000,444000,5169000
Jemen,2024,1,7114000,305000,7419000
Jemen,2024,2,5222000,6000,5228000
Jemen,2024,3,10136000,14000,10150000
Jemen,2024,4,6083000,37000,6120000
Jemen,2024,5,7369000,255000,7624000
Jemen,2024,6,8575000,34000,8609000
Jemen,2024,7,7465000,344000,7809000
Jemen,2024,8,9351000,503000,9854000
Jemen,2024,9,6857000,247000,7104000
Jemen,2024,10,8906000,28000,8934000
Jemen,2024,11,11223000,198000,11421000
Jemen,2024,12,10890000,13000,10903000
Jordanien,2008,1,56523000,1951000,58474000
Jordanien,2008,2,60522000,1184000,61706000
Jordanien,2008,3,85662000,1189000,86851000
Jordanien,2008,4,56847000,808000,57655000
Jordanien,2008,5,94885000,1051000,95936000
Jordanien,2008,6,51779000,2309000,54088000
Jordanien,2008,7,54853000,1293000,56146000
Jordanien,2008,8,46131000,1282000,47413000
Jordanien,2008,9,55810000,820000,56630000
Jordanien,2008,10,51711000,6010000,57721000
Jordanien,2008,11,86808000,1206000,88014000
Jordanien,2008,12,45435000,1402000,46837000
Jordanien,2009,1,40009000,2406000,42415000
Jordanien,2009,2,90265000,1646000,91911000
Jordanien,2009,3,93184000,497000,93681000
Jordanien,2009,4,62512000,940000,63452000
Jordanien,2009,5,44733000,716000,45449000
Jordanien,2009,6,39848000,1077000,40925000
Jordanien,2009,7,91298000,10604000,101902000
Jordanien,2009,8,40600000,520000,41120000
Jordanien,2009,9,40977000,6942000,47919000
Jordanien,2009,10,45928000,545000,46473000
Jordanien,2009,11,49609000,813000,50422000
Jordanien,2009,12,54852000,5348000,60200000
Jordanien,2010,1,81726000,5655000,87381000
Jordanien,2010,2,60846000,813000,61659000
Jordanien,2010,3,56024000,1530000,57554000
Jordanien,2010,4,71623000,1075000,72698000
Jordanien,2010,5,59758000,2536000,62294000
Jordanien,2010,6,52578000,1398000,53976000
Jordanien,2010,7,56416000,687000,57103000
Jordanien,2010,8,49401000,835000,50236000
Jordanien,2010,9,51979000,2018000,53997000
Jordanien,2010,10,76565000,1322000,77887000
Jordanien,2010,11,80763000,5894000,86657000
Jordanien,2010,12,63360000,1833000,65193000
Jordanien,2011,1,70068000,1052000,71120000
Jordanien,2011,2,62491000,1403000,63894000
Jordanien,2011,3,49370000,2322000,51692000
Jordanien,2011,4,43572000,1429000,45001000
Jordanien,2011,5,56544000,984000,57528000
Jordanien,2011,6,44241000,1169000,45410000
Jordanien,2011,7,45170000,1732000,46902000
Jordanien,2011,8,44355000,851000,45206000
Jordanien,2011,9,68895000,1615000,70510000
Jordanien,2011,10,52862000,1642000,54504000
Jordanien,2011,11,61126000,586000,61712000
Jordanien,2011,12,75707000,761000,76468000
Jordanien,2012,1,65064000,1856000,66920000
Jordanien,2012,2,73798000,1000000,74798000
Jordanien,2012,3,75860000,916000,76776000
Jordanien,2012,4,148091000,1176000,149267000
Jordanien,2012,5,61086000,1100000,62186000
Jordanien,2012,6,112620000,1530000,114150000
Jordanien,2012,7,56975000,2783000,59758000
Jordanien,2012,8,52010000,1210000,53220000
Jordanien,2012,9,53402000,1874000,55276000
Jordanien,2012,10,59684000,1945000,61629000
Jordanien,2012,11,61114000,935000,62049000
Jordanien,2012,12,46488000,904000,47392000
Jordanien,2013,1,55486000,1885000,57371000
Jordanien,2013,2,51117000,1026000,52143000
Jordanien,2013,3,62625000,1395000,64020000
Jordanien,2013,4,57229000,2106000,59335000
Jordanien,2013,5,58035000,1668000,59703000
Jordanien,2013,6,53585000,3164000,56749000
Jordanien,2013,7,59233000,1956000,61189000
Jordanien,2013,8,54165000,1131000,55296000
Jordanien,2013,9,65161000,1736000,66897000
Jordanien,2013,10,55635000,8753000,64388000
Jordanien,2013,11,75154000,2697000,77851000
Jordanien,2013,12,51345000,1653000,52998000
Jordanien,2014,1,49093000,1287000,50380000
Jordanien,2014,2,59893000,1869000,61762000
Jordanien,2014,3,61989000,1585000,63574000
Jordanien,2014,4,71870000,1072000,72942000
Jordanien,2014,5,54858000,1010000,55868000
Jordanien,2014,6,55297000,1589000,56886000
Jordanien,2014,7,51374000,2161000,53535000
Jordanien,2014,8,39070000,630000,39700000
Jordanien,2014,9,62469000,1068000,63537000
Jordanien,2014,10,60788000,1047000,61835000
Jordanien,2014,11,56090000,1361000,57451000
Jordanien,2014,12,60992000,2330000,63322000
Jordanien,2015,1,63189000,7093000,70282000
Jordanien,2015,2,72593000,687000,73280000
Jordanien,2015,3,81905000,1715000,83620000
Jordanien,2015,4,74826000,1547000,76373000
Jordanien,2015,5,61082000,2429000,63511000
Jordanien,2015,6,67149000,1322000,68471000
Jordanien,2015,7,64370000,1750000,66120000
Jordanien,2015,8,55970000,2142000,58112000
Jordanien,2015,9,62666000,2113000,64779000
Jordanien,2015,10,63370000,2175000,65545000
Jordanien,2015,11,76012000,954000,76966000
Jordanien,2015,12,68876000,1446000,70322000
Jordanien,2016,1,50688000,1526000,52214000
Jordanien,2016,2,60715000,1810000,62525000
Jordanien,2016,3,58737000,1909000,60646000
Jordanien,2016,4,68166000,1560000,69726000
Jordanien,2016,5,55684000,1843000,57527000
Jordanien,2016,6,64022000,2101000,66123000
Jordanien,2016,7,51348000,2068000,53416000
Jordanien,2016,8,50579000,2829000,53408000
Jordanien,2016,9,67317000,1417000,68734000
Jordanien,2016,10,52387000,2741000,55128000
Jordanien,2016,11,69262000,2093000,71355000
Jordanien,2016,12,59899000,2694000,62593000
Jordanien,2017,1,61208000,2529000,63737000
Jordanien,2017,2,66636000,2040000,68676000
Jordanien,2017,3,69425000,1480000,70905000
Jordanien,2017,4,60476000,2647000,63123000
Jordanien,2017,5,69626000,2238000,71864000
Jordanien,2017,6,57069000,2251000,59320000
Jordanien,2017,7,49369000,1834000,51203000
Jordanien,2017,8,63039000,3612000,66651000
Jordanien,2017,9,60356000,1799000,62155000
Jordanien,2017,10,62227000,2271000,64498000
Jordanien,2017,11,69563000,2944000,72507000
Jordanien,2017,12,58657000,1696000,60353000
Jordanien,2018,1,76796000,2601000,79397000
Jordanien,2018,2,49488000,1931000,51419000
Jordanien,2018,3,65530000,1485000,67015000
Jordanien,2018,4,51042000,2084000,53126000
Jordanien,2018,5,48687000,3321000,52008000
Jordanien,2018,6,62636000,2512000,65148000
Jordanien,2018,7,73071000,2190000,75261000
Jordanien,2018,8,67141000,2074000,69215000
Jordanien,2018,9,62735000,3308000,66043000
Jordanien,2018,10,95941000,2486000,98427000
Jordanien,2018,11,74542000,2151000,76693000
Jordanien,2018,12,87185000,1786000,88971000
Jordanien,2019,1,55478000,3449000,58927000
Jordanien,2019,2,78427000,3588000,82015000
Jordanien,2019,3,85727000,1975000,87702000
Jordanien,2019,4,76049000,2403000,78452000
Jordanien,2019,5,54066000,3515000,57581000
Jordanien,2019,6,43694000,2356000,46050000
Jordanien,2019,7,66841000,2773000,69614000
Jordanien,2019,8,53457000,2154000,55611000
Jordanien,2019,9,64599000,3659000,68258000
Jordanien,2019,10,66717000,1957000,68674000
Jordanien,2019,11,59496000,2764000,62260000
Jordanien,2019,12,69396000,2972000,72368000
Jordanien,2020,1,51944000,3548000,55492000
Jordanien,2020,2,69234000,3256000,72490000
Jordanien,2020,3,62430000,3641000,66071000
Jordanien,2020,4,34115000,1780000,35895000
Jordanien,2020,5,40168000,3175000,43343000
Jordanien,2020,6,52156000,2334000,54490000
Jordanien,2020,7,52194000,2454000,54648000
Jordanien,2020,8,46676000,3930000,50606000
Jordanien,2020,9,58069000,2229000,60298000
Jordanien,2020,10,61761000,3103000,64864000
Jordanien,2020,11,54372000,3337000,57709000
Jordanien,2020,12,49517000,3769000,53286000
Jordanien,2021,1,45102000,2322000,47424000
Jordanien,2021,2,48160000,3386000,51546000
Jordanien,2021,3,57644000,4366000,62010000
Jordanien,2021,4,43478000,5666000,49144000
Jordanien,2021,5,40599000,4117000,44716000
Jordanien,2021,6,47616000,4898000,52514000
Jordanien,2021,7,49486000,5287000,54773000
Jordanien,2021,8,55287000,6319000,61606000
Jordanien,2021,9,60425000,4490000,64915000
Jordanien,2021,10,50831000,4628000,55459000
Jordanien,2021,11,74134000,6237000,80371000
Jordanien,2021,12,52181000,10755000,62936000
Jordanien,2022,1,52839000,6801000,59640000
Jordanien,2022,2,56626000,6074000,62700000
Jordanien,2022,3,68286000,6648000,74934000
Jordanien,2022,4,50618000,8139000,58757000
Jordanien,2022,5,68838000,4819000,73657000
Jordanien,2022,6,69809000,6671000,76480000
Jordanien,2022,7,65241000,6680000,71921000
Jordanien,2022,8,67162000,9209000,76371000
Jordanien,2022,9,61905000,7699000,69604000
Jordanien,2022,10,61823000,7210000,69033000
Jordanien,2022,11,77459000,6569000,84028000
Jordanien,2022,12,70208000,9830000,80038000
Jordanien,2023,1,69971000,7956000,77927000
Jordanien,2023,2,76732000,4793000,81525000
Jordanien,2023,3,88223000,7291000,95514000
Jordanien,2023,4,61559000,6063000,67622000
Jordanien,2023,5,59885000,4047000,63932000
Jordanien,2023,6,64629000,4814000,69443000
Jordanien,2023,7,60537000,7235000,67772000
Jordanien,2023,8,64519000,10143000,74662000
Jordanien,2023,9,67633000,9607000,77240000
Jordanien,2023,10,62505000,7767000,70272000
Jordanien,2023,11,59376000,8383000,67759000
Jordanien,2023,12,48605000,38543000,87148000
Jordanien,2024,1,58145000,6377000,64522000
Jordanien,2024,2,72033000,5528000,77561000
Jordanien,2024,3,88910000,6796000,95706000
Jordanien,2024,4,56801000,5926000,62727000
Jordanien,2024,5,74701000,5992000,80693000
Jordanien,2024,6,64102000,6999000,71101000
Jordanien,2024,7,71344000,8782000,80126000
Jordanien,2024,8,63130000,8015000,71145000
Jordanien,2024,9,69832000,7415000,77247000
Jordanien,2024,10,103337000,7094000,110431000
Jordanien,2024,11,71531000,22193000,93724000
Jordanien,2024,12,62326000,8055000,70381000
Jugoslawien (05/1992 bis 12/1992),2008,1,0,0,0
Jugoslawien (05/1992 bis 12/1992),2008,2,0,0,0
Jugoslawien (05/1992 bis 12/1992),2008,3,0,0,0
Jugoslawien (05/1992 bis 12/1992),2008,4,0,0,0
Jugoslawien (05/1992 bis 12/1992),2008,5,0,0,0
Jugoslawien (05/1992 bis 12/1992),2008,6,0,0,0
Jugoslawien (05/1992 bis 12/1992),2008,7,0,0,0
Jugoslawien (05/1992 bis 12/1992),2008,8,0,0,0
Jugoslawien (05/1992 bis 12/1992),2008,9,0,0,0
Jugoslawien (05/1992 bis 12/1992),2008,10,0,0,0
Jugoslawien (05/1992 bis 12/1992),2008,11,0,0,0
Jugoslawien (05/1992 bis 12/1992),2008,12,0,0,0
Jugoslawien (05/1992 bis 12/1992),2009,1,0,0,0
Jugoslawien (05/1992 bis 12/1992),2009,2,0,0,0
Jugoslawien (05/1992 bis 12/1992),2009,3,0,0,0
Jugoslawien (05/1992 bis 12/1992),2009,4,0,0,0
Jugoslawien (05/1992 bis 12/1992),2009,5,0,0,0
Jugoslawien (05/1992 bis 12/1992),2009,6,0,0,0
Jugoslawien (05/1992 bis 12/1992),2009,7,0,0,0
Jugoslawien (05/1992 bis 12/1992),2009,8,0,0,0
Jugoslawien (05/1992 bis 12/1992),2009,9,0,0,0
Jugoslawien (05/1992 bis 12/1992),2009,10,0,0,0
Jugoslawien (05/1992 bis 12/1992),2009,11,0,0,0
Jugoslawien (05/1992 bis 12/1992),2009,12,0,0,0
Jugoslawien (05/1992 bis 12/1992),2010,1,0,0,0
Jugoslawien (05/1992 bis 12/1992),2010,2,0,0,0
Jugoslawien (05/1992 bis 12/1992),2010,3,0,0,0
Jugoslawien (05/1992 bis 12/1992),2010,4,0,0,0
Jugoslawien (05/1992 bis 12/1992),2010,5,0,0,0
Jugoslawien (05/1992 bis 12/1992),2010,6,0,0,0
Jugoslawien (05/1992 bis 12/1992),2010,7,0,0,0
Jugoslawien (05/1992 bis 12/1992),2010,8,0,0,0
Jugoslawien (05/1992 bis 12/1992),2010,9,0,0,0
Jugoslawien (05/1992 bis 12/1992),2010,10,0,0,0
Jugoslawien (05/1992 bis 12/1992),2010,11,0,0,0
Jugoslawien (05/1992 bis 12/1992),2010,12,0,0,0
Jugoslawien (05/1992 bis 12/1992),2011,1,0,0,0
Jugoslawien (05/1992 bis 12/1992),2011,2,0,0,0
Jugoslawien (05/1992 bis 12/1992),2011,3,0,0,0
Jugoslawien (05/1992 bis 12/1992),2011,4,0,0,0
Jugoslawien (05/1992 bis 12/1992),2011,5,0,0,0
Jugoslawien (05/1992 bis 12/1992),2011,6,0,0,0
Jugoslawien (05/1992 bis 12/1992),2011,7,0,0,0
Jugoslawien (05/1992 bis 12/1992),2011,8,0,0,0
Jugoslawien (05/1992 bis 12/1992),2011,9,0,0,0
Jugoslawien (05/1992 bis 12/1992),2011,10,0,0,0
Jugoslawien (05/1992 bis 12/1992),2011,11,0,0,0
Jugoslawien (05/1992 bis 12/1992),2011,12,0,0,0
Jugoslawien (05/1992 bis 12/1992),2012,1,0,0,0
Jugoslawien (05/1992 bis 12/1992),2012,2,0,0,0
Jugoslawien (05/1992 bis 12/1992),2012,3,0,0,0
Jugoslawien (05/1992 bis 12/1992),2012,4,0,0,0
Jugoslawien (05/1992 bis 12/1992),2012,5,0,0,0
Jugoslawien (05/1992 bis 12/1992),2012,6,0,0,0
Jugoslawien (05/1992 bis 12/1992),2012,7,0,0,0
Jugoslawien (05/1992 bis 12/1992),2012,8,0,0,0
Jugoslawien (05/1992 bis 12/1992),2012,9,0,0,0
Jugoslawien (05/1992 bis 12/1992),2012,10,0,0,0
Jugoslawien (05/1992 bis 12/1992),2012,11,0,0,0
Jugoslawien (05/1992 bis 12/1992),2012,12,0,0,0
Jugoslawien (05/1992 bis 12/1992),2013,1,0,0,0
Jugoslawien (05/1992 bis 12/1992),2013,2,0,0,0
Jugoslawien (05/1992 bis 12/1992),2013,3,0,0,0
Jugoslawien (05/1992 bis 12/1992),2013,4,0,0,0
Jugoslawien (05/1992 bis 12/1992),2013,5,0,0,0
Jugoslawien (05/1992 bis 12/1992),2013,6,0,0,0
Jugoslawien (05/1992 bis 12/1992),2013,7,0,0,0
Jugoslawien (05/1992 bis 12/1992),2013,8,0,0,0
Jugoslawien (05/1992 bis 12/1992),2013,9,0,0,0
Jugoslawien (05/1992 bis 12/1992),2013,10,0,0,0
Jugoslawien (05/1992 bis 12/1992),2013,11,0,0,0
Jugoslawien (05/1992 bis 12/1992),2013,12,0,0,0
Jugoslawien (05/1992 bis 12/1992),2014,1,0,0,0
Jugoslawien (05/1992 bis 12/1992),2014,2,0,0,0
Jugoslawien (05/1992 bis 12/1992),2014,3,0,0,0
Jugoslawien (05/1992 bis 12/1992),2014,4,0,0,0
Jugoslawien (05/1992 bis 12/1992),2014,5,0,0,0
Jugoslawien (05/1992 bis 12/1992),2014,6,0,0,0
Jugoslawien (05/1992 bis 12/1992),2014,7,0,0,0
Jugoslawien (05/1992 bis 12/1992),2014,8,0,0,0
Jugoslawien (05/1992 bis 12/1992),2014,9,0,0,0
Jugoslawien (05/1992 bis 12/1992),2014,10,0,0,0
Jugoslawien (05/1992 bis 12/1992),2014,11,0,0,0
Jugoslawien (05/1992 bis 12/1992),2014,12,0,0,0
Jugoslawien (05/1992 bis 12/1992),2015,1,0,0,0
Jugoslawien (05/1992 bis 12/1992),2015,2,0,0,0
Jugoslawien (05/1992 bis 12/1992),2015,3,0,0,0
Jugoslawien (05/1992 bis 12/1992),2015,4,0,0,0
Jugoslawien (05/1992 bis 12/1992),2015,5,0,0,0
Jugoslawien (05/1992 bis 12/1992),2015,6,0,0,0
Jugoslawien (05/1992 bis 12/1992),2015,7,0,0,0
Jugoslawien (05/1992 bis 12/1992),2015,8,0,0,0
Jugoslawien (05/1992 bis 12/1992),2015,9,0,0,0
Jugoslawien (05/1992 bis 12/1992),2015,10,0,0,0
Jugoslawien (05/1992 bis 12/1992),2015,11,0,0,0
Jugoslawien (05/1992 bis 12/1992),2015,12,0,0,0
Jugoslawien (05/1992 bis 12/1992),2016,1,0,0,0
Jugoslawien (05/1992 bis 12/1992),2016,2,0,0,0
Jugoslawien (05/1992 bis 12/1992),2016,3,0,0,0
Jugoslawien (05/1992 bis 12/1992),2016,4,0,0,0
Jugoslawien (05/1992 bis 12/1992),2016,5,0,0,0
Jugoslawien (05/1992 bis 12/1992),2016,6,0,0,0
Jugoslawien (05/1992 bis 12/1992),2016,7,0,0,0
Jugoslawien (05/1992 bis 12/1992),2016,8,0,0,0
Jugoslawien (05/1992 bis 12/1992),2016,9,0,0,0
Jugoslawien (05/1992 bis 12/1992),2016,10,0,0,0
Jugoslawien (05/1992 bis 12/1992),2016,11,0,0,0
Jugoslawien (05/1992 bis 12/1992),2016,12,0,0,0
Jugoslawien (05/1992 bis 12/1992),2017,1,0,0,0
Jugoslawien (05/1992 bis 12/1992),2017,2,0,0,0
Jugoslawien (05/1992 bis 12/1992),2017,3,0,0,0
Jugoslawien (05/1992 bis 12/1992),2017,4,0,0,0
Jugoslawien (05/1992 bis 12/1992),2017,5,0,0,0
Jugoslawien (05/1992 bis 12/1992),2017,6,0,0,0
Jugoslawien (05/1992 bis 12/1992),2017,7,0,0,0
Jugoslawien (05/1992 bis 12/1992),2017,8,0,0,0
Jugoslawien (05/1992 bis 12/1992),2017,9,0,0,0
Jugoslawien (05/1992 bis 12/1992),2017,10,0,0,0
Jugoslawien (05/1992 bis 12/1992),2017,11,0,0,0
Jugoslawien (05/1992 bis 12/1992),2017,12,0,0,0
Jugoslawien (05/1992 bis 12/1992),2018,1,0,0,0
Jugoslawien (05/1992 bis 12/1992),2018,2,0,0,0
Jugoslawien (05/1992 bis 12/1992),2018,3,0,0,0
Jugoslawien (05/1992 bis 12/1992),2018,4,0,0,0
Jugoslawien (05/1992 bis 12/1992),2018,5,0,0,0
Jugoslawien (05/1992 bis 12/1992),2018,6,0,0,0
Jugoslawien (05/1992 bis 12/1992),2018,7,0,0,0
Jugoslawien (05/1992 bis 12/1992),2018,8,0,0,0
Jugoslawien (05/1992 bis 12/1992),2018,9,0,0,0
Jugoslawien (05/1992 bis 12/1992),2018,10,0,0,0
Jugoslawien (05/1992 bis 12/1992),2018,11,0,0,0
Jugoslawien (05/1992 bis 12/1992),2018,12,0,0,0
Jugoslawien (05/1992 bis 12/1992),2019,1,0,0,0
Jugoslawien (05/1992 bis 12/1992),2019,2,0,0,0
Jugoslawien (05/1992 bis 12/1992),2019,3,0,0,0
Jugoslawien (05/1992 bis 12/1992),2019,4,0,0,0
Jugoslawien (05/1992 bis 12/1992),2019,5,0,0,0
Jugoslawien (05/1992 bis 12/1992),2019,6,0,0,0
Jugoslawien (05/1992 bis 12/1992),2019,7,0,0,0
Jugoslawien (05/1992 bis 12/1992),2019,8,0,0,0
Jugoslawien (05/1992 bis 12/1992),2019,9,0,0,0
Jugoslawien (05/1992 bis 12/1992),2019,10,0,0,0
Jugoslawien (05/1992 bis 12/1992),2019,11,0,0,0
Jugoslawien (05/1992 bis 12/1992),2019,12,0,0,0
Jugoslawien (05/1992 bis 12/1992),2020,1,0,0,0
Jugoslawien (05/1992 bis 12/1992),2020,2,0,0,0
Jugoslawien (05/1992 bis 12/1992),2020,3,0,0,0
Jugoslawien (05/1992 bis 12/1992),2020,4,0,0,0
Jugoslawien (05/1992 bis 12/1992),2020,5,0,0,0
Jugoslawien (05/1992 bis 12/1992),2020,6,0,0,0
Jugoslawien (05/1992 bis 12/1992),2020,7,0,0,0
Jugoslawien (05/1992 bis 12/1992),2020,8,0,0,0
Jugoslawien (05/1992 bis 12/1992),2020,9,0,0,0
Jugoslawien (05/1992 bis 12/1992),2020,10,0,0,0
Jugoslawien (05/1992 bis 12/1992),2020,11,0,0,0
Jugoslawien (05/1992 bis 12/1992),2020,12,0,0,0
Jugoslawien (05/1992 bis 12/1992),2021,1,0,0,0
Jugoslawien (05/1992 bis 12/1992),2021,2,0,0,0
Jugoslawien (05/1992 bis 12/1992),2021,3,0,0,0
Jugoslawien (05/1992 bis 12/1992),2021,4,0,0,0
Jugoslawien (05/1992 bis 12/1992),2021,5,0,0,0
Jugoslawien (05/1992 bis 12/1992),2021,6,0,0,0
Jugoslawien (05/1992 bis 12/1992),2021,7,0,0,0
Jugoslawien (05/1992 bis 12/1992),2021,8,0,0,0
Jugoslawien (05/1992 bis 12/1992),2021,9,0,0,0
Jugoslawien (05/1992 bis 12/1992),2021,10,0,0,0
Jugoslawien (05/1992 bis 12/1992),2021,11,0,0,0
Jugoslawien (05/1992 bis 12/1992),2021,12,0,0,0
Jugoslawien (05/1992 bis 12/1992),2022,1,0,0,0
Jugoslawien (05/1992 bis 12/1992),2022,2,0,0,0
Jugoslawien (05/1992 bis 12/1992),2022,3,0,0,0
Jugoslawien (05/1992 bis 12/1992),2022,4,0,0,0
Jugoslawien (05/1992 bis 12/1992),2022,5,0,0,0
Jugoslawien (05/1992 bis 12/1992),2022,6,0,0,0
Jugoslawien (05/1992 bis 12/1992),2022,7,0,0,0
Jugoslawien (05/1992 bis 12/1992),2022,8,0,0,0
Jugoslawien (05/1992 bis 12/1992),2022,9,0,0,0
Jugoslawien (05/1992 bis 12/1992),2022,10,0,0,0
Jugoslawien (05/1992 bis 12/1992),2022,11,0,0,0
Jugoslawien (05/1992 bis 12/1992),2022,12,0,0,0
Jugoslawien (05/1992 bis 12/1992),2023,1,0,0,0
Jugoslawien (05/1992 bis 12/1992),2023,2,0,0,0
Jugoslawien (05/1992 bis 12/1992),2023,3,0,0,0
Jugoslawien (05/1992 bis 12/1992),2023,4,0,0,0
Jugoslawien (05/1992 bis 12/1992),2023,5,0,0,0
Jugoslawien (05/1992 bis 12/1992),2023,6,0,0,0
Jugoslawien (05/1992 bis 12/1992),2023,7,0,0,0
Jugoslawien (05/1992 bis 12/1992),2023,8,0,0,0
Jugoslawien (05/1992 bis 12/1992),2023,9,0,0,0
Jugoslawien (05/1992 bis 12/1992),2023,10,0,0,0
Jugoslawien (05/1992 bis 12/1992),2023,11,0,0,0
Jugoslawien (05/1992 bis 12/1992),2023,12,0,0,0
Jugoslawien (05/1992 bis 12/1992),2024,1,0,0,0
Jugoslawien (05/1992 bis 12/1992),2024,2,0,0,0
Jugoslawien (05/1992 bis 12/1992),2024,3,0,0,0
Jugoslawien (05/1992 bis 12/1992),2024,4,0,0,0
Jugoslawien (05/1992 bis 12/1992),2024,5,0,0,0
Jugoslawien (05/1992 bis 12/1992),2024,6,0,0,0
Jugoslawien (05/1992 bis 12/1992),2024,7,0,0,0
Jugoslawien (05/1992 bis 12/1992),2024,8,0,0,0
Jugoslawien (05/1992 bis 12/1992),2024,9,0,0,0
Jugoslawien (05/1992 bis 12/1992),2024,10,0,0,0
Jugoslawien (05/1992 bis 12/1992),2024,11,0,0,0
Jugoslawien (05/1992 bis 12/1992),2024,12,0,0,0
Jugoslawien (bis 04/1992),2008,1,0,0,0
Jugoslawien (bis 04/1992),2008,2,0,0,0
Jugoslawien (bis 04/1992),2008,3,0,0,0
Jugoslawien (bis 04/1992),2008,4,0,0,0
Jugoslawien (bis 04/1992),2008,5,0,0,0
Jugoslawien (bis 04/1992),2008,6,0,0,0
Jugoslawien (bis 04/1992),2008,7,0,0,0
Jugoslawien (bis 04/1992),2008,8,0,0,0
Jugoslawien (bis 04/1992),2008,9,0,0,0
Jugoslawien (bis 04/1992),2008,10,0,0,0
Jugoslawien (bis 04/1992),2008,11,0,0,0
Jugoslawien (bis 04/1992),2008,12,0,0,0
Jugoslawien (bis 04/1992),2009,1,0,0,0
Jugoslawien (bis 04/1992),2009,2,0,0,0
Jugoslawien (bis 04/1992),2009,3,0,0,0
Jugoslawien (bis 04/1992),2009,4,0,0,0
Jugoslawien (bis 04/1992),2009,5,0,0,0
Jugoslawien (bis 04/1992),2009,6,0,0,0
Jugoslawien (bis 04/1992),2009,7,0,0,0
Jugoslawien (bis 04/1992),2009,8,0,0,0
Jugoslawien (bis 04/1992),2009,9,0,0,0
Jugoslawien (bis 04/1992),2009,10,0,0,0
Jugoslawien (bis 04/1992),2009,11,0,0,0
Jugoslawien (bis 04/1992),2009,12,0,0,0
Jugoslawien (bis 04/1992),2010,1,0,0,0
Jugoslawien (bis 04/1992),2010,2,0,0,0
Jugoslawien (bis 04/1992),2010,3,0,0,0
Jugoslawien (bis 04/1992),2010,4,0,0,0
Jugoslawien (bis 04/1992),2010,5,0,0,0
Jugoslawien (bis 04/1992),2010,6,0,0,0
Jugoslawien (bis 04/1992),2010,7,0,0,0
Jugoslawien (bis 04/1992),2010,8,0,0,0
Jugoslawien (bis 04/1992),2010,9,0,0,0
Jugoslawien (bis 04/1992),2010,10,0,0,0
Jugoslawien (bis 04/1992),2010,11,0,0,0
Jugoslawien (bis 04/1992),2010,12,0,0,0
Jugoslawien (bis 04/1992),2011,1,0,0,0
Jugoslawien (bis 04/1992),2011,2,0,0,0
Jugoslawien (bis 04/1992),2011,3,0,0,0
Jugoslawien (bis 04/1992),2011,4,0,0,0
Jugoslawien (bis 04/1992),2011,5,0,0,0
Jugoslawien (bis 04/1992),2011,6,0,0,0
Jugoslawien (bis 04/1992),2011,7,0,0,0
Jugoslawien (bis 04/1992),2011,8,0,0,0
Jugoslawien (bis 04/1992),2011,9,0,0,0
Jugoslawien (bis 04/1992),2011,10,0,0,0
Jugoslawien (bis 04/1992),2011,11,0,0,0
Jugoslawien (bis 04/1992),2011,12,0,0,0
Jugoslawien (bis 04/1992),2012,1,0,0,0
Jugoslawien (bis 04/1992),2012,2,0,0,0
Jugoslawien (bis 04/1992),2012,3,0,0,0
Jugoslawien (bis 04/1992),2012,4,0,0,0
Jugoslawien (bis 04/1992),2012,5,0,0,0
Jugoslawien (bis 04/1992),2012,6,0,0,0
Jugoslawien (bis 04/1992),2012,7,0,0,0
Jugoslawien (bis 04/1992),2012,8,0,0,0
Jugoslawien (bis 04/1992),2012,9,0,0,0
Jugoslawien (bis 04/1992),2012,10,0,0,0
Jugoslawien (bis 04/1992),2012,11,0,0,0
Jugoslawien (bis 04/1992),2012,12,0,0,0
Jugoslawien (bis 04/1992),2013,1,0,0,0
Jugoslawien (bis 04/1992),2013,2,0,0,0
Jugoslawien (bis 04/1992),2013,3,0,0,0
Jugoslawien (bis 04/1992),2013,4,0,0,0
Jugoslawien (bis 04/1992),2013,5,0,0,0
Jugoslawien (bis 04/1992),2013,6,0,0,0
Jugoslawien (bis 04/1992),2013,7,0,0,0
Jugoslawien (bis 04/1992),2013,8,0,0,0
Jugoslawien (bis 04/1992),2013,9,0,0,0
Jugoslawien (bis 04/1992),2013,10,0,0,0
Jugoslawien (bis 04/1992),2013,11,0,0,0
Jugoslawien (bis 04/1992),2013,12,0,0,0
Jugoslawien (bis 04/1992),2014,1,0,0,0
Jugoslawien (bis 04/1992),2014,2,0,0,0
Jugoslawien (bis 04/1992),2014,3,0,0,0
Jugoslawien (bis 04/1992),2014,4,0,0,0
Jugoslawien (bis 04/1992),2014,5,0,0,0
Jugoslawien (bis 04/1992),2014,6,0,0,0
Jugoslawien (bis 04/1992),2014,7,0,0,0
Jugoslawien (bis 04/1992),2014,8,0,0,0
Jugoslawien (bis 04/1992),2014,9,0,0,0
Jugoslawien (bis 04/1992),2014,10,0,0,0
Jugoslawien (bis 04/1992),2014,11,0,0,0
Jugoslawien (bis 04/1992),2014,12,0,0,0
Jugoslawien (bis 04/1992),2015,1,0,0,0
Jugoslawien (bis 04/1992),2015,2,0,0,0
Jugoslawien (bis 04/1992),2015,3,0,0,0
Jugoslawien (bis 04/1992),2015,4,0,0,0
Jugoslawien (bis 04/1992),2015,5,0,0,0
Jugoslawien (bis 04/1992),2015,6,0,0,0
Jugoslawien (bis 04/1992),2015,7,0,0,0
Jugoslawien (bis 04/1992),2015,8,0,0,0
Jugoslawien (bis 04/1992),2015,9,0,0,0
Jugoslawien (bis 04/1992),2015,10,0,0,0
Jugoslawien (bis 04/1992),2015,11,0,0,0
Jugoslawien (bis 04/1992),2015,12,0,0,0
Jugoslawien (bis 04/1992),2016,1,0,0,0
Jugoslawien (bis 04/1992),2016,2,0,0,0
Jugoslawien (bis 04/1992),2016,3,0,0,0
Jugoslawien (bis 04/1992),2016,4,0,0,0
Jugoslawien (bis 04/1992),2016,5,0,0,0
Jugoslawien (bis 04/1992),2016,6,0,0,0
Jugoslawien (bis 04/1992),2016,7,0,0,0
Jugoslawien (bis 04/1992),2016,8,0,0,0
Jugoslawien (bis 04/1992),2016,9,0,0,0
Jugoslawien (bis 04/1992),2016,10,0,0,0
Jugoslawien (bis 04/1992),2016,11,0,0,0
Jugoslawien (bis 04/1992),2016,12,0,0,0
Jugoslawien (bis 04/1992),2017,1,0,0,0
Jugoslawien (bis 04/1992),2017,2,0,0,0
Jugoslawien (bis 04/1992),2017,3,0,0,0
Jugoslawien (bis 04/1992),2017,4,0,0,0
Jugoslawien (bis 04/1992),2017,5,0,0,0
Jugoslawien (bis 04/1992),2017,6,0,0,0
Jugoslawien (bis 04/1992),2017,7,0,0,0
Jugoslawien (bis 04/1992),2017,8,0,0,0
Jugoslawien (bis 04/1992),2017,9,0,0,0
Jugoslawien (bis 04/1992),2017,10,0,0,0
Jugoslawien (bis 04/1992),2017,11,0,0,0
Jugoslawien (bis 04/1992),2017,12,0,0,0
Jugoslawien (bis 04/1992),2018,1,0,0,0
Jugoslawien (bis 04/1992),2018,2,0,0,0
Jugoslawien (bis 04/1992),2018,3,0,0,0
Jugoslawien (bis 04/1992),2018,4,0,0,0
Jugoslawien (bis 04/1992),2018,5,0,0,0
Jugoslawien (bis 04/1992),2018,6,0,0,0
Jugoslawien (bis 04/1992),2018,7,0,0,0
Jugoslawien (bis 04/1992),2018,8,0,0,0
Jugoslawien (bis 04/1992),2018,9,0,0,0
Jugoslawien (bis 04/1992),2018,10,0,0,0
Jugoslawien (bis 04/1992),2018,11,0,0,0
Jugoslawien (bis 04/1992),2018,12,0,0,0
Jugoslawien (bis 04/1992),2019,1,0,0,0
Jugoslawien (bis 04/1992),2019,2,0,0,0
Jugoslawien (bis 04/1992),2019,3,0,0,0
Jugoslawien (bis 04/1992),2019,4,0,0,0
Jugoslawien (bis 04/1992),2019,5,0,0,0
Jugoslawien (bis 04/1992),2019,6,0,0,0
Jugoslawien (bis 04/1992),2019,7,0,0,0
Jugoslawien (bis 04/1992),2019,8,0,0,0
Jugoslawien (bis 04/1992),2019,9,0,0,0
Jugoslawien (bis 04/1992),2019,10,0,0,0
Jugoslawien (bis 04/1992),2019,11,0,0,0
Jugoslawien (bis 04/1992),2019,12,0,0,0
Jugoslawien (bis 04/1992),2020,1,0,0,0
Jugoslawien (bis 04/1992),2020,2,0,0,0
Jugoslawien (bis 04/1992),2020,3,0,0,0
Jugoslawien (bis 04/1992),2020,4,0,0,0
Jugoslawien (bis 04/1992),2020,5,0,0,0
Jugoslawien (bis 04/1992),2020,6,0,0,0
Jugoslawien (bis 04/1992),2020,7,0,0,0
Jugoslawien (bis 04/1992),2020,8,0,0,0
Jugoslawien (bis 04/1992),2020,9,0,0,0
Jugoslawien (bis 04/1992),2020,10,0,0,0
Jugoslawien (bis 04/1992),2020,11,0,0,0
Jugoslawien (bis 04/1992),2020,12,0,0,0
Jugoslawien (bis 04/1992),2021,1,0,0,0
Jugoslawien (bis 04/1992),2021,2,0,0,0
Jugoslawien (bis 04/1992),2021,3,0,0,0
Jugoslawien (bis 04/1992),2021,4,0,0,0
Jugoslawien (bis 04/1992),2021,5,0,0,0
Jugoslawien (bis 04/1992),2021,6,0,0,0
Jugoslawien (bis 04/1992),2021,7,0,0,0
Jugoslawien (bis 04/1992),2021,8,0,0,0
Jugoslawien (bis 04/1992),2021,9,0,0,0
Jugoslawien (bis 04/1992),2021,10,0,0,0
Jugoslawien (bis 04/1992),2021,11,0,0,0
Jugoslawien (bis 04/1992),2021,12,0,0,0
Jugoslawien (bis 04/1992),2022,1,0,0,0
Jugoslawien (bis 04/1992),2022,2,0,0,0
Jugoslawien (bis 04/1992),2022,3,0,0,0
Jugoslawien (bis 04/1992),2022,4,0,0,0
Jugoslawien (bis 04/1992),2022,5,0,0,0
Jugoslawien (bis 04/1992),2022,6,0,0,0
Jugoslawien (bis 04/1992),2022,7,0,0,0
Jugoslawien (bis 04/1992),2022,8,0,0,0
Jugoslawien (bis 04/1992),2022,9,0,0,0
Jugoslawien (bis 04/1992),2022,10,0,0,0
Jugoslawien (bis 04/1992),2022,11,0,0,0
Jugoslawien (bis 04/1992),2022,12,0,0,0
Jugoslawien (bis 04/1992),2023,1,0,0,0
Jugoslawien (bis 04/1992),2023,2,0,0,0
Jugoslawien (bis 04/1992),2023,3,0,0,0
Jugoslawien (bis 04/1992),2023,4,0,0,0
Jugoslawien (bis 04/1992),2023,5,0,0,0
Jugoslawien (bis 04/1992),2023,6,0,0,0
Jugoslawien (bis 04/1992),2023,7,0,0,0
Jugoslawien (bis 04/1992),2023,8,0,0,0
Jugoslawien (bis 04/1992),2023,9,0,0,0
Jugoslawien (bis 04/1992),2023,10,0,0,0
Jugoslawien (bis 04/1992),2023,11,0,0,0
Jugoslawien (bis 04/1992),2023,12,0,0,0
Jugoslawien (bis 04/1992),2024,1,0,0,0
Jugoslawien (bis 04/1992),2024,2,0,0,0
Jugoslawien (bis 04/1992),2024,3,0,0,0
Jugoslawien (bis 04/1992),2024,4,0,0,0
Jugoslawien (bis 04/1992),2024,5,0,0,0
Jugoslawien (bis 04/1992),2024,6,0,0,0
Jugoslawien (bis 04/1992),2024,7,0,0,0
Jugoslawien (bis 04/1992),2024,8,0,0,0
Jugoslawien (bis 04/1992),2024,9,0,0,0
Jugoslawien (bis 04/1992),2024,10,0,0,0
Jugoslawien (bis 04/1992),2024,11,0,0,0
Jugoslawien (bis 04/1992),2024,12,0,0,0
Kaimaninseln,2008,1,1398000,73000,1471000
Kaimaninseln,2008,2,3550000,10000,3560000
Kaimaninseln,2008,3,1412000,0,1412000
Kaimaninseln,2008,4,1440000,29000,1469000
Kaimaninseln,2008,5,253917000,31000,253948000
Kaimaninseln,2008,6,50311000,1302000,51613000
Kaimaninseln,2008,7,1875000,5000,1880000
Kaimaninseln,2008,8,174730000,11000,174741000
Kaimaninseln,2008,9,862000,3000,865000
Kaimaninseln,2008,10,2876000,2000,2878000
Kaimaninseln,2008,11,67315000,10000,67325000
Kaimaninseln,2008,12,644000,0,644000
Kaimaninseln,2009,1,963000,0,963000
Kaimaninseln,2009,2,1090000,1000,1091000
Kaimaninseln,2009,3,40692000,2000,40694000
Kaimaninseln,2009,4,275000,693000,968000
Kaimaninseln,2009,5,1189000,2000,1191000
Kaimaninseln,2009,6,548000,5000,553000
Kaimaninseln,2009,7,670000,7000,677000
Kaimaninseln,2009,8,407000,560000,967000
Kaimaninseln,2009,9,552000,460000,1012000
Kaimaninseln,2009,10,1720000,16000,1736000
Kaimaninseln,2009,11,76254000,1000,76255000
Kaimaninseln,2009,12,1121000,16000,1137000
Kaimaninseln,2010,1,1586000,1000,1587000
Kaimaninseln,2010,2,1149000,0,1149000
Kaimaninseln,2010,3,2082000,0,2082000
Kaimaninseln,2010,4,1816000,0,1816000
Kaimaninseln,2010,5,2100000,0,2100000
Kaimaninseln,2010,6,2081000,1000,2082000
Kaimaninseln,2010,7,340379000,0,340379000
Kaimaninseln,2010,8,48080000,0,48080000
Kaimaninseln,2010,9,1742000,0,1742000
Kaimaninseln,2010,10,1088000,0,1088000
Kaimaninseln,2010,11,2546000,0,2546000
Kaimaninseln,2010,12,2680000,10000,2690000
Kaimaninseln,2011,1,1524000,3000,1527000
Kaimaninseln,2011,2,2320000,2000,2322000
Kaimaninseln,2011,3,4576000,11000,4587000
Kaimaninseln,2011,4,90652000,2000,90654000
Kaimaninseln,2011,5,3479000,0,3479000
Kaimaninseln,2011,6,997000,17000,1014000
Kaimaninseln,2011,7,1296000,5000,1301000
Kaimaninseln,2011,8,1565000,10000,1575000
Kaimaninseln,2011,9,1316000,6000,1322000
Kaimaninseln,2011,10,749000,220000000,220749000
Kaimaninseln,2011,11,923000,44000,967000
Kaimaninseln,2011,12,1577000,13000,1590000
Kaimaninseln,2012,1,364000,0,364000
Kaimaninseln,2012,2,710000,2000,712000
Kaimaninseln,2012,3,349000,6000,355000
Kaimaninseln,2012,4,507000,0,507000
Kaimaninseln,2012,5,32167000,0,32167000
Kaimaninseln,2012,6,906000,15000,921000
Kaimaninseln,2012,7,1997000,0,1997000
Kaimaninseln,2012,8,1647000,15000,1662000
Kaimaninseln,2012,9,561000,15000,576000
Kaimaninseln,2012,10,480000,165000,645000
Kaimaninseln,2012,11,2232000,63000,2295000
Kaimaninseln,2012,12,455000,105353000,105808000
Kaimaninseln,2013,1,961000,36000,997000
Kaimaninseln,2013,2,119360000,27000,119387000
Kaimaninseln,2013,3,245000,0,245000
Kaimaninseln,2013,4,775000,48000,823000
Kaimaninseln,2013,5,901000,3000,904000
Kaimaninseln,2013,6,5291000,19000,5310000
Kaimaninseln,2013,7,581000,1000,582000
Kaimaninseln,2013,8,395000,3000,398000
Kaimaninseln,2013,9,655000,20000,675000
Kaimaninseln,2013,10,117136000,208571000,325707000
Kaimaninseln,2013,11,726000,6000,732000
Kaimaninseln,2013,12,597000,22000,619000
Kaimaninseln,2014,1,326000,15000,341000
Kaimaninseln,2014,2,4527000,0,4527000
Kaimaninseln,2014,3,22050000,304000,22354000
Kaimaninseln,2014,4,655000,310000,965000
Kaimaninseln,2014,5,768000,0,768000
Kaimaninseln,2014,6,1151000,0,1151000
Kaimaninseln,2014,7,685000,19000,704000
Kaimaninseln,2014,8,464000,6000,470000
Kaimaninseln,2014,9,862000,5000,867000
Kaimaninseln,2014,10,138852000,68000,138920000
Kaimaninseln,2014,11,595000,92000,687000
Kaimaninseln,2014,12,348000,0,348000
Kaimaninseln,2015,1,479000,19000,498000
Kaimaninseln,2015,2,516000,5000,521000
Kaimaninseln,2015,3,881000,2000,883000
Kaimaninseln,2015,4,495000,28000,523000
Kaimaninseln,2015,5,529000,4000,533000
Kaimaninseln,2015,6,876000,93000,969000
Kaimaninseln,2015,7,3334000,4000,3338000
Kaimaninseln,2015,8,610000,37000,647000
Kaimaninseln,2015,9,1136000,8000,1144000
Kaimaninseln,2015,10,1068000,58000,1126000
Kaimaninseln,2015,11,787000,6000,793000
Kaimaninseln,2015,12,2017000,1000,2018000
Kaimaninseln,2016,1,410000,9000,419000
Kaimaninseln,2016,2,182076000,30000,182106000
Kaimaninseln,2016,3,1642000,2000,1644000
Kaimaninseln,2016,4,768000,3000,771000
Kaimaninseln,2016,5,559112000,0,559112000
Kaimaninseln,2016,6,1415000,17000,1432000
Kaimaninseln,2016,7,648000,1000,649000
Kaimaninseln,2016,8,1100000,0,1100000
Kaimaninseln,2016,9,662000,67000,729000
Kaimaninseln,2016,10,2675000,1110000,3785000
Kaimaninseln,2016,11,1010000,1000,1011000
Kaimaninseln,2016,12,1000000,13000,1013000
Kaimaninseln,2017,1,1455000,0,1455000
Kaimaninseln,2017,2,1103000,8000,1111000
Kaimaninseln,2017,3,218914000,0,218914000
Kaimaninseln,2017,4,574000,7000,581000
Kaimaninseln,2017,5,894000,71000,965000
Kaimaninseln,2017,6,108243000,9000,108252000
Kaimaninseln,2017,7,189900000,897000,190797000
Kaimaninseln,2017,8,1912000,0,1912000
Kaimaninseln,2017,9,56744000,7000,56751000
Kaimaninseln,2017,10,964000,0,964000
Kaimaninseln,2017,11,535000,0,535000
Kaimaninseln,2017,12,56198000,0,56198000
Kaimaninseln,2018,1,515000,11000,526000
Kaimaninseln,2018,2,584000,5000,589000
Kaimaninseln,2018,3,1500000,9000,1509000
Kaimaninseln,2018,4,983000,18000,1001000
Kaimaninseln,2018,5,1612000,17000,1629000
Kaimaninseln,2018,6,82819000,10000,82829000
Kaimaninseln,2018,7,1136000,0,1136000
Kaimaninseln,2018,8,500386000,9000,500395000
Kaimaninseln,2018,9,1757000,1000,1758000
Kaimaninseln,2018,10,56569000,1000,56570000
Kaimaninseln,2018,11,921000,167000,1088000
Kaimaninseln,2018,12,630000,8000,638000
Kaimaninseln,2019,1,931000,1036000,1967000
Kaimaninseln,2019,2,1126000,139000,1265000
Kaimaninseln,2019,3,783000,6000,789000
Kaimaninseln,2019,4,955000,3305000,4260000
Kaimaninseln,2019,5,651000,30000,681000
Kaimaninseln,2019,6,5473000,7000,5480000
Kaimaninseln,2019,7,884000,16000,900000
Kaimaninseln,2019,8,55040000,1000,55041000
Kaimaninseln,2019,9,698000,0,698000
Kaimaninseln,2019,10,866000,0,866000
Kaimaninseln,2019,11,541000,46000,587000
Kaimaninseln,2019,12,572000,1000,573000
Kaimaninseln,2020,1,4711000,10000,4721000
Kaimaninseln,2020,2,3693000,2000,3695000
Kaimaninseln,2020,3,55675000,4000,55679000
Kaimaninseln,2020,4,479000,0,479000
Kaimaninseln,2020,5,326000,0,326000
Kaimaninseln,2020,6,666000,61000,727000
Kaimaninseln,2020,7,162044000,102000,162146000
Kaimaninseln,2020,8,754000,17000,771000
Kaimaninseln,2020,9,1011000,21000,1032000
Kaimaninseln,2020,10,440000,0,440000
Kaimaninseln,2020,11,1310000,25000,1335000
Kaimaninseln,2020,12,619000,3000,622000
Kaimaninseln,2021,1,903000,2000,905000
Kaimaninseln,2021,2,919000,18000,937000
Kaimaninseln,2021,3,815000,7000,822000
Kaimaninseln,2021,4,14407000,221000,14628000
Kaimaninseln,2021,5,1232000,4000,1236000
Kaimaninseln,2021,6,1021000,4000,1025000
Kaimaninseln,2021,7,903000,0,903000
Kaimaninseln,2021,8,1216000,0,1216000
Kaimaninseln,2021,9,4446000,3000,4449000
Kaimaninseln,2021,10,1337000,19000,1356000
Kaimaninseln,2021,11,321007000,10000,321017000
Kaimaninseln,2021,12,1103000,9000,1112000
Kaimaninseln,2022,1,1868000,81000,1949000
Kaimaninseln,2022,2,1509000,0,1509000
Kaimaninseln,2022,3,870000,0,870000
Kaimaninseln,2022,4,56484000,4000,56488000
Kaimaninseln,2022,5,60022000,9000,60031000
Kaimaninseln,2022,6,618000,151000,769000
Kaimaninseln,2022,7,721000,3000,724000
Kaimaninseln,2022,8,563000,3000,566000
Kaimaninseln,2022,9,1366000,7000,1373000
Kaimaninseln,2022,10,1305000,219000,1524000
Kaimaninseln,2022,11,2001000,38000,2039000
Kaimaninseln,2022,12,1336000,3000,1339000
Kaimaninseln,2023,1,529000,17000,546000
Kaimaninseln,2023,2,2065000,40000,2105000
Kaimaninseln,2023,3,578222000,27000,578249000
Kaimaninseln,2023,4,181051000,16000,181067000
Kaimaninseln,2023,5,1115000,217000,1332000
Kaimaninseln,2023,6,3822000,180000,4002000
Kaimaninseln,2023,7,1329000,236000,1565000
Kaimaninseln,2023,8,140752000,130000,140882000
Kaimaninseln,2023,9,3918000,179000,4097000
Kaimaninseln,2023,10,1957000,67664000,69621000
Kaimaninseln,2023,11,1525000,205000,1730000
Kaimaninseln,2023,12,1079000,164000,1243000
Kaimaninseln,2024,1,7800000,27000,7827000
Kaimaninseln,2024,2,1361000,157000,1518000
Kaimaninseln,2024,3,1359000,40000,1399000
Kaimaninseln,2024,4,603950000,43000,603993000
Kaimaninseln,2024,5,274308000,1637000,275945000
Kaimaninseln,2024,6,119969000,17000,119986000
Kaimaninseln,2024,7,1283000,4000,1287000
Kaimaninseln,2024,8,1060000,176000,1236000
Kaimaninseln,2024,9,3941000,157000,4098000
Kaimaninseln,2024,10,2098000,27000,2125000
Kaimaninseln,2024,11,848000,227000,1075000
Kaimaninseln,2024,12,407345000,61000,407406000
Kambodscha,2008,1,920000,26863000,27783000
Kambodscha,2008,2,875000,24706000,25581000
Kambodscha,2008,3,1261000,18325000,19586000
Kambodscha,2008,4,2171000,14848000,17019000
Kambodscha,2008,5,744000,14711000,15455000
Kambodscha,2008,6,638000,15099000,15737000
Kambodscha,2008,7,606000,27448000,28054000
Kambodscha,2008,8,4592000,34833000,39425000
Kambodscha,2008,9,996000,34413000,35409000
Kambodscha,2008,10,1120000,22075000,23195000
Kambodscha,2008,11,3318000,28452000,31770000
Kambodscha,2008,12,1484000,19686000,21170000
Kambodscha,2009,1,2353000,29021000,31374000
Kambodscha,2009,2,3003000,23777000,26780000
Kambodscha,2009,3,1118000,20320000,21438000
Kambodscha,2009,4,751000,23067000,23818000
Kambodscha,2009,5,771000,15898000,16669000
Kambodscha,2009,6,743000,22907000,23650000
Kambodscha,2009,7,1268000,28542000,29810000
Kambodscha,2009,8,1469000,35894000,37363000
Kambodscha,2009,9,753000,30033000,30786000
Kambodscha,2009,10,1202000,23161000,24363000
Kambodscha,2009,11,816000,19931000,20747000
Kambodscha,2009,12,512000,17299000,17811000
Kambodscha,2010,1,850000,23978000,24828000
Kambodscha,2010,2,789000,22014000,22803000
Kambodscha,2010,3,590000,23541000,24131000
Kambodscha,2010,4,618000,17786000,18404000
Kambodscha,2010,5,2148000,17320000,19468000
Kambodscha,2010,6,3144000,23163000,26307000
Kambodscha,2010,7,697000,35359000,36056000
Kambodscha,2010,8,2363000,48880000,51243000
Kambodscha,2010,9,2907000,47315000,50222000
Kambodscha,2010,10,3298000,36714000,40012000
Kambodscha,2010,11,4508000,28743000,33251000
Kambodscha,2010,12,4299000,30256000,34555000
Kambodscha,2011,1,1374000,39045000,40419000
Kambodscha,2011,2,2759000,34374000,37133000
Kambodscha,2011,3,2243000,43628000,45871000
Kambodscha,2011,4,2138000,29562000,31700000
Kambodscha,2011,5,1980000,25919000,27899000
Kambodscha,2011,6,1152000,36736000,37888000
Kambodscha,2011,7,2248000,48045000,50293000
Kambodscha,2011,8,3669000,61968000,65637000
Kambodscha,2011,9,4174000,58630000,62804000
Kambodscha,2011,10,2542000,48532000,51074000
Kambodscha,2011,11,3300000,44626000,47926000
Kambodscha,2011,12,5966000,47068000,53034000
Kambodscha,2012,1,1594000,65414000,67008000
Kambodscha,2012,2,2745000,56696000,59441000
Kambodscha,2012,3,3194000,53073000,56267000
Kambodscha,2012,4,2627000,44082000,46709000
Kambodscha,2012,5,3329000,41646000,44975000
Kambodscha,2012,6,5906000,41502000,47408000
Kambodscha,2012,7,3509000,59236000,62745000
Kambodscha,2012,8,3919000,72526000,76445000
Kambodscha,2012,9,3076000,63367000,66443000
Kambodscha,2012,10,5450000,61218000,66668000
Kambodscha,2012,11,5039000,56151000,61190000
Kambodscha,2012,12,4418000,52370000,56788000
Kambodscha,2013,1,5599000,75857000,81456000
Kambodscha,2013,2,4057000,66936000,70993000
Kambodscha,2013,3,4829000,61690000,66519000
Kambodscha,2013,4,9429000,74327000,83756000
Kambodscha,2013,5,4356000,54492000,58848000
Kambodscha,2013,6,4355000,66344000,70699000
Kambodscha,2013,7,3831000,75637000,79468000
Kambodscha,2013,8,2720000,81375000,84095000
Kambodscha,2013,9,4155000,81724000,85879000
Kambodscha,2013,10,4464000,69406000,73870000
Kambodscha,2013,11,3491000,68422000,71913000
Kambodscha,2013,12,5250000,61365000,66615000
Kambodscha,2014,1,3639000,83386000,87025000
Kambodscha,2014,2,4483000,73515000,77998000
Kambodscha,2014,3,6849000,83181000,90030000
Kambodscha,2014,4,3020000,74908000,77928000
Kambodscha,2014,5,10065000,63768000,73833000
Kambodscha,2014,6,4007000,66406000,70413000
Kambodscha,2014,7,4678000,86274000,90952000
Kambodscha,2014,8,11014000,88127000,99141000
Kambodscha,2014,9,3765000,98620000,102385000
Kambodscha,2014,10,11440000,81946000,93386000
Kambodscha,2014,11,5114000,80812000,85926000
Kambodscha,2014,12,4684000,77303000,81987000
Kambodscha,2015,1,4246000,102472000,106718000
Kambodscha,2015,2,3686000,106748000,110434000
Kambodscha,2015,3,4266000,113194000,117460000
Kambodscha,2015,4,9119000,103917000,113036000
Kambodscha,2015,5,6100000,79026000,85126000
Kambodscha,2015,6,7944000,82622000,90566000
Kambodscha,2015,7,14999000,111067000,126066000
Kambodscha,2015,8,8475000,118016000,126491000
Kambodscha,2015,9,16700000,112829000,129529000
Kambodscha,2015,10,12471000,104915000,117386000
Kambodscha,2015,11,7266000,97703000,104969000
Kambodscha,2015,12,25318000,101851000,127169000
Kambodscha,2016,1,4333000,116537000,120870000
Kambodscha,2016,2,9855000,119483000,129338000
Kambodscha,2016,3,5936000,116598000,122534000
Kambodscha,2016,4,7225000,108914000,116139000
Kambodscha,2016,5,15977000,87127000,103104000
Kambodscha,2016,6,10236000,96189000,106425000
Kambodscha,2016,7,5167000,108774000,113941000
Kambodscha,2016,8,5581000,136758000,142339000
Kambodscha,2016,9,5881000,121338000,127219000
Kambodscha,2016,10,5543000,123334000,128877000
Kambodscha,2016,11,57742000,110970000,168712000
Kambodscha,2016,12,15087000,113344000,128431000
Kambodscha,2017,1,6825000,128478000,135303000
Kambodscha,2017,2,90139000,125112000,215251000
Kambodscha,2017,3,13412000,133309000,146721000
Kambodscha,2017,4,9525000,119458000,128983000
Kambodscha,2017,5,9858000,116468000,126326000
Kambodscha,2017,6,45564000,117978000,163542000
Kambodscha,2017,7,5806000,123281000,129087000
Kambodscha,2017,8,43973000,155421000,199394000
Kambodscha,2017,9,6162000,127515000,133677000
Kambodscha,2017,10,7297000,132625000,139922000
Kambodscha,2017,11,6010000,150765000,156775000
Kambodscha,2017,12,9092000,117038000,126130000
Kambodscha,2018,1,8098000,142719000,150817000
Kambodscha,2018,2,7684000,133251000,140935000
Kambodscha,2018,3,8893000,111048000,119941000
Kambodscha,2018,4,12918000,127979000,140897000
Kambodscha,2018,5,8612000,111317000,119929000
Kambodscha,2018,6,8920000,122314000,131234000
Kambodscha,2018,7,9041000,160640000,169681000
Kambodscha,2018,8,14628000,172956000,187584000
Kambodscha,2018,9,10665000,153765000,164430000
Kambodscha,2018,10,12263000,163553000,175816000
Kambodscha,2018,11,18065000,159478000,177543000
Kambodscha,2018,12,12383000,125679000,138062000
Kambodscha,2019,1,14732000,159341000,174073000
Kambodscha,2019,2,8571000,135037000,143608000
Kambodscha,2019,3,7334000,132235000,139569000
Kambodscha,2019,4,6998000,130077000,137075000
Kambodscha,2019,5,13818000,125969000,139787000
Kambodscha,2019,6,14718000,104106000,118824000
Kambodscha,2019,7,12740000,141081000,153821000
Kambodscha,2019,8,8410000,163087000,171497000
Kambodscha,2019,9,13439000,169754000,183193000
Kambodscha,2019,10,8682000,160638000,169320000
Kambodscha,2019,11,17753000,163351000,181104000
Kambodscha,2019,12,14417000,122884000,137301000
Kambodscha,2020,1,13469000,154989000,168458000
Kambodscha,2020,2,15528000,126306000,141834000
Kambodscha,2020,3,10502000,143512000,154014000
Kambodscha,2020,4,7012000,116097000,123109000
Kambodscha,2020,5,12708000,113227000,125935000
Kambodscha,2020,6,20794000,114923000,135717000
Kambodscha,2020,7,11046000,146991000,158037000
Kambodscha,2020,8,11596000,138642000,150238000
Kambodscha,2020,9,8367000,142035000,150402000
Kambodscha,2020,10,14136000,129541000,143677000
Kambodscha,2020,11,9836000,118205000,128041000
Kambodscha,2020,12,13441000,109777000,123218000
Kambodscha,2021,1,29562000,117739000,147301000
Kambodscha,2021,2,19846000,100180000,120026000
Kambodscha,2021,3,14070000,133286000,147356000
Kambodscha,2021,4,10175000,138212000,148387000
Kambodscha,2021,5,8830000,129730000,138560000
Kambodscha,2021,6,9108000,105274000,114382000
Kambodscha,2021,7,12465000,125519000,137984000
Kambodscha,2021,8,8556000,142086000,150642000
Kambodscha,2021,9,8644000,151624000,160268000
Kambodscha,2021,10,15647000,158567000,174214000
Kambodscha,2021,11,18997000,137876000,156873000
Kambodscha,2021,12,30141000,131950000,162091000
Kambodscha,2022,1,12023000,138417000,150440000
Kambodscha,2022,2,10969000,122171000,133140000
Kambodscha,2022,3,15565000,162071000,177636000
Kambodscha,2022,4,15444000,179913000,195357000
Kambodscha,2022,5,10875000,207075000,217950000
Kambodscha,2022,6,15152000,160834000,175986000
Kambodscha,2022,7,10746000,169735000,180481000
Kambodscha,2022,8,10956000,230539000,241495000
Kambodscha,2022,9,9503000,254972000,264475000
Kambodscha,2022,10,10580000,235560000,246140000
Kambodscha,2022,11,11070000,216161000,227231000
Kambodscha,2022,12,8520000,187879000,196399000
Kambodscha,2023,1,12362000,169439000,181801000
Kambodscha,2023,2,18681000,162108000,180789000
Kambodscha,2023,3,25581000,154823000,180404000
Kambodscha,2023,4,18476000,144993000,163469000
Kambodscha,2023,5,13006000,138476000,151482000
Kambodscha,2023,6,29418000,153733000,183151000
Kambodscha,2023,7,21120000,175226000,196346000
Kambodscha,2023,8,29824000,207263000,237087000
Kambodscha,2023,9,19721000,159214000,178935000
Kambodscha,2023,10,10087000,175753000,185840000
Kambodscha,2023,11,6970000,160729000,167699000
Kambodscha,2023,12,13477000,126843000,140320000
Kambodscha,2024,1,11272000,151949000,163221000
Kambodscha,2024,2,7472000,179825000,187297000
Kambodscha,2024,3,11016000,165642000,176658000
Kambodscha,2024,4,15598000,178093000,193691000
Kambodscha,2024,5,10364000,167186000,177550000
Kambodscha,2024,6,8974000,145375000,154349000
Kambodscha,2024,7,11517000,186682000,198199000
Kambodscha,2024,8,16286000,224419000,240705000
Kambodscha,2024,9,14592000,232893000,247485000
Kambodscha,2024,10,12866000,202358000,215224000
Kambodscha,2024,11,26662000,189590000,216252000
Kambodscha,2024,12,15411000,177997000,193408000
Kamerun,2008,1,7510000,5578000,13088000
Kamerun,2008,2,6432000,3229000,9661000
Kamerun,2008,3,5536000,4475000,10011000
Kamerun,2008,4,12163000,5952000,18115000
Kamerun,2008,5,6574000,4255000,10829000
Kamerun,2008,6,7542000,47649000,55191000
Kamerun,2008,7,8691000,5568000,14259000
Kamerun,2008,8,6502000,5788000,12290000
Kamerun,2008,9,10712000,5372000,16084000
Kamerun,2008,10,14155000,7762000,21917000
Kamerun,2008,11,9400000,4231000,13631000
Kamerun,2008,12,8466000,4420000,12886000
Kamerun,2009,1,6281000,2819000,9100000
Kamerun,2009,2,6206000,4422000,10628000
Kamerun,2009,3,9806000,2421000,12227000
Kamerun,2009,4,9910000,4661000,14571000
Kamerun,2009,5,5001000,3221000,8222000
Kamerun,2009,6,7987000,4034000,12021000
Kamerun,2009,7,8123000,6009000,14132000
Kamerun,2009,8,5390000,5868000,11258000
Kamerun,2009,9,5775000,4680000,10455000
Kamerun,2009,10,9193000,3116000,12309000
Kamerun,2009,11,7359000,2794000,10153000
Kamerun,2009,12,6119000,3032000,9151000
Kamerun,2010,1,6942000,3020000,9962000
Kamerun,2010,2,8103000,5353000,13456000
Kamerun,2010,3,12187000,7304000,19491000
Kamerun,2010,4,6949000,6123000,13072000
Kamerun,2010,5,7291000,5744000,13035000
Kamerun,2010,6,13067000,5277000,18344000
Kamerun,2010,7,10432000,9761000,20193000
Kamerun,2010,8,13082000,7329000,20411000
Kamerun,2010,9,12865000,5601000,18466000
Kamerun,2010,10,13841000,8258000,22099000
Kamerun,2010,11,8631000,5499000,14130000
Kamerun,2010,12,13219000,6984000,20203000
Kamerun,2011,1,11413000,37081000,48494000
Kamerun,2011,2,6563000,7550000,14113000
Kamerun,2011,3,8773000,10776000,19549000
Kamerun,2011,4,9856000,15316000,25172000
Kamerun,2011,5,10935000,11418000,22353000
Kamerun,2011,6,11709000,21612000,33321000
Kamerun,2011,7,13991000,18528000,32519000
Kamerun,2011,8,8101000,13515000,21616000
Kamerun,2011,9,11028000,7100000,18128000
Kamerun,2011,10,8840000,8902000,17742000
Kamerun,2011,11,9793000,40127000,49920000
Kamerun,2011,12,12869000,18472000,31341000
Kamerun,2012,1,7955000,9492000,17447000
Kamerun,2012,2,7310000,5652000,12962000
Kamerun,2012,3,6328000,5804000,12132000
Kamerun,2012,4,7392000,5798000,13190000
Kamerun,2012,5,10465000,6811000,17276000
Kamerun,2012,6,11782000,4383000,16165000
Kamerun,2012,7,9051000,4616000,13667000
Kamerun,2012,8,11027000,7171000,18198000
Kamerun,2012,9,10922000,6807000,17729000
Kamerun,2012,10,17025000,8691000,25716000
Kamerun,2012,11,16754000,4253000,21007000
Kamerun,2012,12,13788000,6349000,20137000
Kamerun,2013,1,16979000,5357000,22336000
Kamerun,2013,2,10888000,2723000,13611000
Kamerun,2013,3,13097000,2513000,15610000
Kamerun,2013,4,15533000,3313000,18846000
Kamerun,2013,5,12687000,6288000,18975000
Kamerun,2013,6,13629000,3645000,17274000
Kamerun,2013,7,14793000,2293000,17086000
Kamerun,2013,8,8508000,5626000,14134000
Kamerun,2013,9,12673000,2566000,15239000
Kamerun,2013,10,10537000,48391000,58928000
Kamerun,2013,11,11428000,31210000,42638000
Kamerun,2013,12,13219000,3262000,16481000
Kamerun,2014,1,9095000,3020000,12115000
Kamerun,2014,2,12556000,2612000,15168000
Kamerun,2014,3,10243000,3544000,13787000
Kamerun,2014,4,11071000,3877000,14948000
Kamerun,2014,5,12987000,2738000,15725000
Kamerun,2014,6,10757000,2106000,12863000
Kamerun,2014,7,12493000,3924000,16417000
Kamerun,2014,8,10708000,6957000,17665000
Kamerun,2014,9,15742000,3110000,18852000
Kamerun,2014,10,9285000,2667000,11952000
Kamerun,2014,11,11835000,3172000,15007000
Kamerun,2014,12,9990000,2783000,12773000
Kamerun,2015,1,12651000,1841000,14492000
Kamerun,2015,2,9511000,3194000,12705000
Kamerun,2015,3,12995000,3459000,16454000
Kamerun,2015,4,14460000,2433000,16893000
Kamerun,2015,5,25064000,2955000,28019000
Kamerun,2015,6,13310000,7130000,20440000
Kamerun,2015,7,13907000,3089000,16996000
Kamerun,2015,8,7676000,6884000,14560000
Kamerun,2015,9,12819000,5420000,18239000
Kamerun,2015,10,10913000,5417000,16330000
Kamerun,2015,11,10846000,5357000,16203000
Kamerun,2015,12,8446000,6401000,14847000
Kamerun,2016,1,6973000,6306000,13279000
Kamerun,2016,2,14133000,5494000,19627000
Kamerun,2016,3,10835000,6318000,17153000
Kamerun,2016,4,9551000,7126000,16677000
Kamerun,2016,5,7977000,4702000,12679000
Kamerun,2016,6,12143000,4204000,16347000
Kamerun,2016,7,10115000,5418000,15533000
Kamerun,2016,8,20660000,6710000,27370000
Kamerun,2016,9,11015000,5790000,16805000
Kamerun,2016,10,12782000,6939000,19721000
Kamerun,2016,11,11366000,6224000,17590000
Kamerun,2016,12,8003000,7658000,15661000
Kamerun,2017,1,6450000,9637000,16087000
Kamerun,2017,2,7983000,5089000,13072000
Kamerun,2017,3,7395000,8482000,15877000
Kamerun,2017,4,6650000,4200000,10850000
Kamerun,2017,5,11186000,8089000,19275000
Kamerun,2017,6,9999000,7470000,17469000
Kamerun,2017,7,14532000,5371000,19903000
Kamerun,2017,8,16540000,6777000,23317000
Kamerun,2017,9,12620000,4947000,17567000
Kamerun,2017,10,7108000,6298000,13406000
Kamerun,2017,11,8544000,4214000,12758000
Kamerun,2017,12,9777000,4492000,14269000
Kamerun,2018,1,6620000,3506000,10126000
Kamerun,2018,2,8320000,6120000,14440000
Kamerun,2018,3,12414000,2788000,15202000
Kamerun,2018,4,9801000,2919000,12720000
Kamerun,2018,5,10438000,3803000,14241000
Kamerun,2018,6,10304000,4997000,15301000
Kamerun,2018,7,12838000,2912000,15750000
Kamerun,2018,8,6694000,45321000,52015000
Kamerun,2018,9,8077000,4883000,12960000
Kamerun,2018,10,6252000,7189000,13441000
Kamerun,2018,11,9574000,4637000,14211000
Kamerun,2018,12,4575000,1901000,6476000
Kamerun,2019,1,6788000,4808000,11596000
Kamerun,2019,2,6280000,4046000,10326000
Kamerun,2019,3,6987000,8216000,15203000
Kamerun,2019,4,8016000,6399000,14415000
Kamerun,2019,5,7027000,4362000,11389000
Kamerun,2019,6,7662000,6274000,13936000
Kamerun,2019,7,13593000,4973000,18566000
Kamerun,2019,8,6070000,6503000,12573000
Kamerun,2019,9,7395000,3883000,11278000
Kamerun,2019,10,11549000,4751000,16300000
Kamerun,2019,11,7308000,13404000,20712000
Kamerun,2019,12,8230000,26578000,34808000
Kamerun,2020,1,6116000,14229000,20345000
Kamerun,2020,2,10170000,24236000,34406000
Kamerun,2020,3,9871000,10960000,20831000
Kamerun,2020,4,9738000,7724000,17462000
Kamerun,2020,5,6819000,9068000,15887000
Kamerun,2020,6,9450000,7343000,16793000
Kamerun,2020,7,8283000,7092000,15375000
Kamerun,2020,8,10445000,9351000,19796000
Kamerun,2020,9,8331000,6263000,14594000
Kamerun,2020,10,9235000,8234000,17469000
Kamerun,2020,11,11319000,6301000,17620000
Kamerun,2020,12,8071000,4160000,12231000
Kamerun,2021,1,6472000,9690000,16162000
Kamerun,2021,2,11105000,3982000,15087000
Kamerun,2021,3,12081000,5649000,17730000
Kamerun,2021,4,8981000,5259000,14240000
Kamerun,2021,5,8193000,7953000,16146000
Kamerun,2021,6,11426000,5948000,17374000
Kamerun,2021,7,8279000,8326000,16605000
Kamerun,2021,8,7281000,6656000,13937000
Kamerun,2021,9,11251000,8191000,19442000
Kamerun,2021,10,11985000,4987000,16972000
Kamerun,2021,11,12243000,9632000,21875000
Kamerun,2021,12,14380000,6019000,20399000
Kamerun,2022,1,7790000,7297000,15087000
Kamerun,2022,2,13185000,9128000,22313000
Kamerun,2022,3,20312000,9355000,29667000
Kamerun,2022,4,11371000,13647000,25018000
Kamerun,2022,5,9793000,8137000,17930000
Kamerun,2022,6,22012000,6067000,28079000
Kamerun,2022,7,10212000,12041000,22253000
Kamerun,2022,8,10122000,15168000,25290000
Kamerun,2022,9,14309000,41837000,56146000
Kamerun,2022,10,10324000,50065000,60389000
Kamerun,2022,11,11627000,30166000,41793000
Kamerun,2022,12,12749000,24800000,37549000
Kamerun,2023,1,21599000,56139000,77738000
Kamerun,2023,2,12938000,25578000,38516000
Kamerun,2023,3,21662000,13900000,35562000
Kamerun,2023,4,12098000,17614000,29712000
Kamerun,2023,5,16563000,11688000,28251000
Kamerun,2023,6,26231000,20769000,47000000
Kamerun,2023,7,15474000,31262000,46736000
Kamerun,2023,8,10687000,13044000,23731000
Kamerun,2023,9,10063000,57798000,67861000
Kamerun,2023,10,7997000,35216000,43213000
Kamerun,2023,11,14607000,25315000,39922000
Kamerun,2023,12,22346000,32113000,54459000
Kamerun,2024,1,19611000,56402000,76013000
Kamerun,2024,2,10558000,35695000,46253000
Kamerun,2024,3,9532000,27557000,37089000
Kamerun,2024,4,9676000,17791000,27467000
Kamerun,2024,5,19488000,65096000,84584000
Kamerun,2024,6,16712000,26451000,43163000
Kamerun,2024,7,15610000,31235000,46845000
Kamerun,2024,8,8610000,41786000,50396000
Kamerun,2024,9,16927000,24288000,41215000
Kamerun,2024,10,10952000,43526000,54478000
Kamerun,2024,11,14876000,83690000,98566000
Kamerun,2024,12,16542000,36687000,53229000
Kanada,2008,1,568153000,304895000,873048000
Kanada,2008,2,606941000,281719000,888660000
Kanada,2008,3,558656000,307156000,865812000
Kanada,2008,4,551649000,313569000,865218000
Kanada,2008,5,551811000,286355000,838166000
Kanada,2008,6,468144000,294175000,762319000
Kanada,2008,7,487106000,453113000,940219000
Kanada,2008,8,425722000,311013000,736735000
Kanada,2008,9,591837000,300856000,892693000
Kanada,2008,10,561411000,315540000,876951000
Kanada,2008,11,477273000,311351000,788624000
Kanada,2008,12,414735000,380952000,795687000
Kanada,2009,1,465957000,302514000,768471000
Kanada,2009,2,454441000,256009000,710450000
Kanada,2009,3,476628000,273997000,750625000
Kanada,2009,4,465448000,308398000,773846000
Kanada,2009,5,407096000,267125000,674221000
Kanada,2009,6,380162000,316095000,696257000
Kanada,2009,7,523784000,266048000,789832000
Kanada,2009,8,360296000,296011000,656307000
Kanada,2009,9,447404000,274832000,722236000
Kanada,2009,10,400359000,314026000,714385000
Kanada,2009,11,492222000,210385000,702607000
Kanada,2009,12,382095000,262052000,644147000
Kanada,2010,1,420814000,370006000,790820000
Kanada,2010,2,456315000,314011000,770326000
Kanada,2010,3,612592000,361200000,973792000
Kanada,2010,4,538708000,314386000,853094000
Kanada,2010,5,537314000,336286000,873600000
Kanada,2010,6,641265000,349556000,990821000
Kanada,2010,7,530907000,382302000,913209000
Kanada,2010,8,506124000,341098000,847222000
Kanada,2010,9,579697000,294657000,874354000
Kanada,2010,10,572881000,330026000,902907000
Kanada,2010,11,532741000,338134000,870875000
Kanada,2010,12,513962000,451343000,965305000
Kanada,2011,1,547945000,438483000,986428000
Kanada,2011,2,624075000,364310000,988385000
Kanada,2011,3,685563000,381024000,1066587000
Kanada,2011,4,577729000,355813000,933542000
Kanada,2011,5,657020000,470784000,1127804000
Kanada,2011,6,529884000,465124000,995008000
Kanada,2011,7,601444000,362792000,964236000
Kanada,2011,8,610372000,462526000,1072898000
Kanada,2011,9,701139000,480002000,1181141000
Kanada,2011,10,642496000,425143000,1067639000
Kanada,2011,11,633341000,614874000,1248215000
Kanada,2011,12,533958000,472375000,1006333000
Kanada,2012,1,629432000,358166000,987598000
Kanada,2012,2,738846000,296982000,1035828000
Kanada,2012,3,834459000,378977000,1213436000
Kanada,2012,4,790815000,295748000,1086563000
Kanada,2012,5,766289000,401412000,1167701000
Kanada,2012,6,745105000,386954000,1132059000
Kanada,2012,7,869448000,483056000,1352504000
Kanada,2012,8,801626000,420625000,1222251000
Kanada,2012,9,695321000,333952000,1029273000
Kanada,2012,10,735096000,390084000,1125180000
Kanada,2012,11,771429000,318770000,1090199000
Kanada,2012,12,530994000,386243000,917237000
Kanada,2013,1,646507000,397782000,1044289000
Kanada,2013,2,751529000,300149000,1051678000
Kanada,2013,3,816261000,379575000,1195836000
Kanada,2013,4,872107000,445529000,1317636000
Kanada,2013,5,749519000,357190000,1106709000
Kanada,2013,6,778210000,369068000,1147278000
Kanada,2013,7,796753000,358867000,1155620000
Kanada,2013,8,730034000,306311000,1036345000
Kanada,2013,9,722477000,298250000,1020727000
Kanada,2013,10,755604000,469017000,1224621000
Kanada,2013,11,657230000,370296000,1027526000
Kanada,2013,12,546206000,380085000,926291000
Kanada,2014,1,622282000,299565000,921847000
Kanada,2014,2,723632000,307909000,1031541000
Kanada,2014,3,781651000,263120000,1044771000
Kanada,2014,4,787766000,299027000,1086793000
Kanada,2014,5,742910000,275309000,1018219000
Kanada,2014,6,711235000,337984000,1049219000
Kanada,2014,7,805139000,323081000,1128220000
Kanada,2014,8,660290000,290238000,950528000
Kanada,2014,9,735275000,322445000,1057720000
Kanada,2014,10,767099000,355825000,1122924000
Kanada,2014,11,655798000,323855000,979653000
Kanada,2014,12,634816000,360662000,995478000
Kanada,2015,1,623595000,280448000,904043000
Kanada,2015,2,753562000,294747000,1048309000
Kanada,2015,3,944725000,343245000,1287970000
Kanada,2015,4,876729000,284694000,1161423000
Kanada,2015,5,878355000,310267000,1188622000
Kanada,2015,6,904364000,321894000,1226258000
Kanada,2015,7,837742000,386451000,1224193000
Kanada,2015,8,734291000,328020000,1062311000
Kanada,2015,9,881195000,329582000,1210777000
Kanada,2015,10,824986000,428097000,1253083000
Kanada,2015,11,870338000,367419000,1237757000
Kanada,2015,12,748690000,292462000,1041152000
Kanada,2016,1,644003000,322928000,966931000
Kanada,2016,2,820586000,301699000,1122285000
Kanada,2016,3,870429000,348522000,1218951000
Kanada,2016,4,820179000,308816000,1128995000
Kanada,2016,5,773138000,282987000,1056125000
Kanada,2016,6,862192000,390526000,1252718000
Kanada,2016,7,785410000,293945000,1079355000
Kanada,2016,8,748625000,348512000,1097137000
Kanada,2016,9,787967000,368526000,1156493000
Kanada,2016,10,752350000,344459000,1096809000
Kanada,2016,11,832421000,386392000,1218813000
Kanada,2016,12,737185000,402306000,1139491000
Kanada,2017,1,689738000,393808000,1083546000
Kanada,2017,2,832670000,342750000,1175420000
Kanada,2017,3,987595000,363113000,1350708000
Kanada,2017,4,804928000,337534000,1142462000
Kanada,2017,5,816841000,381774000,1198615000
Kanada,2017,6,785412000,397791000,1183203000
Kanada,2017,7,830267000,363925000,1194192000
Kanada,2017,8,781776000,317933000,1099709000
Kanada,2017,9,735058000,301633000,1036691000
Kanada,2017,10,811326000,333056000,1144382000
Kanada,2017,11,908390000,414643000,1323033000
Kanada,2017,12,687602000,357607000,1045209000
Kanada,2018,1,821699000,363702000,1185401000
Kanada,2018,2,879031000,350410000,1229441000
Kanada,2018,3,865875000,455322000,1321197000
Kanada,2018,4,802285000,366662000,1168947000
Kanada,2018,5,846843000,347912000,1194755000
Kanada,2018,6,858138000,431838000,1289976000
Kanada,2018,7,895077000,378266000,1273343000
Kanada,2018,8,789035000,398531000,1187566000
Kanada,2018,9,833649000,351570000,1185219000
Kanada,2018,10,937349000,435379000,1372728000
Kanada,2018,11,903636000,434712000,1338348000
Kanada,2018,12,716231000,398790000,1115021000
Kanada,2019,1,889873000,477523000,1367396000
Kanada,2019,2,848383000,395532000,1243915000
Kanada,2019,3,926687000,377058000,1303745000
Kanada,2019,4,982511000,384940000,1367451000
Kanada,2019,5,882329000,509205000,1391534000
Kanada,2019,6,898986000,483570000,1382556000
Kanada,2019,7,995523000,482178000,1477701000
Kanada,2019,8,849856000,439525000,1289381000
Kanada,2019,9,947441000,516347000,1463788000
Kanada,2019,10,921771000,498495000,1420266000
Kanada,2019,11,1023131000,593404000,1616535000
Kanada,2019,12,747031000,515346000,1262377000
Kanada,2020,1,833543000,554545000,1388088000
Kanada,2020,2,1112098000,455457000,1567555000
Kanada,2020,3,924980000,523311000,1448291000
Kanada,2020,4,594336000,356924000,951260000
Kanada,2020,5,539676000,330370000,870046000
Kanada,2020,6,785621000,402830000,1188451000
Kanada,2020,7,857200000,449302000,1306502000
Kanada,2020,8,700400000,403179000,1103579000
Kanada,2020,9,797744000,422528000,1220272000
Kanada,2020,10,771818000,648167000,1419985000
Kanada,2020,11,749913000,488580000,1238493000
Kanada,2020,12,666108000,494440000,1160548000
Kanada,2021,1,626361000,545113000,1171474000
Kanada,2021,2,788859000,406426000,1195285000
Kanada,2021,3,961426000,574159000,1535585000
Kanada,2021,4,830986000,431530000,1262516000
Kanada,2021,5,763663000,402060000,1165723000
Kanada,2021,6,1022185000,586681000,1608866000
Kanada,2021,7,871526000,486623000,1358149000
Kanada,2021,8,717704000,616443000,1334147000
Kanada,2021,9,784449000,522213000,1306662000
Kanada,2021,10,911450000,477141000,1388591000
Kanada,2021,11,923048000,490978000,1414026000
Kanada,2021,12,856290000,638572000,1494862000
Kanada,2022,1,815079000,478449000,1293528000
Kanada,2022,2,941914000,498584000,1440498000
Kanada,2022,3,1142309000,720686000,1862995000
Kanada,2022,4,1022029000,618975000,1641004000
Kanada,2022,5,1145997000,639964000,1785961000
Kanada,2022,6,990597000,787083000,1777680000
Kanada,2022,7,1254784000,601331000,1856115000
Kanada,2022,8,1053099000,654303000,1707402000
Kanada,2022,9,1160246000,911207000,2071453000
Kanada,2022,10,1055136000,734424000,1789560000
Kanada,2022,11,1094966000,675590000,1770556000
Kanada,2022,12,1086328000,682917000,1769245000
Kanada,2023,1,956155000,736931000,1693086000
Kanada,2023,2,1099205000,530771000,1629976000
Kanada,2023,3,1149248000,599626000,1748874000
Kanada,2023,4,1025192000,580492000,1605684000
Kanada,2023,5,1080447000,562099000,1642546000
Kanada,2023,6,1248314000,565275000,1813589000
Kanada,2023,7,1072632000,656885000,1729517000
Kanada,2023,8,1072033000,539499000,1611532000
Kanada,2023,9,1050253000,496792000,1547045000
Kanada,2023,10,1046267000,488158000,1534425000
Kanada,2023,11,1074123000,588224000,1662347000
Kanada,2023,12,854658000,575620000,1430278000
Kanada,2024,1,948223000,641588000,1589811000
Kanada,2024,2,1065482000,671241000,1736723000
Kanada,2024,3,1066952000,662879000,1729831000
Kanada,2024,4,1157323000,603307000,1760630000
Kanada,2024,5,1129550000,441309000,1570859000
Kanada,2024,6,1230046000,555140000,1785186000
Kanada,2024,7,1129367000,576199000,1705566000
Kanada,2024,8,1015017000,605446000,1620463000
Kanada,2024,9,1066848000,509760000,1576608000
Kanada,2024,10,1183028000,604045000,1787073000
Kanada,2024,11,1056101000,574331000,1630432000
Kanada,2024,12,852602000,599432000,1452034000
Kanarische Inseln (bis 1996),2008,1,0,0,0
Kanarische Inseln (bis 1996),2008,2,0,0,0
Kanarische Inseln (bis 1996),2008,3,0,0,0
Kanarische Inseln (bis 1996),2008,4,0,0,0
Kanarische Inseln (bis 1996),2008,5,0,0,0
Kanarische Inseln (bis 1996),2008,6,0,0,0
Kanarische Inseln (bis 1996),2008,7,0,0,0
Kanarische Inseln (bis 1996),2008,8,0,0,0
Kanarische Inseln (bis 1996),2008,9,0,0,0
Kanarische Inseln (bis 1996),2008,10,0,0,0
Kanarische Inseln (bis 1996),2008,11,0,0,0
Kanarische Inseln (bis 1996),2008,12,0,0,0
Kanarische Inseln (bis 1996),2009,1,0,0,0
Kanarische Inseln (bis 1996),2009,2,0,0,0
Kanarische Inseln (bis 1996),2009,3,0,0,0
Kanarische Inseln (bis 1996),2009,4,0,0,0
Kanarische Inseln (bis 1996),2009,5,0,0,0
Kanarische Inseln (bis 1996),2009,6,0,0,0
Kanarische Inseln (bis 1996),2009,7,0,0,0
Kanarische Inseln (bis 1996),2009,8,0,0,0
Kanarische Inseln (bis 1996),2009,9,0,0,0
Kanarische Inseln (bis 1996),2009,10,0,0,0
Kanarische Inseln (bis 1996),2009,11,0,0,0
Kanarische Inseln (bis 1996),2009,12,0,0,0
Kanarische Inseln (bis 1996),2010,1,0,0,0
Kanarische Inseln (bis 1996),2010,2,0,0,0
Kanarische Inseln (bis 1996),2010,3,0,0,0
Kanarische Inseln (bis 1996),2010,4,0,0,0
Kanarische Inseln (bis 1996),2010,5,0,0,0
Kanarische Inseln (bis 1996),2010,6,0,0,0
Kanarische Inseln (bis 1996),2010,7,0,0,0
Kanarische Inseln (bis 1996),2010,8,0,0,0
Kanarische Inseln (bis 1996),2010,9,0,0,0
Kanarische Inseln (bis 1996),2010,10,0,0,0
Kanarische Inseln (bis 1996),2010,11,0,0,0
Kanarische Inseln (bis 1996),2010,12,0,0,0
Kanarische Inseln (bis 1996),2011,1,0,0,0
Kanarische Inseln (bis 1996),2011,2,0,0,0
Kanarische Inseln (bis 1996),2011,3,0,0,0
Kanarische Inseln (bis 1996),2011,4,0,0,0
Kanarische Inseln (bis 1996),2011,5,0,0,0
Kanarische Inseln (bis 1996),2011,6,0,0,0
Kanarische Inseln (bis 1996),2011,7,0,0,0
Kanarische Inseln (bis 1996),2011,8,0,0,0
Kanarische Inseln (bis 1996),2011,9,0,0,0
Kanarische Inseln (bis 1996),2011,10,0,0,0
Kanarische Inseln (bis 1996),2011,11,0,0,0
Kanarische Inseln (bis 1996),2011,12,0,0,0
Kanarische Inseln (bis 1996),2012,1,0,0,0
Kanarische Inseln (bis 1996),2012,2,0,0,0
Kanarische Inseln (bis 1996),2012,3,0,0,0
Kanarische Inseln (bis 1996),2012,4,0,0,0
Kanarische Inseln (bis 1996),2012,5,0,0,0
Kanarische Inseln (bis 1996),2012,6,0,0,0
Kanarische Inseln (bis 1996),2012,7,0,0,0
Kanarische Inseln (bis 1996),2012,8,0,0,0
Kanarische Inseln (bis 1996),2012,9,0,0,0
Kanarische Inseln (bis 1996),2012,10,0,0,0
Kanarische Inseln (bis 1996),2012,11,0,0,0
Kanarische Inseln (bis 1996),2012,12,0,0,0
Kanarische Inseln (bis 1996),2013,1,0,0,0
Kanarische Inseln (bis 1996),2013,2,0,0,0
Kanarische Inseln (bis 1996),2013,3,0,0,0
Kanarische Inseln (bis 1996),2013,4,0,0,0
Kanarische Inseln (bis 1996),2013,5,0,0,0
Kanarische Inseln (bis 1996),2013,6,0,0,0
Kanarische Inseln (bis 1996),2013,7,0,0,0
Kanarische Inseln (bis 1996),2013,8,0,0,0
Kanarische Inseln (bis 1996),2013,9,0,0,0
Kanarische Inseln (bis 1996),2013,10,0,0,0
Kanarische Inseln (bis 1996),2013,11,0,0,0
Kanarische Inseln (bis 1996),2013,12,0,0,0
Kanarische Inseln (bis 1996),2014,1,0,0,0
Kanarische Inseln (bis 1996),2014,2,0,0,0
Kanarische Inseln (bis 1996),2014,3,0,0,0
Kanarische Inseln (bis 1996),2014,4,0,0,0
Kanarische Inseln (bis 1996),2014,5,0,0,0
Kanarische Inseln (bis 1996),2014,6,0,0,0
Kanarische Inseln (bis 1996),2014,7,0,0,0
Kanarische Inseln (bis 1996),2014,8,0,0,0
Kanarische Inseln (bis 1996),2014,9,0,0,0
Kanarische Inseln (bis 1996),2014,10,0,0,0
Kanarische Inseln (bis 1996),2014,11,0,0,0
Kanarische Inseln (bis 1996),2014,12,0,0,0
Kanarische Inseln (bis 1996),2015,1,0,0,0
Kanarische Inseln (bis 1996),2015,2,0,0,0
Kanarische Inseln (bis 1996),2015,3,0,0,0
Kanarische Inseln (bis 1996),2015,4,0,0,0
Kanarische Inseln (bis 1996),2015,5,0,0,0
Kanarische Inseln (bis 1996),2015,6,0,0,0
Kanarische Inseln (bis 1996),2015,7,0,0,0
Kanarische Inseln (bis 1996),2015,8,0,0,0
Kanarische Inseln (bis 1996),2015,9,0,0,0
Kanarische Inseln (bis 1996),2015,10,0,0,0
Kanarische Inseln (bis 1996),2015,11,0,0,0
Kanarische Inseln (bis 1996),2015,12,0,0,0
Kanarische Inseln (bis 1996),2016,1,0,0,0
Kanarische Inseln (bis 1996),2016,2,0,0,0
Kanarische Inseln (bis 1996),2016,3,0,0,0
Kanarische Inseln (bis 1996),2016,4,0,0,0
Kanarische Inseln (bis 1996),2016,5,0,0,0
Kanarische Inseln (bis 1996),2016,6,0,0,0
Kanarische Inseln (bis 1996),2016,7,0,0,0
Kanarische Inseln (bis 1996),2016,8,0,0,0
Kanarische Inseln (bis 1996),2016,9,0,0,0
Kanarische Inseln (bis 1996),2016,10,0,0,0
Kanarische Inseln (bis 1996),2016,11,0,0,0
Kanarische Inseln (bis 1996),2016,12,0,0,0
Kanarische Inseln (bis 1996),2017,1,0,0,0
Kanarische Inseln (bis 1996),2017,2,0,0,0
Kanarische Inseln (bis 1996),2017,3,0,0,0
Kanarische Inseln (bis 1996),2017,4,0,0,0
Kanarische Inseln (bis 1996),2017,5,0,0,0
Kanarische Inseln (bis 1996),2017,6,0,0,0
Kanarische Inseln (bis 1996),2017,7,0,0,0
Kanarische Inseln (bis 1996),2017,8,0,0,0
Kanarische Inseln (bis 1996),2017,9,0,0,0
Kanarische Inseln (bis 1996),2017,10,0,0,0
Kanarische Inseln (bis 1996),2017,11,0,0,0
Kanarische Inseln (bis 1996),2017,12,0,0,0
Kanarische Inseln (bis 1996),2018,1,0,0,0
Kanarische Inseln (bis 1996),2018,2,0,0,0
Kanarische Inseln (bis 1996),2018,3,0,0,0
Kanarische Inseln (bis 1996),2018,4,0,0,0
Kanarische Inseln (bis 1996),2018,5,0,0,0
Kanarische Inseln (bis 1996),2018,6,0,0,0
Kanarische Inseln (bis 1996),2018,7,0,0,0
Kanarische Inseln (bis 1996),2018,8,0,0,0
Kanarische Inseln (bis 1996),2018,9,0,0,0
Kanarische Inseln (bis 1996),2018,10,0,0,0
Kanarische Inseln (bis 1996),2018,11,0,0,0
Kanarische Inseln (bis 1996),2018,12,0,0,0
Kanarische Inseln (bis 1996),2019,1,0,0,0
Kanarische Inseln (bis 1996),2019,2,0,0,0
Kanarische Inseln (bis 1996),2019,3,0,0,0
Kanarische Inseln (bis 1996),2019,4,0,0,0
Kanarische Inseln (bis 1996),2019,5,0,0,0
Kanarische Inseln (bis 1996),2019,6,0,0,0
Kanarische Inseln (bis 1996),2019,7,0,0,0
Kanarische Inseln (bis 1996),2019,8,0,0,0
Kanarische Inseln (bis 1996),2019,9,0,0,0
Kanarische Inseln (bis 1996),2019,10,0,0,0
Kanarische Inseln (bis 1996),2019,11,0,0,0
Kanarische Inseln (bis 1996),2019,12,0,0,0
Kanarische Inseln (bis 1996),2020,1,0,0,0
Kanarische Inseln (bis 1996),2020,2,0,0,0
Kanarische Inseln (bis 1996),2020,3,0,0,0
Kanarische Inseln (bis 1996),2020,4,0,0,0
Kanarische Inseln (bis 1996),2020,5,0,0,0
Kanarische Inseln (bis 1996),2020,6,0,0,0
Kanarische Inseln (bis 1996),2020,7,0,0,0
Kanarische Inseln (bis 1996),2020,8,0,0,0
Kanarische Inseln (bis 1996),2020,9,0,0,0
Kanarische Inseln (bis 1996),2020,10,0,0,0
Kanarische Inseln (bis 1996),2020,11,0,0,0
Kanarische Inseln (bis 1996),2020,12,0,0,0
Kanarische Inseln (bis 1996),2021,1,0,0,0
Kanarische Inseln (bis 1996),2021,2,0,0,0
Kanarische Inseln (bis 1996),2021,3,0,0,0
Kanarische Inseln (bis 1996),2021,4,0,0,0
Kanarische Inseln (bis 1996),2021,5,0,0,0
Kanarische Inseln (bis 1996),2021,6,0,0,0
Kanarische Inseln (bis 1996),2021,7,0,0,0
Kanarische Inseln (bis 1996),2021,8,0,0,0
Kanarische Inseln (bis 1996),2021,9,0,0,0
Kanarische Inseln (bis 1996),2021,10,0,0,0
Kanarische Inseln (bis 1996),2021,11,0,0,0
Kanarische Inseln (bis 1996),2021,12,0,0,0
Kanarische Inseln (bis 1996),2022,1,0,0,0
Kanarische Inseln (bis 1996),2022,2,0,0,0
Kanarische Inseln (bis 1996),2022,3,0,0,0
Kanarische Inseln (bis 1996),2022,4,0,0,0
Kanarische Inseln (bis 1996),2022,5,0,0,0
Kanarische Inseln (bis 1996),2022,6,0,0,0
Kanarische Inseln (bis 1996),2022,7,0,0,0
Kanarische Inseln (bis 1996),2022,8,0,0,0
Kanarische Inseln (bis 1996),2022,9,0,0,0
Kanarische Inseln (bis 1996),2022,10,0,0,0
Kanarische Inseln (bis 1996),2022,11,0,0,0
Kanarische Inseln (bis 1996),2022,12,0,0,0
Kanarische Inseln (bis 1996),2023,1,0,0,0
Kanarische Inseln (bis 1996),2023,2,0,0,0
Kanarische Inseln (bis 1996),2023,3,0,0,0
Kanarische Inseln (bis 1996),2023,4,0,0,0
Kanarische Inseln (bis 1996),2023,5,0,0,0
Kanarische Inseln (bis 1996),2023,6,0,0,0
Kanarische Inseln (bis 1996),2023,7,0,0,0
Kanarische Inseln (bis 1996),2023,8,0,0,0
Kanarische Inseln (bis 1996),2023,9,0,0,0
Kanarische Inseln (bis 1996),2023,10,0,0,0
Kanarische Inseln (bis 1996),2023,11,0,0,0
Kanarische Inseln (bis 1996),2023,12,0,0,0
Kanarische Inseln (bis 1996),2024,1,0,0,0
Kanarische Inseln (bis 1996),2024,2,0,0,0
Kanarische Inseln (bis 1996),2024,3,0,0,0
Kanarische Inseln (bis 1996),2024,4,0,0,0
Kanarische Inseln (bis 1996),2024,5,0,0,0
Kanarische Inseln (bis 1996),2024,6,0,0,0
Kanarische Inseln (bis 1996),2024,7,0,0,0
Kanarische Inseln (bis 1996),2024,8,0,0,0
Kanarische Inseln (bis 1996),2024,9,0,0,0
Kanarische Inseln (bis 1996),2024,10,0,0,0
Kanarische Inseln (bis 1996),2024,11,0,0,0
Kanarische Inseln (bis 1996),2024,12,0,0,0
Kasachstan (ab 05/1992),2008,1,103334000,376244000,479578000
Kasachstan (ab 05/1992),2008,2,106158000,384949000,491107000
Kasachstan (ab 05/1992),2008,3,184810000,329896000,514706000
Kasachstan (ab 05/1992),2008,4,122028000,375626000,497654000
Kasachstan (ab 05/1992),2008,5,102638000,382655000,485293000
Kasachstan (ab 05/1992),2008,6,145771000,415949000,561720000
Kasachstan (ab 05/1992),2008,7,167649000,415202000,582851000
Kasachstan (ab 05/1992),2008,8,175327000,230928000,406255000
Kasachstan (ab 05/1992),2008,9,145645000,273710000,419355000
Kasachstan (ab 05/1992),2008,10,146425000,681525000,827950000
Kasachstan (ab 05/1992),2008,11,128389000,305308000,433697000
Kasachstan (ab 05/1992),2008,12,131906000,242165000,374071000
Kasachstan (ab 05/1992),2009,1,95008000,175808000,270816000
Kasachstan (ab 05/1992),2009,2,165604000,132409000,298013000
Kasachstan (ab 05/1992),2009,3,109277000,149787000,259064000
Kasachstan (ab 05/1992),2009,4,114489000,221602000,336091000
Kasachstan (ab 05/1992),2009,5,94694000,178467000,273161000
Kasachstan (ab 05/1992),2009,6,97278000,81988000,179266000
Kasachstan (ab 05/1992),2009,7,128412000,190325000,318737000
Kasachstan (ab 05/1992),2009,8,100564000,250784000,351348000
Kasachstan (ab 05/1992),2009,9,110243000,275970000,386213000
Kasachstan (ab 05/1992),2009,10,106061000,289678000,395739000
Kasachstan (ab 05/1992),2009,11,101029000,132641000,233670000
Kasachstan (ab 05/1992),2009,12,105296000,225160000,330456000
Kasachstan (ab 05/1992),2010,1,48514000,133193000,181707000
Kasachstan (ab 05/1992),2010,2,73912000,372491000,446403000
Kasachstan (ab 05/1992),2010,3,106676000,232027000,338703000
Kasachstan (ab 05/1992),2010,4,120155000,264553000,384708000
Kasachstan (ab 05/1992),2010,5,96785000,466340000,563125000
Kasachstan (ab 05/1992),2010,6,132884000,370235000,503119000
Kasachstan (ab 05/1992),2010,7,129699000,225815000,355514000
Kasachstan (ab 05/1992),2010,8,136165000,448718000,584883000
Kasachstan (ab 05/1992),2010,9,153459000,343977000,497436000
Kasachstan (ab 05/1992),2010,10,121588000,323697000,445285000
Kasachstan (ab 05/1992),2010,11,136416000,351705000,488121000
Kasachstan (ab 05/1992),2010,12,124941000,309253000,434194000
Kasachstan (ab 05/1992),2011,1,76034000,304043000,380077000
Kasachstan (ab 05/1992),2011,2,110102000,298402000,408504000
Kasachstan (ab 05/1992),2011,3,147084000,212280000,359364000
Kasachstan (ab 05/1992),2011,4,145664000,693917000,839581000
Kasachstan (ab 05/1992),2011,5,151265000,165404000,316669000
Kasachstan (ab 05/1992),2011,6,138190000,271953000,410143000
Kasachstan (ab 05/1992),2011,7,162055000,605223000,767278000
Kasachstan (ab 05/1992),2011,8,152837000,254421000,407258000
Kasachstan (ab 05/1992),2011,9,166070000,249382000,415452000
Kasachstan (ab 05/1992),2011,10,158697000,720973000,879670000
Kasachstan (ab 05/1992),2011,11,193448000,376490000,569938000
Kasachstan (ab 05/1992),2011,12,132410000,314995000,447405000
Kasachstan (ab 05/1992),2012,1,90930000,206070000,297000000
Kasachstan (ab 05/1992),2012,2,116988000,647959000,764947000
Kasachstan (ab 05/1992),2012,3,172419000,381901000,554320000
Kasachstan (ab 05/1992),2012,4,164367000,142515000,306882000
Kasachstan (ab 05/1992),2012,5,176278000,279740000,456018000
Kasachstan (ab 05/1992),2012,6,159013000,481868000,640881000
Kasachstan (ab 05/1992),2012,7,193301000,136465000,329766000
Kasachstan (ab 05/1992),2012,8,155392000,294801000,450193000
Kasachstan (ab 05/1992),2012,9,148585000,209280000,357865000
Kasachstan (ab 05/1992),2012,10,194837000,315113000,509950000
Kasachstan (ab 05/1992),2012,11,241538000,259091000,500629000
Kasachstan (ab 05/1992),2012,12,190581000,718375000,908956000
Kasachstan (ab 05/1992),2013,1,118561000,339554000,458115000
Kasachstan (ab 05/1992),2013,2,128158000,389910000,518068000
Kasachstan (ab 05/1992),2013,3,156668000,177137000,333805000
Kasachstan (ab 05/1992),2013,4,190646000,253451000,444097000
Kasachstan (ab 05/1992),2013,5,179444000,271084000,450528000
Kasachstan (ab 05/1992),2013,6,167672000,458778000,626450000
Kasachstan (ab 05/1992),2013,7,367681000,593471000,961152000
Kasachstan (ab 05/1992),2013,8,156589000,471923000,628512000
Kasachstan (ab 05/1992),2013,9,157578000,445588000,603166000
Kasachstan (ab 05/1992),2013,10,176757000,359668000,536425000
Kasachstan (ab 05/1992),2013,11,206988000,399083000,606071000
Kasachstan (ab 05/1992),2013,12,149621000,433495000,583116000
Kasachstan (ab 05/1992),2014,1,116829000,412419000,529248000
Kasachstan (ab 05/1992),2014,2,154073000,371343000,525416000
Kasachstan (ab 05/1992),2014,3,170603000,432892000,603495000
Kasachstan (ab 05/1992),2014,4,146730000,276322000,423052000
Kasachstan (ab 05/1992),2014,5,119487000,410343000,529830000
Kasachstan (ab 05/1992),2014,6,120214000,441728000,561942000
Kasachstan (ab 05/1992),2014,7,155490000,462038000,617528000
Kasachstan (ab 05/1992),2014,8,125656000,541319000,666975000
Kasachstan (ab 05/1992),2014,9,147225000,278951000,426176000
Kasachstan (ab 05/1992),2014,10,186065000,355270000,541335000
Kasachstan (ab 05/1992),2014,11,158307000,221975000,380282000
Kasachstan (ab 05/1992),2014,12,116805000,240468000,357273000
Kasachstan (ab 05/1992),2015,1,69039000,318300000,387339000
Kasachstan (ab 05/1992),2015,2,90826000,300104000,390930000
Kasachstan (ab 05/1992),2015,3,125602000,198295000,323897000
Kasachstan (ab 05/1992),2015,4,136470000,186171000,322641000
Kasachstan (ab 05/1992),2015,5,100925000,221534000,322459000
Kasachstan (ab 05/1992),2015,6,134358000,304536000,438894000
Kasachstan (ab 05/1992),2015,7,127713000,217726000,345439000
Kasachstan (ab 05/1992),2015,8,104660000,248309000,352969000
Kasachstan (ab 05/1992),2015,9,87224000,146523000,233747000
Kasachstan (ab 05/1992),2015,10,85111000,250552000,335663000
Kasachstan (ab 05/1992),2015,11,88115000,192358000,280473000
Kasachstan (ab 05/1992),2015,12,85000000,240618000,325618000
Kasachstan (ab 05/1992),2016,1,58310000,231660000,289970000
Kasachstan (ab 05/1992),2016,2,78428000,170093000,248521000
Kasachstan (ab 05/1992),2016,3,94301000,231370000,325671000
Kasachstan (ab 05/1992),2016,4,110007000,209321000,319328000
Kasachstan (ab 05/1992),2016,5,84732000,224215000,308947000
Kasachstan (ab 05/1992),2016,6,83326000,262481000,345807000
Kasachstan (ab 05/1992),2016,7,90478000,257642000,348120000
Kasachstan (ab 05/1992),2016,8,87891000,273492000,361383000
Kasachstan (ab 05/1992),2016,9,101713000,215053000,316766000
Kasachstan (ab 05/1992),2016,10,87612000,255948000,343560000
Kasachstan (ab 05/1992),2016,11,113236000,267180000,380416000
Kasachstan (ab 05/1992),2016,12,92954000,301081000,394035000
Kasachstan (ab 05/1992),2017,1,68698000,308691000,377389000
Kasachstan (ab 05/1992),2017,2,108250000,327076000,435326000
Kasachstan (ab 05/1992),2017,3,112410000,307275000,419685000
Kasachstan (ab 05/1992),2017,4,124086000,199790000,323876000
Kasachstan (ab 05/1992),2017,5,102706000,380139000,482845000
Kasachstan (ab 05/1992),2017,6,102422000,291875000,394297000
Kasachstan (ab 05/1992),2017,7,94031000,342928000,436959000
Kasachstan (ab 05/1992),2017,8,90161000,251351000,341512000
Kasachstan (ab 05/1992),2017,9,94498000,279672000,374170000
Kasachstan (ab 05/1992),2017,10,84594000,272684000,357278000
Kasachstan (ab 05/1992),2017,11,105834000,283215000,389049000
Kasachstan (ab 05/1992),2017,12,174019000,347751000,521770000
Kasachstan (ab 05/1992),2018,1,68200000,373823000,442023000
Kasachstan (ab 05/1992),2018,2,89385000,399377000,488762000
Kasachstan (ab 05/1992),2018,3,123315000,374921000,498236000
Kasachstan (ab 05/1992),2018,4,109669000,301525000,411194000
Kasachstan (ab 05/1992),2018,5,131920000,337465000,469385000
Kasachstan (ab 05/1992),2018,6,177217000,405167000,582384000
Kasachstan (ab 05/1992),2018,7,182157000,338035000,520192000
Kasachstan (ab 05/1992),2018,8,107573000,341445000,449018000
Kasachstan (ab 05/1992),2018,9,91273000,304117000,395390000
Kasachstan (ab 05/1992),2018,10,113244000,179073000,292317000
Kasachstan (ab 05/1992),2018,11,138061000,126857000,264918000
Kasachstan (ab 05/1992),2018,12,80446000,254063000,334509000
Kasachstan (ab 05/1992),2019,1,94635000,243782000,338417000
Kasachstan (ab 05/1992),2019,2,122320000,269881000,392201000
Kasachstan (ab 05/1992),2019,3,102752000,226289000,329041000
Kasachstan (ab 05/1992),2019,4,109234000,321630000,430864000
Kasachstan (ab 05/1992),2019,5,108692000,270347000,379039000
Kasachstan (ab 05/1992),2019,6,171593000,343505000,515098000
Kasachstan (ab 05/1992),2019,7,113482000,216319000,329801000
Kasachstan (ab 05/1992),2019,8,102811000,366206000,469017000
Kasachstan (ab 05/1992),2019,9,233117000,185565000,418682000
Kasachstan (ab 05/1992),2019,10,89684000,211116000,300800000
Kasachstan (ab 05/1992),2019,11,104227000,287604000,391831000
Kasachstan (ab 05/1992),2019,12,91499000,279817000,371316000
Kasachstan (ab 05/1992),2020,1,71100000,412590000,483690000
Kasachstan (ab 05/1992),2020,2,167973000,348316000,516289000
Kasachstan (ab 05/1992),2020,3,137228000,203588000,340816000
Kasachstan (ab 05/1992),2020,4,95545000,125942000,221487000
Kasachstan (ab 05/1992),2020,5,88537000,143351000,231888000
Kasachstan (ab 05/1992),2020,6,100329000,112283000,212612000
Kasachstan (ab 05/1992),2020,7,118831000,196202000,315033000
Kasachstan (ab 05/1992),2020,8,154843000,155817000,310660000
Kasachstan (ab 05/1992),2020,9,113307000,143506000,256813000
Kasachstan (ab 05/1992),2020,10,172375000,173186000,345561000
Kasachstan (ab 05/1992),2020,11,136307000,217513000,353820000
Kasachstan (ab 05/1992),2020,12,95299000,179815000,275114000
Kasachstan (ab 05/1992),2021,1,73422000,195003000,268425000
Kasachstan (ab 05/1992),2021,2,85756000,206750000,292506000
Kasachstan (ab 05/1992),2021,3,177193000,354154000,531347000
Kasachstan (ab 05/1992),2021,4,113488000,275384000,388872000
Kasachstan (ab 05/1992),2021,5,93502000,318237000,411739000
Kasachstan (ab 05/1992),2021,6,110377000,296522000,406899000
Kasachstan (ab 05/1992),2021,7,136723000,481194000,617917000
Kasachstan (ab 05/1992),2021,8,159376000,324728000,484104000
Kasachstan (ab 05/1992),2021,9,97023000,237647000,334670000
Kasachstan (ab 05/1992),2021,10,102271000,271030000,373301000
Kasachstan (ab 05/1992),2021,11,109241000,331357000,440598000
Kasachstan (ab 05/1992),2021,12,182100000,385373000,567473000
Kasachstan (ab 05/1992),2022,1,84100000,439656000,523756000
Kasachstan (ab 05/1992),2022,2,130323000,481690000,612013000
Kasachstan (ab 05/1992),2022,3,150494000,570159000,720653000
Kasachstan (ab 05/1992),2022,4,131279000,617428000,748707000
Kasachstan (ab 05/1992),2022,5,259469000,538385000,797854000
Kasachstan (ab 05/1992),2022,6,191933000,644547000,836480000
Kasachstan (ab 05/1992),2022,7,233783000,737855000,971638000
Kasachstan (ab 05/1992),2022,8,259935000,686641000,946576000
Kasachstan (ab 05/1992),2022,9,319516000,576491000,896007000
Kasachstan (ab 05/1992),2022,10,337599000,462992000,800591000
Kasachstan (ab 05/1992),2022,11,337658000,644925000,982583000
Kasachstan (ab 05/1992),2022,12,365702000,715237000,1080939000
Kasachstan (ab 05/1992),2023,1,247706000,647382000,895088000
Kasachstan (ab 05/1992),2023,2,296746000,395614000,692360000
Kasachstan (ab 05/1992),2023,3,313548000,302074000,615622000
Kasachstan (ab 05/1992),2023,4,264102000,337159000,601261000
Kasachstan (ab 05/1992),2023,5,290001000,546768000,836769000
Kasachstan (ab 05/1992),2023,6,292924000,493550000,786474000
Kasachstan (ab 05/1992),2023,7,240738000,481802000,722540000
Kasachstan (ab 05/1992),2023,8,252304000,499579000,751883000
Kasachstan (ab 05/1992),2023,9,243390000,491336000,734726000
Kasachstan (ab 05/1992),2023,10,326323000,518274000,844597000
Kasachstan (ab 05/1992),2023,11,242647000,318460000,561107000
Kasachstan (ab 05/1992),2023,12,212722000,485029000,697751000
Kasachstan (ab 05/1992),2024,1,245489000,424676000,670165000
Kasachstan (ab 05/1992),2024,2,243179000,531317000,774496000
Kasachstan (ab 05/1992),2024,3,233125000,583110000,816235000
Kasachstan (ab 05/1992),2024,4,244571000,725081000,969652000
Kasachstan (ab 05/1992),2024,5,235646000,667467000,903113000
Kasachstan (ab 05/1992),2024,6,243015000,453427000,696442000
Kasachstan (ab 05/1992),2024,7,254589000,494794000,749383000
Kasachstan (ab 05/1992),2024,8,238495000,533567000,772062000
Kasachstan (ab 05/1992),2024,9,236739000,477639000,714378000
Kasachstan (ab 05/1992),2024,10,239727000,701167000,940894000
Kasachstan (ab 05/1992),2024,11,290559000,499773000,790332000
Kasachstan (ab 05/1992),2024,12,246294000,433949000,680243000
Katar,2008,1,133264000,763000,134027000
Katar,2008,2,176029000,1251000,177280000
Katar,2008,3,91931000,1685000,93616000
Katar,2008,4,130676000,707000,131383000
Katar,2008,5,108889000,2253000,111142000
Katar,2008,6,110232000,677000,110909000
Katar,2008,7,128373000,2022000,130395000
Katar,2008,8,76053000,1552000,77605000
Katar,2008,9,147989000,2490000,150479000
Katar,2008,10,191739000,6069000,197808000
Katar,2008,11,172935000,10058000,182993000
Katar,2008,12,128157000,4310000,132467000
Katar,2009,1,99055000,5900000,104955000
Katar,2009,2,97274000,6208000,103482000
Katar,2009,3,115460000,3972000,119432000
Katar,2009,4,131921000,646000,132567000
Katar,2009,5,69187000,921000,70108000
Katar,2009,6,70264000,1699000,71963000
Katar,2009,7,83015000,10892000,93907000
Katar,2009,8,62355000,14733000,77088000
Katar,2009,9,73594000,1351000,74945000
Katar,2009,10,68785000,1308000,70093000
Katar,2009,11,85993000,2747000,88740000
Katar,2009,12,119851000,22051000,141902000
Katar,2010,1,45514000,8952000,54466000
Katar,2010,2,120471000,19900000,140371000
Katar,2010,3,84583000,2680000,87263000
Katar,2010,4,65342000,9936000,75278000
Katar,2010,5,64529000,11966000,76495000
Katar,2010,6,72225000,1188000,73413000
Katar,2010,7,151692000,26062000,177754000
Katar,2010,8,154987000,13007000,167994000
Katar,2010,9,446970000,1103000,448073000
Katar,2010,10,96589000,1665000,98254000
Katar,2010,11,118336000,2424000,120760000
Katar,2010,12,146112000,19494000,165606000
Katar,2011,1,59903000,35738000,95641000
Katar,2011,2,76910000,73661000,150571000
Katar,2011,3,145409000,111333000,256742000
Katar,2011,4,55060000,120993000,176053000
Katar,2011,5,101822000,151574000,253396000
Katar,2011,6,78702000,89260000,167962000
Katar,2011,7,83349000,51939000,135288000
Katar,2011,8,67697000,110227000,177924000
Katar,2011,9,81123000,7958000,89081000
Katar,2011,10,71329000,45412000,116741000
Katar,2011,11,84457000,56826000,141283000
Katar,2011,12,103366000,47818000,151184000
Katar,2012,1,82253000,59552000,141805000
Katar,2012,2,66142000,69676000,135818000
Katar,2012,3,102008000,63339000,165347000
Katar,2012,4,72312000,137567000,209879000
Katar,2012,5,83444000,78584000,162028000
Katar,2012,6,94950000,28195000,123145000
Katar,2012,7,160694000,113470000,274164000
Katar,2012,8,101314000,90279000,191593000
Katar,2012,9,125891000,20908000,146799000
Katar,2012,10,99215000,21406000,120621000
Katar,2012,11,89948000,2378000,92326000
Katar,2012,12,92284000,38310000,130594000
Katar,2013,1,111168000,76392000,187560000
Katar,2013,2,89136000,50735000,139871000
Katar,2013,3,101531000,71733000,173264000
Katar,2013,4,109674000,65983000,175657000
Katar,2013,5,90920000,84957000,175877000
Katar,2013,6,94079000,24442000,118521000
Katar,2013,7,122258000,131081000,253339000
Katar,2013,8,100586000,54036000,154622000
Katar,2013,9,115854000,74540000,190394000
Katar,2013,10,90251000,62269000,152520000
Katar,2013,11,127703000,74318000,202021000
Katar,2013,12,100312000,75031000,175343000
Katar,2014,1,114619000,38338000,152957000
Katar,2014,2,102499000,41738000,144237000
Katar,2014,3,115944000,50592000,166536000
Katar,2014,4,137834000,73605000,211439000
Katar,2014,5,133063000,74710000,207773000
Katar,2014,6,143142000,71467000,214609000
Katar,2014,7,143107000,76623000,219730000
Katar,2014,8,116461000,52715000,169176000
Katar,2014,9,384963000,56010000,440973000
Katar,2014,10,399271000,49579000,448850000
Katar,2014,11,151187000,60829000,212016000
Katar,2014,12,155443000,32135000,187578000
Katar,2015,1,137145000,23117000,160262000
Katar,2015,2,142151000,33905000,176056000
Katar,2015,3,175447000,21974000,197421000
Katar,2015,4,169075000,16927000,186002000
Katar,2015,5,109467000,42879000,152346000
Katar,2015,6,151202000,44740000,195942000
Katar,2015,7,168255000,44272000,212527000
Katar,2015,8,136582000,54677000,191259000
Katar,2015,9,274703000,37102000,311805000
Katar,2015,10,237164000,16618000,253782000
Katar,2015,11,156782000,29225000,186007000
Katar,2015,12,288190000,21515000,309705000
Katar,2016,1,109476000,49321000,158797000
Katar,2016,2,193687000,36029000,229716000
Katar,2016,3,273709000,29280000,302989000
Katar,2016,4,205898000,34295000,240193000
Katar,2016,5,201161000,29595000,230756000
Katar,2016,6,235740000,36000000,271740000
Katar,2016,7,214026000,28327000,242353000
Katar,2016,8,234787000,40130000,274917000
Katar,2016,9,227162000,26940000,254102000
Katar,2016,10,225719000,56040000,281759000
Katar,2016,11,227366000,23310000,250676000
Katar,2016,12,169082000,34975000,204057000
Katar,2017,1,140111000,11287000,151398000
Katar,2017,2,93084000,33658000,126742000
Katar,2017,3,169686000,34340000,204026000
Katar,2017,4,155457000,20421000,175878000
Katar,2017,5,140366000,14569000,154935000
Katar,2017,6,142543000,18983000,161526000
Katar,2017,7,151484000,96840000,248324000
Katar,2017,8,149463000,15835000,165298000
Katar,2017,9,665590000,32175000,697765000
Katar,2017,10,138344000,27496000,165840000
Katar,2017,11,129006000,30273000,159279000
Katar,2017,12,104876000,19896000,124772000
Katar,2018,1,102150000,22659000,124809000
Katar,2018,2,106984000,39215000,146199000
Katar,2018,3,112984000,14573000,127557000
Katar,2018,4,116647000,34625000,151272000
Katar,2018,5,113158000,23545000,136703000
Katar,2018,6,113398000,42548000,155946000
Katar,2018,7,126915000,13873000,140788000
Katar,2018,8,113178000,29304000,142482000
Katar,2018,9,105108000,29634000,134742000
Katar,2018,10,123554000,32234000,155788000
Katar,2018,11,107899000,29767000,137666000
Katar,2018,12,107133000,6957000,114090000
Katar,2019,1,191299000,32137000,223436000
Katar,2019,2,86972000,32944000,119916000
Katar,2019,3,121277000,10493000,131770000
Katar,2019,4,97519000,31975000,129494000
Katar,2019,5,109045000,17954000,126999000
Katar,2019,6,80669000,38403000,119072000
Katar,2019,7,129790000,15807000,145597000
Katar,2019,8,116778000,40053000,156831000
Katar,2019,9,113745000,31816000,145561000
Katar,2019,10,145848000,9883000,155731000
Katar,2019,11,135322000,24896000,160218000
Katar,2019,12,122091000,9035000,131126000
Katar,2020,1,102245000,28549000,130794000
Katar,2020,2,102071000,8010000,110081000
Katar,2020,3,103822000,440758000,544580000
Katar,2020,4,85702000,21748000,107450000
Katar,2020,5,82291000,17873000,100164000
Katar,2020,6,83348000,9078000,92426000
Katar,2020,7,491072000,9470000,500542000
Katar,2020,8,84508000,23114000,107622000
Katar,2020,9,101455000,27559000,129014000
Katar,2020,10,94530000,13942000,108472000
Katar,2020,11,90627000,30048000,120675000
Katar,2020,12,113909000,405143000,519052000
Katar,2021,1,73556000,21886000,95442000
Katar,2021,2,90482000,6754000,97236000
Katar,2021,3,105361000,35088000,140449000
Katar,2021,4,128112000,31433000,159545000
Katar,2021,5,92242000,33893000,126135000
Katar,2021,6,99512000,34956000,134468000
Katar,2021,7,110108000,48642000,158750000
Katar,2021,8,106636000,39397000,146033000
Katar,2021,9,156699000,46969000,203668000
Katar,2021,10,114839000,49877000,164716000
Katar,2021,11,131010000,47462000,178472000
Katar,2021,12,122622000,33924000,156546000
Katar,2022,1,125691000,16851000,142542000
Katar,2022,2,103668000,46112000,149780000
Katar,2022,3,129751000,44718000,174469000
Katar,2022,4,69082000,52781000,121863000
Katar,2022,5,102569000,20400000,122969000
Katar,2022,6,112988000,54348000,167336000
Katar,2022,7,119988000,60005000,179993000
Katar,2022,8,114557000,78772000,193329000
Katar,2022,9,113457000,66591000,180048000
Katar,2022,10,97443000,59136000,156579000
Katar,2022,11,150933000,73597000,224530000
Katar,2022,12,136829000,53191000,190020000
Katar,2023,1,102693000,52495000,155188000
Katar,2023,2,78795000,56703000,135498000
Katar,2023,3,122491000,49712000,172203000
Katar,2023,4,78663000,65132000,143795000
Katar,2023,5,76259000,54934000,131193000
Katar,2023,6,97540000,90819000,188359000
Katar,2023,7,104753000,15551000,120304000
Katar,2023,8,104999000,61380000,166379000
Katar,2023,9,155511000,51571000,207082000
Katar,2023,10,123835000,77374000,201209000
Katar,2023,11,104355000,50454000,154809000
Katar,2023,12,123157000,43288000,166445000
Katar,2024,1,94819000,12288000,107107000
Katar,2024,2,93159000,17177000,110336000
Katar,2024,3,113469000,112379000,225848000
Katar,2024,4,81820000,43147000,124967000
Katar,2024,5,87434000,37713000,125147000
Katar,2024,6,104807000,30249000,135056000
Katar,2024,7,116169000,30329000,146498000
Katar,2024,8,82143000,126624000,208767000
Katar,2024,9,109149000,33346000,142495000
Katar,2024,10,116063000,35057000,151120000
Katar,2024,11,114071000,32442000,146513000
Katar,2024,12,172547000,33684000,206231000
Kenia,2008,1,15520000,11382000,26902000
Kenia,2008,2,14638000,8625000,23263000
Kenia,2008,3,13388000,8170000,21558000
Kenia,2008,4,12526000,9702000,22228000
Kenia,2008,5,23427000,16150000,39577000
Kenia,2008,6,16594000,9519000,26113000
Kenia,2008,7,29670000,14496000,44166000
Kenia,2008,8,19403000,10050000,29453000
Kenia,2008,9,16819000,8634000,25453000
Kenia,2008,10,35426000,11003000,46429000
Kenia,2008,11,19849000,9470000,29319000
Kenia,2008,12,14496000,9764000,24260000
Kenia,2009,1,14508000,8894000,23402000
Kenia,2009,2,14565000,12659000,27224000
Kenia,2009,3,17231000,10488000,27719000
Kenia,2009,4,12474000,11222000,23696000
Kenia,2009,5,15868000,8835000,24703000
Kenia,2009,6,13223000,8951000,22174000
Kenia,2009,7,17732000,7205000,24937000
Kenia,2009,8,17855000,8042000,25897000
Kenia,2009,9,17380000,8515000,25895000
Kenia,2009,10,15031000,8115000,23146000
Kenia,2009,11,19021000,6768000,25789000
Kenia,2009,12,25217000,8078000,33295000
Kenia,2010,1,15309000,6658000,21967000
Kenia,2010,2,32426000,9154000,41580000
Kenia,2010,3,18800000,7190000,25990000
Kenia,2010,4,18170000,8496000,26666000
Kenia,2010,5,21145000,8299000,29444000
Kenia,2010,6,21166000,7601000,28767000
Kenia,2010,7,21651000,10143000,31794000
Kenia,2010,8,20424000,7414000,27838000
Kenia,2010,9,29763000,7739000,37502000
Kenia,2010,10,17543000,7379000,24922000
Kenia,2010,11,39769000,7800000,47569000
Kenia,2010,12,24741000,6742000,31483000
Kenia,2011,1,13452000,10304000,23756000
Kenia,2011,2,17943000,9697000,27640000
Kenia,2011,3,29672000,11274000,40946000
Kenia,2011,4,25365000,12413000,37778000
Kenia,2011,5,15728000,14704000,30432000
Kenia,2011,6,18255000,10017000,28272000
Kenia,2011,7,19309000,9100000,28409000
Kenia,2011,8,20837000,9490000,30327000
Kenia,2011,9,22690000,9403000,32093000
Kenia,2011,10,16874000,7818000,24692000
Kenia,2011,11,23734000,16196000,39930000
Kenia,2011,12,25433000,7361000,32794000
Kenia,2012,1,13798000,7734000,21532000
Kenia,2012,2,31946000,7828000,39774000
Kenia,2012,3,28265000,10423000,38688000
Kenia,2012,4,27214000,9604000,36818000
Kenia,2012,5,21383000,8383000,29766000
Kenia,2012,6,22559000,6973000,29532000
Kenia,2012,7,31838000,12814000,44652000
Kenia,2012,8,27841000,12601000,40442000
Kenia,2012,9,27535000,9331000,36866000
Kenia,2012,10,28680000,10848000,39528000
Kenia,2012,11,21007000,9594000,30601000
Kenia,2012,12,22190000,12468000,34658000
Kenia,2013,1,22848000,10124000,32972000
Kenia,2013,2,18141000,11933000,30074000
Kenia,2013,3,20839000,7330000,28169000
Kenia,2013,4,34216000,8442000,42658000
Kenia,2013,5,26795000,10040000,36835000
Kenia,2013,6,30030000,10680000,40710000
Kenia,2013,7,23926000,11920000,35846000
Kenia,2013,8,21293000,8250000,29543000
Kenia,2013,9,24989000,8947000,33936000
Kenia,2013,10,29403000,9157000,38560000
Kenia,2013,11,25878000,8635000,34513000
Kenia,2013,12,21112000,8440000,29552000
Kenia,2014,1,26641000,8381000,35022000
Kenia,2014,2,23885000,8016000,31901000
Kenia,2014,3,27739000,10454000,38193000
Kenia,2014,4,23955000,12928000,36883000
Kenia,2014,5,21951000,18139000,40090000
Kenia,2014,6,31577000,16961000,48538000
Kenia,2014,7,24529000,12641000,37170000
Kenia,2014,8,17507000,12116000,29623000
Kenia,2014,9,41536000,13356000,54892000
Kenia,2014,10,25210000,10602000,35812000
Kenia,2014,11,25575000,11039000,36614000
Kenia,2014,12,25685000,9556000,35241000
Kenia,2015,1,25445000,11905000,37350000
Kenia,2015,2,29975000,10745000,40720000
Kenia,2015,3,23831000,11977000,35808000
Kenia,2015,4,35752000,18181000,53933000
Kenia,2015,5,49452000,16880000,66332000
Kenia,2015,6,34028000,14565000,48593000
Kenia,2015,7,36721000,14480000,51201000
Kenia,2015,8,21695000,13244000,34939000
Kenia,2015,9,24835000,14313000,39148000
Kenia,2015,10,36127000,12388000,48515000
Kenia,2015,11,25542000,12832000,38374000
Kenia,2015,12,22573000,11793000,34366000
Kenia,2016,1,29175000,12764000,41939000
Kenia,2016,2,31200000,11348000,42548000
Kenia,2016,3,30204000,10639000,40843000
Kenia,2016,4,35454000,16009000,51463000
Kenia,2016,5,21859000,19615000,41474000
Kenia,2016,6,32021000,12865000,44886000
Kenia,2016,7,28022000,11586000,39608000
Kenia,2016,8,22168000,14441000,36609000
Kenia,2016,9,22962000,14945000,37907000
Kenia,2016,10,27088000,14547000,41635000
Kenia,2016,11,29614000,13804000,43418000
Kenia,2016,12,23241000,15676000,38917000
Kenia,2017,1,21251000,17158000,38409000
Kenia,2017,2,20749000,13113000,33862000
Kenia,2017,3,31890000,12054000,43944000
Kenia,2017,4,24165000,14283000,38448000
Kenia,2017,5,35983000,18398000,54381000
Kenia,2017,6,25445000,15842000,41287000
Kenia,2017,7,31569000,10468000,42037000
Kenia,2017,8,25773000,13208000,38981000
Kenia,2017,9,25685000,10778000,36463000
Kenia,2017,10,15340000,11334000,26674000
Kenia,2017,11,28129000,10349000,38478000
Kenia,2017,12,20744000,10999000,31743000
Kenia,2018,1,28142000,11421000,39563000
Kenia,2018,2,25640000,10982000,36622000
Kenia,2018,3,29576000,8824000,38400000
Kenia,2018,4,46990000,8106000,55096000
Kenia,2018,5,25400000,13425000,38825000
Kenia,2018,6,33358000,9784000,43142000
Kenia,2018,7,35233000,15585000,50818000
Kenia,2018,8,28297000,15240000,43537000
Kenia,2018,9,27067000,11229000,38296000
Kenia,2018,10,27741000,10004000,37745000
Kenia,2018,11,32592000,9874000,42466000
Kenia,2018,12,29689000,9921000,39610000
Kenia,2019,1,34583000,11740000,46323000
Kenia,2019,2,30145000,9519000,39664000
Kenia,2019,3,57225000,12080000,69305000
Kenia,2019,4,31459000,12170000,43629000
Kenia,2019,5,23101000,17718000,40819000
Kenia,2019,6,19026000,11447000,30473000
Kenia,2019,7,25420000,13745000,39165000
Kenia,2019,8,23107000,9814000,32921000
Kenia,2019,9,25971000,10465000,36436000
Kenia,2019,10,21060000,10584000,31644000
Kenia,2019,11,38412000,9983000,48395000
Kenia,2019,12,21270000,9398000,30668000
Kenia,2020,1,24449000,11972000,36421000
Kenia,2020,2,31468000,10161000,41629000
Kenia,2020,3,21181000,7789000,28970000
Kenia,2020,4,24832000,14585000,39417000
Kenia,2020,5,19710000,18056000,37766000
Kenia,2020,6,27874000,12044000,39918000
Kenia,2020,7,15167000,17217000,32384000
Kenia,2020,8,17631000,10685000,28316000
Kenia,2020,9,18628000,15898000,34526000
Kenia,2020,10,16776000,14173000,30949000
Kenia,2020,11,23198000,12091000,35289000
Kenia,2020,12,23301000,10971000,34272000
Kenia,2021,1,18259000,12647000,30906000
Kenia,2021,2,18860000,14323000,33183000
Kenia,2021,3,26388000,14767000,41155000
Kenia,2021,4,20929000,24774000,45703000
Kenia,2021,5,21348000,14476000,35824000
Kenia,2021,6,20104000,16349000,36453000
Kenia,2021,7,23292000,12915000,36207000
Kenia,2021,8,22359000,10816000,33175000
Kenia,2021,9,18597000,15413000,34010000
Kenia,2021,10,20193000,13564000,33757000
Kenia,2021,11,20674000,12070000,32744000
Kenia,2021,12,19805000,9070000,28875000
Kenia,2022,1,14306000,20959000,35265000
Kenia,2022,2,18119000,21378000,39497000
Kenia,2022,3,25083000,11389000,36472000
Kenia,2022,4,21568000,21614000,43182000
Kenia,2022,5,20616000,16231000,36847000
Kenia,2022,6,40560000,17504000,58064000
Kenia,2022,7,17843000,10329000,28172000
Kenia,2022,8,18072000,21607000,39679000
Kenia,2022,9,23310000,17105000,40415000
Kenia,2022,10,15757000,17251000,33008000
Kenia,2022,11,25740000,18188000,43928000
Kenia,2022,12,18869000,14731000,33600000
Kenia,2023,1,23907000,19365000,43272000
Kenia,2023,2,28254000,13825000,42079000
Kenia,2023,3,29945000,16447000,46392000
Kenia,2023,4,27437000,17850000,45287000
Kenia,2023,5,28600000,18215000,46815000
Kenia,2023,6,16829000,17894000,34723000
Kenia,2023,7,18546000,14942000,33488000
Kenia,2023,8,22092000,24489000,46581000
Kenia,2023,9,18488000,23338000,41826000
Kenia,2023,10,15183000,20263000,35446000
Kenia,2023,11,19351000,17492000,36843000
Kenia,2023,12,18028000,10793000,28821000
Kenia,2024,1,14104000,13182000,27286000
Kenia,2024,2,16650000,14426000,31076000
Kenia,2024,3,17474000,12436000,29910000
Kenia,2024,4,18108000,18649000,36757000
Kenia,2024,5,27508000,22068000,49576000
Kenia,2024,6,18310000,19654000,37964000
Kenia,2024,7,23521000,21020000,44541000
Kenia,2024,8,26663000,20947000,47610000
Kenia,2024,9,20267000,20070000,40337000
Kenia,2024,10,23857000,21536000,45393000
Kenia,2024,11,28516000,21823000,50339000
Kenia,2024,12,20728000,17463000,38191000
Kirgisistan (ab 05/1992),2008,1,8649000,563000,9212000
Kirgisistan (ab 05/1992),2008,2,5396000,799000,6195000
Kirgisistan (ab 05/1992),2008,3,4244000,689000,4933000
Kirgisistan (ab 05/1992),2008,4,3786000,728000,4514000
Kirgisistan (ab 05/1992),2008,5,4219000,757000,4976000
Kirgisistan (ab 05/1992),2008,6,6732000,406000,7138000
Kirgisistan (ab 05/1992),2008,7,4162000,553000,4715000
Kirgisistan (ab 05/1992),2008,8,6286000,646000,6932000
Kirgisistan (ab 05/1992),2008,9,4233000,868000,5101000
Kirgisistan (ab 05/1992),2008,10,3678000,629000,4307000
Kirgisistan (ab 05/1992),2008,11,5705000,244000,5949000
Kirgisistan (ab 05/1992),2008,12,6013000,291000,6304000
Kirgisistan (ab 05/1992),2009,1,2072000,130000,2202000
Kirgisistan (ab 05/1992),2009,2,3744000,269000,4013000
Kirgisistan (ab 05/1992),2009,3,4929000,223000,5152000
Kirgisistan (ab 05/1992),2009,4,5060000,370000,5430000
Kirgisistan (ab 05/1992),2009,5,3640000,187000,3827000
Kirgisistan (ab 05/1992),2009,6,3229000,329000,3558000
Kirgisistan (ab 05/1992),2009,7,3660000,269000,3929000
Kirgisistan (ab 05/1992),2009,8,3511000,550000,4061000
Kirgisistan (ab 05/1992),2009,9,4048000,1525000,5573000
Kirgisistan (ab 05/1992),2009,10,4193000,429000,4622000
Kirgisistan (ab 05/1992),2009,11,4327000,341000,4668000
Kirgisistan (ab 05/1992),2009,12,3106000,445000,3551000
Kirgisistan (ab 05/1992),2010,1,2207000,314000,2521000
Kirgisistan (ab 05/1992),2010,2,2740000,147000,2887000
Kirgisistan (ab 05/1992),2010,3,5203000,1599000,6802000
Kirgisistan (ab 05/1992),2010,4,2664000,465000,3129000
Kirgisistan (ab 05/1992),2010,5,2416000,269000,2685000
Kirgisistan (ab 05/1992),2010,6,3533000,332000,3865000
Kirgisistan (ab 05/1992),2010,7,2395000,300000,2695000
Kirgisistan (ab 05/1992),2010,8,3399000,392000,3791000
Kirgisistan (ab 05/1992),2010,9,3976000,561000,4537000
Kirgisistan (ab 05/1992),2010,10,3731000,1115000,4846000
Kirgisistan (ab 05/1992),2010,11,3066000,510000,3576000
Kirgisistan (ab 05/1992),2010,12,2842000,477000,3319000
Kirgisistan (ab 05/1992),2011,1,2993000,1210000,4203000
Kirgisistan (ab 05/1992),2011,2,3701000,1827000,5528000
Kirgisistan (ab 05/1992),2011,3,4909000,1722000,6631000
Kirgisistan (ab 05/1992),2011,4,2830000,1053000,3883000
Kirgisistan (ab 05/1992),2011,5,5118000,1075000,6193000
Kirgisistan (ab 05/1992),2011,6,7162000,1292000,8454000
Kirgisistan (ab 05/1992),2011,7,5766000,1503000,7269000
Kirgisistan (ab 05/1992),2011,8,5088000,697000,5785000
Kirgisistan (ab 05/1992),2011,9,5351000,645000,5996000
Kirgisistan (ab 05/1992),2011,10,6888000,817000,7705000
Kirgisistan (ab 05/1992),2011,11,8648000,677000,9325000
Kirgisistan (ab 05/1992),2011,12,8490000,540000,9030000
Kirgisistan (ab 05/1992),2012,1,5617000,870000,6487000
Kirgisistan (ab 05/1992),2012,2,10009000,973000,10982000
Kirgisistan (ab 05/1992),2012,3,7105000,1570000,8675000
Kirgisistan (ab 05/1992),2012,4,7063000,1003000,8066000
Kirgisistan (ab 05/1992),2012,5,9042000,1864000,10906000
Kirgisistan (ab 05/1992),2012,6,5359000,1496000,6855000
Kirgisistan (ab 05/1992),2012,7,8452000,1838000,10290000
Kirgisistan (ab 05/1992),2012,8,7598000,1084000,8682000
Kirgisistan (ab 05/1992),2012,9,6412000,668000,7080000
Kirgisistan (ab 05/1992),2012,10,8064000,1379000,9443000
Kirgisistan (ab 05/1992),2012,11,10642000,1640000,12282000
Kirgisistan (ab 05/1992),2012,12,12982000,859000,13841000
Kirgisistan (ab 05/1992),2013,1,6496000,1149000,7645000
Kirgisistan (ab 05/1992),2013,2,10908000,1641000,12549000
Kirgisistan (ab 05/1992),2013,3,7749000,1254000,9003000
Kirgisistan (ab 05/1992),2013,4,8288000,1662000,9950000
Kirgisistan (ab 05/1992),2013,5,5904000,1177000,7081000
Kirgisistan (ab 05/1992),2013,6,7783000,693000,8476000
Kirgisistan (ab 05/1992),2013,7,6864000,1019000,7883000
Kirgisistan (ab 05/1992),2013,8,7053000,480000,7533000
Kirgisistan (ab 05/1992),2013,9,7232000,715000,7947000
Kirgisistan (ab 05/1992),2013,10,7312000,1057000,8369000
Kirgisistan (ab 05/1992),2013,11,6903000,870000,7773000
Kirgisistan (ab 05/1992),2013,12,3861000,896000,4757000
Kirgisistan (ab 05/1992),2014,1,3621000,754000,4375000
Kirgisistan (ab 05/1992),2014,2,6942000,527000,7469000
Kirgisistan (ab 05/1992),2014,3,6374000,999000,7373000
Kirgisistan (ab 05/1992),2014,4,6364000,1696000,8060000
Kirgisistan (ab 05/1992),2014,5,7819000,1079000,8898000
Kirgisistan (ab 05/1992),2014,6,7035000,1262000,8297000
Kirgisistan (ab 05/1992),2014,7,7138000,1750000,8888000
Kirgisistan (ab 05/1992),2014,8,6066000,978000,7044000
Kirgisistan (ab 05/1992),2014,9,8820000,550000,9370000
Kirgisistan (ab 05/1992),2014,10,7829000,1185000,9014000
Kirgisistan (ab 05/1992),2014,11,7196000,836000,8032000
Kirgisistan (ab 05/1992),2014,12,6254000,880000,7134000
Kirgisistan (ab 05/1992),2015,1,3328000,997000,4325000
Kirgisistan (ab 05/1992),2015,2,5479000,1033000,6512000
Kirgisistan (ab 05/1992),2015,3,7690000,1128000,8818000
Kirgisistan (ab 05/1992),2015,4,6352000,883000,7235000
Kirgisistan (ab 05/1992),2015,5,3815000,943000,4758000
Kirgisistan (ab 05/1992),2015,6,3732000,1148000,4880000
Kirgisistan (ab 05/1992),2015,7,5379000,1025000,6404000
Kirgisistan (ab 05/1992),2015,8,2842000,1507000,4349000
Kirgisistan (ab 05/1992),2015,9,3057000,700000,3757000
Kirgisistan (ab 05/1992),2015,10,3312000,1146000,4458000
Kirgisistan (ab 05/1992),2015,11,3095000,1586000,4681000
Kirgisistan (ab 05/1992),2015,12,2771000,831000,3602000
Kirgisistan (ab 05/1992),2016,1,2191000,1187000,3378000
Kirgisistan (ab 05/1992),2016,2,3517000,1198000,4715000
Kirgisistan (ab 05/1992),2016,3,3524000,837000,4361000
Kirgisistan (ab 05/1992),2016,4,5646000,1017000,6663000
Kirgisistan (ab 05/1992),2016,5,5801000,4125000,9926000
Kirgisistan (ab 05/1992),2016,6,6427000,1028000,7455000
Kirgisistan (ab 05/1992),2016,7,3913000,1266000,5179000
Kirgisistan (ab 05/1992),2016,8,4217000,851000,5068000
Kirgisistan (ab 05/1992),2016,9,2819000,827000,3646000
Kirgisistan (ab 05/1992),2016,10,3608000,1058000,4666000
Kirgisistan (ab 05/1992),2016,11,3522000,1092000,4614000
Kirgisistan (ab 05/1992),2016,12,3319000,955000,4274000
Kirgisistan (ab 05/1992),2017,1,2375000,1303000,3678000
Kirgisistan (ab 05/1992),2017,2,4390000,1033000,5423000
Kirgisistan (ab 05/1992),2017,3,5603000,1959000,7562000
Kirgisistan (ab 05/1992),2017,4,4435000,658000,5093000
Kirgisistan (ab 05/1992),2017,5,5571000,1255000,6826000
Kirgisistan (ab 05/1992),2017,6,5507000,1056000,6563000
Kirgisistan (ab 05/1992),2017,7,4102000,819000,4921000
Kirgisistan (ab 05/1992),2017,8,4094000,858000,4952000
Kirgisistan (ab 05/1992),2017,9,6627000,811000,7438000
Kirgisistan (ab 05/1992),2017,10,8585000,1308000,9893000
Kirgisistan (ab 05/1992),2017,11,7053000,1452000,8505000
Kirgisistan (ab 05/1992),2017,12,3670000,1437000,5107000
Kirgisistan (ab 05/1992),2018,1,4241000,1015000,5256000
Kirgisistan (ab 05/1992),2018,2,5616000,1384000,7000000
Kirgisistan (ab 05/1992),2018,3,5922000,1173000,7095000
Kirgisistan (ab 05/1992),2018,4,5357000,1024000,6381000
Kirgisistan (ab 05/1992),2018,5,5934000,677000,6611000
Kirgisistan (ab 05/1992),2018,6,4272000,926000,5198000
Kirgisistan (ab 05/1992),2018,7,4354000,541000,4895000
Kirgisistan (ab 05/1992),2018,8,3592000,1018000,4610000
Kirgisistan (ab 05/1992),2018,9,5020000,1321000,6341000
Kirgisistan (ab 05/1992),2018,10,6872000,1904000,8776000
Kirgisistan (ab 05/1992),2018,11,4447000,1309000,5756000
Kirgisistan (ab 05/1992),2018,12,4126000,1383000,5509000
Kirgisistan (ab 05/1992),2019,1,3183000,1015000,4198000
Kirgisistan (ab 05/1992),2019,2,5482000,1267000,6749000
Kirgisistan (ab 05/1992),2019,3,4401000,1855000,6256000
Kirgisistan (ab 05/1992),2019,4,5190000,1711000,6901000
Kirgisistan (ab 05/1992),2019,5,3238000,1364000,4602000
Kirgisistan (ab 05/1992),2019,6,3217000,815000,4032000
Kirgisistan (ab 05/1992),2019,7,4636000,3004000,7640000
Kirgisistan (ab 05/1992),2019,8,4164000,1748000,5912000
Kirgisistan (ab 05/1992),2019,9,5833000,550000,6383000
Kirgisistan (ab 05/1992),2019,10,4903000,1117000,6020000
Kirgisistan (ab 05/1992),2019,11,7174000,2152000,9326000
Kirgisistan (ab 05/1992),2019,12,5050000,1024000,6074000
Kirgisistan (ab 05/1992),2020,1,3694000,1082000,4776000
Kirgisistan (ab 05/1992),2020,2,3714000,599000,4313000
Kirgisistan (ab 05/1992),2020,3,4155000,1167000,5322000
Kirgisistan (ab 05/1992),2020,4,2175000,1026000,3201000
Kirgisistan (ab 05/1992),2020,5,3112000,1190000,4302000
Kirgisistan (ab 05/1992),2020,6,3848000,1059000,4907000
Kirgisistan (ab 05/1992),2020,7,2649000,1336000,3985000
Kirgisistan (ab 05/1992),2020,8,2876000,1073000,3949000
Kirgisistan (ab 05/1992),2020,9,3060000,2815000,5875000
Kirgisistan (ab 05/1992),2020,10,3752000,1492000,5244000
Kirgisistan (ab 05/1992),2020,11,4253000,2610000,6863000
Kirgisistan (ab 05/1992),2020,12,2687000,3117000,5804000
Kirgisistan (ab 05/1992),2021,1,2448000,1698000,4146000
Kirgisistan (ab 05/1992),2021,2,3655000,2313000,5968000
Kirgisistan (ab 05/1992),2021,3,4425000,903000,5328000
Kirgisistan (ab 05/1992),2021,4,4518000,2479000,6997000
Kirgisistan (ab 05/1992),2021,5,3332000,758000,4090000
Kirgisistan (ab 05/1992),2021,6,3867000,2071000,5938000
Kirgisistan (ab 05/1992),2021,7,4893000,1716000,6609000
Kirgisistan (ab 05/1992),2021,8,3715000,1380000,5095000
Kirgisistan (ab 05/1992),2021,9,4005000,1094000,5099000
Kirgisistan (ab 05/1992),2021,10,3850000,998000,4848000
Kirgisistan (ab 05/1992),2021,11,5653000,840000,6493000
Kirgisistan (ab 05/1992),2021,12,4458000,3561000,8019000
Kirgisistan (ab 05/1992),2022,1,4056000,881000,4937000
Kirgisistan (ab 05/1992),2022,2,5159000,4936000,10095000
Kirgisistan (ab 05/1992),2022,3,7107000,2467000,9574000
Kirgisistan (ab 05/1992),2022,4,6891000,2164000,9055000
Kirgisistan (ab 05/1992),2022,5,8528000,2260000,10788000
Kirgisistan (ab 05/1992),2022,6,15687000,1914000,17601000
Kirgisistan (ab 05/1992),2022,7,29632000,2220000,31852000
Kirgisistan (ab 05/1992),2022,8,37569000,3887000,41456000
Kirgisistan (ab 05/1992),2022,9,53150000,1885000,55035000
Kirgisistan (ab 05/1992),2022,10,43194000,2496000,45690000
Kirgisistan (ab 05/1992),2022,11,57968000,3261000,61229000
Kirgisistan (ab 05/1992),2022,12,54286000,2265000,56551000
Kirgisistan (ab 05/1992),2023,1,42407000,1975000,44382000
Kirgisistan (ab 05/1992),2023,2,58762000,1314000,60076000
Kirgisistan (ab 05/1992),2023,3,69044000,1228000,70272000
Kirgisistan (ab 05/1992),2023,4,60200000,1735000,61935000
Kirgisistan (ab 05/1992),2023,5,67968000,3052000,71020000
Kirgisistan (ab 05/1992),2023,6,72578000,2040000,74618000
Kirgisistan (ab 05/1992),2023,7,53849000,1402000,55251000
Kirgisistan (ab 05/1992),2023,8,55843000,1214000,57057000
Kirgisistan (ab 05/1992),2023,9,53898000,1228000,55126000
Kirgisistan (ab 05/1992),2023,10,55149000,2051000,57200000
Kirgisistan (ab 05/1992),2023,11,62966000,1061000,64027000
Kirgisistan (ab 05/1992),2023,12,60754000,1489000,62243000
Kirgisistan (ab 05/1992),2024,1,43798000,1608000,45406000
Kirgisistan (ab 05/1992),2024,2,75689000,1558000,77247000
Kirgisistan (ab 05/1992),2024,3,67126000,1320000,68446000
Kirgisistan (ab 05/1992),2024,4,62302000,1418000,63720000
Kirgisistan (ab 05/1992),2024,5,60641000,1482000,62123000
Kirgisistan (ab 05/1992),2024,6,61986000,1337000,63323000
Kirgisistan (ab 05/1992),2024,7,64165000,1868000,66033000
Kirgisistan (ab 05/1992),2024,8,56685000,850000,57535000
Kirgisistan (ab 05/1992),2024,9,61825000,1160000,62985000
Kirgisistan (ab 05/1992),2024,10,55107000,1289000,56396000
Kirgisistan (ab 05/1992),2024,11,45626000,1595000,47221000
Kirgisistan (ab 05/1992),2024,12,37024000,1137000,38161000
Kiribati,2008,1,0,0,0
Kiribati,2008,2,86000,0,86000
Kiribati,2008,3,4000,12000,16000
Kiribati,2008,4,13000,0,13000
Kiribati,2008,5,0,5000,5000
Kiribati,2008,6,10000,0,10000
Kiribati,2008,7,19000,4000,23000
Kiribati,2008,8,4000,0,4000
Kiribati,2008,9,17000,0,17000
Kiribati,2008,10,39000,0,39000
Kiribati,2008,11,0,0,0
Kiribati,2008,12,16000,0,16000
Kiribati,2009,1,16000,0,16000
Kiribati,2009,2,2000,0,2000
Kiribati,2009,3,30000,4000,34000
Kiribati,2009,4,47000,0,47000
Kiribati,2009,5,15000,0,15000
Kiribati,2009,6,35000,4000,39000
Kiribati,2009,7,1000,0,1000
Kiribati,2009,8,2000,0,2000
Kiribati,2009,9,0,0,0
Kiribati,2009,10,43000,0,43000
Kiribati,2009,11,11000,0,11000
Kiribati,2009,12,0,6000,6000
Kiribati,2010,1,4000,0,4000
Kiribati,2010,2,0,0,0
Kiribati,2010,3,0,0,0
Kiribati,2010,4,3000,0,3000
Kiribati,2010,5,0,0,0
Kiribati,2010,6,0,0,0
Kiribati,2010,7,0,0,0
Kiribati,2010,8,0,3000,3000
Kiribati,2010,9,0,7000,7000
Kiribati,2010,10,0,0,0
Kiribati,2010,11,8000,0,8000
Kiribati,2010,12,0,0,0
Kiribati,2011,1,0,0,0
Kiribati,2011,2,0,10000,10000
Kiribati,2011,3,50000,1000,51000
Kiribati,2011,4,0,0,0
Kiribati,2011,5,0,0,0
Kiribati,2011,6,0,0,0
Kiribati,2011,7,0,13000,13000
Kiribati,2011,8,0,0,0
Kiribati,2011,9,4000,1000,5000
Kiribati,2011,10,0,13000,13000
Kiribati,2011,11,6000,1000,7000
Kiribati,2011,12,12000,1000,13000
Kiribati,2012,1,0,1000,1000
Kiribati,2012,2,0,11000,11000
Kiribati,2012,3,6000,0,6000
Kiribati,2012,4,0,4000,4000
Kiribati,2012,5,0,0,0
Kiribati,2012,6,2000,0,2000
Kiribati,2012,7,0,0,0
Kiribati,2012,8,20000,7000,27000
Kiribati,2012,9,0,0,0
Kiribati,2012,10,0,0,0
Kiribati,2012,11,0,0,0
Kiribati,2012,12,6000,1000,7000
Kiribati,2013,1,0,0,0
Kiribati,2013,2,29000,0,29000
Kiribati,2013,3,42000,0,42000
Kiribati,2013,4,0,4000,4000
Kiribati,2013,5,0,0,0
Kiribati,2013,6,8000,0,8000
Kiribati,2013,7,1000,1000,2000
Kiribati,2013,8,0,0,0
Kiribati,2013,9,0,5000,5000
Kiribati,2013,10,17000,0,17000
Kiribati,2013,11,0,0,0
Kiribati,2013,12,9000,6000,15000
Kiribati,2014,1,0,9000,9000
Kiribati,2014,2,1000,0,1000
Kiribati,2014,3,14000,0,14000
Kiribati,2014,4,0,0,0
Kiribati,2014,5,3000,0,3000
Kiribati,2014,6,0,0,0
Kiribati,2014,7,0,0,0
Kiribati,2014,8,3000,0,3000
Kiribati,2014,9,0,0,0
Kiribati,2014,10,0,0,0
Kiribati,2014,11,7000,0,7000
Kiribati,2014,12,1000,0,1000
Kiribati,2015,1,0,0,0
Kiribati,2015,2,0,0,0
Kiribati,2015,3,0,0,0
Kiribati,2015,4,19000,0,19000
Kiribati,2015,5,24000,0,24000
Kiribati,2015,6,0,5000,5000
Kiribati,2015,7,2000,2000,4000
Kiribati,2015,8,0,3000,3000
Kiribati,2015,9,0,5000,5000
Kiribati,2015,10,6000,3000,9000
Kiribati,2015,11,22000,5000,27000
Kiribati,2015,12,18000,5000,23000
Kiribati,2016,1,3000,1000,4000
Kiribati,2016,2,1000,1000,2000
Kiribati,2016,3,2000,6000,8000
Kiribati,2016,4,0,0,0
Kiribati,2016,5,0,8000,8000
Kiribati,2016,6,0,7000,7000
Kiribati,2016,7,36000,5000,41000
Kiribati,2016,8,0,0,0
Kiribati,2016,9,0,8000,8000
Kiribati,2016,10,8000,4000,12000
Kiribati,2016,11,0,5000,5000
Kiribati,2016,12,0,9000,9000
Kiribati,2017,1,1000,0,1000
Kiribati,2017,2,0,7000,7000
Kiribati,2017,3,28000,5000,33000
Kiribati,2017,4,0,5000,5000
Kiribati,2017,5,26000,3000,29000
Kiribati,2017,6,0,5000,5000
Kiribati,2017,7,0,4000,4000
Kiribati,2017,8,0,2000,2000
Kiribati,2017,9,0,7000,7000
Kiribati,2017,10,2000,3000,5000
Kiribati,2017,11,3000,7000,10000
Kiribati,2017,12,0,0,0
Kiribati,2018,1,0,5000,5000
Kiribati,2018,2,3000,6000,9000
Kiribati,2018,3,0,0,0
Kiribati,2018,4,0,2000,2000
Kiribati,2018,5,0,4000,4000
Kiribati,2018,6,0,0,0
Kiribati,2018,7,7000,0,7000
Kiribati,2018,8,0,2000,2000
Kiribati,2018,9,0,1000,1000
Kiribati,2018,10,0,1000,1000
Kiribati,2018,11,0,2000,2000
Kiribati,2018,12,3000,0,3000
Kiribati,2019,1,6000,3000,9000
Kiribati,2019,2,1000,0,1000
Kiribati,2019,3,0,0,0
Kiribati,2019,4,3000,0,3000
Kiribati,2019,5,3000,2000,5000
Kiribati,2019,6,0,2000,2000
Kiribati,2019,7,0,16000,16000
Kiribati,2019,8,0,0,0
Kiribati,2019,9,0,6000,6000
Kiribati,2019,10,5000,11000,16000
Kiribati,2019,11,0,15000,15000
Kiribati,2019,12,15000,5000,20000
Kiribati,2020,1,43000,5000,48000
Kiribati,2020,2,0,0,0
Kiribati,2020,3,0,0,0
Kiribati,2020,4,0,157000,157000
Kiribati,2020,5,0,0,0
Kiribati,2020,6,0,0,0
Kiribati,2020,7,0,0,0
Kiribati,2020,8,0,0,0
Kiribati,2020,9,0,9000,9000
Kiribati,2020,10,0,0,0
Kiribati,2020,11,4000,0,4000
Kiribati,2020,12,2000,0,2000
Kiribati,2021,1,0,0,0
Kiribati,2021,2,0,0,0
Kiribati,2021,3,29000,0,29000
Kiribati,2021,4,178000,0,178000
Kiribati,2021,5,0,0,0
Kiribati,2021,6,72000,0,72000
Kiribati,2021,7,0,0,0
Kiribati,2021,8,21000,0,21000
Kiribati,2021,9,0,0,0
Kiribati,2021,10,40000,0,40000
Kiribati,2021,11,0,0,0
Kiribati,2021,12,0,0,0
Kiribati,2022,1,0,5000,5000
Kiribati,2022,2,0,0,0
Kiribati,2022,3,0,0,0
Kiribati,2022,4,0,0,0
Kiribati,2022,5,1000,0,1000
Kiribati,2022,6,13000,0,13000
Kiribati,2022,7,3000,0,3000
Kiribati,2022,8,49000,0,49000
Kiribati,2022,9,245000,0,245000
Kiribati,2022,10,16000,0,16000
Kiribati,2022,11,0,0,0
Kiribati,2022,12,0,0,0
Kiribati,2023,1,0,0,0
Kiribati,2023,2,100000,0,100000
Kiribati,2023,3,0,0,0
Kiribati,2023,4,0,0,0
Kiribati,2023,5,0,2000,2000
Kiribati,2023,6,5000,0,5000
Kiribati,2023,7,0,0,0
Kiribati,2023,8,0,0,0
Kiribati,2023,9,0,0,0
Kiribati,2023,10,0,0,0
Kiribati,2023,11,0,0,0
Kiribati,2023,12,0,0,0
Kiribati,2024,1,0,0,0
Kiribati,2024,2,0,0,0
Kiribati,2024,3,0,0,0
Kiribati,2024,4,63000,0,63000
Kiribati,2024,5,0,0,0
Kiribati,2024,6,0,0,0
Kiribati,2024,7,0,0,0
Kiribati,2024,8,0,0,0
Kiribati,2024,9,0,0,0
Kiribati,2024,10,48000,0,48000
Kiribati,2024,11,41000,0,41000
Kiribati,2024,12,3000,0,3000
Kokosinseln (Keelinginseln) (ab 2001),2008,1,92000,0,92000
Kokosinseln (Keelinginseln) (ab 2001),2008,2,46000,2000,48000
Kokosinseln (Keelinginseln) (ab 2001),2008,3,33000,0,33000
Kokosinseln (Keelinginseln) (ab 2001),2008,4,46000,0,46000
Kokosinseln (Keelinginseln) (ab 2001),2008,5,13000,0,13000
Kokosinseln (Keelinginseln) (ab 2001),2008,6,7000,0,7000
Kokosinseln (Keelinginseln) (ab 2001),2008,7,29000,0,29000
Kokosinseln (Keelinginseln) (ab 2001),2008,8,0,4000,4000
Kokosinseln (Keelinginseln) (ab 2001),2008,9,5000,0,5000
Kokosinseln (Keelinginseln) (ab 2001),2008,10,0,0,0
Kokosinseln (Keelinginseln) (ab 2001),2008,11,2000,0,2000
Kokosinseln (Keelinginseln) (ab 2001),2008,12,13000,16000,29000
Kokosinseln (Keelinginseln) (ab 2001),2009,1,7000,2000,9000
Kokosinseln (Keelinginseln) (ab 2001),2009,2,31000,0,31000
Kokosinseln (Keelinginseln) (ab 2001),2009,3,56000,0,56000
Kokosinseln (Keelinginseln) (ab 2001),2009,4,23000,0,23000
Kokosinseln (Keelinginseln) (ab 2001),2009,5,73000,0,73000
Kokosinseln (Keelinginseln) (ab 2001),2009,6,72000,0,72000
Kokosinseln (Keelinginseln) (ab 2001),2009,7,2000,0,2000
Kokosinseln (Keelinginseln) (ab 2001),2009,8,3000,0,3000
Kokosinseln (Keelinginseln) (ab 2001),2009,9,0,0,0
Kokosinseln (Keelinginseln) (ab 2001),2009,10,0,0,0
Kokosinseln (Keelinginseln) (ab 2001),2009,11,0,0,0
Kokosinseln (Keelinginseln) (ab 2001),2009,12,0,0,0
Kokosinseln (Keelinginseln) (ab 2001),2010,1,0,0,0
Kokosinseln (Keelinginseln) (ab 2001),2010,2,1000,0,1000
Kokosinseln (Keelinginseln) (ab 2001),2010,3,0,0,0
Kokosinseln (Keelinginseln) (ab 2001),2010,4,0,0,0
Kokosinseln (Keelinginseln) (ab 2001),2010,5,0,0,0
Kokosinseln (Keelinginseln) (ab 2001),2010,6,0,0,0
Kokosinseln (Keelinginseln) (ab 2001),2010,7,0,0,0
Kokosinseln (Keelinginseln) (ab 2001),2010,8,0,0,0
Kokosinseln (Keelinginseln) (ab 2001),2010,9,0,0,0
Kokosinseln (Keelinginseln) (ab 2001),2010,10,0,0,0
Kokosinseln (Keelinginseln) (ab 2001),2010,11,0,0,0
Kokosinseln (Keelinginseln) (ab 2001),2010,12,0,0,0
Kokosinseln (Keelinginseln) (ab 2001),2011,1,0,0,0
Kokosinseln (Keelinginseln) (ab 2001),2011,2,0,0,0
Kokosinseln (Keelinginseln) (ab 2001),2011,3,0,0,0
Kokosinseln (Keelinginseln) (ab 2001),2011,4,0,0,0
Kokosinseln (Keelinginseln) (ab 2001),2011,5,0,0,0
Kokosinseln (Keelinginseln) (ab 2001),2011,6,0,0,0
Kokosinseln (Keelinginseln) (ab 2001),2011,7,0,0,0
Kokosinseln (Keelinginseln) (ab 2001),2011,8,0,0,0
Kokosinseln (Keelinginseln) (ab 2001),2011,9,0,0,0
Kokosinseln (Keelinginseln) (ab 2001),2011,10,0,0,0
Kokosinseln (Keelinginseln) (ab 2001),2011,11,0,0,0
Kokosinseln (Keelinginseln) (ab 2001),2011,12,0,0,0
Kokosinseln (Keelinginseln) (ab 2001),2012,1,0,0,0
Kokosinseln (Keelinginseln) (ab 2001),2012,2,0,0,0
Kokosinseln (Keelinginseln) (ab 2001),2012,3,0,0,0
Kokosinseln (Keelinginseln) (ab 2001),2012,4,0,0,0
Kokosinseln (Keelinginseln) (ab 2001),2012,5,0,0,0
Kokosinseln (Keelinginseln) (ab 2001),2012,6,0,0,0
Kokosinseln (Keelinginseln) (ab 2001),2012,7,0,0,0
Kokosinseln (Keelinginseln) (ab 2001),2012,8,0,0,0
Kokosinseln (Keelinginseln) (ab 2001),2012,9,0,0,0
Kokosinseln (Keelinginseln) (ab 2001),2012,10,0,0,0
Kokosinseln (Keelinginseln) (ab 2001),2012,11,0,0,0
Kokosinseln (Keelinginseln) (ab 2001),2012,12,0,0,0
Kokosinseln (Keelinginseln) (ab 2001),2013,1,0,0,0
Kokosinseln (Keelinginseln) (ab 2001),2013,2,0,0,0
Kokosinseln (Keelinginseln) (ab 2001),2013,3,0,0,0
Kokosinseln (Keelinginseln) (ab 2001),2013,4,0,0,0
Kokosinseln (Keelinginseln) (ab 2001),2013,5,0,0,0
Kokosinseln (Keelinginseln) (ab 2001),2013,6,0,0,0
Kokosinseln (Keelinginseln) (ab 2001),2013,7,0,0,0
Kokosinseln (Keelinginseln) (ab 2001),2013,8,0,0,0
Kokosinseln (Keelinginseln) (ab 2001),2013,9,0,0,0
Kokosinseln (Keelinginseln) (ab 2001),2013,10,0,0,0
Kokosinseln (Keelinginseln) (ab 2001),2013,11,0,0,0
Kokosinseln (Keelinginseln) (ab 2001),2013,12,0,0,0
Kokosinseln (Keelinginseln) (ab 2001),2014,1,0,0,0
Kokosinseln (Keelinginseln) (ab 2001),2014,2,0,0,0
Kokosinseln (Keelinginseln) (ab 2001),2014,3,0,0,0
Kokosinseln (Keelinginseln) (ab 2001),2014,4,0,0,0
Kokosinseln (Keelinginseln) (ab 2001),2014,5,0,0,0
Kokosinseln (Keelinginseln) (ab 2001),2014,6,0,0,0
Kokosinseln (Keelinginseln) (ab 2001),2014,7,0,0,0
Kokosinseln (Keelinginseln) (ab 2001),2014,8,0,0,0
Kokosinseln (Keelinginseln) (ab 2001),2014,9,0,0,0
Kokosinseln (Keelinginseln) (ab 2001),2014,10,0,0,0
Kokosinseln (Keelinginseln) (ab 2001),2014,11,0,0,0
Kokosinseln (Keelinginseln) (ab 2001),2014,12,0,0,0
Kokosinseln (Keelinginseln) (ab 2001),2015,1,0,0,0
Kokosinseln (Keelinginseln) (ab 2001),2015,2,0,0,0
Kokosinseln (Keelinginseln) (ab 2001),2015,3,0,0,0
Kokosinseln (Keelinginseln) (ab 2001),2015,4,0,0,0
Kokosinseln (Keelinginseln) (ab 2001),2015,5,0,0,0
Kokosinseln (Keelinginseln) (ab 2001),2015,6,0,0,0
Kokosinseln (Keelinginseln) (ab 2001),2015,7,0,0,0
Kokosinseln (Keelinginseln) (ab 2001),2015,8,0,0,0
Kokosinseln (Keelinginseln) (ab 2001),2015,9,0,0,0
Kokosinseln (Keelinginseln) (ab 2001),2015,10,0,0,0
Kokosinseln (Keelinginseln) (ab 2001),2015,11,0,0,0
Kokosinseln (Keelinginseln) (ab 2001),2015,12,0,0,0
Kokosinseln (Keelinginseln) (ab 2001),2016,1,0,0,0
Kokosinseln (Keelinginseln) (ab 2001),2016,2,0,0,0
Kokosinseln (Keelinginseln) (ab 2001),2016,3,0,0,0
Kokosinseln (Keelinginseln) (ab 2001),2016,4,0,0,0
Kokosinseln (Keelinginseln) (ab 2001),2016,5,0,0,0
Kokosinseln (Keelinginseln) (ab 2001),2016,6,0,0,0
Kokosinseln (Keelinginseln) (ab 2001),2016,7,0,0,0
Kokosinseln (Keelinginseln) (ab 2001),2016,8,0,16000,16000
Kokosinseln (Keelinginseln) (ab 2001),2016,9,0,0,0
Kokosinseln (Keelinginseln) (ab 2001),2016,10,0,1000,1000
Kokosinseln (Keelinginseln) (ab 2001),2016,11,2000,15000,17000
Kokosinseln (Keelinginseln) (ab 2001),2016,12,0,9000,9000
Kokosinseln (Keelinginseln) (ab 2001),2017,1,0,0,0
Kokosinseln (Keelinginseln) (ab 2001),2017,2,0,0,0
Kokosinseln (Keelinginseln) (ab 2001),2017,3,0,0,0
Kokosinseln (Keelinginseln) (ab 2001),2017,4,0,0,0
Kokosinseln (Keelinginseln) (ab 2001),2017,5,0,0,0
Kokosinseln (Keelinginseln) (ab 2001),2017,6,0,0,0
Kokosinseln (Keelinginseln) (ab 2001),2017,7,0,0,0
Kokosinseln (Keelinginseln) (ab 2001),2017,8,0,0,0
Kokosinseln (Keelinginseln) (ab 2001),2017,9,0,0,0
Kokosinseln (Keelinginseln) (ab 2001),2017,10,0,0,0
Kokosinseln (Keelinginseln) (ab 2001),2017,11,0,0,0
Kokosinseln (Keelinginseln) (ab 2001),2017,12,0,0,0
Kokosinseln (Keelinginseln) (ab 2001),2018,1,0,0,0
Kokosinseln (Keelinginseln) (ab 2001),2018,2,0,0,0
Kokosinseln (Keelinginseln) (ab 2001),2018,3,0,9000,9000
Kokosinseln (Keelinginseln) (ab 2001),2018,4,0,0,0
Kokosinseln (Keelinginseln) (ab 2001),2018,5,0,0,0
Kokosinseln (Keelinginseln) (ab 2001),2018,6,0,18000,18000
Kokosinseln (Keelinginseln) (ab 2001),2018,7,0,0,0
Kokosinseln (Keelinginseln) (ab 2001),2018,8,0,0,0
Kokosinseln (Keelinginseln) (ab 2001),2018,9,0,0,0
Kokosinseln (Keelinginseln) (ab 2001),2018,10,0,0,0
Kokosinseln (Keelinginseln) (ab 2001),2018,11,0,0,0
Kokosinseln (Keelinginseln) (ab 2001),2018,12,0,0,0
Kokosinseln (Keelinginseln) (ab 2001),2019,1,0,0,0
Kokosinseln (Keelinginseln) (ab 2001),2019,2,141000,0,141000
Kokosinseln (Keelinginseln) (ab 2001),2019,3,0,0,0
Kokosinseln (Keelinginseln) (ab 2001),2019,4,0,0,0
Kokosinseln (Keelinginseln) (ab 2001),2019,5,0,0,0
Kokosinseln (Keelinginseln) (ab 2001),2019,6,0,0,0
Kokosinseln (Keelinginseln) (ab 2001),2019,7,0,0,0
Kokosinseln (Keelinginseln) (ab 2001),2019,8,0,0,0
Kokosinseln (Keelinginseln) (ab 2001),2019,9,0,0,0
Kokosinseln (Keelinginseln) (ab 2001),2019,10,0,0,0
Kokosinseln (Keelinginseln) (ab 2001),2019,11,0,0,0
Kokosinseln (Keelinginseln) (ab 2001),2019,12,0,0,0
Kokosinseln (Keelinginseln) (ab 2001),2020,1,1000,0,1000
Kokosinseln (Keelinginseln) (ab 2001),2020,2,0,0,0
Kokosinseln (Keelinginseln) (ab 2001),2020,3,0,0,0
Kokosinseln (Keelinginseln) (ab 2001),2020,4,0,0,0
Kokosinseln (Keelinginseln) (ab 2001),2020,5,0,0,0
Kokosinseln (Keelinginseln) (ab 2001),2020,6,0,0,0
Kokosinseln (Keelinginseln) (ab 2001),2020,7,0,0,0
Kokosinseln (Keelinginseln) (ab 2001),2020,8,0,0,0
Kokosinseln (Keelinginseln) (ab 2001),2020,9,0,0,0
Kokosinseln (Keelinginseln) (ab 2001),2020,10,0,0,0
Kokosinseln (Keelinginseln) (ab 2001),2020,11,0,0,0
Kokosinseln (Keelinginseln) (ab 2001),2020,12,0,44000,44000
Kokosinseln (Keelinginseln) (ab 2001),2021,1,0,0,0
Kokosinseln (Keelinginseln) (ab 2001),2021,2,0,0,0
Kokosinseln (Keelinginseln) (ab 2001),2021,3,0,0,0
Kokosinseln (Keelinginseln) (ab 2001),2021,4,0,0,0
Kokosinseln (Keelinginseln) (ab 2001),2021,5,0,58000,58000
Kokosinseln (Keelinginseln) (ab 2001),2021,6,0,0,0
Kokosinseln (Keelinginseln) (ab 2001),2021,7,0,34000,34000
Kokosinseln (Keelinginseln) (ab 2001),2021,8,0,10000,10000
Kokosinseln (Keelinginseln) (ab 2001),2021,9,0,0,0
Kokosinseln (Keelinginseln) (ab 2001),2021,10,0,0,0
Kokosinseln (Keelinginseln) (ab 2001),2021,11,0,0,0
Kokosinseln (Keelinginseln) (ab 2001),2021,12,0,0,0
Kokosinseln (Keelinginseln) (ab 2001),2022,1,0,1000,1000
Kokosinseln (Keelinginseln) (ab 2001),2022,2,0,0,0
Kokosinseln (Keelinginseln) (ab 2001),2022,3,0,0,0
Kokosinseln (Keelinginseln) (ab 2001),2022,4,0,0,0
Kokosinseln (Keelinginseln) (ab 2001),2022,5,0,0,0
Kokosinseln (Keelinginseln) (ab 2001),2022,6,0,0,0
Kokosinseln (Keelinginseln) (ab 2001),2022,7,0,0,0
Kokosinseln (Keelinginseln) (ab 2001),2022,8,2000,0,2000
Kokosinseln (Keelinginseln) (ab 2001),2022,9,0,0,0
Kokosinseln (Keelinginseln) (ab 2001),2022,10,0,0,0
Kokosinseln (Keelinginseln) (ab 2001),2022,11,0,0,0
Kokosinseln (Keelinginseln) (ab 2001),2022,12,0,0,0
Kokosinseln (Keelinginseln) (ab 2001),2023,1,0,0,0
Kokosinseln (Keelinginseln) (ab 2001),2023,2,0,0,0
Kokosinseln (Keelinginseln) (ab 2001),2023,3,0,8000,8000
Kokosinseln (Keelinginseln) (ab 2001),2023,4,0,0,0
Kokosinseln (Keelinginseln) (ab 2001),2023,5,0,0,0
Kokosinseln (Keelinginseln) (ab 2001),2023,6,0,0,0
Kokosinseln (Keelinginseln) (ab 2001),2023,7,0,0,0
Kokosinseln (Keelinginseln) (ab 2001),2023,8,0,0,0
Kokosinseln (Keelinginseln) (ab 2001),2023,9,0,0,0
Kokosinseln (Keelinginseln) (ab 2001),2023,10,0,8000,8000
Kokosinseln (Keelinginseln) (ab 2001),2023,11,0,0,0
Kokosinseln (Keelinginseln) (ab 2001),2023,12,0,0,0
Kokosinseln (Keelinginseln) (ab 2001),2024,1,0,4000,4000
Kokosinseln (Keelinginseln) (ab 2001),2024,2,0,2000,2000
Kokosinseln (Keelinginseln) (ab 2001),2024,3,0,0,0
Kokosinseln (Keelinginseln) (ab 2001),2024,4,0,0,0
Kokosinseln (Keelinginseln) (ab 2001),2024,5,0,0,0
Kokosinseln (Keelinginseln) (ab 2001),2024,6,0,0,0
Kokosinseln (Keelinginseln) (ab 2001),2024,7,0,0,0
Kokosinseln (Keelinginseln) (ab 2001),2024,8,0,9000,9000
Kokosinseln (Keelinginseln) (ab 2001),2024,9,0,0,0
Kokosinseln (Keelinginseln) (ab 2001),2024,10,0,0,0
Kokosinseln (Keelinginseln) (ab 2001),2024,11,0,23000,23000
Kokosinseln (Keelinginseln) (ab 2001),2024,12,0,0,0
Kolumbien,2008,1,64286000,78930000,143216000
Kolumbien,2008,2,72783000,90276000,163059000
Kolumbien,2008,3,65911000,75898000,141809000
Kolumbien,2008,4,98720000,103247000,201967000
Kolumbien,2008,5,108105000,76981000,185086000
Kolumbien,2008,6,69698000,112069000,181767000
Kolumbien,2008,7,77705000,99129000,176834000
Kolumbien,2008,8,70733000,93614000,164347000
Kolumbien,2008,9,89694000,56737000,146431000
Kolumbien,2008,10,125963000,111098000,237061000
Kolumbien,2008,11,74004000,130149000,204153000
Kolumbien,2008,12,111293000,133824000,245117000
Kolumbien,2009,1,58375000,74901000,133276000
Kolumbien,2009,2,57710000,76242000,133952000
Kolumbien,2009,3,55455000,78418000,133873000
Kolumbien,2009,4,60582000,49104000,109686000
Kolumbien,2009,5,98476000,67129000,165605000
Kolumbien,2009,6,54447000,69457000,123904000
Kolumbien,2009,7,88801000,62729000,151530000
Kolumbien,2009,8,67535000,56575000,124110000
Kolumbien,2009,9,60644000,62686000,123330000
Kolumbien,2009,10,122860000,66948000,189808000
Kolumbien,2009,11,80542000,69263000,149805000
Kolumbien,2009,12,77946000,76363000,154309000
Kolumbien,2010,1,55816000,81515000,137331000
Kolumbien,2010,2,152696000,68459000,221155000
Kolumbien,2010,3,87399000,74036000,161435000
Kolumbien,2010,4,76507000,78130000,154637000
Kolumbien,2010,5,78731000,86895000,165626000
Kolumbien,2010,6,92504000,65776000,158280000
Kolumbien,2010,7,104584000,68317000,172901000
Kolumbien,2010,8,93933000,69204000,163137000
Kolumbien,2010,9,131372000,73358000,204730000
Kolumbien,2010,10,116295000,81789000,198084000
Kolumbien,2010,11,107456000,83658000,191114000
Kolumbien,2010,12,107827000,136061000,243888000
Kolumbien,2011,1,88543000,123797000,212340000
Kolumbien,2011,2,89917000,109247000,199164000
Kolumbien,2011,3,130644000,106222000,236866000
Kolumbien,2011,4,90452000,95181000,185633000
Kolumbien,2011,5,120776000,96800000,217576000
Kolumbien,2011,6,100102000,137670000,237772000
Kolumbien,2011,7,111992000,121804000,233796000
Kolumbien,2011,8,118532000,129192000,247724000
Kolumbien,2011,9,102075000,144522000,246597000
Kolumbien,2011,10,105881000,142666000,248547000
Kolumbien,2011,11,119793000,200239000,320032000
Kolumbien,2011,12,107256000,169841000,277097000
Kolumbien,2012,1,97165000,124062000,221227000
Kolumbien,2012,2,118186000,101536000,219722000
Kolumbien,2012,3,158036000,123230000,281266000
Kolumbien,2012,4,144220000,108374000,252594000
Kolumbien,2012,5,142174000,103606000,245780000
Kolumbien,2012,6,183979000,114842000,298821000
Kolumbien,2012,7,161686000,93230000,254916000
Kolumbien,2012,8,118907000,110770000,229677000
Kolumbien,2012,9,113346000,110831000,224177000
Kolumbien,2012,10,130619000,138423000,269042000
Kolumbien,2012,11,174598000,127418000,302016000
Kolumbien,2012,12,102151000,141147000,243298000
Kolumbien,2013,1,143463000,100509000,243972000
Kolumbien,2013,2,106023000,94970000,200993000
Kolumbien,2013,3,134278000,76008000,210286000
Kolumbien,2013,4,129723000,128489000,258212000
Kolumbien,2013,5,114242000,184259000,298501000
Kolumbien,2013,6,101066000,100482000,201548000
Kolumbien,2013,7,130775000,134928000,265703000
Kolumbien,2013,8,115775000,140059000,255834000
Kolumbien,2013,9,119023000,122914000,241937000
Kolumbien,2013,10,123115000,198613000,321728000
Kolumbien,2013,11,117324000,94000000,211324000
Kolumbien,2013,12,114402000,144873000,259275000
Kolumbien,2014,1,91662000,104924000,196586000
Kolumbien,2014,2,147650000,104725000,252375000
Kolumbien,2014,3,112258000,119361000,231619000
Kolumbien,2014,4,169317000,94436000,263753000
Kolumbien,2014,5,141066000,94669000,235735000
Kolumbien,2014,6,151794000,153168000,304962000
Kolumbien,2014,7,224816000,197776000,422592000
Kolumbien,2014,8,171752000,63600000,235352000
Kolumbien,2014,9,118615000,101340000,219955000
Kolumbien,2014,10,126343000,228842000,355185000
Kolumbien,2014,11,160853000,119682000,280535000
Kolumbien,2014,12,175178000,93610000,268788000
Kolumbien,2015,1,112716000,108282000,220998000
Kolumbien,2015,2,121797000,108428000,230225000
Kolumbien,2015,3,145621000,118268000,263889000
Kolumbien,2015,4,137188000,110388000,247576000
Kolumbien,2015,5,137862000,90610000,228472000
Kolumbien,2015,6,200896000,92259000,293155000
Kolumbien,2015,7,148837000,103035000,251872000
Kolumbien,2015,8,160478000,185373000,345851000
Kolumbien,2015,9,180455000,130996000,311451000
Kolumbien,2015,10,182485000,108460000,290945000
Kolumbien,2015,11,183625000,168650000,352275000
Kolumbien,2015,12,96154000,110695000,206849000
Kolumbien,2016,1,88482000,91879000,180361000
Kolumbien,2016,2,106229000,109862000,216091000
Kolumbien,2016,3,122652000,103333000,225985000
Kolumbien,2016,4,111005000,81460000,192465000
Kolumbien,2016,5,96594000,92760000,189354000
Kolumbien,2016,6,108283000,89849000,198132000
Kolumbien,2016,7,133883000,115438000,249321000
Kolumbien,2016,8,169732000,104011000,273743000
Kolumbien,2016,9,123917000,107493000,231410000
Kolumbien,2016,10,153987000,115161000,269148000
Kolumbien,2016,11,109695000,107512000,217207000
Kolumbien,2016,12,101660000,152912000,254572000
Kolumbien,2017,1,110809000,138227000,249036000
Kolumbien,2017,2,110929000,111094000,222023000
Kolumbien,2017,3,125914000,148077000,273991000
Kolumbien,2017,4,108897000,94928000,203825000
Kolumbien,2017,5,130076000,101148000,231224000
Kolumbien,2017,6,113036000,85391000,198427000
Kolumbien,2017,7,123155000,80282000,203437000
Kolumbien,2017,8,115570000,87612000,203182000
Kolumbien,2017,9,252415000,69933000,322348000
Kolumbien,2017,10,120241000,70879000,191120000
Kolumbien,2017,11,127469000,106472000,233941000
Kolumbien,2017,12,222527000,132880000,355407000
Kolumbien,2018,1,107600000,99729000,207329000
Kolumbien,2018,2,105463000,80680000,186143000
Kolumbien,2018,3,122915000,88852000,211767000
Kolumbien,2018,4,124798000,78265000,203063000
Kolumbien,2018,5,113821000,64094000,177915000
Kolumbien,2018,6,115085000,58454000,173539000
Kolumbien,2018,7,121740000,86267000,208007000
Kolumbien,2018,8,131450000,70718000,202168000
Kolumbien,2018,9,122259000,87898000,210157000
Kolumbien,2018,10,185236000,72083000,257319000
Kolumbien,2018,11,138360000,80225000,218585000
Kolumbien,2018,12,92529000,64301000,156830000
Kolumbien,2019,1,138723000,79742000,218465000
Kolumbien,2019,2,119359000,59713000,179072000
Kolumbien,2019,3,138537000,51991000,190528000
Kolumbien,2019,4,135031000,61862000,196893000
Kolumbien,2019,5,131547000,56683000,188230000
Kolumbien,2019,6,120862000,55458000,176320000
Kolumbien,2019,7,138027000,52962000,190989000
Kolumbien,2019,8,131556000,52888000,184444000
Kolumbien,2019,9,210165000,55870000,266035000
Kolumbien,2019,10,127325000,57091000,184416000
Kolumbien,2019,11,206241000,48746000,254987000
Kolumbien,2019,12,118077000,63848000,181925000
Kolumbien,2020,1,119909000,69201000,189110000
Kolumbien,2020,2,125769000,66579000,192348000
Kolumbien,2020,3,131797000,74417000,206214000
Kolumbien,2020,4,98050000,61589000,159639000
Kolumbien,2020,5,103537000,54028000,157565000
Kolumbien,2020,6,94457000,55677000,150134000
Kolumbien,2020,7,108801000,51510000,160311000
Kolumbien,2020,8,103180000,63649000,166829000
Kolumbien,2020,9,100444000,51843000,152287000
Kolumbien,2020,10,111397000,57129000,168526000
Kolumbien,2020,11,125369000,63970000,189339000
Kolumbien,2020,12,100872000,60724000,161596000
Kolumbien,2021,1,107883000,85140000,193023000
Kolumbien,2021,2,112009000,73646000,185655000
Kolumbien,2021,3,150136000,72265000,222401000
Kolumbien,2021,4,161363000,74705000,236068000
Kolumbien,2021,5,125679000,84380000,210059000
Kolumbien,2021,6,130796000,71009000,201805000
Kolumbien,2021,7,139693000,70911000,210604000
Kolumbien,2021,8,127213000,99958000,227171000
Kolumbien,2021,9,128941000,115956000,244897000
Kolumbien,2021,10,138834000,105295000,244129000
Kolumbien,2021,11,145241000,113659000,258900000
Kolumbien,2021,12,146867000,121387000,268254000
Kolumbien,2022,1,153214000,99112000,252326000
Kolumbien,2022,2,175922000,89687000,265609000
Kolumbien,2022,3,219137000,268283000,487420000
Kolumbien,2022,4,131000000,187072000,318072000
Kolumbien,2022,5,156009000,236731000,392740000
Kolumbien,2022,6,173321000,207249000,380570000
Kolumbien,2022,7,159844000,185950000,345794000
Kolumbien,2022,8,161748000,445276000,607024000
Kolumbien,2022,9,168881000,437098000,605979000
Kolumbien,2022,10,175908000,391305000,567213000
Kolumbien,2022,11,175637000,288297000,463934000
Kolumbien,2022,12,141124000,255020000,396144000
Kolumbien,2023,1,157690000,250283000,407973000
Kolumbien,2023,2,232957000,177273000,410230000
Kolumbien,2023,3,249260000,201097000,450357000
Kolumbien,2023,4,130870000,80134000,211004000
Kolumbien,2023,5,150419000,118081000,268500000
Kolumbien,2023,6,147948000,107880000,255828000
Kolumbien,2023,7,149638000,91154000,240792000
Kolumbien,2023,8,168076000,99323000,267399000
Kolumbien,2023,9,136957000,85063000,222020000
Kolumbien,2023,10,153391000,130161000,283552000
Kolumbien,2023,11,146363000,142344000,288707000
Kolumbien,2023,12,152394000,126552000,278946000
Kolumbien,2024,1,129943000,153903000,283846000
Kolumbien,2024,2,153094000,130271000,283365000
Kolumbien,2024,3,238410000,103153000,341563000
Kolumbien,2024,4,164766000,84946000,249712000
Kolumbien,2024,5,148765000,90257000,239022000
Kolumbien,2024,6,170113000,96486000,266599000
Kolumbien,2024,7,165917000,110430000,276347000
Kolumbien,2024,8,154437000,111626000,266063000
Kolumbien,2024,9,140412000,138155000,278567000
Kolumbien,2024,10,158258000,134204000,292462000
Kolumbien,2024,11,140559000,133883000,274442000
Kolumbien,2024,12,134557000,157609000,292166000
Komoren,2008,1,21000,32000,53000
Komoren,2008,2,27000,177000,204000
Komoren,2008,3,664000,66000,730000
Komoren,2008,4,81000,4000,85000
Komoren,2008,5,1119000,129000,1248000
Komoren,2008,6,78000,45000,123000
Komoren,2008,7,44000,151000,195000
Komoren,2008,8,26000,101000,127000
Komoren,2008,9,123000,31000,154000
Komoren,2008,10,0,161000,161000
Komoren,2008,11,3000,6000,9000
Komoren,2008,12,15000,75000,90000
Komoren,2009,1,47000,81000,128000
Komoren,2009,2,89000,184000,273000
Komoren,2009,3,71000,113000,184000
Komoren,2009,4,60000,41000,101000
Komoren,2009,5,36000,10000,46000
Komoren,2009,6,3000,17000,20000
Komoren,2009,7,54000,383000,437000
Komoren,2009,8,94000,64000,158000
Komoren,2009,9,28000,61000,89000
Komoren,2009,10,24000,102000,126000
Komoren,2009,11,43000,16000,59000
Komoren,2009,12,55000,67000,122000
Komoren,2010,1,37000,48000,85000
Komoren,2010,2,52000,460000,512000
Komoren,2010,3,69000,59000,128000
Komoren,2010,4,151000,118000,269000
Komoren,2010,5,50000,74000,124000
Komoren,2010,6,135000,0,135000
Komoren,2010,7,146000,64000,210000
Komoren,2010,8,130000,381000,511000
Komoren,2010,9,140000,55000,195000
Komoren,2010,10,267000,142000,409000
Komoren,2010,11,205000,207000,412000
Komoren,2010,12,249000,94000,343000
Komoren,2011,1,48000,202000,250000
Komoren,2011,2,160000,227000,387000
Komoren,2011,3,196000,94000,290000
Komoren,2011,4,84000,138000,222000
Komoren,2011,5,26000,47000,73000
Komoren,2011,6,39000,303000,342000
Komoren,2011,7,25000,13000,38000
Komoren,2011,8,84000,8000,92000
Komoren,2011,9,59000,229000,288000
Komoren,2011,10,177000,309000,486000
Komoren,2011,11,124000,636000,760000
Komoren,2011,12,301000,164000,465000
Komoren,2012,1,163000,285000,448000
Komoren,2012,2,267000,224000,491000
Komoren,2012,3,239000,397000,636000
Komoren,2012,4,262000,266000,528000
Komoren,2012,5,374000,143000,517000
Komoren,2012,6,199000,109000,308000
Komoren,2012,7,469000,394000,863000
Komoren,2012,8,325000,111000,436000
Komoren,2012,9,155000,325000,480000
Komoren,2012,10,293000,180000,473000
Komoren,2012,11,431000,129000,560000
Komoren,2012,12,286000,261000,547000
Komoren,2013,1,124000,259000,383000
Komoren,2013,2,206000,4000,210000
Komoren,2013,3,40000,361000,401000
Komoren,2013,4,237000,503000,740000
Komoren,2013,5,302000,349000,651000
Komoren,2013,6,1264000,0,1264000
Komoren,2013,7,28000,109000,137000
Komoren,2013,8,58000,279000,337000
Komoren,2013,9,274000,712000,986000
Komoren,2013,10,175000,494000,669000
Komoren,2013,11,155000,362000,517000
Komoren,2013,12,60000,92000,152000
Komoren,2014,1,36000,531000,567000
Komoren,2014,2,119000,1064000,1183000
Komoren,2014,3,35000,15000,50000
Komoren,2014,4,38000,271000,309000
Komoren,2014,5,114000,561000,675000
Komoren,2014,6,44000,1136000,1180000
Komoren,2014,7,148000,0,148000
Komoren,2014,8,5000,128000,133000
Komoren,2014,9,30000,207000,237000
Komoren,2014,10,119000,233000,352000
Komoren,2014,11,84000,110000,194000
Komoren,2014,12,323000,710000,1033000
Komoren,2015,1,99000,877000,976000
Komoren,2015,2,63000,0,63000
Komoren,2015,3,142000,115000,257000
Komoren,2015,4,108000,854000,962000
Komoren,2015,5,103000,408000,511000
Komoren,2015,6,104000,40000,144000
Komoren,2015,7,130000,797000,927000
Komoren,2015,8,41000,58000,99000
Komoren,2015,9,207000,0,207000
Komoren,2015,10,141000,485000,626000
Komoren,2015,11,77000,322000,399000
Komoren,2015,12,84000,225000,309000
Komoren,2016,1,57000,298000,355000
Komoren,2016,2,139000,44000,183000
Komoren,2016,3,4088000,813000,4901000
Komoren,2016,4,155000,970000,1125000
Komoren,2016,5,167000,79000,246000
Komoren,2016,6,153000,298000,451000
Komoren,2016,7,157000,151000,308000
Komoren,2016,8,74000,380000,454000
Komoren,2016,9,99000,56000,155000
Komoren,2016,10,58000,143000,201000
Komoren,2016,11,54000,1081000,1135000
Komoren,2016,12,28000,290000,318000
Komoren,2017,1,184000,1336000,1520000
Komoren,2017,2,52000,960000,1012000
Komoren,2017,3,107000,284000,391000
Komoren,2017,4,59000,0,59000
Komoren,2017,5,67000,99000,166000
Komoren,2017,6,225000,181000,406000
Komoren,2017,7,105000,0,105000
Komoren,2017,8,66000,68000,134000
Komoren,2017,9,132000,66000,198000
Komoren,2017,10,160000,66000,226000
Komoren,2017,11,187000,2935000,3122000
Komoren,2017,12,92000,253000,345000
Komoren,2018,1,82000,1766000,1848000
Komoren,2018,2,131000,203000,334000
Komoren,2018,3,205000,892000,1097000
Komoren,2018,4,64000,70000,134000
Komoren,2018,5,107000,43000,150000
Komoren,2018,6,72000,0,72000
Komoren,2018,7,64000,0,64000
Komoren,2018,8,24000,0,24000
Komoren,2018,9,90000,0,90000
Komoren,2018,10,103000,36000,139000
Komoren,2018,11,107000,50000,157000
Komoren,2018,12,109000,1021000,1130000
Komoren,2019,1,52000,349000,401000
Komoren,2019,2,66000,3722000,3788000
Komoren,2019,3,14000,0,14000
Komoren,2019,4,59000,693000,752000
Komoren,2019,5,111000,1019000,1130000
Komoren,2019,6,47000,26000,73000
Komoren,2019,7,172000,173000,345000
Komoren,2019,8,31000,177000,208000
Komoren,2019,9,104000,23000,127000
Komoren,2019,10,75000,18000,93000
Komoren,2019,11,37000,241000,278000
Komoren,2019,12,58000,824000,882000
Komoren,2020,1,137000,781000,918000
Komoren,2020,2,36000,1336000,1372000
Komoren,2020,3,18000,347000,365000
Komoren,2020,4,174000,338000,512000
Komoren,2020,5,131000,599000,730000
Komoren,2020,6,47000,0,47000
Komoren,2020,7,38000,150000,188000
Komoren,2020,8,28000,14000,42000
Komoren,2020,9,184000,746000,930000
Komoren,2020,10,61000,413000,474000
Komoren,2020,11,622000,153000,775000
Komoren,2020,12,11000,224000,235000
Komoren,2021,1,53000,147000,200000
Komoren,2021,2,64000,1026000,1090000
Komoren,2021,3,36000,338000,374000
Komoren,2021,4,42000,18000,60000
Komoren,2021,5,60000,0,60000
Komoren,2021,6,90000,31000,121000
Komoren,2021,7,68000,52000,120000
Komoren,2021,8,131000,148000,279000
Komoren,2021,9,58000,0,58000
Komoren,2021,10,19000,192000,211000
Komoren,2021,11,45000,120000,165000
Komoren,2021,12,74000,834000,908000
Komoren,2022,1,26000,554000,580000
Komoren,2022,2,88000,1534000,1622000
Komoren,2022,3,24000,198000,222000
Komoren,2022,4,28000,43000,71000
Komoren,2022,5,151000,0,151000
Komoren,2022,6,91000,86000,177000
Komoren,2022,7,24000,75000,99000
Komoren,2022,8,15000,43000,58000
Komoren,2022,9,22000,0,22000
Komoren,2022,10,27000,0,27000
Komoren,2022,11,42000,189000,231000
Komoren,2022,12,81000,1156000,1237000
Komoren,2023,1,120000,435000,555000
Komoren,2023,2,19000,270000,289000
Komoren,2023,3,39000,167000,206000
Komoren,2023,4,48000,253000,301000
Komoren,2023,5,278000,0,278000
Komoren,2023,6,6000,86000,92000
Komoren,2023,7,0,0,0
Komoren,2023,8,47000,82000,129000
Komoren,2023,9,4000,172000,176000
Komoren,2023,10,21000,134000,155000
Komoren,2023,11,165000,169000,334000
Komoren,2023,12,16000,58000,74000
Komoren,2024,1,74000,477000,551000
Komoren,2024,2,76000,85000,161000
Komoren,2024,3,86000,130000,216000
Komoren,2024,4,51000,0,51000
Komoren,2024,5,32000,216000,248000
Komoren,2024,6,33000,0,33000
Komoren,2024,7,1300000,7000,1307000
Komoren,2024,8,85000,59000,144000
Komoren,2024,9,68000,527000,595000
Komoren,2024,10,65000,42000,107000
Komoren,2024,11,28000,90000,118000
Komoren,2024,12,180000,309000,489000
Kongo,2008,1,2923000,10436000,13359000
Kongo,2008,2,4659000,1114000,5773000
Kongo,2008,3,6281000,2010000,8291000
Kongo,2008,4,3308000,2072000,5380000
Kongo,2008,5,5097000,3438000,8535000
Kongo,2008,6,8413000,1281000,9694000
Kongo,2008,7,4849000,1159000,6008000
Kongo,2008,8,4565000,3907000,8472000
Kongo,2008,9,3384000,2976000,6360000
Kongo,2008,10,7066000,961000,8027000
Kongo,2008,11,5894000,823000,6717000
Kongo,2008,12,8589000,5592000,14181000
Kongo,2009,1,3495000,2187000,5682000
Kongo,2009,2,5924000,3416000,9340000
Kongo,2009,3,3653000,5757000,9410000
Kongo,2009,4,4060000,2628000,6688000
Kongo,2009,5,4101000,1900000,6001000
Kongo,2009,6,3106000,548000,3654000
Kongo,2009,7,7355000,1345000,8700000
Kongo,2009,8,3662000,1854000,5516000
Kongo,2009,9,3207000,4473000,7680000
Kongo,2009,10,5308000,2051000,7359000
Kongo,2009,11,6385000,874000,7259000
Kongo,2009,12,4768000,8375000,13143000
Kongo,2010,1,3003000,3484000,6487000
Kongo,2010,2,4008000,432000,4440000
Kongo,2010,3,5001000,1453000,6454000
Kongo,2010,4,2928000,451000,3379000
Kongo,2010,5,10398000,372000,10770000
Kongo,2010,6,5830000,1221000,7051000
Kongo,2010,7,4545000,1648000,6193000
Kongo,2010,8,10600000,1927000,12527000
Kongo,2010,9,3289000,689000,3978000
Kongo,2010,10,4431000,2833000,7264000
Kongo,2010,11,6523000,2209000,8732000
Kongo,2010,12,4346000,16240000,20586000
Kongo,2011,1,2792000,21310000,24102000
Kongo,2011,2,6014000,5417000,11431000
Kongo,2011,3,3313000,1927000,5240000
Kongo,2011,4,2434000,13311000,15745000
Kongo,2011,5,4770000,14973000,19743000
Kongo,2011,6,5121000,7308000,12429000
Kongo,2011,7,3834000,25416000,29250000
Kongo,2011,8,3628000,24878000,28506000
Kongo,2011,9,4668000,8230000,12898000
Kongo,2011,10,4069000,4270000,8339000
Kongo,2011,11,10092000,30857000,40949000
Kongo,2011,12,4183000,12803000,16986000
Kongo,2012,1,3631000,18243000,21874000
Kongo,2012,2,4067000,9131000,13198000
Kongo,2012,3,3544000,2249000,5793000
Kongo,2012,4,4444000,1830000,6274000
Kongo,2012,5,6185000,13528000,19713000
Kongo,2012,6,4471000,1283000,5754000
Kongo,2012,7,7615000,1166000,8781000
Kongo,2012,8,8849000,2452000,11301000
Kongo,2012,9,7365000,1496000,8861000
Kongo,2012,10,5342000,2227000,7569000
Kongo,2012,11,6479000,9071000,15550000
Kongo,2012,12,5576000,10353000,15929000
Kongo,2013,1,3166000,1135000,4301000
Kongo,2013,2,5057000,630000,5687000
Kongo,2013,3,4017000,7362000,11379000
Kongo,2013,4,4888000,1080000,5968000
Kongo,2013,5,4391000,1608000,5999000
Kongo,2013,6,7270000,370000,7640000
Kongo,2013,7,13614000,1631000,15245000
Kongo,2013,8,5801000,1696000,7497000
Kongo,2013,9,5981000,2530000,8511000
Kongo,2013,10,4697000,2433000,7130000
Kongo,2013,11,6686000,7842000,14528000
Kongo,2013,12,13141000,1983000,15124000
Kongo,2014,1,4688000,903000,5591000
Kongo,2014,2,3230000,1770000,5000000
Kongo,2014,3,4122000,1819000,5941000
Kongo,2014,4,9434000,2939000,12373000
Kongo,2014,5,8882000,2772000,11654000
Kongo,2014,6,10299000,1024000,11323000
Kongo,2014,7,8900000,1966000,10866000
Kongo,2014,8,9679000,1742000,11421000
Kongo,2014,9,13547000,2024000,15571000
Kongo,2014,10,8360000,1044000,9404000
Kongo,2014,11,5226000,2527000,7753000
Kongo,2014,12,9236000,3069000,12305000
Kongo,2015,1,9646000,755000,10401000
Kongo,2015,2,3724000,1521000,5245000
Kongo,2015,3,11277000,1443000,12720000
Kongo,2015,4,6620000,751000,7371000
Kongo,2015,5,14952000,977000,15929000
Kongo,2015,6,15841000,1263000,17104000
Kongo,2015,7,19641000,1481000,21122000
Kongo,2015,8,14039000,911000,14950000
Kongo,2015,9,23322000,1079000,24401000
Kongo,2015,10,8748000,3782000,12530000
Kongo,2015,11,6499000,1972000,8471000
Kongo,2015,12,3674000,2459000,6133000
Kongo,2016,1,3205000,1185000,4390000
Kongo,2016,2,31994000,1896000,33890000
Kongo,2016,3,3400000,1745000,5145000
Kongo,2016,4,4111000,1808000,5919000
Kongo,2016,5,3055000,1100000,4155000
Kongo,2016,6,7160000,5508000,12668000
Kongo,2016,7,3681000,1990000,5671000
Kongo,2016,8,6301000,2338000,8639000
Kongo,2016,9,4407000,2742000,7149000
Kongo,2016,10,6514000,1914000,8428000
Kongo,2016,11,4011000,804000,4815000
Kongo,2016,12,3133000,939000,4072000
Kongo,2017,1,2151000,3290000,5441000
Kongo,2017,2,2377000,719000,3096000
Kongo,2017,3,8836000,4456000,13292000
Kongo,2017,4,3033000,864000,3897000
Kongo,2017,5,3783000,1727000,5510000
Kongo,2017,6,3174000,1909000,5083000
Kongo,2017,7,6526000,1641000,8167000
Kongo,2017,8,4249000,1262000,5511000
Kongo,2017,9,6254000,2848000,9102000
Kongo,2017,10,2548000,1063000,3611000
Kongo,2017,11,4469000,1283000,5752000
Kongo,2017,12,6010000,19338000,25348000
Kongo,2018,1,2205000,2036000,4241000
Kongo,2018,2,2054000,2404000,4458000
Kongo,2018,3,2442000,754000,3196000
Kongo,2018,4,2112000,932000,3044000
Kongo,2018,5,2969000,1529000,4498000
Kongo,2018,6,3346000,1304000,4650000
Kongo,2018,7,3541000,1028000,4569000
Kongo,2018,8,3036000,1406000,4442000
Kongo,2018,9,2407000,1862000,4269000
Kongo,2018,10,4385000,2134000,6519000
Kongo,2018,11,9822000,2861000,12683000
Kongo,2018,12,4430000,1017000,5447000
Kongo,2019,1,6594000,1123000,7717000
Kongo,2019,2,2205000,231000,2436000
Kongo,2019,3,2092000,2540000,4632000
Kongo,2019,4,3351000,1048000,4399000
Kongo,2019,5,3313000,656000,3969000
Kongo,2019,6,3324000,1383000,4707000
Kongo,2019,7,3798000,1053000,4851000
Kongo,2019,8,4765000,724000,5489000
Kongo,2019,9,2201000,928000,3129000
Kongo,2019,10,3464000,1722000,5186000
Kongo,2019,11,5483000,1693000,7176000
Kongo,2019,12,2630000,1199000,3829000
Kongo,2020,1,3020000,2563000,5583000
Kongo,2020,2,2682000,830000,3512000
Kongo,2020,3,6436000,2205000,8641000
Kongo,2020,4,2645000,9579000,12224000
Kongo,2020,5,5206000,3332000,8538000
Kongo,2020,6,2467000,6230000,8697000
Kongo,2020,7,3098000,628000,3726000
Kongo,2020,8,2288000,432000,2720000
Kongo,2020,9,3828000,501000,4329000
Kongo,2020,10,4355000,648000,5003000
Kongo,2020,11,3849000,802000,4651000
Kongo,2020,12,4388000,826000,5214000
Kongo,2021,1,3906000,832000,4738000
Kongo,2021,2,3321000,651000,3972000
Kongo,2021,3,3612000,1962000,5574000
Kongo,2021,4,3929000,744000,4673000
Kongo,2021,5,3434000,2405000,5839000
Kongo,2021,6,3444000,17079000,20523000
Kongo,2021,7,4133000,1533000,5666000
Kongo,2021,8,3630000,1011000,4641000
Kongo,2021,9,4647000,1354000,6001000
Kongo,2021,10,5455000,1743000,7198000
Kongo,2021,11,5339000,1484000,6823000
Kongo,2021,12,4809000,1165000,5974000
Kongo,2022,1,3957000,879000,4836000
Kongo,2022,2,3509000,716000,4225000
Kongo,2022,3,4594000,1584000,6178000
Kongo,2022,4,4336000,851000,5187000
Kongo,2022,5,3972000,4347000,8319000
Kongo,2022,6,4531000,3015000,7546000
Kongo,2022,7,12202000,4604000,16806000
Kongo,2022,8,9954000,6863000,16817000
Kongo,2022,9,7477000,2646000,10123000
Kongo,2022,10,7596000,1468000,9064000
Kongo,2022,11,8557000,2623000,11180000
Kongo,2022,12,8588000,4483000,13071000
Kongo,2023,1,9994000,6686000,16680000
Kongo,2023,2,6544000,2362000,8906000
Kongo,2023,3,8677000,13747000,22424000
Kongo,2023,4,5524000,8510000,14034000
Kongo,2023,5,6652000,1843000,8495000
Kongo,2023,6,10457000,7807000,18264000
Kongo,2023,7,10387000,33622000,44009000
Kongo,2023,8,8264000,1433000,9697000
Kongo,2023,9,7340000,1042000,8382000
Kongo,2023,10,10096000,4630000,14726000
Kongo,2023,11,12673000,4980000,17653000
Kongo,2023,12,5341000,732000,6073000
Kongo,2024,1,4360000,6939000,11299000
Kongo,2024,2,4482000,7469000,11951000
Kongo,2024,3,6405000,271000,6676000
Kongo,2024,4,5305000,20918000,26223000
Kongo,2024,5,7479000,5298000,12777000
Kongo,2024,6,10612000,3841000,14453000
Kongo,2024,7,5445000,5048000,10493000
Kongo,2024,8,5035000,989000,6024000
Kongo,2024,9,10888000,11062000,21950000
Kongo,2024,10,7715000,8573000,16288000
Kongo,2024,11,6019000,3836000,9855000
Kongo,2024,12,4296000,5914000,10210000
Kosovo (ab 06/2005),2008,1,4860000,495000,5355000
Kosovo (ab 06/2005),2008,2,5333000,254000,5587000
Kosovo (ab 06/2005),2008,3,7706000,641000,8347000
Kosovo (ab 06/2005),2008,4,7681000,1629000,9310000
Kosovo (ab 06/2005),2008,5,6269000,1386000,7655000
Kosovo (ab 06/2005),2008,6,9029000,862000,9891000
Kosovo (ab 06/2005),2008,7,11330000,472000,11802000
Kosovo (ab 06/2005),2008,8,8107000,2696000,10803000
Kosovo (ab 06/2005),2008,9,9204000,451000,9655000
Kosovo (ab 06/2005),2008,10,8530000,368000,8898000
Kosovo (ab 06/2005),2008,11,11146000,995000,12141000
Kosovo (ab 06/2005),2008,12,13434000,453000,13887000
Kosovo (ab 06/2005),2009,1,7554000,164000,7718000
Kosovo (ab 06/2005),2009,2,10260000,778000,11038000
Kosovo (ab 06/2005),2009,3,15075000,596000,15671000
Kosovo (ab 06/2005),2009,4,12234000,587000,12821000
Kosovo (ab 06/2005),2009,5,21678000,318000,21996000
Kosovo (ab 06/2005),2009,6,14232000,394000,14626000
Kosovo (ab 06/2005),2009,7,14087000,510000,14597000
Kosovo (ab 06/2005),2009,8,12905000,280000,13185000
Kosovo (ab 06/2005),2009,9,13042000,799000,13841000
Kosovo (ab 06/2005),2009,10,13067000,568000,13635000
Kosovo (ab 06/2005),2009,11,13012000,556000,13568000
Kosovo (ab 06/2005),2009,12,11063000,649000,11712000
Kosovo (ab 06/2005),2010,1,7324000,311000,7635000
Kosovo (ab 06/2005),2010,2,11764000,901000,12665000
Kosovo (ab 06/2005),2010,3,15818000,11296000,27114000
Kosovo (ab 06/2005),2010,4,17720000,607000,18327000
Kosovo (ab 06/2005),2010,5,17493000,1555000,19048000
Kosovo (ab 06/2005),2010,6,19546000,5120000,24666000
Kosovo (ab 06/2005),2010,7,16002000,772000,16774000
Kosovo (ab 06/2005),2010,8,16405000,860000,17265000
Kosovo (ab 06/2005),2010,9,16919000,1547000,18466000
Kosovo (ab 06/2005),2010,10,13766000,1047000,14813000
Kosovo (ab 06/2005),2010,11,12134000,865000,12999000
Kosovo (ab 06/2005),2010,12,13418000,6226000,19644000
Kosovo (ab 06/2005),2011,1,7108000,1001000,8109000
Kosovo (ab 06/2005),2011,2,10738000,848000,11586000
Kosovo (ab 06/2005),2011,3,12901000,845000,13746000
Kosovo (ab 06/2005),2011,4,10475000,4768000,15243000
Kosovo (ab 06/2005),2011,5,13524000,1343000,14867000
Kosovo (ab 06/2005),2011,6,16303000,1575000,17878000
Kosovo (ab 06/2005),2011,7,12902000,1140000,14042000
Kosovo (ab 06/2005),2011,8,16231000,1117000,17348000
Kosovo (ab 06/2005),2011,9,13498000,1071000,14569000
Kosovo (ab 06/2005),2011,10,12587000,1092000,13679000
Kosovo (ab 06/2005),2011,11,12805000,1021000,13826000
Kosovo (ab 06/2005),2011,12,11434000,1178000,12612000
Kosovo (ab 06/2005),2012,1,8049000,994000,9043000
Kosovo (ab 06/2005),2012,2,8770000,597000,9367000
Kosovo (ab 06/2005),2012,3,11404000,749000,12153000
Kosovo (ab 06/2005),2012,4,10281000,496000,10777000
Kosovo (ab 06/2005),2012,5,13758000,1075000,14833000
Kosovo (ab 06/2005),2012,6,19869000,971000,20840000
Kosovo (ab 06/2005),2012,7,17370000,809000,18179000
Kosovo (ab 06/2005),2012,8,12132000,3905000,16037000
Kosovo (ab 06/2005),2012,9,12719000,787000,13506000
Kosovo (ab 06/2005),2012,10,15200000,5005000,20205000
Kosovo (ab 06/2005),2012,11,13089000,802000,13891000
Kosovo (ab 06/2005),2012,12,11018000,752000,11770000
Kosovo (ab 06/2005),2013,1,7881000,957000,8838000
Kosovo (ab 06/2005),2013,2,7565000,1281000,8846000
Kosovo (ab 06/2005),2013,3,10568000,1131000,11699000
Kosovo (ab 06/2005),2013,4,12374000,1920000,14294000
Kosovo (ab 06/2005),2013,5,11352000,718000,12070000
Kosovo (ab 06/2005),2013,6,12095000,5039000,17134000
Kosovo (ab 06/2005),2013,7,11921000,790000,12711000
Kosovo (ab 06/2005),2013,8,11919000,727000,12646000
Kosovo (ab 06/2005),2013,9,13626000,1394000,15020000
Kosovo (ab 06/2005),2013,10,12563000,787000,13350000
Kosovo (ab 06/2005),2013,11,12449000,715000,13164000
Kosovo (ab 06/2005),2013,12,9606000,989000,10595000
Kosovo (ab 06/2005),2014,1,7413000,1002000,8415000
Kosovo (ab 06/2005),2014,2,9876000,732000,10608000
Kosovo (ab 06/2005),2014,3,10035000,915000,10950000
Kosovo (ab 06/2005),2014,4,11328000,651000,11979000
Kosovo (ab 06/2005),2014,5,12625000,670000,13295000
Kosovo (ab 06/2005),2014,6,13554000,603000,14157000
Kosovo (ab 06/2005),2014,7,13490000,1722000,15212000
Kosovo (ab 06/2005),2014,8,22060000,770000,22830000
Kosovo (ab 06/2005),2014,9,15364000,1159000,16523000
Kosovo (ab 06/2005),2014,10,12986000,1239000,14225000
Kosovo (ab 06/2005),2014,11,12900000,1139000,14039000
Kosovo (ab 06/2005),2014,12,10741000,856000,11597000
Kosovo (ab 06/2005),2015,1,7648000,623000,8271000
Kosovo (ab 06/2005),2015,2,10151000,627000,10778000
Kosovo (ab 06/2005),2015,3,13921000,654000,14575000
Kosovo (ab 06/2005),2015,4,12640000,765000,13405000
Kosovo (ab 06/2005),2015,5,12653000,839000,13492000
Kosovo (ab 06/2005),2015,6,15670000,766000,16436000
Kosovo (ab 06/2005),2015,7,14537000,1322000,15859000
Kosovo (ab 06/2005),2015,8,11873000,1214000,13087000
Kosovo (ab 06/2005),2015,9,14359000,1105000,15464000
Kosovo (ab 06/2005),2015,10,14668000,1333000,16001000
Kosovo (ab 06/2005),2015,11,14704000,1068000,15772000
Kosovo (ab 06/2005),2015,12,13050000,786000,13836000
Kosovo (ab 06/2005),2016,1,10048000,754000,10802000
Kosovo (ab 06/2005),2016,2,13616000,1110000,14726000
Kosovo (ab 06/2005),2016,3,15046000,713000,15759000
Kosovo (ab 06/2005),2016,4,16932000,1242000,18174000
Kosovo (ab 06/2005),2016,5,14912000,1037000,15949000
Kosovo (ab 06/2005),2016,6,15057000,1312000,16369000
Kosovo (ab 06/2005),2016,7,15147000,1021000,16168000
Kosovo (ab 06/2005),2016,8,17163000,1256000,18419000
Kosovo (ab 06/2005),2016,9,15670000,1800000,17470000
Kosovo (ab 06/2005),2016,10,17199000,1672000,18871000
Kosovo (ab 06/2005),2016,11,17546000,1897000,19443000
Kosovo (ab 06/2005),2016,12,15166000,1199000,16365000
Kosovo (ab 06/2005),2017,1,10228000,1204000,11432000
Kosovo (ab 06/2005),2017,2,14486000,1234000,15720000
Kosovo (ab 06/2005),2017,3,18882000,1805000,20687000
Kosovo (ab 06/2005),2017,4,16041000,1142000,17183000
Kosovo (ab 06/2005),2017,5,18816000,1986000,20802000
Kosovo (ab 06/2005),2017,6,16780000,1430000,18210000
Kosovo (ab 06/2005),2017,7,17573000,4521000,22094000
Kosovo (ab 06/2005),2017,8,16673000,1579000,18252000
Kosovo (ab 06/2005),2017,9,15094000,1990000,17084000
Kosovo (ab 06/2005),2017,10,15411000,1704000,17115000
Kosovo (ab 06/2005),2017,11,17268000,2592000,19860000
Kosovo (ab 06/2005),2017,12,14295000,1793000,16088000
Kosovo (ab 06/2005),2018,1,16490000,1564000,18054000
Kosovo (ab 06/2005),2018,2,16250000,1799000,18049000
Kosovo (ab 06/2005),2018,3,16421000,2209000,18630000
Kosovo (ab 06/2005),2018,4,23213000,2165000,25378000
Kosovo (ab 06/2005),2018,5,28393000,1882000,30275000
Kosovo (ab 06/2005),2018,6,18643000,1656000,20299000
Kosovo (ab 06/2005),2018,7,18755000,2558000,21313000
Kosovo (ab 06/2005),2018,8,21766000,2143000,23909000
Kosovo (ab 06/2005),2018,9,19722000,2504000,22226000
Kosovo (ab 06/2005),2018,10,17701000,2876000,20577000
Kosovo (ab 06/2005),2018,11,23607000,3235000,26842000
Kosovo (ab 06/2005),2018,12,14235000,1822000,16057000
Kosovo (ab 06/2005),2019,1,14494000,2302000,16796000
Kosovo (ab 06/2005),2019,2,18689000,1913000,20602000
Kosovo (ab 06/2005),2019,3,20797000,2253000,23050000
Kosovo (ab 06/2005),2019,4,21144000,2298000,23442000
Kosovo (ab 06/2005),2019,5,26912000,2443000,29355000
Kosovo (ab 06/2005),2019,6,19959000,3784000,23743000
Kosovo (ab 06/2005),2019,7,29486000,2575000,32061000
Kosovo (ab 06/2005),2019,8,20747000,2450000,23197000
Kosovo (ab 06/2005),2019,9,19665000,3191000,22856000
Kosovo (ab 06/2005),2019,10,22871000,3361000,26232000
Kosovo (ab 06/2005),2019,11,22782000,3764000,26546000
Kosovo (ab 06/2005),2019,12,19467000,2426000,21893000
Kosovo (ab 06/2005),2020,1,16856000,2595000,19451000
Kosovo (ab 06/2005),2020,2,21625000,2912000,24537000
Kosovo (ab 06/2005),2020,3,19062000,2822000,21884000
Kosovo (ab 06/2005),2020,4,12111000,2794000,14905000
Kosovo (ab 06/2005),2020,5,16223000,2667000,18890000
Kosovo (ab 06/2005),2020,6,20557000,7935000,28492000
Kosovo (ab 06/2005),2020,7,21827000,5326000,27153000
Kosovo (ab 06/2005),2020,8,15706000,3960000,19666000
Kosovo (ab 06/2005),2020,9,21358000,5397000,26755000
Kosovo (ab 06/2005),2020,10,19105000,4607000,23712000
Kosovo (ab 06/2005),2020,11,20943000,4862000,25805000
Kosovo (ab 06/2005),2020,12,21299000,4605000,25904000
Kosovo (ab 06/2005),2021,1,18113000,2789000,20902000
Kosovo (ab 06/2005),2021,2,29613000,5850000,35463000
Kosovo (ab 06/2005),2021,3,37870000,4167000,42037000
Kosovo (ab 06/2005),2021,4,24490000,4700000,29190000
Kosovo (ab 06/2005),2021,5,31366000,3913000,35279000
Kosovo (ab 06/2005),2021,6,26015000,5363000,31378000
Kosovo (ab 06/2005),2021,7,26143000,4524000,30667000
Kosovo (ab 06/2005),2021,8,26490000,4389000,30879000
Kosovo (ab 06/2005),2021,9,27895000,6093000,33988000
Kosovo (ab 06/2005),2021,10,26907000,7046000,33953000
Kosovo (ab 06/2005),2021,11,29719000,7231000,36950000
Kosovo (ab 06/2005),2021,12,21693000,6477000,28170000
Kosovo (ab 06/2005),2022,1,21340000,4707000,26047000
Kosovo (ab 06/2005),2022,2,24143000,5823000,29966000
Kosovo (ab 06/2005),2022,3,31232000,6446000,37678000
Kosovo (ab 06/2005),2022,4,26065000,7017000,33082000
Kosovo (ab 06/2005),2022,5,27069000,8345000,35414000
Kosovo (ab 06/2005),2022,6,28084000,6917000,35001000
Kosovo (ab 06/2005),2022,7,25390000,7727000,33117000
Kosovo (ab 06/2005),2022,8,22363000,8271000,30634000
Kosovo (ab 06/2005),2022,9,25843000,9873000,35716000
Kosovo (ab 06/2005),2022,10,41508000,9748000,51256000
Kosovo (ab 06/2005),2022,11,28266000,9709000,37975000
Kosovo (ab 06/2005),2022,12,24543000,7455000,31998000
Kosovo (ab 06/2005),2023,1,22103000,7063000,29166000
Kosovo (ab 06/2005),2023,2,24684000,6827000,31511000
Kosovo (ab 06/2005),2023,3,33810000,7984000,41794000
Kosovo (ab 06/2005),2023,4,26898000,6271000,33169000
Kosovo (ab 06/2005),2023,5,28462000,8362000,36824000
Kosovo (ab 06/2005),2023,6,33510000,9016000,42526000
Kosovo (ab 06/2005),2023,7,31003000,7390000,38393000
Kosovo (ab 06/2005),2023,8,28125000,8366000,36491000
Kosovo (ab 06/2005),2023,9,30947000,9398000,40345000
Kosovo (ab 06/2005),2023,10,30895000,9157000,40052000
Kosovo (ab 06/2005),2023,11,30996000,9084000,40080000
Kosovo (ab 06/2005),2023,12,28423000,6690000,35113000
Kosovo (ab 06/2005),2024,1,30322000,5237000,35559000
Kosovo (ab 06/2005),2024,2,37202000,7539000,44741000
Kosovo (ab 06/2005),2024,3,36620000,7992000,44612000
Kosovo (ab 06/2005),2024,4,34280000,9361000,43641000
Kosovo (ab 06/2005),2024,5,29264000,9176000,38440000
Kosovo (ab 06/2005),2024,6,34743000,7922000,42665000
Kosovo (ab 06/2005),2024,7,35814000,8835000,44649000
Kosovo (ab 06/2005),2024,8,34028000,7475000,41503000
Kosovo (ab 06/2005),2024,9,33236000,8607000,41843000
Kosovo (ab 06/2005),2024,10,36440000,9365000,45805000
Kosovo (ab 06/2005),2024,11,32324000,10498000,42822000
Kosovo (ab 06/2005),2024,12,33722000,8476000,42198000
Kroatien (ab 05/1992),2008,1,242785000,68090000,310875000
Kroatien (ab 05/1992),2008,2,251996000,69229000,321225000
Kroatien (ab 05/1992),2008,3,248387000,63581000,311968000
Kroatien (ab 05/1992),2008,4,274341000,72326000,346667000
Kroatien (ab 05/1992),2008,5,238400000,61066000,299466000
Kroatien (ab 05/1992),2008,6,267475000,72337000,339812000
Kroatien (ab 05/1992),2008,7,247069000,80440000,327509000
Kroatien (ab 05/1992),2008,8,202696000,76278000,278974000
Kroatien (ab 05/1992),2008,9,249872000,66529000,316401000
Kroatien (ab 05/1992),2008,10,275718000,67417000,343135000
Kroatien (ab 05/1992),2008,11,216948000,58565000,275513000
Kroatien (ab 05/1992),2008,12,209752000,53827000,263579000
Kroatien (ab 05/1992),2009,1,179392000,51747000,231139000
Kroatien (ab 05/1992),2009,2,217622000,86993000,304615000
Kroatien (ab 05/1992),2009,3,225177000,57594000,282771000
Kroatien (ab 05/1992),2009,4,199847000,53678000,253525000
Kroatien (ab 05/1992),2009,5,168248000,44726000,212974000
Kroatien (ab 05/1992),2009,6,208941000,49468000,258409000
Kroatien (ab 05/1992),2009,7,202548000,57317000,259865000
Kroatien (ab 05/1992),2009,8,166163000,42148000,208311000
Kroatien (ab 05/1992),2009,9,193853000,55096000,248949000
Kroatien (ab 05/1992),2009,10,177996000,53271000,231267000
Kroatien (ab 05/1992),2009,11,176245000,61036000,237281000
Kroatien (ab 05/1992),2009,12,154277000,46231000,200508000
Kroatien (ab 05/1992),2010,1,130313000,42538000,172851000
Kroatien (ab 05/1992),2010,2,151084000,53055000,204139000
Kroatien (ab 05/1992),2010,3,194565000,68538000,263103000
Kroatien (ab 05/1992),2010,4,162634000,59937000,222571000
Kroatien (ab 05/1992),2010,5,176220000,67292000,243512000
Kroatien (ab 05/1992),2010,6,186425000,62999000,249424000
Kroatien (ab 05/1992),2010,7,175982000,61575000,237557000
Kroatien (ab 05/1992),2010,8,156367000,48520000,204887000
Kroatien (ab 05/1992),2010,9,192415000,62897000,255312000
Kroatien (ab 05/1992),2010,10,180475000,60756000,241231000
Kroatien (ab 05/1992),2010,11,178799000,67281000,246080000
Kroatien (ab 05/1992),2010,12,154863000,60300000,215163000
Kroatien (ab 05/1992),2011,1,146644000,59354000,205998000
Kroatien (ab 05/1992),2011,2,171222000,65394000,236616000
Kroatien (ab 05/1992),2011,3,239408000,86817000,326225000
Kroatien (ab 05/1992),2011,4,175429000,72662000,248091000
Kroatien (ab 05/1992),2011,5,202739000,80527000,283266000
Kroatien (ab 05/1992),2011,6,176326000,67621000,243947000
Kroatien (ab 05/1992),2011,7,184788000,69194000,253982000
Kroatien (ab 05/1992),2011,8,186929000,63936000,250865000
Kroatien (ab 05/1992),2011,9,208969000,69981000,278950000
Kroatien (ab 05/1992),2011,10,195884000,75950000,271834000
Kroatien (ab 05/1992),2011,11,203343000,74311000,277654000
Kroatien (ab 05/1992),2011,12,163183000,61908000,225091000
Kroatien (ab 05/1992),2012,1,168040000,66963000,235003000
Kroatien (ab 05/1992),2012,2,183402000,70557000,253959000
Kroatien (ab 05/1992),2012,3,212314000,77892000,290206000
Kroatien (ab 05/1992),2012,4,182499000,76750000,259249000
Kroatien (ab 05/1992),2012,5,197305000,80139000,277444000
Kroatien (ab 05/1992),2012,6,175012000,75765000,250777000
Kroatien (ab 05/1992),2012,7,177771000,83287000,261058000
Kroatien (ab 05/1992),2012,8,184883000,63468000,248351000
Kroatien (ab 05/1992),2012,9,187920000,69767000,257687000
Kroatien (ab 05/1992),2012,10,194094000,80251000,274345000
Kroatien (ab 05/1992),2012,11,193864000,73937000,267801000
Kroatien (ab 05/1992),2012,12,142572000,57458000,200030000
Kroatien (ab 05/1992),2013,1,170690000,75344000,246034000
Kroatien (ab 05/1992),2013,2,169202000,71458000,240660000
Kroatien (ab 05/1992),2013,3,191116000,78484000,269600000
Kroatien (ab 05/1992),2013,4,197592000,79789000,277381000
Kroatien (ab 05/1992),2013,5,195704000,78569000,274273000
Kroatien (ab 05/1992),2013,6,162770000,81912000,244682000
Kroatien (ab 05/1992),2013,7,159100000,71756000,230856000
Kroatien (ab 05/1992),2013,8,146833000,65058000,211891000
Kroatien (ab 05/1992),2013,9,164617000,81146000,245763000
Kroatien (ab 05/1992),2013,10,180315000,80262000,260577000
Kroatien (ab 05/1992),2013,11,159076000,77566000,236642000
Kroatien (ab 05/1992),2013,12,144872000,65100000,209972000
Kroatien (ab 05/1992),2014,1,174326000,72254000,246580000
Kroatien (ab 05/1992),2014,2,179015000,76271000,255286000
Kroatien (ab 05/1992),2014,3,200175000,82126000,282301000
Kroatien (ab 05/1992),2014,4,192497000,79388000,271885000
Kroatien (ab 05/1992),2014,5,185035000,81006000,266041000
Kroatien (ab 05/1992),2014,6,189967000,79902000,269869000
Kroatien (ab 05/1992),2014,7,202147000,90537000,292684000
Kroatien (ab 05/1992),2014,8,165491000,70330000,235821000
Kroatien (ab 05/1992),2014,9,194160000,84094000,278254000
Kroatien (ab 05/1992),2014,10,209800000,88352000,298152000
Kroatien (ab 05/1992),2014,11,184593000,89892000,274485000
Kroatien (ab 05/1992),2014,12,171168000,83553000,254721000
Kroatien (ab 05/1992),2015,1,176169000,84331000,260500000
Kroatien (ab 05/1992),2015,2,207091000,90139000,297230000
Kroatien (ab 05/1992),2015,3,249457000,99172000,348629000
Kroatien (ab 05/1992),2015,4,219199000,90882000,310081000
Kroatien (ab 05/1992),2015,5,227189000,101120000,328309000
Kroatien (ab 05/1992),2015,6,214444000,96977000,311421000
Kroatien (ab 05/1992),2015,7,220011000,110935000,330946000
Kroatien (ab 05/1992),2015,8,208171000,84592000,292763000
Kroatien (ab 05/1992),2015,9,226575000,124642000,351217000
Kroatien (ab 05/1992),2015,10,242451000,112240000,354691000
Kroatien (ab 05/1992),2015,11,232800000,110375000,343175000
Kroatien (ab 05/1992),2015,12,210507000,95937000,306444000
Kroatien (ab 05/1992),2016,1,206833000,101831000,308664000
Kroatien (ab 05/1992),2016,2,246016000,113654000,359670000
Kroatien (ab 05/1992),2016,3,281884000,117430000,399314000
Kroatien (ab 05/1992),2016,4,263389000,111836000,375225000
Kroatien (ab 05/1992),2016,5,241876000,124098000,365974000
Kroatien (ab 05/1992),2016,6,250276000,115370000,365646000
Kroatien (ab 05/1992),2016,7,236200000,114980000,351180000
Kroatien (ab 05/1992),2016,8,227053000,95946000,322999000
Kroatien (ab 05/1992),2016,9,264392000,119389000,383781000
Kroatien (ab 05/1992),2016,10,260924000,119985000,380909000
Kroatien (ab 05/1992),2016,11,262746000,122574000,385320000
Kroatien (ab 05/1992),2016,12,231500000,142285000,373785000
Kroatien (ab 05/1992),2017,1,238117000,114221000,352338000
Kroatien (ab 05/1992),2017,2,244058000,126666000,370724000
Kroatien (ab 05/1992),2017,3,328298000,135106000,463404000
Kroatien (ab 05/1992),2017,4,279700000,121340000,401040000
Kroatien (ab 05/1992),2017,5,288359000,148987000,437346000
Kroatien (ab 05/1992),2017,6,263923000,127144000,391067000
Kroatien (ab 05/1992),2017,7,267941000,143839000,411780000
Kroatien (ab 05/1992),2017,8,273582000,120513000,394095000
Kroatien (ab 05/1992),2017,9,290240000,135121000,425361000
Kroatien (ab 05/1992),2017,10,284518000,155353000,439871000
Kroatien (ab 05/1992),2017,11,285839000,167709000,453548000
Kroatien (ab 05/1992),2017,12,240154000,131905000,372059000
Kroatien (ab 05/1992),2018,1,278371000,139928000,418299000
Kroatien (ab 05/1992),2018,2,282584000,137830000,420414000
Kroatien (ab 05/1992),2018,3,327055000,147484000,474539000
Kroatien (ab 05/1992),2018,4,318730000,151026000,469756000
Kroatien (ab 05/1992),2018,5,308730000,150270000,459000000
Kroatien (ab 05/1992),2018,6,304574000,145077000,449651000
Kroatien (ab 05/1992),2018,7,298732000,165446000,464178000
Kroatien (ab 05/1992),2018,8,277245000,135274000,412519000
Kroatien (ab 05/1992),2018,9,292511000,146169000,438680000
Kroatien (ab 05/1992),2018,10,310283000,161782000,472065000
Kroatien (ab 05/1992),2018,11,339460000,144423000,483883000
Kroatien (ab 05/1992),2018,12,269201000,139875000,409076000
Kroatien (ab 05/1992),2019,1,306773000,143973000,450746000
Kroatien (ab 05/1992),2019,2,317918000,150110000,468028000
Kroatien (ab 05/1992),2019,3,333021000,157337000,490358000
Kroatien (ab 05/1992),2019,4,324718000,160305000,485023000
Kroatien (ab 05/1992),2019,5,332588000,150045000,482633000
Kroatien (ab 05/1992),2019,6,310378000,148250000,458628000
Kroatien (ab 05/1992),2019,7,318840000,164686000,483526000
Kroatien (ab 05/1992),2019,8,279318000,129046000,408364000
Kroatien (ab 05/1992),2019,9,324510000,154847000,479357000
Kroatien (ab 05/1992),2019,10,314785000,154506000,469291000
Kroatien (ab 05/1992),2019,11,296318000,157079000,453397000
Kroatien (ab 05/1992),2019,12,271955000,130164000,402119000
Kroatien (ab 05/1992),2020,1,286641000,136540000,423181000
Kroatien (ab 05/1992),2020,2,325212000,137029000,462241000
Kroatien (ab 05/1992),2020,3,332947000,156289000,489236000
Kroatien (ab 05/1992),2020,4,211102000,117383000,328485000
Kroatien (ab 05/1992),2020,5,241412000,124530000,365942000
Kroatien (ab 05/1992),2020,6,273396000,138167000,411563000
Kroatien (ab 05/1992),2020,7,293711000,135834000,429545000
Kroatien (ab 05/1992),2020,8,256442000,115135000,371577000
Kroatien (ab 05/1992),2020,9,302630000,145559000,448189000
Kroatien (ab 05/1992),2020,10,308164000,148412000,456576000
Kroatien (ab 05/1992),2020,11,285966000,168979000,454945000
Kroatien (ab 05/1992),2020,12,253559000,120103000,373662000
Kroatien (ab 05/1992),2021,1,266242000,125318000,391560000
Kroatien (ab 05/1992),2021,2,296834000,145792000,442626000
Kroatien (ab 05/1992),2021,3,358372000,173328000,531700000
Kroatien (ab 05/1992),2021,4,315778000,151253000,467031000
Kroatien (ab 05/1992),2021,5,329048000,170264000,499312000
Kroatien (ab 05/1992),2021,6,335841000,163508000,499349000
Kroatien (ab 05/1992),2021,7,332605000,179307000,511912000
Kroatien (ab 05/1992),2021,8,321664000,141389000,463053000
Kroatien (ab 05/1992),2021,9,359961000,165414000,525375000
Kroatien (ab 05/1992),2021,10,350030000,183823000,533853000
Kroatien (ab 05/1992),2021,11,362085000,196536000,558621000
Kroatien (ab 05/1992),2021,12,337148000,158585000,495733000
Kroatien (ab 05/1992),2022,1,352151000,190101000,542252000
Kroatien (ab 05/1992),2022,2,396774000,195314000,592088000
Kroatien (ab 05/1992),2022,3,457614000,216239000,673853000
Kroatien (ab 05/1992),2022,4,415664000,194263000,609927000
Kroatien (ab 05/1992),2022,5,438165000,216742000,654907000
Kroatien (ab 05/1992),2022,6,445245000,202775000,648020000
Kroatien (ab 05/1992),2022,7,399809000,221530000,621339000
Kroatien (ab 05/1992),2022,8,388713000,172748000,561461000
Kroatien (ab 05/1992),2022,9,469644000,199222000,668866000
Kroatien (ab 05/1992),2022,10,440520000,201173000,641693000
Kroatien (ab 05/1992),2022,11,474346000,213884000,688230000
Kroatien (ab 05/1992),2022,12,416269000,188390000,604659000
Kroatien (ab 05/1992),2023,1,428411000,171741000,600152000
Kroatien (ab 05/1992),2023,2,444226000,200785000,645011000
Kroatien (ab 05/1992),2023,3,510824000,229545000,740369000
Kroatien (ab 05/1992),2023,4,417430000,185207000,602637000
Kroatien (ab 05/1992),2023,5,474465000,210354000,684819000
Kroatien (ab 05/1992),2023,6,487223000,210944000,698167000
Kroatien (ab 05/1992),2023,7,437672000,210255000,647927000
Kroatien (ab 05/1992),2023,8,432611000,176529000,609140000
Kroatien (ab 05/1992),2023,9,444218000,214649000,658867000
Kroatien (ab 05/1992),2023,10,454531000,222745000,677276000
Kroatien (ab 05/1992),2023,11,480116000,214987000,695103000
Kroatien (ab 05/1992),2023,12,372240000,188557000,560797000
Kroatien (ab 05/1992),2024,1,481976000,191361000,673337000
Kroatien (ab 05/1992),2024,2,493518000,206799000,700317000
Kroatien (ab 05/1992),2024,3,493498000,214657000,708155000
Kroatien (ab 05/1992),2024,4,489983000,225262000,715245000
Kroatien (ab 05/1992),2024,5,496625000,201129000,697754000
Kroatien (ab 05/1992),2024,6,444485000,204630000,649115000
Kroatien (ab 05/1992),2024,7,486215000,230105000,716320000
Kroatien (ab 05/1992),2024,8,415581000,176055000,591636000
Kroatien (ab 05/1992),2024,9,468071000,206228000,674299000
Kroatien (ab 05/1992),2024,10,491731000,235536000,727267000
Kroatien (ab 05/1992),2024,11,465998000,207956000,673954000
Kroatien (ab 05/1992),2024,12,431120000,222064000,653184000
Kuba,2008,1,21217000,2429000,23646000
Kuba,2008,2,15020000,3676000,18696000
Kuba,2008,3,19761000,2055000,21816000
Kuba,2008,4,16079000,3629000,19708000
Kuba,2008,5,16794000,3480000,20274000
Kuba,2008,6,27284000,2934000,30218000
Kuba,2008,7,17844000,4847000,22691000
Kuba,2008,8,16583000,3680000,20263000
Kuba,2008,9,14190000,2994000,17184000
Kuba,2008,10,15474000,3006000,18480000
Kuba,2008,11,12065000,5987000,18052000
Kuba,2008,12,12336000,2819000,15155000
Kuba,2009,1,12714000,3544000,16258000
Kuba,2009,2,9489000,2781000,12270000
Kuba,2009,3,19008000,3086000,22094000
Kuba,2009,4,10198000,1899000,12097000
Kuba,2009,5,7601000,2447000,10048000
Kuba,2009,6,8575000,3352000,11927000
Kuba,2009,7,15354000,4467000,19821000
Kuba,2009,8,10917000,3777000,14694000
Kuba,2009,9,24656000,3445000,28101000
Kuba,2009,10,8026000,3502000,11528000
Kuba,2009,11,13820000,2506000,16326000
Kuba,2009,12,15932000,1661000,17593000
Kuba,2010,1,11375000,2631000,14006000
Kuba,2010,2,14510000,2689000,17199000
Kuba,2010,3,13663000,3953000,17616000
Kuba,2010,4,11353000,3872000,15225000
Kuba,2010,5,16586000,3453000,20039000
Kuba,2010,6,12815000,4853000,17668000
Kuba,2010,7,14644000,4007000,18651000
Kuba,2010,8,15173000,6592000,21765000
Kuba,2010,9,11944000,3872000,15816000
Kuba,2010,10,19134000,3671000,22805000
Kuba,2010,11,13552000,4349000,17901000
Kuba,2010,12,12296000,3107000,15403000
Kuba,2011,1,7828000,3119000,10947000
Kuba,2011,2,10380000,3208000,13588000
Kuba,2011,3,16015000,4918000,20933000
Kuba,2011,4,11500000,3195000,14695000
Kuba,2011,5,12182000,2889000,15071000
Kuba,2011,6,13148000,2727000,15875000
Kuba,2011,7,12873000,2952000,15825000
Kuba,2011,8,16896000,2370000,19266000
Kuba,2011,9,9435000,2369000,11804000
Kuba,2011,10,14147000,2825000,16972000
Kuba,2011,11,14271000,3101000,17372000
Kuba,2011,12,17302000,1822000,19124000
Kuba,2012,1,11034000,2634000,13668000
Kuba,2012,2,16560000,3495000,20055000
Kuba,2012,3,13656000,2752000,16408000
Kuba,2012,4,16601000,2873000,19474000
Kuba,2012,5,15707000,2254000,17961000
Kuba,2012,6,14402000,2762000,17164000
Kuba,2012,7,12909000,9551000,22460000
Kuba,2012,8,14657000,3894000,18551000
Kuba,2012,9,18860000,2259000,21119000
Kuba,2012,10,13630000,3206000,16836000
Kuba,2012,11,19747000,3644000,23391000
Kuba,2012,12,13936000,1929000,15865000
Kuba,2013,1,7883000,4134000,12017000
Kuba,2013,2,12823000,4901000,17724000
Kuba,2013,3,13025000,2461000,15486000
Kuba,2013,4,16898000,3025000,19923000
Kuba,2013,5,18082000,8748000,26830000
Kuba,2013,6,19993000,3167000,23160000
Kuba,2013,7,18111000,3193000,21304000
Kuba,2013,8,18181000,4960000,23141000
Kuba,2013,9,14783000,6137000,20920000
Kuba,2013,10,12616000,3568000,16184000
Kuba,2013,11,16359000,4386000,20745000
Kuba,2013,12,15708000,6507000,22215000
Kuba,2014,1,15920000,1939000,17859000
Kuba,2014,2,20577000,2448000,23025000
Kuba,2014,3,17593000,2531000,20124000
Kuba,2014,4,15971000,2691000,18662000
Kuba,2014,5,8589000,3147000,11736000
Kuba,2014,6,12903000,3133000,16036000
Kuba,2014,7,11411000,3781000,15192000
Kuba,2014,8,13889000,2559000,16448000
Kuba,2014,9,17669000,2820000,20489000
Kuba,2014,10,15667000,2674000,18341000
Kuba,2014,11,17808000,2047000,19855000
Kuba,2014,12,23152000,3079000,26231000
Kuba,2015,1,20666000,3453000,24119000
Kuba,2015,2,19581000,3828000,23409000
Kuba,2015,3,18001000,2878000,20879000
Kuba,2015,4,14834000,2356000,17190000
Kuba,2015,5,14719000,2639000,17358000
Kuba,2015,6,28586000,2874000,31460000
Kuba,2015,7,25234000,2806000,28040000
Kuba,2015,8,12561000,2666000,15227000
Kuba,2015,9,13900000,3793000,17693000
Kuba,2015,10,14800000,3102000,17902000
Kuba,2015,11,48994000,2797000,51791000
Kuba,2015,12,24007000,2425000,26432000
Kuba,2016,1,10653000,3806000,14459000
Kuba,2016,2,18777000,3085000,21862000
Kuba,2016,3,22768000,2963000,25731000
Kuba,2016,4,20416000,4898000,25314000
Kuba,2016,5,25046000,3293000,28339000
Kuba,2016,6,22362000,3185000,25547000
Kuba,2016,7,25024000,4122000,29146000
Kuba,2016,8,21992000,3546000,25538000
Kuba,2016,9,14274000,4151000,18425000
Kuba,2016,10,17861000,4151000,22012000
Kuba,2016,11,14760000,4139000,18899000
Kuba,2016,12,22664000,4411000,27075000
Kuba,2017,1,20963000,3930000,24893000
Kuba,2017,2,23550000,4616000,28166000
Kuba,2017,3,23051000,8484000,31535000
Kuba,2017,4,16931000,15875000,32806000
Kuba,2017,5,13856000,6105000,19961000
Kuba,2017,6,23637000,3741000,27378000
Kuba,2017,7,22654000,5337000,27991000
Kuba,2017,8,21166000,10096000,31262000
Kuba,2017,9,20771000,4817000,25588000
Kuba,2017,10,19620000,3190000,22810000
Kuba,2017,11,14206000,4771000,18977000
Kuba,2017,12,23795000,4059000,27854000
Kuba,2018,1,16975000,5326000,22301000
Kuba,2018,2,20842000,3776000,24618000
Kuba,2018,3,15148000,3655000,18803000
Kuba,2018,4,20345000,7985000,28330000
Kuba,2018,5,22484000,5088000,27572000
Kuba,2018,6,19672000,5328000,25000000
Kuba,2018,7,21155000,4126000,25281000
Kuba,2018,8,20221000,5040000,25261000
Kuba,2018,9,23386000,4580000,27966000
Kuba,2018,10,15854000,4010000,19864000
Kuba,2018,11,15173000,5184000,20357000
Kuba,2018,12,15124000,2063000,17187000
Kuba,2019,1,6232000,3659000,9891000
Kuba,2019,2,18263000,4141000,22404000
Kuba,2019,3,13731000,2965000,16696000
Kuba,2019,4,18052000,4525000,22577000
Kuba,2019,5,17309000,6219000,23528000
Kuba,2019,6,18293000,5205000,23498000
Kuba,2019,7,18959000,3919000,22878000
Kuba,2019,8,12367000,5356000,17723000
Kuba,2019,9,22259000,2813000,25072000
Kuba,2019,10,13823000,4970000,18793000
Kuba,2019,11,16184000,3831000,20015000
Kuba,2019,12,23184000,4037000,27221000
Kuba,2020,1,10221000,4169000,14390000
Kuba,2020,2,8359000,2771000,11130000
Kuba,2020,3,20548000,3621000,24169000
Kuba,2020,4,23921000,2840000,26761000
Kuba,2020,5,15953000,2520000,18473000
Kuba,2020,6,12660000,3259000,15919000
Kuba,2020,7,14469000,4437000,18906000
Kuba,2020,8,8338000,2751000,11089000
Kuba,2020,9,6284000,4626000,10910000
Kuba,2020,10,7797000,4896000,12693000
Kuba,2020,11,11369000,4140000,15509000
Kuba,2020,12,4527000,2477000,7004000
Kuba,2021,1,4812000,4829000,9641000
Kuba,2021,2,7065000,4142000,11207000
Kuba,2021,3,5269000,4918000,10187000
Kuba,2021,4,6409000,3246000,9655000
Kuba,2021,5,9970000,4188000,14158000
Kuba,2021,6,8875000,4866000,13741000
Kuba,2021,7,11221000,3610000,14831000
Kuba,2021,8,7690000,5110000,12800000
Kuba,2021,9,15461000,3130000,18591000
Kuba,2021,10,14974000,3991000,18965000
Kuba,2021,11,10875000,3150000,14025000
Kuba,2021,12,11937000,4233000,16170000
Kuba,2022,1,6510000,2836000,9346000
Kuba,2022,2,8348000,2912000,11260000
Kuba,2022,3,18805000,4947000,23752000
Kuba,2022,4,4749000,2560000,7309000
Kuba,2022,5,8529000,4152000,12681000
Kuba,2022,6,16769000,5260000,22029000
Kuba,2022,7,4798000,4142000,8940000
Kuba,2022,8,20986000,4994000,25980000
Kuba,2022,9,12815000,3905000,16720000
Kuba,2022,10,12313000,3784000,16097000
Kuba,2022,11,22927000,4231000,27158000
Kuba,2022,12,14116000,3306000,17422000
Kuba,2023,1,11924000,4249000,16173000
Kuba,2023,2,16602000,5159000,21761000
Kuba,2023,3,18138000,5149000,23287000
Kuba,2023,4,13166000,5143000,18309000
Kuba,2023,5,12146000,5612000,17758000
Kuba,2023,6,11632000,4651000,16283000
Kuba,2023,7,12976000,5953000,18929000
Kuba,2023,8,11036000,2797000,13833000
Kuba,2023,9,15222000,4392000,19614000
Kuba,2023,10,15971000,4592000,20563000
Kuba,2023,11,17879000,3301000,21180000
Kuba,2023,12,12270000,2322000,14592000
Kuba,2024,1,5499000,3021000,8520000
Kuba,2024,2,11635000,3164000,14799000
Kuba,2024,3,8704000,3470000,12174000
Kuba,2024,4,9078000,3535000,12613000
Kuba,2024,5,7155000,6254000,13409000
Kuba,2024,6,16351000,4849000,21200000
Kuba,2024,7,8858000,4485000,13343000
Kuba,2024,8,12158000,4986000,17144000
Kuba,2024,9,6838000,3899000,10737000
Kuba,2024,10,7199000,5315000,12514000
Kuba,2024,11,4301000,3990000,8291000
Kuba,2024,12,7705000,1976000,9681000
Kuwait,2008,1,108830000,8364000,117194000
Kuwait,2008,2,92767000,21643000,114410000
Kuwait,2008,3,91896000,10541000,102437000
Kuwait,2008,4,85777000,3275000,89052000
Kuwait,2008,5,77790000,2715000,80505000
Kuwait,2008,6,86222000,34787000,121009000
Kuwait,2008,7,92788000,8913000,101701000
Kuwait,2008,8,87436000,25407000,112843000
Kuwait,2008,9,95501000,21682000,117183000
Kuwait,2008,10,104209000,2334000,106543000
Kuwait,2008,11,176844000,807000,177651000
Kuwait,2008,12,186001000,1741000,187742000
Kuwait,2009,1,74754000,1184000,75938000
Kuwait,2009,2,74328000,927000,75255000
Kuwait,2009,3,77787000,3462000,81249000
Kuwait,2009,4,68498000,797000,69295000
Kuwait,2009,5,106762000,6757000,113519000
Kuwait,2009,6,65527000,5266000,70793000
Kuwait,2009,7,78995000,2896000,81891000
Kuwait,2009,8,90827000,1570000,92397000
Kuwait,2009,9,70460000,1346000,71806000
Kuwait,2009,10,79773000,5131000,84904000
Kuwait,2009,11,87736000,26951000,114687000
Kuwait,2009,12,95353000,32552000,127905000
Kuwait,2010,1,55480000,26247000,81727000
Kuwait,2010,2,97007000,15136000,112143000
Kuwait,2010,3,95157000,914000,96071000
Kuwait,2010,4,90172000,1532000,91704000
Kuwait,2010,5,106024000,2375000,108399000
Kuwait,2010,6,165134000,814000,165948000
Kuwait,2010,7,108969000,2466000,111435000
Kuwait,2010,8,83579000,934000,84513000
Kuwait,2010,9,107748000,4571000,112319000
Kuwait,2010,10,78806000,2918000,81724000
Kuwait,2010,11,108781000,659000,109440000
Kuwait,2010,12,98320000,1314000,99634000
Kuwait,2011,1,82948000,7486000,90434000
Kuwait,2011,2,74504000,1278000,75782000
Kuwait,2011,3,105179000,1472000,106651000
Kuwait,2011,4,70555000,4792000,75347000
Kuwait,2011,5,84373000,10079000,94452000
Kuwait,2011,6,83790000,884000,84674000
Kuwait,2011,7,90544000,1043000,91587000
Kuwait,2011,8,77492000,32453000,109945000
Kuwait,2011,9,88095000,13113000,101208000
Kuwait,2011,10,81448000,12705000,94153000
Kuwait,2011,11,102323000,14212000,116535000
Kuwait,2011,12,116465000,1852000,118317000
Kuwait,2012,1,82466000,11897000,94363000
Kuwait,2012,2,132971000,2195000,135166000
Kuwait,2012,3,94548000,986000,95534000
Kuwait,2012,4,75988000,1785000,77773000
Kuwait,2012,5,86631000,2107000,88738000
Kuwait,2012,6,97510000,12352000,109862000
Kuwait,2012,7,99138000,1050000,100188000
Kuwait,2012,8,112420000,45229000,157649000
Kuwait,2012,9,114693000,17368000,132061000
Kuwait,2012,10,97899000,57911000,155810000
Kuwait,2012,11,109780000,78608000,188388000
Kuwait,2012,12,114263000,39377000,153640000
Kuwait,2013,1,103866000,35445000,139311000
Kuwait,2013,2,108435000,1605000,110040000
Kuwait,2013,3,130591000,1453000,132044000
Kuwait,2013,4,111561000,16021000,127582000
Kuwait,2013,5,93462000,50475000,143937000
Kuwait,2013,6,94262000,42469000,136731000
Kuwait,2013,7,112386000,52486000,164872000
Kuwait,2013,8,135956000,97212000,233168000
Kuwait,2013,9,108049000,30962000,139011000
Kuwait,2013,10,97472000,39388000,136860000
Kuwait,2013,11,122857000,1347000,124204000
Kuwait,2013,12,98900000,1248000,100148000
Kuwait,2014,1,95638000,6757000,102395000
Kuwait,2014,2,104040000,1418000,105458000
Kuwait,2014,3,121416000,848000,122264000
Kuwait,2014,4,106325000,2189000,108514000
Kuwait,2014,5,229652000,41391000,271043000
Kuwait,2014,6,101754000,5073000,106827000
Kuwait,2014,7,116240000,38018000,154258000
Kuwait,2014,8,94695000,20109000,114804000
Kuwait,2014,9,133540000,923000,134463000
Kuwait,2014,10,113982000,4409000,118391000
Kuwait,2014,11,115080000,13740000,128820000
Kuwait,2014,12,89869000,1934000,91803000
Kuwait,2015,1,75208000,788000,75996000
Kuwait,2015,2,133488000,1009000,134497000
Kuwait,2015,3,129623000,758000,130381000
Kuwait,2015,4,122458000,1215000,123673000
Kuwait,2015,5,93906000,637000,94543000
Kuwait,2015,6,101693000,2101000,103794000
Kuwait,2015,7,112604000,1757000,114361000
Kuwait,2015,8,87037000,20487000,107524000
Kuwait,2015,9,99800000,7003000,106803000
Kuwait,2015,10,98926000,14498000,113424000
Kuwait,2015,11,136920000,9917000,146837000
Kuwait,2015,12,119556000,649000,120205000
Kuwait,2016,1,86304000,988000,87292000
Kuwait,2016,2,135237000,339000,135576000
Kuwait,2016,3,139829000,1364000,141193000
Kuwait,2016,4,129437000,930000,130367000
Kuwait,2016,5,118862000,588000,119450000
Kuwait,2016,6,115009000,1711000,116720000
Kuwait,2016,7,110611000,844000,111455000
Kuwait,2016,8,105716000,635000,106351000
Kuwait,2016,9,105882000,1027000,106909000
Kuwait,2016,10,93413000,1205000,94618000
Kuwait,2016,11,107600000,922000,108522000
Kuwait,2016,12,152504000,699000,153203000
Kuwait,2017,1,99576000,833000,100409000
Kuwait,2017,2,134069000,2197000,136266000
Kuwait,2017,3,133505000,672000,134177000
Kuwait,2017,4,97942000,6401000,104343000
Kuwait,2017,5,97529000,22252000,119781000
Kuwait,2017,6,95371000,1781000,97152000
Kuwait,2017,7,100227000,988000,101215000
Kuwait,2017,8,118457000,1075000,119532000
Kuwait,2017,9,111373000,9896000,121269000
Kuwait,2017,10,108370000,962000,109332000
Kuwait,2017,11,102090000,1467000,103557000
Kuwait,2017,12,107206000,687000,107893000
Kuwait,2018,1,79388000,1353000,80741000
Kuwait,2018,2,135781000,1280000,137061000
Kuwait,2018,3,128874000,1081000,129955000
Kuwait,2018,4,91614000,1311000,92925000
Kuwait,2018,5,82045000,929000,82974000
Kuwait,2018,6,106223000,1198000,107421000
Kuwait,2018,7,125347000,1482000,126829000
Kuwait,2018,8,112418000,26412000,138830000
Kuwait,2018,9,87505000,2016000,89521000
Kuwait,2018,10,121470000,968000,122438000
Kuwait,2018,11,102253000,1987000,104240000
Kuwait,2018,12,103143000,867000,104010000
Kuwait,2019,1,101070000,1263000,102333000
Kuwait,2019,2,81330000,1322000,82652000
Kuwait,2019,3,80688000,1223000,81911000
Kuwait,2019,4,94966000,1381000,96347000
Kuwait,2019,5,89478000,2920000,92398000
Kuwait,2019,6,75623000,12724000,88347000
Kuwait,2019,7,92091000,25200000,117291000
Kuwait,2019,8,187640000,1139000,188779000
Kuwait,2019,9,127821000,25839000,153660000
Kuwait,2019,10,162742000,1270000,164012000
Kuwait,2019,11,200106000,1792000,201898000
Kuwait,2019,12,149981000,1570000,151551000
Kuwait,2020,1,155586000,1429000,157015000
Kuwait,2020,2,73877000,1716000,75593000
Kuwait,2020,3,74942000,2274000,77216000
Kuwait,2020,4,65490000,1730000,67220000
Kuwait,2020,5,55168000,4342000,59510000
Kuwait,2020,6,71647000,1066000,72713000
Kuwait,2020,7,95161000,817000,95978000
Kuwait,2020,8,65898000,12003000,77901000
Kuwait,2020,9,76652000,894000,77546000
Kuwait,2020,10,87658000,902000,88560000
Kuwait,2020,11,94624000,666000,95290000
Kuwait,2020,12,107516000,785000,108301000
Kuwait,2021,1,124360000,1064000,125424000
Kuwait,2021,2,81831000,1856000,83687000
Kuwait,2021,3,97450000,1590000,99040000
Kuwait,2021,4,98606000,1194000,99800000
Kuwait,2021,5,69881000,1116000,70997000
Kuwait,2021,6,73221000,1690000,74911000
Kuwait,2021,7,74678000,2344000,77022000
Kuwait,2021,8,61730000,3219000,64949000
Kuwait,2021,9,74888000,2085000,76973000
Kuwait,2021,10,85314000,1922000,87236000
Kuwait,2021,11,93387000,3338000,96725000
Kuwait,2021,12,77406000,3180000,80586000
Kuwait,2022,1,65211000,2424000,67635000
Kuwait,2022,2,75831000,2529000,78360000
Kuwait,2022,3,90234000,2195000,92429000
Kuwait,2022,4,65959000,1276000,67235000
Kuwait,2022,5,91111000,1800000,92911000
Kuwait,2022,6,79120000,2886000,82006000
Kuwait,2022,7,87362000,1352000,88714000
Kuwait,2022,8,102407000,1226000,103633000
Kuwait,2022,9,123905000,1638000,125543000
Kuwait,2022,10,86574000,35086000,121660000
Kuwait,2022,11,120626000,1404000,122030000
Kuwait,2022,12,115801000,1003000,116804000
Kuwait,2023,1,88858000,38304000,127162000
Kuwait,2023,2,101247000,1225000,102472000
Kuwait,2023,3,103020000,44047000,147067000
Kuwait,2023,4,81773000,50215000,131988000
Kuwait,2023,5,78792000,99477000,178269000
Kuwait,2023,6,91587000,48581000,140168000
Kuwait,2023,7,97483000,41811000,139294000
Kuwait,2023,8,88112000,73323000,161435000
Kuwait,2023,9,100961000,94457000,195418000
Kuwait,2023,10,104650000,30525000,135175000
Kuwait,2023,11,103044000,117594000,220638000
Kuwait,2023,12,83787000,55949000,139736000
Kuwait,2024,1,70205000,1871000,72076000
Kuwait,2024,2,99307000,48272000,147579000
Kuwait,2024,3,95330000,1256000,96586000
Kuwait,2024,4,90186000,43356000,133542000
Kuwait,2024,5,85082000,53435000,138517000
Kuwait,2024,6,85394000,105950000,191344000
Kuwait,2024,7,103502000,1508000,105010000
Kuwait,2024,8,88534000,56725000,145259000
Kuwait,2024,9,152946000,1212000,154158000
Kuwait,2024,10,138830000,1338000,140168000
Kuwait,2024,11,93490000,82127000,175617000
Kuwait,2024,12,99327000,992000,100319000
Lesotho,2008,1,1162000,0,1162000
Lesotho,2008,2,757000,0,757000
Lesotho,2008,3,979000,36000,1015000
Lesotho,2008,4,507000,5000,512000
Lesotho,2008,5,494000,7000,501000
Lesotho,2008,6,392000,12000,404000
Lesotho,2008,7,611000,9000,620000
Lesotho,2008,8,517000,23000,540000
Lesotho,2008,9,929000,1000,930000
Lesotho,2008,10,151000,1000,152000
Lesotho,2008,11,260000,1000,261000
Lesotho,2008,12,365000,3000,368000
Lesotho,2009,1,797000,21000,818000
Lesotho,2009,2,943000,112000,1055000
Lesotho,2009,3,619000,6000,625000
Lesotho,2009,4,1325000,4000,1329000
Lesotho,2009,5,424000,46000,470000
Lesotho,2009,6,632000,30000,662000
Lesotho,2009,7,81000,2000,83000
Lesotho,2009,8,34000,178000,212000
Lesotho,2009,9,17000,40000,57000
Lesotho,2009,10,18000,239000,257000
Lesotho,2009,11,146000,1000,147000
Lesotho,2009,12,165000,0,165000
Lesotho,2010,1,75000,0,75000
Lesotho,2010,2,13000,1000,14000
Lesotho,2010,3,8000,0,8000
Lesotho,2010,4,6000,0,6000
Lesotho,2010,5,13000,1000,14000
Lesotho,2010,6,85000,2000,87000
Lesotho,2010,7,39000,75000,114000
Lesotho,2010,8,69000,0,69000
Lesotho,2010,9,545000,4000,549000
Lesotho,2010,10,120000,87000,207000
Lesotho,2010,11,70000,40000,110000
Lesotho,2010,12,123000,190000,313000
Lesotho,2011,1,8000,228000,236000
Lesotho,2011,2,61000,187000,248000
Lesotho,2011,3,17000,22000,39000
Lesotho,2011,4,11000,199000,210000
Lesotho,2011,5,68000,132000,200000
Lesotho,2011,6,15000,262000,277000
Lesotho,2011,7,114000,69000,183000
Lesotho,2011,8,3000,122000,125000
Lesotho,2011,9,107000,1000,108000
Lesotho,2011,10,173000,0,173000
Lesotho,2011,11,669000,121000,790000
Lesotho,2011,12,73000,1000,74000
Lesotho,2012,1,251000,0,251000
Lesotho,2012,2,84000,0,84000
Lesotho,2012,3,50000,93000,143000
Lesotho,2012,4,99000,2000,101000
Lesotho,2012,5,51000,5000,56000
Lesotho,2012,6,119000,49000,168000
Lesotho,2012,7,422000,2000,424000
Lesotho,2012,8,119000,53000,172000
Lesotho,2012,9,123000,147000,270000
Lesotho,2012,10,29000,125000,154000
Lesotho,2012,11,187000,73000,260000
Lesotho,2012,12,36000,0,36000
Lesotho,2013,1,102000,40000,142000
Lesotho,2013,2,76000,45000,121000
Lesotho,2013,3,177000,47000,224000
Lesotho,2013,4,188000,88000,276000
Lesotho,2013,5,124000,135000,259000
Lesotho,2013,6,399000,50000,449000
Lesotho,2013,7,281000,95000,376000
Lesotho,2013,8,567000,111000,678000
Lesotho,2013,9,37000,797000,834000
Lesotho,2013,10,267000,94000,361000
Lesotho,2013,11,4016000,101000,4117000
Lesotho,2013,12,178000,132000,310000
Lesotho,2014,1,62000,250000,312000
Lesotho,2014,2,227000,135000,362000
Lesotho,2014,3,147000,44000,191000
Lesotho,2014,4,761000,50000,811000
Lesotho,2014,5,120000,66000,186000
Lesotho,2014,6,99000,95000,194000
Lesotho,2014,7,121000,136000,257000
Lesotho,2014,8,208000,236000,444000
Lesotho,2014,9,99000,67000,166000
Lesotho,2014,10,129000,199000,328000
Lesotho,2014,11,132000,76000,208000
Lesotho,2014,12,150000,138000,288000
Lesotho,2015,1,162000,132000,294000
Lesotho,2015,2,2200000,67000,2267000
Lesotho,2015,3,392000,68000,460000
Lesotho,2015,4,82000,8000,90000
Lesotho,2015,5,59000,82000,141000
Lesotho,2015,6,182000,4000,186000
Lesotho,2015,7,309000,143000,452000
Lesotho,2015,8,1170000,315000,1485000
Lesotho,2015,9,343000,227000,570000
Lesotho,2015,10,206000,216000,422000
Lesotho,2015,11,63000,212000,275000
Lesotho,2015,12,154000,2000,156000
Lesotho,2016,1,57000,138000,195000
Lesotho,2016,2,89000,9000,98000
Lesotho,2016,3,113000,171000,284000
Lesotho,2016,4,149000,75000,224000
Lesotho,2016,5,73000,122000,195000
Lesotho,2016,6,282000,268000,550000
Lesotho,2016,7,65000,415000,480000
Lesotho,2016,8,161000,208000,369000
Lesotho,2016,9,273000,71000,344000
Lesotho,2016,10,53000,150000,203000
Lesotho,2016,11,120000,23000,143000
Lesotho,2016,12,139000,73000,212000
Lesotho,2017,1,49000,8000,57000
Lesotho,2017,2,107000,28000,135000
Lesotho,2017,3,548000,6000,554000
Lesotho,2017,4,58000,149000,207000
Lesotho,2017,5,132000,82000,214000
Lesotho,2017,6,119000,233000,352000
Lesotho,2017,7,161000,143000,304000
Lesotho,2017,8,85000,541000,626000
Lesotho,2017,9,149000,262000,411000
Lesotho,2017,10,251000,295000,546000
Lesotho,2017,11,90000,344000,434000
Lesotho,2017,12,143000,20000,163000
Lesotho,2018,1,234000,100000,334000
Lesotho,2018,2,78000,122000,200000
Lesotho,2018,3,65000,158000,223000
Lesotho,2018,4,105000,285000,390000
Lesotho,2018,5,157000,151000,308000
Lesotho,2018,6,89000,24000,113000
Lesotho,2018,7,62000,105000,167000
Lesotho,2018,8,234000,250000,484000
Lesotho,2018,9,67000,197000,264000
Lesotho,2018,10,58000,385000,443000
Lesotho,2018,11,31000,101000,132000
Lesotho,2018,12,239000,242000,481000
Lesotho,2019,1,31000,223000,254000
Lesotho,2019,2,34000,22000,56000
Lesotho,2019,3,43000,84000,127000
Lesotho,2019,4,101000,10705000,10806000
Lesotho,2019,5,168000,75000,243000
Lesotho,2019,6,1011000,99000,1110000
Lesotho,2019,7,57000,206000,263000
Lesotho,2019,8,18000,427000,445000
Lesotho,2019,9,35000,373000,408000
Lesotho,2019,10,37000,503000,540000
Lesotho,2019,11,44000,292000,336000
Lesotho,2019,12,104000,462000,566000
Lesotho,2020,1,55000,356000,411000
Lesotho,2020,2,71000,23000,94000
Lesotho,2020,3,49000,419000,468000
Lesotho,2020,4,80000,299000,379000
Lesotho,2020,5,1384000,76000,1460000
Lesotho,2020,6,133000,269000,402000
Lesotho,2020,7,113000,80000,193000
Lesotho,2020,8,65000,557000,622000
Lesotho,2020,9,41000,316000,357000
Lesotho,2020,10,105000,180000,285000
Lesotho,2020,11,125000,316000,441000
Lesotho,2020,12,266000,81000,347000
Lesotho,2021,1,664000,154000,818000
Lesotho,2021,2,160000,70000,230000
Lesotho,2021,3,70000,170000,240000
Lesotho,2021,4,82000,25000,107000
Lesotho,2021,5,85000,17000,102000
Lesotho,2021,6,62000,429000,491000
Lesotho,2021,7,360000,581000,941000
Lesotho,2021,8,12000,198000,210000
Lesotho,2021,9,1830000,197000,2027000
Lesotho,2021,10,166000,812000,978000
Lesotho,2021,11,123000,883000,1006000
Lesotho,2021,12,5000,248000,253000
Lesotho,2022,1,79000,166000,245000
Lesotho,2022,2,54000,391000,445000
Lesotho,2022,3,715000,674000,1389000
Lesotho,2022,4,178000,87000,265000
Lesotho,2022,5,133000,56000,189000
Lesotho,2022,6,87000,134000,221000
Lesotho,2022,7,86000,339000,425000
Lesotho,2022,8,83000,335000,418000
Lesotho,2022,9,57000,621000,678000
Lesotho,2022,10,432000,775000,1207000
Lesotho,2022,11,16000,445000,461000
Lesotho,2022,12,31000,198000,229000
Lesotho,2023,1,108000,111000,219000
Lesotho,2023,2,134000,288000,422000
Lesotho,2023,3,123000,396000,519000
Lesotho,2023,4,83000,223000,306000
Lesotho,2023,5,208000,160000,368000
Lesotho,2023,6,490000,386000,876000
Lesotho,2023,7,49000,192000,241000
Lesotho,2023,8,12000,681000,693000
Lesotho,2023,9,59000,669000,728000
Lesotho,2023,10,177000,207000,384000
Lesotho,2023,11,210000,262000,472000
Lesotho,2023,12,33000,352000,385000
Lesotho,2024,1,64000,234000,298000
Lesotho,2024,2,9000,8000,17000
Lesotho,2024,3,365000,442000,807000
Lesotho,2024,4,87000,461000,548000
Lesotho,2024,5,159000,216000,375000
Lesotho,2024,6,113000,202000,315000
Lesotho,2024,7,1059000,411000,1470000
Lesotho,2024,8,1818000,557000,2375000
Lesotho,2024,9,247000,639000,886000
Lesotho,2024,10,197000,658000,855000
Lesotho,2024,11,156000,558000,714000
Lesotho,2024,12,171000,392000,563000
Lettland (ab 1992),2008,1,119039000,44195000,163234000
Lettland (ab 1992),2008,2,121749000,44781000,166530000
Lettland (ab 1992),2008,3,132635000,47379000,180014000
Lettland (ab 1992),2008,4,132919000,41775000,174694000
Lettland (ab 1992),2008,5,126382000,41444000,167826000
Lettland (ab 1992),2008,6,126895000,37437000,164332000
Lettland (ab 1992),2008,7,138630000,38888000,177518000
Lettland (ab 1992),2008,8,115292000,38389000,153681000
Lettland (ab 1992),2008,9,119727000,33132000,152859000
Lettland (ab 1992),2008,10,110540000,39796000,150336000
Lettland (ab 1992),2008,11,87245000,38309000,125554000
Lettland (ab 1992),2008,12,80367000,29816000,110183000
Lettland (ab 1992),2009,1,68358000,29089000,97447000
Lettland (ab 1992),2009,2,61851000,26922000,88773000
Lettland (ab 1992),2009,3,68018000,35756000,103774000
Lettland (ab 1992),2009,4,67687000,32314000,100001000
Lettland (ab 1992),2009,5,59738000,28242000,87980000
Lettland (ab 1992),2009,6,62476000,35545000,98021000
Lettland (ab 1992),2009,7,68541000,33966000,102507000
Lettland (ab 1992),2009,8,57405000,32914000,90319000
Lettland (ab 1992),2009,9,78357000,31419000,109776000
Lettland (ab 1992),2009,10,74240000,34576000,108816000
Lettland (ab 1992),2009,11,68449000,33886000,102335000
Lettland (ab 1992),2009,12,73825000,34349000,108174000
Lettland (ab 1992),2010,1,58811000,31606000,90417000
Lettland (ab 1992),2010,2,70049000,41677000,111726000
Lettland (ab 1992),2010,3,77045000,44478000,121523000
Lettland (ab 1992),2010,4,72467000,36839000,109306000
Lettland (ab 1992),2010,5,77865000,42143000,120008000
Lettland (ab 1992),2010,6,88004000,57773000,145777000
Lettland (ab 1992),2010,7,82710000,52622000,135332000
Lettland (ab 1992),2010,8,76449000,56992000,133441000
Lettland (ab 1992),2010,9,84552000,53089000,137641000
Lettland (ab 1992),2010,10,97389000,50346000,147735000
Lettland (ab 1992),2010,11,89825000,59631000,149456000
Lettland (ab 1992),2010,12,84657000,53667000,138324000
Lettland (ab 1992),2011,1,90374000,49399000,139773000
Lettland (ab 1992),2011,2,83305000,46449000,129754000
Lettland (ab 1992),2011,3,110299000,56459000,166758000
Lettland (ab 1992),2011,4,111522000,49408000,160930000
Lettland (ab 1992),2011,5,107411000,53685000,161096000
Lettland (ab 1992),2011,6,116654000,67785000,184439000
Lettland (ab 1992),2011,7,121319000,51779000,173098000
Lettland (ab 1992),2011,8,114328000,53227000,167555000
Lettland (ab 1992),2011,9,121046000,54398000,175444000
Lettland (ab 1992),2011,10,142298000,64806000,207104000
Lettland (ab 1992),2011,11,111924000,57208000,169132000
Lettland (ab 1992),2011,12,91896000,53159000,145055000
Lettland (ab 1992),2012,1,122631000,50909000,173540000
Lettland (ab 1992),2012,2,133198000,58033000,191231000
Lettland (ab 1992),2012,3,137308000,52350000,189658000
Lettland (ab 1992),2012,4,102984000,59368000,162352000
Lettland (ab 1992),2012,5,111733000,50487000,162220000
Lettland (ab 1992),2012,6,124519000,49661000,174180000
Lettland (ab 1992),2012,7,123476000,48450000,171926000
Lettland (ab 1992),2012,8,117562000,61626000,179188000
Lettland (ab 1992),2012,9,118214000,62833000,181047000
Lettland (ab 1992),2012,10,131174000,72529000,203703000
Lettland (ab 1992),2012,11,119272000,72607000,191879000
Lettland (ab 1992),2012,12,91260000,40305000,131565000
Lettland (ab 1992),2013,1,109728000,54266000,163994000
Lettland (ab 1992),2013,2,99989000,53578000,153567000
Lettland (ab 1992),2013,3,117922000,49779000,167701000
Lettland (ab 1992),2013,4,127624000,52375000,179999000
Lettland (ab 1992),2013,5,111192000,60459000,171651000
Lettland (ab 1992),2013,6,133603000,52858000,186461000
Lettland (ab 1992),2013,7,129428000,44022000,173450000
Lettland (ab 1992),2013,8,120757000,52254000,173011000
Lettland (ab 1992),2013,9,129747000,57511000,187258000
Lettland (ab 1992),2013,10,127639000,63181000,190820000
Lettland (ab 1992),2013,11,119853000,55261000,175114000
Lettland (ab 1992),2013,12,98606000,40505000,139111000
Lettland (ab 1992),2014,1,116219000,54832000,171051000
Lettland (ab 1992),2014,2,128358000,47364000,175722000
Lettland (ab 1992),2014,3,114667000,48834000,163501000
Lettland (ab 1992),2014,4,133384000,54936000,188320000
Lettland (ab 1992),2014,5,123037000,52016000,175053000
Lettland (ab 1992),2014,6,132786000,55203000,187989000
Lettland (ab 1992),2014,7,136775000,48774000,185549000
Lettland (ab 1992),2014,8,128203000,51959000,180162000
Lettland (ab 1992),2014,9,130972000,59234000,190206000
Lettland (ab 1992),2014,10,136501000,60447000,196948000
Lettland (ab 1992),2014,11,121323000,63821000,185144000
Lettland (ab 1992),2014,12,113080000,45040000,158120000
Lettland (ab 1992),2015,1,108593000,51096000,159689000
Lettland (ab 1992),2015,2,111845000,47534000,159379000
Lettland (ab 1992),2015,3,132934000,59401000,192335000
Lettland (ab 1992),2015,4,139817000,54884000,194701000
Lettland (ab 1992),2015,5,132410000,56031000,188441000
Lettland (ab 1992),2015,6,160324000,46176000,206500000
Lettland (ab 1992),2015,7,165163000,57180000,222343000
Lettland (ab 1992),2015,8,125542000,55570000,181112000
Lettland (ab 1992),2015,9,140052000,60439000,200491000
Lettland (ab 1992),2015,10,142543000,59193000,201736000
Lettland (ab 1992),2015,11,131594000,54989000,186583000
Lettland (ab 1992),2015,12,128602000,43152000,171754000
Lettland (ab 1992),2016,1,117451000,54683000,172134000
Lettland (ab 1992),2016,2,129664000,57158000,186822000
Lettland (ab 1992),2016,3,140541000,53827000,194368000
Lettland (ab 1992),2016,4,154499000,54916000,209415000
Lettland (ab 1992),2016,5,135593000,57382000,192975000
Lettland (ab 1992),2016,6,156230000,54915000,211145000
Lettland (ab 1992),2016,7,143009000,53994000,197003000
Lettland (ab 1992),2016,8,136658000,60256000,196914000
Lettland (ab 1992),2016,9,146277000,82412000,228689000
Lettland (ab 1992),2016,10,143030000,86262000,229292000
Lettland (ab 1992),2016,11,154410000,72709000,227119000
Lettland (ab 1992),2016,12,131690000,51733000,183423000
Lettland (ab 1992),2017,1,126534000,67650000,194184000
Lettland (ab 1992),2017,2,140554000,63866000,204420000
Lettland (ab 1992),2017,3,152571000,68008000,220579000
Lettland (ab 1992),2017,4,156936000,68136000,225072000
Lettland (ab 1992),2017,5,158134000,67787000,225921000
Lettland (ab 1992),2017,6,149301000,78122000,227423000
Lettland (ab 1992),2017,7,154857000,70789000,225646000
Lettland (ab 1992),2017,8,150837000,75556000,226393000
Lettland (ab 1992),2017,9,161744000,77429000,239173000
Lettland (ab 1992),2017,10,148977000,82378000,231355000
Lettland (ab 1992),2017,11,167768000,68365000,236133000
Lettland (ab 1992),2017,12,127060000,72368000,199428000
Lettland (ab 1992),2018,1,148329000,67836000,216165000
Lettland (ab 1992),2018,2,144591000,74092000,218683000
Lettland (ab 1992),2018,3,158446000,77543000,235989000
Lettland (ab 1992),2018,4,151660000,75002000,226662000
Lettland (ab 1992),2018,5,154029000,80615000,234644000
Lettland (ab 1992),2018,6,161669000,88874000,250543000
Lettland (ab 1992),2018,7,161372000,75837000,237209000
Lettland (ab 1992),2018,8,144127000,83026000,227153000
Lettland (ab 1992),2018,9,150627000,78260000,228887000
Lettland (ab 1992),2018,10,146232000,69000000,215232000
Lettland (ab 1992),2018,11,145335000,78466000,223801000
Lettland (ab 1992),2018,12,126928000,67558000,194486000
Lettland (ab 1992),2019,1,128727000,61821000,190548000
Lettland (ab 1992),2019,2,127238000,67830000,195068000
Lettland (ab 1992),2019,3,149949000,85184000,235133000
Lettland (ab 1992),2019,4,139518000,76265000,215783000
Lettland (ab 1992),2019,5,146041000,64745000,210786000
Lettland (ab 1992),2019,6,151317000,75747000,227064000
Lettland (ab 1992),2019,7,147818000,67237000,215055000
Lettland (ab 1992),2019,8,153260000,77360000,230620000
Lettland (ab 1992),2019,9,145340000,74144000,219484000
Lettland (ab 1992),2019,10,152017000,81181000,233198000
Lettland (ab 1992),2019,11,163484000,83378000,246862000
Lettland (ab 1992),2019,12,120434000,57057000,177491000
Lettland (ab 1992),2020,1,135057000,92903000,227960000
Lettland (ab 1992),2020,2,134602000,74807000,209409000
Lettland (ab 1992),2020,3,141611000,73767000,215378000
Lettland (ab 1992),2020,4,106777000,72552000,179329000
Lettland (ab 1992),2020,5,104647000,70862000,175509000
Lettland (ab 1992),2020,6,121405000,64605000,186010000
Lettland (ab 1992),2020,7,144541000,68016000,212557000
Lettland (ab 1992),2020,8,124541000,86037000,210578000
Lettland (ab 1992),2020,9,134358000,92757000,227115000
Lettland (ab 1992),2020,10,144831000,87453000,232284000
Lettland (ab 1992),2020,11,144056000,88446000,232502000
Lettland (ab 1992),2020,12,126131000,61813000,187944000
Lettland (ab 1992),2021,1,124680000,67957000,192637000
Lettland (ab 1992),2021,2,141287000,74900000,216187000
Lettland (ab 1992),2021,3,169355000,88495000,257850000
Lettland (ab 1992),2021,4,191865000,81208000,273073000
Lettland (ab 1992),2021,5,172490000,90390000,262880000
Lettland (ab 1992),2021,6,154237000,89876000,244113000
Lettland (ab 1992),2021,7,173441000,91018000,264459000
Lettland (ab 1992),2021,8,161375000,102214000,263589000
Lettland (ab 1992),2021,9,179308000,101383000,280691000
Lettland (ab 1992),2021,10,182360000,97638000,279998000
Lettland (ab 1992),2021,11,179894000,128570000,308464000
Lettland (ab 1992),2021,12,179082000,80355000,259437000
Lettland (ab 1992),2022,1,192305000,92291000,284596000
Lettland (ab 1992),2022,2,195508000,90627000,286135000
Lettland (ab 1992),2022,3,229931000,108220000,338151000
Lettland (ab 1992),2022,4,198994000,98960000,297954000
Lettland (ab 1992),2022,5,212950000,109187000,322137000
Lettland (ab 1992),2022,6,230286000,97373000,327659000
Lettland (ab 1992),2022,7,212352000,91170000,303522000
Lettland (ab 1992),2022,8,212449000,124383000,336832000
Lettland (ab 1992),2022,9,232106000,102460000,334566000
Lettland (ab 1992),2022,10,204434000,106905000,311339000
Lettland (ab 1992),2022,11,218133000,107188000,325321000
Lettland (ab 1992),2022,12,187098000,76173000,263271000
Lettland (ab 1992),2023,1,213526000,92705000,306231000
Lettland (ab 1992),2023,2,204503000,101123000,305626000
Lettland (ab 1992),2023,3,239295000,109266000,348561000
Lettland (ab 1992),2023,4,219254000,88423000,307677000
Lettland (ab 1992),2023,5,206748000,93219000,299967000
Lettland (ab 1992),2023,6,240853000,92625000,333478000
Lettland (ab 1992),2023,7,209278000,86317000,295595000
Lettland (ab 1992),2023,8,230127000,85653000,315780000
Lettland (ab 1992),2023,9,202389000,105804000,308193000
Lettland (ab 1992),2023,10,205961000,104000000,309961000
Lettland (ab 1992),2023,11,210644000,94383000,305027000
Lettland (ab 1992),2023,12,203013000,73965000,276978000
Lettland (ab 1992),2024,1,198899000,93850000,292749000
Lettland (ab 1992),2024,2,215639000,87690000,303329000
Lettland (ab 1992),2024,3,221842000,95917000,317759000
Lettland (ab 1992),2024,4,221581000,90016000,311597000
Lettland (ab 1992),2024,5,205856000,97938000,303794000
Lettland (ab 1992),2024,6,211622000,76590000,288212000
Lettland (ab 1992),2024,7,225492000,83553000,309045000
Lettland (ab 1992),2024,8,223508000,80198000,303706000
Lettland (ab 1992),2024,9,213098000,88561000,301659000
Lettland (ab 1992),2024,10,225709000,82966000,308675000
Lettland (ab 1992),2024,11,209415000,82201000,291616000
Lettland (ab 1992),2024,12,186392000,67973000,254365000
Libanon,2008,1,38555000,3768000,42323000
Libanon,2008,2,40243000,2072000,42315000
Libanon,2008,3,39520000,3464000,42984000
Libanon,2008,4,48985000,4181000,53166000
Libanon,2008,5,32650000,1730000,34380000
Libanon,2008,6,41031000,4356000,45387000
Libanon,2008,7,45761000,4248000,50009000
Libanon,2008,8,43397000,3046000,46443000
Libanon,2008,9,46166000,2351000,48517000
Libanon,2008,10,51566000,3490000,55056000
Libanon,2008,11,54112000,2343000,56455000
Libanon,2008,12,46761000,2538000,49299000
Libanon,2009,1,42634000,2997000,45631000
Libanon,2009,2,49184000,2119000,51303000
Libanon,2009,3,55995000,1811000,57806000
Libanon,2009,4,46628000,1616000,48244000
Libanon,2009,5,45445000,1963000,47408000
Libanon,2009,6,44303000,3670000,47973000
Libanon,2009,7,59995000,1481000,61476000
Libanon,2009,8,45390000,2652000,48042000
Libanon,2009,9,55691000,1078000,56769000
Libanon,2009,10,52165000,1901000,54066000
Libanon,2009,11,57266000,1467000,58733000
Libanon,2009,12,47260000,3781000,51041000
Libanon,2010,1,38886000,2237000,41123000
Libanon,2010,2,56326000,3020000,59346000
Libanon,2010,3,68828000,2185000,71013000
Libanon,2010,4,56120000,1728000,57848000
Libanon,2010,5,93456000,3291000,96747000
Libanon,2010,6,112912000,2956000,115868000
Libanon,2010,7,67824000,3361000,71185000
Libanon,2010,8,55449000,1660000,57109000
Libanon,2010,9,64884000,2298000,67182000
Libanon,2010,10,57851000,1419000,59270000
Libanon,2010,11,54632000,2907000,57539000
Libanon,2010,12,49064000,3263000,52327000
Libanon,2011,1,43526000,2951000,46477000
Libanon,2011,2,53578000,3390000,56968000
Libanon,2011,3,67862000,5327000,73189000
Libanon,2011,4,91955000,4195000,96150000
Libanon,2011,5,59272000,2636000,61908000
Libanon,2011,6,48139000,4491000,52630000
Libanon,2011,7,53610000,6526000,60136000
Libanon,2011,8,49848000,3437000,53285000
Libanon,2011,9,62283000,3673000,65956000
Libanon,2011,10,56595000,1651000,58246000
Libanon,2011,11,61507000,2625000,64132000
Libanon,2011,12,56428000,3232000,59660000
Libanon,2012,1,89653000,3556000,93209000
Libanon,2012,2,57508000,4946000,62454000
Libanon,2012,3,67091000,3799000,70890000
Libanon,2012,4,67658000,3234000,70892000
Libanon,2012,5,108806000,5095000,113901000
Libanon,2012,6,69420000,4031000,73451000
Libanon,2012,7,65667000,3901000,69568000
Libanon,2012,8,66170000,4815000,70985000
Libanon,2012,9,63237000,3638000,66875000
Libanon,2012,10,77279000,3305000,80584000
Libanon,2012,11,64764000,3979000,68743000
Libanon,2012,12,63921000,2781000,66702000
Libanon,2013,1,54145000,4460000,58605000
Libanon,2013,2,74421000,2287000,76708000
Libanon,2013,3,71730000,2927000,74657000
Libanon,2013,4,75454000,3324000,78778000
Libanon,2013,5,66417000,3281000,69698000
Libanon,2013,6,61008000,6809000,67817000
Libanon,2013,7,60798000,1979000,62777000
Libanon,2013,8,64227000,5798000,70025000
Libanon,2013,9,60527000,3472000,63999000
Libanon,2013,10,59944000,4382000,64326000
Libanon,2013,11,69682000,4987000,74669000
Libanon,2013,12,54090000,5339000,59429000
Libanon,2014,1,55204000,3179000,58383000
Libanon,2014,2,79817000,3212000,83029000
Libanon,2014,3,68199000,3413000,71612000
Libanon,2014,4,61896000,4535000,66431000
Libanon,2014,5,66223000,3298000,69521000
Libanon,2014,6,61525000,5689000,67214000
Libanon,2014,7,75405000,3058000,78463000
Libanon,2014,8,54910000,2827000,57737000
Libanon,2014,9,68470000,5059000,73529000
Libanon,2014,10,64736000,3419000,68155000
Libanon,2014,11,61730000,3275000,65005000
Libanon,2014,12,52979000,3539000,56518000
Libanon,2015,1,62253000,4393000,66646000
Libanon,2015,2,64928000,3320000,68248000
Libanon,2015,3,79958000,3854000,83812000
Libanon,2015,4,75007000,3844000,78851000
Libanon,2015,5,65665000,5115000,70780000
Libanon,2015,6,71053000,3638000,74691000
Libanon,2015,7,71839000,2846000,74685000
Libanon,2015,8,63679000,2983000,66662000
Libanon,2015,9,67407000,3200000,70607000
Libanon,2015,10,72573000,4019000,76592000
Libanon,2015,11,67765000,4527000,72292000
Libanon,2015,12,54835000,3797000,58632000
Libanon,2016,1,53649000,3405000,57054000
Libanon,2016,2,67262000,3281000,70543000
Libanon,2016,3,77376000,5472000,82848000
Libanon,2016,4,82831000,5011000,87842000
Libanon,2016,5,67463000,8418000,75881000
Libanon,2016,6,67535000,6707000,74242000
Libanon,2016,7,75679000,2925000,78604000
Libanon,2016,8,66385000,1188000,67573000
Libanon,2016,9,62778000,3505000,66283000
Libanon,2016,10,63831000,2828000,66659000
Libanon,2016,11,67488000,6534000,74022000
Libanon,2016,12,63060000,3214000,66274000
Libanon,2017,1,62285000,3506000,65791000
Libanon,2017,2,75953000,2548000,78501000
Libanon,2017,3,84850000,4430000,89280000
Libanon,2017,4,74496000,3204000,77700000
Libanon,2017,5,74465000,3243000,77708000
Libanon,2017,6,66497000,5793000,72290000
Libanon,2017,7,61193000,3482000,64675000
Libanon,2017,8,65887000,5998000,71885000
Libanon,2017,9,64333000,2837000,67170000
Libanon,2017,10,66722000,3227000,69949000
Libanon,2017,11,61542000,3907000,65449000
Libanon,2017,12,55862000,3650000,59512000
Libanon,2018,1,58774000,2570000,61344000
Libanon,2018,2,71265000,2676000,73941000
Libanon,2018,3,64037000,6282000,70319000
Libanon,2018,4,56196000,5230000,61426000
Libanon,2018,5,53342000,2845000,56187000
Libanon,2018,6,63044000,3214000,66258000
Libanon,2018,7,70448000,3074000,73522000
Libanon,2018,8,60291000,3330000,63621000
Libanon,2018,9,66421000,3952000,70373000
Libanon,2018,10,71042000,2749000,73791000
Libanon,2018,11,65414000,4066000,69480000
Libanon,2018,12,59648000,2844000,62492000
Libanon,2019,1,53211000,3034000,56245000
Libanon,2019,2,71637000,4548000,76185000
Libanon,2019,3,59416000,2933000,62349000
Libanon,2019,4,57147000,3032000,60179000
Libanon,2019,5,61649000,3410000,65059000
Libanon,2019,6,56216000,3432000,59648000
Libanon,2019,7,57472000,4256000,61728000
Libanon,2019,8,53063000,3146000,56209000
Libanon,2019,9,60602000,2888000,63490000
Libanon,2019,10,47351000,3702000,51053000
Libanon,2019,11,28919000,2723000,31642000
Libanon,2019,12,38711000,2968000,41679000
Libanon,2020,1,25754000,4773000,30527000
Libanon,2020,2,32851000,4141000,36992000
Libanon,2020,3,35588000,4668000,40256000
Libanon,2020,4,23101000,5495000,28596000
Libanon,2020,5,22508000,1667000,24175000
Libanon,2020,6,29203000,5086000,34289000
Libanon,2020,7,163720000,6427000,170147000
Libanon,2020,8,23128000,4929000,28057000
Libanon,2020,9,43337000,3364000,46701000
Libanon,2020,10,42855000,3100000,45955000
Libanon,2020,11,96884000,3520000,100404000
Libanon,2020,12,226114000,4723000,230837000
Libanon,2021,1,30925000,1795000,32720000
Libanon,2021,2,32053000,3698000,35751000
Libanon,2021,3,32663000,4196000,36859000
Libanon,2021,4,97036000,4492000,101528000
Libanon,2021,5,93723000,3999000,97722000
Libanon,2021,6,34000000,3122000,37122000
Libanon,2021,7,28402000,3373000,31775000
Libanon,2021,8,28390000,3478000,31868000
Libanon,2021,9,29246000,3909000,33155000
Libanon,2021,10,29414000,3054000,32468000
Libanon,2021,11,41614000,3225000,44839000
Libanon,2021,12,39429000,3561000,42990000
Libanon,2022,1,33039000,2575000,35614000
Libanon,2022,2,33760000,4217000,37977000
Libanon,2022,3,46688000,6032000,52720000
Libanon,2022,4,39054000,3855000,42909000
Libanon,2022,5,40217000,3769000,43986000
Libanon,2022,6,45291000,4918000,50209000
Libanon,2022,7,47073000,4244000,51317000
Libanon,2022,8,41797000,3052000,44849000
Libanon,2022,9,46800000,4711000,51511000
Libanon,2022,10,40334000,4618000,44952000
Libanon,2022,11,46980000,3133000,50113000
Libanon,2022,12,44501000,9250000,53751000
Libanon,2023,1,35731000,3806000,39537000
Libanon,2023,2,38533000,4089000,42622000
Libanon,2023,3,40980000,5381000,46361000
Libanon,2023,4,32196000,3416000,35612000
Libanon,2023,5,41258000,4974000,46232000
Libanon,2023,6,40841000,3980000,44821000
Libanon,2023,7,36200000,4599000,40799000
Libanon,2023,8,43180000,3452000,46632000
Libanon,2023,9,39958000,11817000,51775000
Libanon,2023,10,40651000,3803000,44454000
Libanon,2023,11,35401000,5455000,40856000
Libanon,2023,12,29653000,2264000,31917000
Libanon,2024,1,32106000,3321000,35427000
Libanon,2024,2,42217000,4639000,46856000
Libanon,2024,3,39907000,3334000,43241000
Libanon,2024,4,38410000,3859000,42269000
Libanon,2024,5,36695000,4000000,40695000
Libanon,2024,6,117727000,2655000,120382000
Libanon,2024,7,51486000,3584000,55070000
Libanon,2024,8,37627000,3562000,41189000
Libanon,2024,9,38463000,3193000,41656000
Libanon,2024,10,32975000,3762000,36737000
Libanon,2024,11,35019000,5860000,40879000
Libanon,2024,12,34751000,4299000,39050000
Liberia,2008,1,2166000,1679000,3845000
Liberia,2008,2,1253000,581000,1834000
Liberia,2008,3,988000,40091000,41079000
Liberia,2008,4,1373000,1975000,3348000
Liberia,2008,5,40754000,1033000,41787000
Liberia,2008,6,2861000,760000,3621000
Liberia,2008,7,1081000,1280000,2361000
Liberia,2008,8,957000,1627000,2584000
Liberia,2008,9,19484000,1631000,21115000
Liberia,2008,10,1428000,2215000,3643000
Liberia,2008,11,82714000,1234000,83948000
Liberia,2008,12,41986000,1160000,43146000
Liberia,2009,1,3242000,2113000,5355000
Liberia,2009,2,55297000,22411000,77708000
Liberia,2009,3,1499000,429000,1928000
Liberia,2009,4,998000,944000,1942000
Liberia,2009,5,863000,2207000,3070000
Liberia,2009,6,1430000,1447000,2877000
Liberia,2009,7,1550000,894000,2444000
Liberia,2009,8,1202000,248000,1450000
Liberia,2009,9,2923000,96830000,99753000
Liberia,2009,10,1456000,49754000,51210000
Liberia,2009,11,4537000,85499000,90036000
Liberia,2009,12,972000,1189000,2161000
Liberia,2010,1,693000,1763000,2456000
Liberia,2010,2,983000,1069000,2052000
Liberia,2010,3,13751000,16690000,30441000
Liberia,2010,4,2380000,1813000,4193000
Liberia,2010,5,1282000,1154000,2436000
Liberia,2010,6,1079000,459000,1538000
Liberia,2010,7,81360000,1182000,82542000
Liberia,2010,8,1357000,585000,1942000
Liberia,2010,9,705000,607000,1312000
Liberia,2010,10,1306000,925000,2231000
Liberia,2010,11,1624000,1291000,2915000
Liberia,2010,12,897000,425000,1322000
Liberia,2011,1,33554000,1076000,34630000
Liberia,2011,2,57310000,1178000,58488000
Liberia,2011,3,1951000,2118000,4069000
Liberia,2011,4,62312000,2308000,64620000
Liberia,2011,5,31545000,4084000,35629000
Liberia,2011,6,2114000,391000,2505000
Liberia,2011,7,33059000,1304000,34363000
Liberia,2011,8,33377000,7307000,40684000
Liberia,2011,9,1000000,4875000,5875000
Liberia,2011,10,8343000,4036000,12379000
Liberia,2011,11,25145000,1264000,26409000
Liberia,2011,12,26743000,1091000,27834000
Liberia,2012,1,26770000,1319000,28089000
Liberia,2012,2,1196000,1224000,2420000
Liberia,2012,3,1425000,1274000,2699000
Liberia,2012,4,6755000,480000,7235000
Liberia,2012,5,3553000,797000,4350000
Liberia,2012,6,11839000,1150000,12989000
Liberia,2012,7,2119000,1949000,4068000
Liberia,2012,8,1450000,1946000,3396000
Liberia,2012,9,2659000,1291000,3950000
Liberia,2012,10,1808000,1231000,3039000
Liberia,2012,11,10963000,576000,11539000
Liberia,2012,12,1827000,2299000,4126000
Liberia,2013,1,2265000,1992000,4257000
Liberia,2013,2,2132000,1500000,3632000
Liberia,2013,3,4254000,3590000,7844000
Liberia,2013,4,4371000,7435000,11806000
Liberia,2013,5,16332000,4161000,20493000
Liberia,2013,6,15069000,2347000,17416000
Liberia,2013,7,1006000,4456000,5462000
Liberia,2013,8,18353000,6014000,24367000
Liberia,2013,9,1316000,3397000,4713000
Liberia,2013,10,3822000,1981000,5803000
Liberia,2013,11,3137000,3946000,7083000
Liberia,2013,12,14369000,4903000,19272000
Liberia,2014,1,7722000,3819000,11541000
Liberia,2014,2,36287000,1857000,38144000
Liberia,2014,3,11347000,1507000,12854000
Liberia,2014,4,1023000,1669000,2692000
Liberia,2014,5,54831000,3361000,58192000
Liberia,2014,6,67596000,1343000,68939000
Liberia,2014,7,6224000,1443000,7667000
Liberia,2014,8,9963000,402000,10365000
Liberia,2014,9,86138000,48932000,135070000
Liberia,2014,10,32790000,813000,33603000
Liberia,2014,11,2353000,925000,3278000
Liberia,2014,12,16161000,1675000,17836000
Liberia,2015,1,3231000,2052000,5283000
Liberia,2015,2,5891000,1386000,7277000
Liberia,2015,3,26519000,923000,27442000
Liberia,2015,4,1119000,1807000,2926000
Liberia,2015,5,4595000,141000,4736000
Liberia,2015,6,138575000,230000,138805000
Liberia,2015,7,15992000,2362000,18354000
Liberia,2015,8,16020000,1305000,17325000
Liberia,2015,9,36172000,1614000,37786000
Liberia,2015,10,10490000,904000,11394000
Liberia,2015,11,39412000,3228000,42640000
Liberia,2015,12,1448000,767000,2215000
Liberia,2016,1,2641000,32500000,35141000
Liberia,2016,2,7117000,2045000,9162000
Liberia,2016,3,6735000,303000,7038000
Liberia,2016,4,64268000,3529000,67797000
Liberia,2016,5,6425000,2330000,8755000
Liberia,2016,6,14929000,9845000,24774000
Liberia,2016,7,38007000,3927000,41934000
Liberia,2016,8,2084000,3421000,5505000
Liberia,2016,9,1310000,1866000,3176000
Liberia,2016,10,5595000,2240000,7835000
Liberia,2016,11,6178000,3684000,9862000
Liberia,2016,12,42610000,1600000,44210000
Liberia,2017,1,1808000,2013000,3821000
Liberia,2017,2,15471000,525000,15996000
Liberia,2017,3,4446000,2177000,6623000
Liberia,2017,4,12456000,3110000,15566000
Liberia,2017,5,1488000,2449000,3937000
Liberia,2017,6,27116000,2755000,29871000
Liberia,2017,7,7540000,70656000,78196000
Liberia,2017,8,16908000,749000,17657000
Liberia,2017,9,4299000,68313000,72612000
Liberia,2017,10,45931000,194875000,240806000
Liberia,2017,11,11687000,356000,12043000
Liberia,2017,12,665000,68261000,68926000
Liberia,2018,1,4824000,3365000,8189000
Liberia,2018,2,568000,78175000,78743000
Liberia,2018,3,22710000,3815000,26525000
Liberia,2018,4,18083000,1936000,20019000
Liberia,2018,5,18039000,3436000,21475000
Liberia,2018,6,32296000,2319000,34615000
Liberia,2018,7,24067000,19388000,43455000
Liberia,2018,8,854000,1906000,2760000
Liberia,2018,9,58389000,1386000,59775000
Liberia,2018,10,30007000,1407000,31414000
Liberia,2018,11,42577000,2012000,44589000
Liberia,2018,12,708000,3209000,3917000
Liberia,2019,1,915000,3514000,4429000
Liberia,2019,2,31458000,6239000,37697000
Liberia,2019,3,35876000,4920000,40796000
Liberia,2019,4,6010000,13455000,19465000
Liberia,2019,5,5795000,561000,6356000
Liberia,2019,6,28133000,6886000,35019000
Liberia,2019,7,51073000,8966000,60039000
Liberia,2019,8,35097000,3705000,38802000
Liberia,2019,9,19527000,4399000,23926000
Liberia,2019,10,4592000,4239000,8831000
Liberia,2019,11,593000,11438000,12031000
Liberia,2019,12,602000,9000,611000
Liberia,2020,1,21189000,8315000,29504000
Liberia,2020,2,7968000,846000,8814000
Liberia,2020,3,15999000,16079000,32078000
Liberia,2020,4,10446000,8043000,18489000
Liberia,2020,5,6305000,3742000,10047000
Liberia,2020,6,113784000,5890000,119674000
Liberia,2020,7,998000,440000,1438000
Liberia,2020,8,1062000,5915000,6977000
Liberia,2020,9,4248000,14554000,18802000
Liberia,2020,10,7144000,8230000,15374000
Liberia,2020,11,2217000,14279000,16496000
Liberia,2020,12,90617000,3631000,94248000
Liberia,2021,1,20377000,11599000,31976000
Liberia,2021,2,11988000,403000,12391000
Liberia,2021,3,142117000,10791000,152908000
Liberia,2021,4,3422000,28503000,31925000
Liberia,2021,5,13070000,19605000,32675000
Liberia,2021,6,13043000,5908000,18951000
Liberia,2021,7,65259000,19578000,84837000
Liberia,2021,8,1531000,6447000,7978000
Liberia,2021,9,243755000,11419000,255174000
Liberia,2021,10,45250000,19983000,65233000
Liberia,2021,11,89538000,3328000,92866000
Liberia,2021,12,19958000,6573000,26531000
Liberia,2022,1,85083000,15942000,101025000
Liberia,2022,2,88533000,6100000,94633000
Liberia,2022,3,49104000,8290000,57394000
Liberia,2022,4,20229000,8750000,28979000
Liberia,2022,5,54411000,12527000,66938000
Liberia,2022,6,49722000,47367000,97089000
Liberia,2022,7,1129000,7048000,8177000
Liberia,2022,8,27292000,28983000,56275000
Liberia,2022,9,23335000,13757000,37092000
Liberia,2022,10,316231000,7812000,324043000
Liberia,2022,11,64075000,8218000,72293000
Liberia,2022,12,23651000,5078000,28729000
Liberia,2023,1,65473000,11807000,77280000
Liberia,2023,2,31795000,8004000,39799000
Liberia,2023,3,34244000,34939000,69183000
Liberia,2023,4,45209000,9252000,54461000
Liberia,2023,5,107089000,37551000,144640000
Liberia,2023,6,589477000,8080000,597557000
Liberia,2023,7,59119000,6907000,66026000
Liberia,2023,8,25876000,7490000,33366000
Liberia,2023,9,2066000,4279000,6345000
Liberia,2023,10,23041000,2390000,25431000
Liberia,2023,11,32292000,32800000,65092000
Liberia,2023,12,1653000,7307000,8960000
Liberia,2024,1,33737000,3396000,37133000
Liberia,2024,2,25028000,4494000,29522000
Liberia,2024,3,20325000,4900000,25225000
Liberia,2024,4,47840000,102341000,150181000
Liberia,2024,5,20543000,53951000,74494000
Liberia,2024,6,45462000,3684000,49146000
Liberia,2024,7,25523000,32098000,57621000
Liberia,2024,8,30364000,7610000,37974000
Liberia,2024,9,84299000,8908000,93207000
Liberia,2024,10,22403000,2086000,24489000
Liberia,2024,11,1204000,6500000,7704000
Liberia,2024,12,13392000,3153000,16545000
Libyen,2008,1,50341000,439635000,489976000
Libyen,2008,2,56067000,534180000,590247000
Libyen,2008,3,50861000,359710000,410571000
Libyen,2008,4,83736000,531606000,615342000
Libyen,2008,5,79575000,418346000,497921000
Libyen,2008,6,67469000,628289000,695758000
Libyen,2008,7,68556000,462363000,530919000
Libyen,2008,8,94641000,650328000,744969000
Libyen,2008,9,113261000,359983000,473244000
Libyen,2008,10,211930000,523249000,735179000
Libyen,2008,11,78378000,328479000,406857000
Libyen,2008,12,92082000,282571000,374653000
Libyen,2009,1,96556000,316468000,413024000
Libyen,2009,2,125397000,243040000,368437000
Libyen,2009,3,137029000,58847000,195876000
Libyen,2009,4,91914000,214817000,306731000
Libyen,2009,5,89685000,202579000,292264000
Libyen,2009,6,75691000,73206000,148897000
Libyen,2009,7,84388000,249152000,333540000
Libyen,2009,8,104376000,392723000,497099000
Libyen,2009,9,75831000,282990000,358821000
Libyen,2009,10,84762000,269323000,354085000
Libyen,2009,11,66041000,338278000,404319000
Libyen,2009,12,101889000,177598000,279487000
Libyen,2010,1,56549000,228989000,285538000
Libyen,2010,2,88880000,140649000,229529000
Libyen,2010,3,94803000,270649000,365452000
Libyen,2010,4,57142000,336178000,393320000
Libyen,2010,5,73730000,192855000,266585000
Libyen,2010,6,81682000,377712000,459394000
Libyen,2010,7,71605000,157229000,228834000
Libyen,2010,8,51930000,330063000,381993000
Libyen,2010,9,72656000,289459000,362115000
Libyen,2010,10,71354000,139273000,210627000
Libyen,2010,11,144279000,395349000,539628000
Libyen,2010,12,88123000,244620000,332743000
Libyen,2011,1,63718000,465234000,528952000
Libyen,2011,2,58223000,371956000,430179000
Libyen,2011,3,2632000,264731000,267363000
Libyen,2011,4,3613000,424878000,428491000
Libyen,2011,5,6687000,58173000,64860000
Libyen,2011,6,9171000,142297000,151468000
Libyen,2011,7,4791000,21614000,26405000
Libyen,2011,8,7312000,319000,7631000
Libyen,2011,9,18985000,116000,19101000
Libyen,2011,10,17504000,30314000,47818000
Libyen,2011,11,91332000,70535000,161867000
Libyen,2011,12,35239000,138262000,173501000
Libyen,2012,1,56892000,249535000,306427000
Libyen,2012,2,38463000,353339000,391802000
Libyen,2012,3,55517000,476167000,531684000
Libyen,2012,4,44835000,445293000,490128000
Libyen,2012,5,48230000,590723000,638953000
Libyen,2012,6,50294000,536069000,586363000
Libyen,2012,7,60996000,203289000,264285000
Libyen,2012,8,66892000,412916000,479808000
Libyen,2012,9,53773000,541563000,595336000
Libyen,2012,10,59215000,534257000,593472000
Libyen,2012,11,67831000,496362000,564193000
Libyen,2012,12,87595000,700866000,788461000
Libyen,2013,1,51556000,502185000,553741000
Libyen,2013,2,94576000,644761000,739337000
Libyen,2013,3,110749000,509963000,620712000
Libyen,2013,4,77673000,518369000,596042000
Libyen,2013,5,65115000,499190000,564305000
Libyen,2013,6,94958000,424878000,519836000
Libyen,2013,7,68360000,539779000,608139000
Libyen,2013,8,68441000,530096000,598537000
Libyen,2013,9,92355000,203011000,295366000
Libyen,2013,10,67601000,154614000,222215000
Libyen,2013,11,56862000,78891000,135753000
Libyen,2013,12,65960000,74477000,140437000
Libyen,2014,1,54228000,144727000,198955000
Libyen,2014,2,58887000,102712000,161599000
Libyen,2014,3,73532000,31416000,104948000
Libyen,2014,4,45192000,109195000,154387000
Libyen,2014,5,59976000,65604000,125580000
Libyen,2014,6,36198000,92264000,128462000
Libyen,2014,7,30268000,83442000,113710000
Libyen,2014,8,42525000,75133000,117658000
Libyen,2014,9,18180000,314191000,332371000
Libyen,2014,10,33244000,225336000,258580000
Libyen,2014,11,41405000,238817000,280222000
Libyen,2014,12,43042000,241180000,284222000
Libyen,2015,1,18272000,177237000,195509000
Libyen,2015,2,35364000,47733000,83097000
Libyen,2015,3,32330000,88074000,120404000
Libyen,2015,4,33757000,81965000,115722000
Libyen,2015,5,28541000,112197000,140738000
Libyen,2015,6,31346000,110639000,141985000
Libyen,2015,7,40746000,84986000,125732000
Libyen,2015,8,26357000,108519000,134876000
Libyen,2015,9,39957000,76757000,116714000
Libyen,2015,10,22164000,101425000,123589000
Libyen,2015,11,18668000,94789000,113457000
Libyen,2015,12,23986000,115694000,139680000
Libyen,2016,1,28663000,40660000,69323000
Libyen,2016,2,16808000,43733000,60541000
Libyen,2016,3,22356000,49539000,71895000
Libyen,2016,4,36495000,28505000,65000000
Libyen,2016,5,24307000,31209000,55516000
Libyen,2016,6,37859000,22080000,59939000
Libyen,2016,7,22445000,33095000,55540000
Libyen,2016,8,24765000,27189000,51954000
Libyen,2016,9,10160000,42530000,52690000
Libyen,2016,10,17299000,54267000,71566000
Libyen,2016,11,28509000,95120000,123629000
Libyen,2016,12,28762000,87844000,116606000
Libyen,2017,1,17411000,109235000,126646000
Libyen,2017,2,24152000,164668000,188820000
Libyen,2017,3,47148000,198373000,245521000
Libyen,2017,4,24184000,150386000,174570000
Libyen,2017,5,25629000,72328000,97957000
Libyen,2017,6,25432000,193298000,218730000
Libyen,2017,7,22491000,198056000,220547000
Libyen,2017,8,17115000,242207000,259322000
Libyen,2017,9,14766000,230586000,245352000
Libyen,2017,10,19591000,272459000,292050000
Libyen,2017,11,25049000,333895000,358944000
Libyen,2017,12,25576000,319244000,344820000
Libyen,2018,1,13583000,383111000,396694000
Libyen,2018,2,17236000,336194000,353430000
Libyen,2018,3,27227000,307191000,334418000
Libyen,2018,4,22084000,262833000,284917000
Libyen,2018,5,37602000,226917000,264519000
Libyen,2018,6,33710000,354929000,388639000
Libyen,2018,7,20397000,178729000,199126000
Libyen,2018,8,18901000,158585000,177486000
Libyen,2018,9,16504000,290403000,306907000
Libyen,2018,10,28681000,349645000,378326000
Libyen,2018,11,44438000,404208000,448646000
Libyen,2018,12,45693000,185930000,231623000
Libyen,2019,1,32436000,271657000,304093000
Libyen,2019,2,50718000,198513000,249231000
Libyen,2019,3,43270000,237440000,280710000
Libyen,2019,4,34767000,375343000,410110000
Libyen,2019,5,35096000,364439000,399535000
Libyen,2019,6,28127000,336679000,364806000
Libyen,2019,7,40159000,433044000,473203000
Libyen,2019,8,35732000,325854000,361586000
Libyen,2019,9,27742000,255063000,282805000
Libyen,2019,10,21015000,360693000,381708000
Libyen,2019,11,49295000,369433000,418728000
Libyen,2019,12,34067000,393508000,427575000
Libyen,2020,1,37783000,360248000,398031000
Libyen,2020,2,30326000,163018000,193344000
Libyen,2020,3,41048000,7607000,48655000
Libyen,2020,4,21780000,183000,21963000
Libyen,2020,5,27618000,0,27618000
Libyen,2020,6,33166000,1000,33167000
Libyen,2020,7,25130000,46000,25176000
Libyen,2020,8,33243000,5000,33248000
Libyen,2020,9,28629000,3785000,32414000
Libyen,2020,10,27908000,23147000,51055000
Libyen,2020,11,22512000,64832000,87344000
Libyen,2020,12,23073000,127110000,150183000
Libyen,2021,1,40173000,264282000,304455000
Libyen,2021,2,28353000,187374000,215727000
Libyen,2021,3,33043000,126734000,159777000
Libyen,2021,4,32973000,101414000,134387000
Libyen,2021,5,25865000,282768000,308633000
Libyen,2021,6,73580000,222790000,296370000
Libyen,2021,7,84894000,152629000,237523000
Libyen,2021,8,60182000,252516000,312698000
Libyen,2021,9,63944000,352681000,416625000
Libyen,2021,10,44929000,355532000,400461000
Libyen,2021,11,42820000,458775000,501595000
Libyen,2021,12,46438000,352568000,399006000
Libyen,2022,1,26517000,305822000,332339000
Libyen,2022,2,35585000,264247000,299832000
Libyen,2022,3,49224000,445641000,494865000
Libyen,2022,4,31847000,388511000,420358000
Libyen,2022,5,39025000,205391000,244416000
Libyen,2022,6,48833000,294317000,343150000
Libyen,2022,7,36772000,90092000,126864000
Libyen,2022,8,49388000,220971000,270359000
Libyen,2022,9,38267000,232191000,270458000
Libyen,2022,10,58399000,293447000,351846000
Libyen,2022,11,66552000,464924000,531476000
Libyen,2022,12,52669000,390456000,443125000
Libyen,2023,1,50408000,290231000,340639000
Libyen,2023,2,57820000,186724000,244544000
Libyen,2023,3,40952000,351662000,392614000
Libyen,2023,4,28793000,484442000,513235000
Libyen,2023,5,46772000,425549000,472321000
Libyen,2023,6,46642000,498493000,545135000
Libyen,2023,7,32492000,468774000,501266000
Libyen,2023,8,67502000,277820000,345322000
Libyen,2023,9,34358000,504140000,538498000
Libyen,2023,10,38318000,455001000,493319000
Libyen,2023,11,33978000,528615000,562593000
Libyen,2023,12,91517000,447629000,539146000
Libyen,2024,1,38560000,317144000,355704000
Libyen,2024,2,45673000,189877000,235550000
Libyen,2024,3,53550000,445529000,499079000
Libyen,2024,4,28847000,367600000,396447000
Libyen,2024,5,52029000,424908000,476937000
Libyen,2024,6,42300000,441819000,484119000
Libyen,2024,7,56044000,562462000,618506000
Libyen,2024,8,52260000,415187000,467447000
Libyen,2024,9,47739000,233058000,280797000
Libyen,2024,10,38862000,142257000,181119000
Libyen,2024,11,74609000,303371000,377980000
Libyen,2024,12,75688000,556705000,632393000
Liechtenstein (ab 1995),2008,1,39210000,28397000,67607000
Liechtenstein (ab 1995),2008,2,44592000,30453000,75045000
Liechtenstein (ab 1995),2008,3,44646000,29292000,73938000
Liechtenstein (ab 1995),2008,4,50465000,34814000,85279000
Liechtenstein (ab 1995),2008,5,46638000,26289000,72927000
Liechtenstein (ab 1995),2008,6,45337000,32158000,77495000
Liechtenstein (ab 1995),2008,7,61521000,30419000,91940000
Liechtenstein (ab 1995),2008,8,40449000,25754000,66203000
Liechtenstein (ab 1995),2008,9,48420000,33652000,82072000
Liechtenstein (ab 1995),2008,10,60613000,34590000,95203000
Liechtenstein (ab 1995),2008,11,34400000,32316000,66716000
Liechtenstein (ab 1995),2008,12,36240000,29551000,65791000
Liechtenstein (ab 1995),2009,1,41881000,27504000,69385000
Liechtenstein (ab 1995),2009,2,39688000,26174000,65862000
Liechtenstein (ab 1995),2009,3,43698000,33197000,76895000
Liechtenstein (ab 1995),2009,4,31686000,31951000,63637000
Liechtenstein (ab 1995),2009,5,26680000,31100000,57780000
Liechtenstein (ab 1995),2009,6,44788000,36027000,80815000
Liechtenstein (ab 1995),2009,7,52963000,33943000,86906000
Liechtenstein (ab 1995),2009,8,37321000,25487000,62808000
Liechtenstein (ab 1995),2009,9,42042000,32524000,74566000
Liechtenstein (ab 1995),2009,10,42843000,37228000,80071000
Liechtenstein (ab 1995),2009,11,48246000,35962000,84208000
Liechtenstein (ab 1995),2009,12,32252000,33596000,65848000
Liechtenstein (ab 1995),2010,1,33506000,30546000,64052000
Liechtenstein (ab 1995),2010,2,39374000,29939000,69313000
Liechtenstein (ab 1995),2010,3,44860000,34936000,79796000
Liechtenstein (ab 1995),2010,4,45787000,32829000,78616000
Liechtenstein (ab 1995),2010,5,39303000,32790000,72093000
Liechtenstein (ab 1995),2010,6,44878000,33364000,78242000
Liechtenstein (ab 1995),2010,7,48311000,35468000,83779000
Liechtenstein (ab 1995),2010,8,39187000,30536000,69723000
Liechtenstein (ab 1995),2010,9,45773000,37466000,83239000
Liechtenstein (ab 1995),2010,10,39889000,36198000,76087000
Liechtenstein (ab 1995),2010,11,42299000,38414000,80713000
Liechtenstein (ab 1995),2010,12,33129000,30959000,64088000
Liechtenstein (ab 1995),2011,1,38585000,31749000,70334000
Liechtenstein (ab 1995),2011,2,45793000,31221000,77014000
Liechtenstein (ab 1995),2011,3,52221000,40373000,92594000
Liechtenstein (ab 1995),2011,4,44364000,33654000,78018000
Liechtenstein (ab 1995),2011,5,51120000,38183000,89303000
Liechtenstein (ab 1995),2011,6,44363000,33078000,77441000
Liechtenstein (ab 1995),2011,7,50971000,36821000,87792000
Liechtenstein (ab 1995),2011,8,52908000,34022000,86930000
Liechtenstein (ab 1995),2011,9,50684000,35704000,86388000
Liechtenstein (ab 1995),2011,10,47398000,37331000,84729000
Liechtenstein (ab 1995),2011,11,49357000,39562000,88919000
Liechtenstein (ab 1995),2011,12,43752000,34751000,78503000
Liechtenstein (ab 1995),2012,1,41565000,37019000,78584000
Liechtenstein (ab 1995),2012,2,42379000,36373000,78752000
Liechtenstein (ab 1995),2012,3,49832000,38873000,88705000
Liechtenstein (ab 1995),2012,4,42254000,33951000,76205000
Liechtenstein (ab 1995),2012,5,49308000,35650000,84958000
Liechtenstein (ab 1995),2012,6,44416000,35389000,79805000
Liechtenstein (ab 1995),2012,7,48866000,30760000,79626000
Liechtenstein (ab 1995),2012,8,43833000,29330000,73163000
Liechtenstein (ab 1995),2012,9,40627000,42266000,82893000
Liechtenstein (ab 1995),2012,10,48992000,40303000,89295000
Liechtenstein (ab 1995),2012,11,50319000,39357000,89676000
Liechtenstein (ab 1995),2012,12,36823000,32118000,68941000
Liechtenstein (ab 1995),2013,1,45639000,36635000,82274000
Liechtenstein (ab 1995),2013,2,49282000,30557000,79839000
Liechtenstein (ab 1995),2013,3,42770000,34804000,77574000
Liechtenstein (ab 1995),2013,4,48387000,35104000,83491000
Liechtenstein (ab 1995),2013,5,45140000,34436000,79576000
Liechtenstein (ab 1995),2013,6,43972000,39059000,83031000
Liechtenstein (ab 1995),2013,7,57893000,35164000,93057000
Liechtenstein (ab 1995),2013,8,46451000,29878000,76329000
Liechtenstein (ab 1995),2013,9,53085000,36240000,89325000
Liechtenstein (ab 1995),2013,10,55777000,42111000,97888000
Liechtenstein (ab 1995),2013,11,47102000,38645000,85747000
Liechtenstein (ab 1995),2013,12,39970000,32703000,72673000
Liechtenstein (ab 1995),2014,1,47311000,38307000,85618000
Liechtenstein (ab 1995),2014,2,50276000,36707000,86983000
Liechtenstein (ab 1995),2014,3,50524000,41078000,91602000
Liechtenstein (ab 1995),2014,4,50223000,36667000,86890000
Liechtenstein (ab 1995),2014,5,48462000,39022000,87484000
Liechtenstein (ab 1995),2014,6,55693000,38624000,94317000
Liechtenstein (ab 1995),2014,7,51085000,37275000,88360000
Liechtenstein (ab 1995),2014,8,42640000,29251000,71891000
Liechtenstein (ab 1995),2014,9,53904000,38998000,92902000
Liechtenstein (ab 1995),2014,10,55087000,43781000,98868000
Liechtenstein (ab 1995),2014,11,53731000,39150000,92881000
Liechtenstein (ab 1995),2014,12,50411000,42481000,92892000
Liechtenstein (ab 1995),2015,1,60930000,37024000,97954000
Liechtenstein (ab 1995),2015,2,55367000,37253000,92620000
Liechtenstein (ab 1995),2015,3,58298000,45955000,104253000
Liechtenstein (ab 1995),2015,4,52361000,38914000,91275000
Liechtenstein (ab 1995),2015,5,47076000,37527000,84603000
Liechtenstein (ab 1995),2015,6,53796000,44308000,98104000
Liechtenstein (ab 1995),2015,7,56324000,45319000,101643000
Liechtenstein (ab 1995),2015,8,44634000,34479000,79113000
Liechtenstein (ab 1995),2015,9,49371000,44070000,93441000
Liechtenstein (ab 1995),2015,10,55138000,44157000,99295000
Liechtenstein (ab 1995),2015,11,54139000,45727000,99866000
Liechtenstein (ab 1995),2015,12,43243000,38701000,81944000
Liechtenstein (ab 1995),2016,1,39650000,40783000,80433000
Liechtenstein (ab 1995),2016,2,48700000,42455000,91155000
Liechtenstein (ab 1995),2016,3,53077000,42566000,95643000
Liechtenstein (ab 1995),2016,4,50549000,46715000,97264000
Liechtenstein (ab 1995),2016,5,43993000,44614000,88607000
Liechtenstein (ab 1995),2016,6,54182000,48131000,102313000
Liechtenstein (ab 1995),2016,7,49522000,42567000,92089000
Liechtenstein (ab 1995),2016,8,46565000,36061000,82626000
Liechtenstein (ab 1995),2016,9,49396000,44468000,93864000
Liechtenstein (ab 1995),2016,10,48175000,47585000,95760000
Liechtenstein (ab 1995),2016,11,57637000,46154000,103791000
Liechtenstein (ab 1995),2016,12,47986000,31288000,79274000
Liechtenstein (ab 1995),2017,1,46325000,56276000,102601000
Liechtenstein (ab 1995),2017,2,49890000,42721000,92611000
Liechtenstein (ab 1995),2017,3,57463000,52475000,109938000
Liechtenstein (ab 1995),2017,4,46008000,38059000,84067000
Liechtenstein (ab 1995),2017,5,54278000,45539000,99817000
Liechtenstein (ab 1995),2017,6,53044000,45225000,98269000
Liechtenstein (ab 1995),2017,7,50923000,43034000,93957000
Liechtenstein (ab 1995),2017,8,56034000,38622000,94656000
Liechtenstein (ab 1995),2017,9,55247000,48680000,103927000
Liechtenstein (ab 1995),2017,10,55815000,49366000,105181000
Liechtenstein (ab 1995),2017,11,56369000,52148000,108517000
Liechtenstein (ab 1995),2017,12,78751000,28983000,107734000
Liechtenstein (ab 1995),2018,1,52241000,55265000,107506000
Liechtenstein (ab 1995),2018,2,50192000,43233000,93425000
Liechtenstein (ab 1995),2018,3,54556000,43575000,98131000
Liechtenstein (ab 1995),2018,4,51883000,44991000,96874000
Liechtenstein (ab 1995),2018,5,52204000,39631000,91835000
Liechtenstein (ab 1995),2018,6,59936000,43748000,103684000
Liechtenstein (ab 1995),2018,7,50649000,43058000,93707000
Liechtenstein (ab 1995),2018,8,50959000,35962000,86921000
Liechtenstein (ab 1995),2018,9,48824000,34418000,83242000
Liechtenstein (ab 1995),2018,10,54338000,47311000,101649000
Liechtenstein (ab 1995),2018,11,50858000,41934000,92792000
Liechtenstein (ab 1995),2018,12,36266000,33641000,69907000
Liechtenstein (ab 1995),2019,1,49086000,39971000,89057000
Liechtenstein (ab 1995),2019,2,48605000,39778000,88383000
Liechtenstein (ab 1995),2019,3,55231000,41894000,97125000
Liechtenstein (ab 1995),2019,4,52752000,40522000,93274000
Liechtenstein (ab 1995),2019,5,52599000,45850000,98449000
Liechtenstein (ab 1995),2019,6,42617000,35677000,78294000
Liechtenstein (ab 1995),2019,7,54775000,40746000,95521000
Liechtenstein (ab 1995),2019,8,47068000,35276000,82344000
Liechtenstein (ab 1995),2019,9,52846000,38288000,91134000
Liechtenstein (ab 1995),2019,10,53765000,46513000,100278000
Liechtenstein (ab 1995),2019,11,53670000,44186000,97856000
Liechtenstein (ab 1995),2019,12,39906000,40241000,80147000
Liechtenstein (ab 1995),2020,1,44463000,42989000,87452000
Liechtenstein (ab 1995),2020,2,47558000,42331000,89889000
Liechtenstein (ab 1995),2020,3,49042000,45039000,94081000
Liechtenstein (ab 1995),2020,4,40611000,34114000,74725000
Liechtenstein (ab 1995),2020,5,37133000,29684000,66817000
Liechtenstein (ab 1995),2020,6,41343000,39645000,80988000
Liechtenstein (ab 1995),2020,7,46581000,40639000,87220000
Liechtenstein (ab 1995),2020,8,42056000,37118000,79174000
Liechtenstein (ab 1995),2020,9,43861000,43234000,87095000
Liechtenstein (ab 1995),2020,10,48043000,47820000,95863000
Liechtenstein (ab 1995),2020,11,56242000,53059000,109301000
Liechtenstein (ab 1995),2020,12,40682000,40641000,81323000
Liechtenstein (ab 1995),2021,1,41411000,55483000,96894000
Liechtenstein (ab 1995),2021,2,55154000,49362000,104516000
Liechtenstein (ab 1995),2021,3,62569000,67761000,130330000
Liechtenstein (ab 1995),2021,4,51732000,67603000,119335000
Liechtenstein (ab 1995),2021,5,57081000,58433000,115514000
Liechtenstein (ab 1995),2021,6,65392000,59583000,124975000
Liechtenstein (ab 1995),2021,7,51965000,71686000,123651000
Liechtenstein (ab 1995),2021,8,56219000,78846000,135065000
Liechtenstein (ab 1995),2021,9,52908000,64825000,117733000
Liechtenstein (ab 1995),2021,10,51607000,68060000,119667000
Liechtenstein (ab 1995),2021,11,58001000,65249000,123250000
Liechtenstein (ab 1995),2021,12,43382000,59495000,102877000
Liechtenstein (ab 1995),2022,1,53716000,67713000,121429000
Liechtenstein (ab 1995),2022,2,59209000,68029000,127238000
Liechtenstein (ab 1995),2022,3,61692000,77546000,139238000
Liechtenstein (ab 1995),2022,4,61881000,68704000,130585000
Liechtenstein (ab 1995),2022,5,64128000,70531000,134659000
Liechtenstein (ab 1995),2022,6,57012000,70595000,127607000
Liechtenstein (ab 1995),2022,7,61772000,67475000,129247000
Liechtenstein (ab 1995),2022,8,62058000,71620000,133678000
Liechtenstein (ab 1995),2022,9,63328000,76856000,140184000
Liechtenstein (ab 1995),2022,10,57241000,72271000,129512000
Liechtenstein (ab 1995),2022,11,84430000,77576000,162006000
Liechtenstein (ab 1995),2022,12,70990000,68908000,139898000
Liechtenstein (ab 1995),2023,1,67305000,73379000,140684000
Liechtenstein (ab 1995),2023,2,59494000,76041000,135535000
Liechtenstein (ab 1995),2023,3,69690000,84243000,153933000
Liechtenstein (ab 1995),2023,4,52921000,69737000,122658000
Liechtenstein (ab 1995),2023,5,57749000,74720000,132469000
Liechtenstein (ab 1995),2023,6,57740000,77000000,134740000
Liechtenstein (ab 1995),2023,7,61668000,75738000,137406000
Liechtenstein (ab 1995),2023,8,60288000,73522000,133810000
Liechtenstein (ab 1995),2023,9,63933000,74134000,138067000
Liechtenstein (ab 1995),2023,10,67641000,78215000,145856000
Liechtenstein (ab 1995),2023,11,70128000,89097000,159225000
Liechtenstein (ab 1995),2023,12,46605000,65900000,112505000
Liechtenstein (ab 1995),2024,1,64020000,85821000,149841000
Liechtenstein (ab 1995),2024,2,65290000,85204000,150494000
Liechtenstein (ab 1995),2024,3,67307000,84899000,152206000
Liechtenstein (ab 1995),2024,4,62987000,89143000,152130000
Liechtenstein (ab 1995),2024,5,61549000,75323000,136872000
Liechtenstein (ab 1995),2024,6,61263000,81532000,142795000
Liechtenstein (ab 1995),2024,7,61053000,82646000,143699000
Liechtenstein (ab 1995),2024,8,55074000,70356000,125430000
Liechtenstein (ab 1995),2024,9,57690000,77521000,135211000
Liechtenstein (ab 1995),2024,10,63531000,75376000,138907000
Liechtenstein (ab 1995),2024,11,63274000,76906000,140180000
Liechtenstein (ab 1995),2024,12,42184000,52698000,94882000
Litauen (ab 1992),2008,1,188291000,101316000,289607000
Litauen (ab 1992),2008,2,197815000,107161000,304976000
Litauen (ab 1992),2008,3,202162000,96980000,299142000
Litauen (ab 1992),2008,4,218367000,103077000,321444000
Litauen (ab 1992),2008,5,196087000,98030000,294117000
Litauen (ab 1992),2008,6,222744000,105839000,328583000
Litauen (ab 1992),2008,7,211524000,95945000,307469000
Litauen (ab 1992),2008,8,187586000,104603000,292189000
Litauen (ab 1992),2008,9,224309000,125844000,350153000
Litauen (ab 1992),2008,10,216004000,103244000,319248000
Litauen (ab 1992),2008,11,176992000,85730000,262722000
Litauen (ab 1992),2008,12,139197000,112118000,251315000
Litauen (ab 1992),2009,1,113818000,88982000,202800000
Litauen (ab 1992),2009,2,111467000,79395000,190862000
Litauen (ab 1992),2009,3,130321000,103097000,233418000
Litauen (ab 1992),2009,4,126473000,74073000,200546000
Litauen (ab 1992),2009,5,112795000,82922000,195717000
Litauen (ab 1992),2009,6,107159000,82871000,190030000
Litauen (ab 1992),2009,7,114268000,95624000,209892000
Litauen (ab 1992),2009,8,107149000,115329000,222478000
Litauen (ab 1992),2009,9,115580000,97027000,212607000
Litauen (ab 1992),2009,10,120384000,93631000,214015000
Litauen (ab 1992),2009,11,109320000,87365000,196685000
Litauen (ab 1992),2009,12,142667000,97049000,239716000
Litauen (ab 1992),2010,1,97726000,94060000,191786000
Litauen (ab 1992),2010,2,96357000,97228000,193585000
Litauen (ab 1992),2010,3,136496000,117294000,253790000
Litauen (ab 1992),2010,4,133058000,109710000,242768000
Litauen (ab 1992),2010,5,149798000,154947000,304745000
Litauen (ab 1992),2010,6,152303000,123511000,275814000
Litauen (ab 1992),2010,7,165257000,114410000,279667000
Litauen (ab 1992),2010,8,156254000,135796000,292050000
Litauen (ab 1992),2010,9,163385000,123803000,287188000
Litauen (ab 1992),2010,10,181017000,139727000,320744000
Litauen (ab 1992),2010,11,163872000,122249000,286121000
Litauen (ab 1992),2010,12,149660000,118174000,267834000
Litauen (ab 1992),2011,1,143645000,137615000,281260000
Litauen (ab 1992),2011,2,158483000,126194000,284677000
Litauen (ab 1992),2011,3,195525000,146667000,342192000
Litauen (ab 1992),2011,4,187552000,122327000,309879000
Litauen (ab 1992),2011,5,183669000,146882000,330551000
Litauen (ab 1992),2011,6,201699000,127293000,328992000
Litauen (ab 1992),2011,7,184343000,121250000,305593000
Litauen (ab 1992),2011,8,210892000,214244000,425136000
Litauen (ab 1992),2011,9,204343000,135266000,339609000
Litauen (ab 1992),2011,10,177277000,149791000,327068000
Litauen (ab 1992),2011,11,192809000,125497000,318306000
Litauen (ab 1992),2011,12,167076000,140944000,308020000
Litauen (ab 1992),2012,1,148509000,149240000,297749000
Litauen (ab 1992),2012,2,170141000,134506000,304647000
Litauen (ab 1992),2012,3,203590000,139354000,342944000
Litauen (ab 1992),2012,4,186361000,150682000,337043000
Litauen (ab 1992),2012,5,203585000,162236000,365821000
Litauen (ab 1992),2012,6,210943000,151017000,361960000
Litauen (ab 1992),2012,7,192475000,129436000,321911000
Litauen (ab 1992),2012,8,218840000,151745000,370585000
Litauen (ab 1992),2012,9,227872000,160395000,388267000
Litauen (ab 1992),2012,10,237367000,183545000,420912000
Litauen (ab 1992),2012,11,203293000,148982000,352275000
Litauen (ab 1992),2012,12,170611000,111319000,281930000
Litauen (ab 1992),2013,1,171276000,142488000,313764000
Litauen (ab 1992),2013,2,188480000,133927000,322407000
Litauen (ab 1992),2013,3,208269000,194722000,402991000
Litauen (ab 1992),2013,4,211378000,168907000,380285000
Litauen (ab 1992),2013,5,199072000,132629000,331701000
Litauen (ab 1992),2013,6,202384000,156129000,358513000
Litauen (ab 1992),2013,7,225611000,170899000,396510000
Litauen (ab 1992),2013,8,206786000,116104000,322890000
Litauen (ab 1992),2013,9,235806000,117210000,353016000
Litauen (ab 1992),2013,10,233091000,146421000,379512000
Litauen (ab 1992),2013,11,218752000,125227000,343979000
Litauen (ab 1992),2013,12,171351000,137221000,308572000
Litauen (ab 1992),2014,1,172236000,127085000,299321000
Litauen (ab 1992),2014,2,192372000,128425000,320797000
Litauen (ab 1992),2014,3,209647000,130038000,339685000
Litauen (ab 1992),2014,4,207567000,138095000,345662000
Litauen (ab 1992),2014,5,205551000,125034000,330585000
Litauen (ab 1992),2014,6,217143000,135285000,352428000
Litauen (ab 1992),2014,7,253770000,134164000,387934000
Litauen (ab 1992),2014,8,209696000,117464000,327160000
Litauen (ab 1992),2014,9,258214000,136257000,394471000
Litauen (ab 1992),2014,10,250045000,158090000,408135000
Litauen (ab 1992),2014,11,205872000,139412000,345284000
Litauen (ab 1992),2014,12,182691000,130151000,312842000
Litauen (ab 1992),2015,1,165209000,125745000,290954000
Litauen (ab 1992),2015,2,212577000,141482000,354059000
Litauen (ab 1992),2015,3,250669000,154799000,405468000
Litauen (ab 1992),2015,4,236700000,137706000,374406000
Litauen (ab 1992),2015,5,251030000,137418000,388448000
Litauen (ab 1992),2015,6,247643000,131176000,378819000
Litauen (ab 1992),2015,7,243231000,131919000,375150000
Litauen (ab 1992),2015,8,217876000,132984000,350860000
Litauen (ab 1992),2015,9,268101000,157383000,425484000
Litauen (ab 1992),2015,10,247712000,169424000,417136000
Litauen (ab 1992),2015,11,232805000,137105000,369910000
Litauen (ab 1992),2015,12,191443000,116597000,308040000
Litauen (ab 1992),2016,1,187409000,125273000,312682000
Litauen (ab 1992),2016,2,218766000,157885000,376651000
Litauen (ab 1992),2016,3,271981000,136279000,408260000
Litauen (ab 1992),2016,4,320469000,148486000,468955000
Litauen (ab 1992),2016,5,316084000,135536000,451620000
Litauen (ab 1992),2016,6,257774000,156129000,413903000
Litauen (ab 1992),2016,7,247524000,131172000,378696000
Litauen (ab 1992),2016,8,247909000,135286000,383195000
Litauen (ab 1992),2016,9,270734000,142196000,412930000
Litauen (ab 1992),2016,10,253071000,140048000,393119000
Litauen (ab 1992),2016,11,227032000,156189000,383221000
Litauen (ab 1992),2016,12,193865000,141007000,334872000
Litauen (ab 1992),2017,1,209065000,129024000,338089000
Litauen (ab 1992),2017,2,245002000,142384000,387386000
Litauen (ab 1992),2017,3,308904000,154693000,463597000
Litauen (ab 1992),2017,4,259375000,138466000,397841000
Litauen (ab 1992),2017,5,271618000,153833000,425451000
Litauen (ab 1992),2017,6,287046000,148382000,435428000
Litauen (ab 1992),2017,7,286490000,149941000,436431000
Litauen (ab 1992),2017,8,283619000,157887000,441506000
Litauen (ab 1992),2017,9,269422000,159948000,429370000
Litauen (ab 1992),2017,10,276385000,173123000,449508000
Litauen (ab 1992),2017,11,306064000,179321000,485385000
Litauen (ab 1992),2017,12,257192000,143061000,400253000
Litauen (ab 1992),2018,1,299778000,144986000,444764000
Litauen (ab 1992),2018,2,256765000,151369000,408134000
Litauen (ab 1992),2018,3,303353000,158569000,461922000
Litauen (ab 1992),2018,4,297822000,156436000,454258000
Litauen (ab 1992),2018,5,271507000,153154000,424661000
Litauen (ab 1992),2018,6,290095000,160686000,450781000
Litauen (ab 1992),2018,7,299560000,188393000,487953000
Litauen (ab 1992),2018,8,289954000,161554000,451508000
Litauen (ab 1992),2018,9,282242000,163785000,446027000
Litauen (ab 1992),2018,10,314506000,177406000,491912000
Litauen (ab 1992),2018,11,295763000,183296000,479059000
Litauen (ab 1992),2018,12,254116000,152700000,406816000
Litauen (ab 1992),2019,1,250636000,162308000,412944000
Litauen (ab 1992),2019,2,247567000,164327000,411894000
Litauen (ab 1992),2019,3,313242000,181874000,495116000
Litauen (ab 1992),2019,4,280480000,168309000,448789000
Litauen (ab 1992),2019,5,283417000,169260000,452677000
Litauen (ab 1992),2019,6,290971000,166793000,457764000
Litauen (ab 1992),2019,7,303029000,183613000,486642000
Litauen (ab 1992),2019,8,278675000,171184000,449859000
Litauen (ab 1992),2019,9,315927000,210457000,526384000
Litauen (ab 1992),2019,10,346164000,186236000,532400000
Litauen (ab 1992),2019,11,298555000,188720000,487275000
Litauen (ab 1992),2019,12,252953000,154513000,407466000
Litauen (ab 1992),2020,1,298882000,188593000,487475000
Litauen (ab 1992),2020,2,298503000,186916000,485419000
Litauen (ab 1992),2020,3,298291000,181410000,479701000
Litauen (ab 1992),2020,4,226478000,149706000,376184000
Litauen (ab 1992),2020,5,215592000,150899000,366491000
Litauen (ab 1992),2020,6,283684000,173851000,457535000
Litauen (ab 1992),2020,7,313460000,187116000,500576000
Litauen (ab 1992),2020,8,276648000,207775000,484423000
Litauen (ab 1992),2020,9,322791000,204383000,527174000
Litauen (ab 1992),2020,10,308917000,215893000,524810000
Litauen (ab 1992),2020,11,348978000,216062000,565040000
Litauen (ab 1992),2020,12,263224000,199862000,463086000
Litauen (ab 1992),2021,1,269772000,178501000,448273000
Litauen (ab 1992),2021,2,308151000,203323000,511474000
Litauen (ab 1992),2021,3,400767000,240571000,641338000
Litauen (ab 1992),2021,4,336050000,200746000,536796000
Litauen (ab 1992),2021,5,365387000,221596000,586983000
Litauen (ab 1992),2021,6,373382000,231988000,605370000
Litauen (ab 1992),2021,7,355301000,216202000,571503000
Litauen (ab 1992),2021,8,375596000,283587000,659183000
Litauen (ab 1992),2021,9,394014000,246064000,640078000
Litauen (ab 1992),2021,10,414286000,262107000,676393000
Litauen (ab 1992),2021,11,406684000,265384000,672068000
Litauen (ab 1992),2021,12,396644000,272293000,668937000
Litauen (ab 1992),2022,1,362732000,242436000,605168000
Litauen (ab 1992),2022,2,418660000,274418000,693078000
Litauen (ab 1992),2022,3,463106000,281928000,745034000
Litauen (ab 1992),2022,4,391837000,281752000,673589000
Litauen (ab 1992),2022,5,417989000,271052000,689041000
Litauen (ab 1992),2022,6,441402000,261393000,702795000
Litauen (ab 1992),2022,7,453567000,244289000,697856000
Litauen (ab 1992),2022,8,483064000,280506000,763570000
Litauen (ab 1992),2022,9,516157000,307612000,823769000
Litauen (ab 1992),2022,10,553856000,301805000,855661000
Litauen (ab 1992),2022,11,517497000,258011000,775508000
Litauen (ab 1992),2022,12,470278000,248571000,718849000
Litauen (ab 1992),2023,1,436074000,250390000,686464000
Litauen (ab 1992),2023,2,436918000,228828000,665746000
Litauen (ab 1992),2023,3,526684000,271479000,798163000
Litauen (ab 1992),2023,4,423936000,235743000,659679000
Litauen (ab 1992),2023,5,517916000,257254000,775170000
Litauen (ab 1992),2023,6,499397000,220279000,719676000
Litauen (ab 1992),2023,7,444952000,212569000,657521000
Litauen (ab 1992),2023,8,446679000,242469000,689148000
Litauen (ab 1992),2023,9,467992000,229939000,697931000
Litauen (ab 1992),2023,10,506104000,244248000,750352000
Litauen (ab 1992),2023,11,501354000,270301000,771655000
Litauen (ab 1992),2023,12,418229000,194027000,612256000
Litauen (ab 1992),2024,1,429291000,240625000,669916000
Litauen (ab 1992),2024,2,437816000,230988000,668804000
Litauen (ab 1992),2024,3,445555000,244042000,689597000
Litauen (ab 1992),2024,4,459371000,242979000,702350000
Litauen (ab 1992),2024,5,438403000,227766000,666169000
Litauen (ab 1992),2024,6,435289000,208946000,644235000
Litauen (ab 1992),2024,7,445636000,225482000,671118000
Litauen (ab 1992),2024,8,435318000,235334000,670652000
Litauen (ab 1992),2024,9,459105000,283836000,742941000
Litauen (ab 1992),2024,10,442180000,282814000,724994000
Litauen (ab 1992),2024,11,411439000,271431000,682870000
Litauen (ab 1992),2024,12,358313000,232682000,590995000
Luxemburg (ab 1999),2008,1,384249000,259849000,644098000
Luxemburg (ab 1999),2008,2,443150000,261947000,705097000
Luxemburg (ab 1999),2008,3,486927000,259004000,745931000
Luxemburg (ab 1999),2008,4,463349000,279183000,742532000
Luxemburg (ab 1999),2008,5,454659000,293395000,748054000
Luxemburg (ab 1999),2008,6,443493000,304208000,747701000
Luxemburg (ab 1999),2008,7,466899000,325940000,792839000
Luxemburg (ab 1999),2008,8,423532000,300834000,724366000
Luxemburg (ab 1999),2008,9,474149000,286737000,760886000
Luxemburg (ab 1999),2008,10,454646000,319919000,774565000
Luxemburg (ab 1999),2008,11,443339000,229357000,672696000
Luxemburg (ab 1999),2008,12,358182000,216036000,574218000
Luxemburg (ab 1999),2009,1,321043000,218153000,539196000
Luxemburg (ab 1999),2009,2,351860000,225688000,577548000
Luxemburg (ab 1999),2009,3,401000000,233092000,634092000
Luxemburg (ab 1999),2009,4,404430000,217142000,621572000
Luxemburg (ab 1999),2009,5,331705000,192241000,523946000
Luxemburg (ab 1999),2009,6,351587000,231656000,583243000
Luxemburg (ab 1999),2009,7,366459000,208058000,574517000
Luxemburg (ab 1999),2009,8,358892000,212144000,571036000
Luxemburg (ab 1999),2009,9,390556000,239696000,630252000
Luxemburg (ab 1999),2009,10,441237000,247022000,688259000
Luxemburg (ab 1999),2009,11,353173000,227000000,580173000
Luxemburg (ab 1999),2009,12,350195000,200903000,551098000
Luxemburg (ab 1999),2010,1,380398000,174011000,554409000
Luxemburg (ab 1999),2010,2,430747000,184719000,615466000
Luxemburg (ab 1999),2010,3,487710000,240941000,728651000
Luxemburg (ab 1999),2010,4,522739000,209750000,732489000
Luxemburg (ab 1999),2010,5,493339000,225222000,718561000
Luxemburg (ab 1999),2010,6,489428000,253973000,743401000
Luxemburg (ab 1999),2010,7,445761000,225110000,670871000
Luxemburg (ab 1999),2010,8,385786000,229948000,615734000
Luxemburg (ab 1999),2010,9,443563000,255055000,698618000
Luxemburg (ab 1999),2010,10,511082000,258565000,769647000
Luxemburg (ab 1999),2010,11,457031000,242405000,699436000
Luxemburg (ab 1999),2010,12,458332000,222367000,680699000
Luxemburg (ab 1999),2011,1,502341000,221050000,723391000
Luxemburg (ab 1999),2011,2,466639000,239892000,706531000
Luxemburg (ab 1999),2011,3,558337000,273924000,832261000
Luxemburg (ab 1999),2011,4,502922000,257444000,760366000
Luxemburg (ab 1999),2011,5,515993000,247329000,763322000
Luxemburg (ab 1999),2011,6,501637000,255675000,757312000
Luxemburg (ab 1999),2011,7,520489000,250305000,770794000
Luxemburg (ab 1999),2011,8,511905000,266016000,777921000
Luxemburg (ab 1999),2011,9,552882000,267386000,820268000
Luxemburg (ab 1999),2011,10,526923000,242083000,769006000
Luxemburg (ab 1999),2011,11,530967000,229726000,760693000
Luxemburg (ab 1999),2011,12,494135000,223473000,717608000
Luxemburg (ab 1999),2012,1,448507000,247486000,695993000
Luxemburg (ab 1999),2012,2,462694000,226628000,689322000
Luxemburg (ab 1999),2012,3,514475000,251238000,765713000
Luxemburg (ab 1999),2012,4,443713000,239812000,683525000
Luxemburg (ab 1999),2012,5,490192000,221672000,711864000
Luxemburg (ab 1999),2012,6,476586000,244416000,721002000
Luxemburg (ab 1999),2012,7,463992000,223351000,687343000
Luxemburg (ab 1999),2012,8,401946000,219738000,621684000
Luxemburg (ab 1999),2012,9,457185000,216545000,673730000
Luxemburg (ab 1999),2012,10,506258000,254786000,761044000
Luxemburg (ab 1999),2012,11,471006000,204590000,675596000
Luxemburg (ab 1999),2012,12,441763000,186206000,627969000
Luxemburg (ab 1999),2013,1,472070000,212732000,684802000
Luxemburg (ab 1999),2013,2,406196000,233247000,639443000
Luxemburg (ab 1999),2013,3,474472000,236500000,710972000
Luxemburg (ab 1999),2013,4,483017000,240539000,723556000
Luxemburg (ab 1999),2013,5,465003000,240314000,705317000
Luxemburg (ab 1999),2013,6,473315000,243894000,717209000
Luxemburg (ab 1999),2013,7,442395000,251615000,694010000
Luxemburg (ab 1999),2013,8,417783000,241117000,658900000
Luxemburg (ab 1999),2013,9,498868000,267144000,766012000
Luxemburg (ab 1999),2013,10,478059000,284869000,762928000
Luxemburg (ab 1999),2013,11,442845000,304992000,747837000
Luxemburg (ab 1999),2013,12,462578000,230312000,692890000
Luxemburg (ab 1999),2014,1,413998000,254018000,668016000
Luxemburg (ab 1999),2014,2,437424000,235804000,673228000
Luxemburg (ab 1999),2014,3,446354000,250057000,696411000
Luxemburg (ab 1999),2014,4,462162000,254195000,716357000
Luxemburg (ab 1999),2014,5,432397000,249428000,681825000
Luxemburg (ab 1999),2014,6,450838000,274313000,725151000
Luxemburg (ab 1999),2014,7,483468000,270175000,753643000
Luxemburg (ab 1999),2014,8,405240000,244812000,650052000
Luxemburg (ab 1999),2014,9,465655000,269289000,734944000
Luxemburg (ab 1999),2014,10,466864000,264813000,731677000
Luxemburg (ab 1999),2014,11,469117000,249887000,719004000
Luxemburg (ab 1999),2014,12,406441000,224434000,630875000
Luxemburg (ab 1999),2015,1,399044000,238203000,637247000
Luxemburg (ab 1999),2015,2,421821000,239950000,661771000
Luxemburg (ab 1999),2015,3,472641000,282494000,755135000
Luxemburg (ab 1999),2015,4,505363000,246404000,751767000
Luxemburg (ab 1999),2015,5,439367000,281749000,721116000
Luxemburg (ab 1999),2015,6,475295000,293896000,769191000
Luxemburg (ab 1999),2015,7,469902000,300406000,770308000
Luxemburg (ab 1999),2015,8,376548000,260717000,637265000
Luxemburg (ab 1999),2015,9,455745000,283020000,738765000
Luxemburg (ab 1999),2015,10,463800000,278900000,742700000
Luxemburg (ab 1999),2015,11,441766000,314961000,756727000
Luxemburg (ab 1999),2015,12,373622000,231140000,604762000
Luxemburg (ab 1999),2016,1,374062000,248010000,622072000
Luxemburg (ab 1999),2016,2,426764000,274294000,701058000
Luxemburg (ab 1999),2016,3,453396000,258243000,711639000
Luxemburg (ab 1999),2016,4,492211000,271399000,763610000
Luxemburg (ab 1999),2016,5,441425000,251824000,693249000
Luxemburg (ab 1999),2016,6,461678000,271753000,733431000
Luxemburg (ab 1999),2016,7,459338000,268659000,727997000
Luxemburg (ab 1999),2016,8,407610000,267185000,674795000
Luxemburg (ab 1999),2016,9,464206000,255097000,719303000
Luxemburg (ab 1999),2016,10,470331000,249836000,720167000
Luxemburg (ab 1999),2016,11,466116000,256609000,722725000
Luxemburg (ab 1999),2016,12,438075000,235408000,673483000
Luxemburg (ab 1999),2017,1,454146000,259526000,713672000
Luxemburg (ab 1999),2017,2,472185000,256246000,728431000
Luxemburg (ab 1999),2017,3,505143000,275314000,780457000
Luxemburg (ab 1999),2017,4,489925000,253651000,743576000
Luxemburg (ab 1999),2017,5,492296000,273315000,765611000
Luxemburg (ab 1999),2017,6,557154000,269224000,826378000
Luxemburg (ab 1999),2017,7,502361000,281597000,783958000
Luxemburg (ab 1999),2017,8,445433000,267332000,712765000
Luxemburg (ab 1999),2017,9,482607000,279631000,762238000
Luxemburg (ab 1999),2017,10,469903000,267922000,737825000
Luxemburg (ab 1999),2017,11,505928000,310908000,816836000
Luxemburg (ab 1999),2017,12,431332000,240647000,671979000
Luxemburg (ab 1999),2018,1,455112000,272979000,728091000
Luxemburg (ab 1999),2018,2,515964000,285451000,801415000
Luxemburg (ab 1999),2018,3,533386000,308441000,841827000
Luxemburg (ab 1999),2018,4,526788000,316853000,843641000
Luxemburg (ab 1999),2018,5,520303000,276983000,797286000
Luxemburg (ab 1999),2018,6,538124000,280914000,819038000
Luxemburg (ab 1999),2018,7,532643000,311844000,844487000
Luxemburg (ab 1999),2018,8,456309000,297038000,753347000
Luxemburg (ab 1999),2018,9,502903000,271521000,774424000
Luxemburg (ab 1999),2018,10,509886000,306336000,816222000
Luxemburg (ab 1999),2018,11,498770000,289172000,787942000
Luxemburg (ab 1999),2018,12,445292000,238538000,683830000
Luxemburg (ab 1999),2019,1,458757000,279148000,737905000
Luxemburg (ab 1999),2019,2,468008000,279565000,747573000
Luxemburg (ab 1999),2019,3,510082000,316536000,826618000
Luxemburg (ab 1999),2019,4,522939000,297759000,820698000
Luxemburg (ab 1999),2019,5,497076000,281002000,778078000
Luxemburg (ab 1999),2019,6,460893000,280269000,741162000
Luxemburg (ab 1999),2019,7,489646000,278952000,768598000
Luxemburg (ab 1999),2019,8,424416000,255761000,680177000
Luxemburg (ab 1999),2019,9,473268000,269695000,742963000
Luxemburg (ab 1999),2019,10,532258000,256590000,788848000
Luxemburg (ab 1999),2019,11,482965000,260961000,743926000
Luxemburg (ab 1999),2019,12,442407000,217600000,660007000
Luxemburg (ab 1999),2020,1,465440000,261967000,727407000
Luxemburg (ab 1999),2020,2,485962000,238840000,724802000
Luxemburg (ab 1999),2020,3,450755000,255030000,705785000
Luxemburg (ab 1999),2020,4,324268000,190395000,514663000
Luxemburg (ab 1999),2020,5,384844000,211894000,596738000
Luxemburg (ab 1999),2020,6,472921000,226499000,699420000
Luxemburg (ab 1999),2020,7,520136000,233607000,753743000
Luxemburg (ab 1999),2020,8,444315000,229894000,674209000
Luxemburg (ab 1999),2020,9,473360000,248432000,721792000
Luxemburg (ab 1999),2020,10,507703000,230391000,738094000
Luxemburg (ab 1999),2020,11,545618000,247912000,793530000
Luxemburg (ab 1999),2020,12,441652000,221917000,663569000
Luxemburg (ab 1999),2021,1,444502000,241533000,686035000
Luxemburg (ab 1999),2021,2,492902000,261590000,754492000
Luxemburg (ab 1999),2021,3,613512000,298469000,911981000
Luxemburg (ab 1999),2021,4,524032000,272659000,796691000
Luxemburg (ab 1999),2021,5,576529000,260663000,837192000
Luxemburg (ab 1999),2021,6,582028000,287712000,869740000
Luxemburg (ab 1999),2021,7,565052000,296085000,861137000
Luxemburg (ab 1999),2021,8,491994000,283140000,775134000
Luxemburg (ab 1999),2021,9,562737000,290735000,853472000
Luxemburg (ab 1999),2021,10,615543000,291438000,906981000
Luxemburg (ab 1999),2021,11,633548000,298504000,932052000
Luxemburg (ab 1999),2021,12,566301000,340775000,907076000
Luxemburg (ab 1999),2022,1,593327000,313200000,906527000
Luxemburg (ab 1999),2022,2,630298000,330984000,961282000
Luxemburg (ab 1999),2022,3,769075000,380158000,1149233000
Luxemburg (ab 1999),2022,4,670498000,378982000,1049480000
Luxemburg (ab 1999),2022,5,660931000,377629000,1038560000
Luxemburg (ab 1999),2022,6,716535000,333621000,1050156000
Luxemburg (ab 1999),2022,7,673540000,345960000,1019500000
Luxemburg (ab 1999),2022,8,666351000,324801000,991152000
Luxemburg (ab 1999),2022,9,751261000,344045000,1095306000
Luxemburg (ab 1999),2022,10,604941000,341057000,945998000
Luxemburg (ab 1999),2022,11,673196000,313177000,986373000
Luxemburg (ab 1999),2022,12,588935000,302132000,891067000
Luxemburg (ab 1999),2023,1,581201000,330472000,911673000
Luxemburg (ab 1999),2023,2,579008000,321804000,900812000
Luxemburg (ab 1999),2023,3,645857000,367079000,1012936000
Luxemburg (ab 1999),2023,4,548887000,302217000,851104000
Luxemburg (ab 1999),2023,5,544085000,312560000,856645000
Luxemburg (ab 1999),2023,6,571551000,296963000,868514000
Luxemburg (ab 1999),2023,7,644475000,294093000,938568000
Luxemburg (ab 1999),2023,8,512166000,284084000,796250000
Luxemburg (ab 1999),2023,9,520292000,282427000,802719000
Luxemburg (ab 1999),2023,10,539616000,288774000,828390000
Luxemburg (ab 1999),2023,11,573871000,292904000,866775000
Luxemburg (ab 1999),2023,12,486733000,260879000,747612000
Luxemburg (ab 1999),2024,1,560805000,283004000,843809000
Luxemburg (ab 1999),2024,2,606774000,314591000,921365000
Luxemburg (ab 1999),2024,3,576022000,306056000,882078000
Luxemburg (ab 1999),2024,4,620588000,305564000,926152000
Luxemburg (ab 1999),2024,5,529656000,273257000,802913000
Luxemburg (ab 1999),2024,6,529933000,277049000,806982000
Luxemburg (ab 1999),2024,7,545648000,295277000,840925000
Luxemburg (ab 1999),2024,8,475626000,264020000,739646000
Luxemburg (ab 1999),2024,9,528650000,283217000,811867000
Luxemburg (ab 1999),2024,10,560946000,315832000,876778000
Luxemburg (ab 1999),2024,11,599461000,270079000,869540000
Luxemburg (ab 1999),2024,12,516115000,256027000,772142000
Macau,2008,1,4682000,16038000,20720000
Macau,2008,2,5889000,10400000,16289000
Macau,2008,3,1402000,5790000,7192000
Macau,2008,4,3733000,5092000,8825000
Macau,2008,5,1704000,5389000,7093000
Macau,2008,6,12838000,5130000,17968000
Macau,2008,7,3712000,5109000,8821000
Macau,2008,8,1988000,3612000,5600000
Macau,2008,9,2701000,5076000,7777000
Macau,2008,10,3118000,4316000,7434000
Macau,2008,11,3013000,5812000,8825000
Macau,2008,12,5188000,3756000,8944000
Macau,2009,1,3896000,7453000,11349000
Macau,2009,2,2941000,4464000,7405000
Macau,2009,3,2805000,2877000,5682000
Macau,2009,4,3585000,3122000,6707000
Macau,2009,5,1425000,3598000,5023000
Macau,2009,6,2955000,2416000,5371000
Macau,2009,7,3202000,2430000,5632000
Macau,2009,8,1554000,2104000,3658000
Macau,2009,9,2549000,2488000,5037000
Macau,2009,10,1087000,2028000,3115000
Macau,2009,11,1916000,2226000,4142000
Macau,2009,12,2671000,1628000,4299000
Macau,2010,1,1598000,1743000,3341000
Macau,2010,2,1337000,1831000,3168000
Macau,2010,3,2658000,1501000,4159000
Macau,2010,4,1469000,617000,2086000
Macau,2010,5,2377000,995000,3372000
Macau,2010,6,1463000,1295000,2758000
Macau,2010,7,2600000,1512000,4112000
Macau,2010,8,2498000,1405000,3903000
Macau,2010,9,7629000,1466000,9095000
Macau,2010,10,2929000,1184000,4113000
Macau,2010,11,3126000,906000,4032000
Macau,2010,12,3095000,779000,3874000
Macau,2011,1,3964000,1379000,5343000
Macau,2011,2,4235000,1523000,5758000
Macau,2011,3,1579000,2199000,3778000
Macau,2011,4,2520000,1653000,4173000
Macau,2011,5,3181000,1800000,4981000
Macau,2011,6,6196000,1496000,7692000
Macau,2011,7,4135000,1532000,5667000
Macau,2011,8,3581000,1749000,5330000
Macau,2011,9,3640000,2480000,6120000
Macau,2011,10,5661000,3810000,9471000
Macau,2011,11,3075000,5142000,8217000
Macau,2011,12,8089000,3133000,11222000
Macau,2012,1,4349000,4718000,9067000
Macau,2012,2,4475000,5161000,9636000
Macau,2012,3,5838000,4877000,10715000
Macau,2012,4,4229000,5457000,9686000
Macau,2012,5,4915000,3986000,8901000
Macau,2012,6,4586000,3549000,8135000
Macau,2012,7,6209000,3566000,9775000
Macau,2012,8,5869000,4436000,10305000
Macau,2012,9,4568000,3534000,8102000
Macau,2012,10,5586000,3946000,9532000
Macau,2012,11,4136000,2605000,6741000
Macau,2012,12,4260000,4546000,8806000
Macau,2013,1,2470000,4097000,6567000
Macau,2013,2,57011000,2986000,59997000
Macau,2013,3,55576000,3527000,59103000
Macau,2013,4,4503000,4087000,8590000
Macau,2013,5,3694000,4079000,7773000
Macau,2013,6,5106000,1957000,7063000
Macau,2013,7,3577000,1634000,5211000
Macau,2013,8,4568000,1240000,5808000
Macau,2013,9,7661000,814000,8475000
Macau,2013,10,9310000,895000,10205000
Macau,2013,11,6404000,835000,7239000
Macau,2013,12,7062000,1256000,8318000
Macau,2014,1,6538000,1646000,8184000
Macau,2014,2,4241000,934000,5175000
Macau,2014,3,6322000,1739000,8061000
Macau,2014,4,4756000,2213000,6969000
Macau,2014,5,6002000,2146000,8148000
Macau,2014,6,4966000,2044000,7010000
Macau,2014,7,7290000,3006000,10296000
Macau,2014,8,9938000,803000,10741000
Macau,2014,9,8654000,1149000,9803000
Macau,2014,10,11990000,2806000,14796000
Macau,2014,11,7642000,1705000,9347000
Macau,2014,12,7014000,1836000,8850000
Macau,2015,1,4288000,3215000,7503000
Macau,2015,2,10224000,3226000,13450000
Macau,2015,3,64826000,4124000,68950000
Macau,2015,4,5909000,1886000,7795000
Macau,2015,5,8777000,2884000,11661000
Macau,2015,6,9839000,3377000,13216000
Macau,2015,7,10113000,5774000,15887000
Macau,2015,8,9098000,3716000,12814000
Macau,2015,9,7966000,3092000,11058000
Macau,2015,10,64125000,2954000,67079000
Macau,2015,11,9322000,4314000,13636000
Macau,2015,12,70198000,2100000,72298000
Macau,2016,1,66230000,3607000,69837000
Macau,2016,2,7893000,3463000,11356000
Macau,2016,3,10613000,3402000,14015000
Macau,2016,4,11435000,3606000,15041000
Macau,2016,5,8339000,2081000,10420000
Macau,2016,6,7498000,3798000,11296000
Macau,2016,7,9567000,2667000,12234000
Macau,2016,8,8554000,2088000,10642000
Macau,2016,9,6235000,4682000,10917000
Macau,2016,10,6426000,3322000,9748000
Macau,2016,11,5241000,2921000,8162000
Macau,2016,12,6020000,2283000,8303000
Macau,2017,1,5654000,3499000,9153000
Macau,2017,2,6905000,6235000,13140000
Macau,2017,3,6273000,6165000,12438000
Macau,2017,4,4950000,5569000,10519000
Macau,2017,5,6817000,5912000,12729000
Macau,2017,6,5294000,6562000,11856000
Macau,2017,7,5104000,5477000,10581000
Macau,2017,8,5315000,4264000,9579000
Macau,2017,9,5322000,4774000,10096000
Macau,2017,10,4767000,4549000,9316000
Macau,2017,11,8418000,5085000,13503000
Macau,2017,12,5291000,5314000,10605000
Macau,2018,1,8955000,5846000,14801000
Macau,2018,2,7500000,5413000,12913000
Macau,2018,3,6635000,6131000,12766000
Macau,2018,4,8808000,5552000,14360000
Macau,2018,5,6130000,5021000,11151000
Macau,2018,6,7243000,5847000,13090000
Macau,2018,7,6450000,5329000,11779000
Macau,2018,8,9268000,2553000,11821000
Macau,2018,9,10457000,4032000,14489000
Macau,2018,10,7723000,3503000,11226000
Macau,2018,11,12166000,3144000,15310000
Macau,2018,12,7224000,4603000,11827000
Macau,2019,1,7104000,5305000,12409000
Macau,2019,2,6345000,9633000,15978000
Macau,2019,3,6562000,4783000,11345000
Macau,2019,4,6837000,3804000,10641000
Macau,2019,5,6414000,4133000,10547000
Macau,2019,6,5602000,1519000,7121000
Macau,2019,7,5527000,993000,6520000
Macau,2019,8,9042000,1237000,10279000
Macau,2019,9,5094000,441000,5535000
Macau,2019,10,9248000,766000,10014000
Macau,2019,11,7321000,664000,7985000
Macau,2019,12,71553000,1194000,72747000
Macau,2020,1,7564000,713000,8277000
Macau,2020,2,3815000,3070000,6885000
Macau,2020,3,4672000,1127000,5799000
Macau,2020,4,5010000,1487000,6497000
Macau,2020,5,6381000,1380000,7761000
Macau,2020,6,5325000,1221000,6546000
Macau,2020,7,5471000,876000,6347000
Macau,2020,8,4322000,760000,5082000
Macau,2020,9,6827000,605000,7432000
Macau,2020,10,8488000,766000,9254000
Macau,2020,11,8278000,632000,8910000
Macau,2020,12,6849000,1396000,8245000
Macau,2021,1,5661000,2396000,8057000
Macau,2021,2,68663000,1196000,69859000
Macau,2021,3,9631000,930000,10561000
Macau,2021,4,7350000,448000,7798000
Macau,2021,5,6355000,978000,7333000
Macau,2021,6,68313000,757000,69070000
Macau,2021,7,9946000,384000,10330000
Macau,2021,8,66896000,756000,67652000
Macau,2021,9,12887000,1140000,14027000
Macau,2021,10,10561000,672000,11233000
Macau,2021,11,15045000,1087000,16132000
Macau,2021,12,14844000,1071000,15915000
Macau,2022,1,10276000,1626000,11902000
Macau,2022,2,11751000,776000,12527000
Macau,2022,3,15166000,967000,16133000
Macau,2022,4,12226000,622000,12848000
Macau,2022,5,13857000,871000,14728000
Macau,2022,6,13093000,1352000,14445000
Macau,2022,7,13325000,735000,14060000
Macau,2022,8,28934000,1341000,30275000
Macau,2022,9,33996000,890000,34886000
Macau,2022,10,34297000,1060000,35357000
Macau,2022,11,38500000,1863000,40363000
Macau,2022,12,11438000,648000,12086000
Macau,2023,1,9325000,1005000,10330000
Macau,2023,2,10670000,942000,11612000
Macau,2023,3,12348000,976000,13324000
Macau,2023,4,8161000,621000,8782000
Macau,2023,5,8831000,666000,9497000
Macau,2023,6,15511000,1171000,16682000
Macau,2023,7,13206000,1188000,14394000
Macau,2023,8,12703000,512000,13215000
Macau,2023,9,13799000,579000,14378000
Macau,2023,10,20324000,999000,21323000
Macau,2023,11,15332000,856000,16188000
Macau,2023,12,16010000,1356000,17366000
Macau,2024,1,17004000,844000,17848000
Macau,2024,2,18742000,1393000,20135000
Macau,2024,3,25242000,948000,26190000
Macau,2024,4,22677000,1420000,24097000
Macau,2024,5,19696000,1168000,20864000
Macau,2024,6,20190000,510000,20700000
Macau,2024,7,15287000,1728000,17015000
Macau,2024,8,11079000,784000,11863000
Macau,2024,9,8364000,1604000,9968000
Macau,2024,10,6329000,1030000,7359000
Macau,2024,11,10647000,1081000,11728000
Macau,2024,12,6280000,1448000,7728000
Madagaskar,2008,1,3092000,5089000,8181000
Madagaskar,2008,2,2647000,3166000,5813000
Madagaskar,2008,3,2492000,2264000,4756000
Madagaskar,2008,4,5045000,1793000,6838000
Madagaskar,2008,5,2115000,3914000,6029000
Madagaskar,2008,6,3647000,4968000,8615000
Madagaskar,2008,7,4988000,8850000,13838000
Madagaskar,2008,8,4398000,9248000,13646000
Madagaskar,2008,9,5826000,9837000,15663000
Madagaskar,2008,10,7959000,8397000,16356000
Madagaskar,2008,11,9838000,8871000,18709000
Madagaskar,2008,12,6459000,4537000,10996000
Madagaskar,2009,1,4622000,5121000,9743000
Madagaskar,2009,2,13549000,2303000,15852000
Madagaskar,2009,3,8388000,2254000,10642000
Madagaskar,2009,4,6958000,1830000,8788000
Madagaskar,2009,5,3951000,5247000,9198000
Madagaskar,2009,6,4671000,3156000,7827000
Madagaskar,2009,7,5949000,5654000,11603000
Madagaskar,2009,8,932000,12652000,13584000
Madagaskar,2009,9,2647000,12849000,15496000
Madagaskar,2009,10,7523000,4708000,12231000
Madagaskar,2009,11,2193000,3945000,6138000
Madagaskar,2009,12,5313000,4133000,9446000
Madagaskar,2010,1,1772000,4816000,6588000
Madagaskar,2010,2,1405000,2445000,3850000
Madagaskar,2010,3,2762000,2527000,5289000
Madagaskar,2010,4,3275000,3179000,6454000
Madagaskar,2010,5,5400000,2759000,8159000
Madagaskar,2010,6,2980000,5666000,8646000
Madagaskar,2010,7,970000,9315000,10285000
Madagaskar,2010,8,4318000,11204000,15522000
Madagaskar,2010,9,1493000,9036000,10529000
Madagaskar,2010,10,3226000,5363000,8589000
Madagaskar,2010,11,4687000,7536000,12223000
Madagaskar,2010,12,6057000,5995000,12052000
Madagaskar,2011,1,1327000,4811000,6138000
Madagaskar,2011,2,829000,2469000,3298000
Madagaskar,2011,3,5442000,3771000,9213000
Madagaskar,2011,4,2156000,2801000,4957000
Madagaskar,2011,5,2667000,5827000,8494000
Madagaskar,2011,6,1499000,5671000,7170000
Madagaskar,2011,7,1769000,12692000,14461000
Madagaskar,2011,8,1667000,15072000,16739000
Madagaskar,2011,9,5385000,6066000,11451000
Madagaskar,2011,10,1167000,8908000,10075000
Madagaskar,2011,11,1537000,7812000,9349000
Madagaskar,2011,12,5733000,7098000,12831000
Madagaskar,2012,1,1419000,6863000,8282000
Madagaskar,2012,2,3094000,5121000,8215000
Madagaskar,2012,3,3366000,3437000,6803000
Madagaskar,2012,4,2526000,3180000,5706000
Madagaskar,2012,5,2257000,6967000,9224000
Madagaskar,2012,6,5211000,9722000,14933000
Madagaskar,2012,7,2572000,9121000,11693000
Madagaskar,2012,8,1471000,18028000,19499000
Madagaskar,2012,9,2440000,9087000,11527000
Madagaskar,2012,10,4198000,8676000,12874000
Madagaskar,2012,11,2475000,7560000,10035000
Madagaskar,2012,12,3274000,9507000,12781000
Madagaskar,2013,1,2322000,11194000,13516000
Madagaskar,2013,2,2728000,4560000,7288000
Madagaskar,2013,3,2892000,5996000,8888000
Madagaskar,2013,4,5587000,5087000,10674000
Madagaskar,2013,5,2946000,5057000,8003000
Madagaskar,2013,6,2216000,9282000,11498000
Madagaskar,2013,7,3920000,15276000,19196000
Madagaskar,2013,8,5167000,18773000,23940000
Madagaskar,2013,9,1364000,12086000,13450000
Madagaskar,2013,10,4023000,9424000,13447000
Madagaskar,2013,11,3729000,5610000,9339000
Madagaskar,2013,12,1808000,11145000,12953000
Madagaskar,2014,1,4240000,11912000,16152000
Madagaskar,2014,2,5833000,9855000,15688000
Madagaskar,2014,3,2879000,5121000,8000000
Madagaskar,2014,4,2885000,7619000,10504000
Madagaskar,2014,5,3255000,4532000,7787000
Madagaskar,2014,6,3183000,11706000,14889000
Madagaskar,2014,7,4430000,16046000,20476000
Madagaskar,2014,8,4175000,17392000,21567000
Madagaskar,2014,9,2904000,11144000,14048000
Madagaskar,2014,10,2546000,11032000,13578000
Madagaskar,2014,11,2894000,7383000,10277000
Madagaskar,2014,12,4076000,13115000,17191000
Madagaskar,2015,1,1611000,11533000,13144000
Madagaskar,2015,2,1592000,10769000,12361000
Madagaskar,2015,3,2241000,7864000,10105000
Madagaskar,2015,4,1918000,7660000,9578000
Madagaskar,2015,5,8881000,10048000,18929000
Madagaskar,2015,6,2562000,11290000,13852000
Madagaskar,2015,7,3445000,19300000,22745000
Madagaskar,2015,8,2021000,33625000,35646000
Madagaskar,2015,9,4352000,12702000,17054000
Madagaskar,2015,10,2654000,11833000,14487000
Madagaskar,2015,11,3140000,11993000,15133000
Madagaskar,2015,12,1961000,15073000,17034000
Madagaskar,2016,1,1498000,13808000,15306000
Madagaskar,2016,2,1722000,15973000,17695000
Madagaskar,2016,3,3185000,19000000,22185000
Madagaskar,2016,4,2689000,12040000,14729000
Madagaskar,2016,5,1811000,13435000,15246000
Madagaskar,2016,6,3030000,14410000,17440000
Madagaskar,2016,7,2958000,15576000,18534000
Madagaskar,2016,8,2193000,23858000,26051000
Madagaskar,2016,9,3137000,20172000,23309000
Madagaskar,2016,10,3042000,20675000,23717000
Madagaskar,2016,11,2993000,14911000,17904000
Madagaskar,2016,12,2185000,34337000,36522000
Madagaskar,2017,1,2359000,35108000,37467000
Madagaskar,2017,2,2807000,14814000,17621000
Madagaskar,2017,3,3327000,15500000,18827000
Madagaskar,2017,4,2344000,8895000,11239000
Madagaskar,2017,5,6261000,10039000,16300000
Madagaskar,2017,6,3332000,8494000,11826000
Madagaskar,2017,7,3289000,18671000,21960000
Madagaskar,2017,8,4060000,30086000,34146000
Madagaskar,2017,9,3846000,15614000,19460000
Madagaskar,2017,10,4096000,12623000,16719000
Madagaskar,2017,11,3688000,29277000,32965000
Madagaskar,2017,12,2459000,31348000,33807000
Madagaskar,2018,1,1790000,26909000,28699000
Madagaskar,2018,2,2533000,26280000,28813000
Madagaskar,2018,3,2980000,25671000,28651000
Madagaskar,2018,4,2148000,33780000,35928000
Madagaskar,2018,5,4755000,13981000,18736000
Madagaskar,2018,6,3282000,17113000,20395000
Madagaskar,2018,7,4146000,18369000,22515000
Madagaskar,2018,8,5137000,30435000,35572000
Madagaskar,2018,9,3193000,19724000,22917000
Madagaskar,2018,10,4147000,22898000,27045000
Madagaskar,2018,11,2981000,21884000,24865000
Madagaskar,2018,12,2249000,31609000,33858000
Madagaskar,2019,1,2977000,16267000,19244000
Madagaskar,2019,2,3154000,26136000,29290000
Madagaskar,2019,3,3725000,11022000,14747000
Madagaskar,2019,4,3580000,11957000,15537000
Madagaskar,2019,5,4029000,15662000,19691000
Madagaskar,2019,6,4893000,17689000,22582000
Madagaskar,2019,7,6605000,22569000,29174000
Madagaskar,2019,8,5217000,25880000,31097000
Madagaskar,2019,9,4059000,8364000,12423000
Madagaskar,2019,10,7994000,12455000,20449000
Madagaskar,2019,11,3034000,11803000,14837000
Madagaskar,2019,12,3264000,10278000,13542000
Madagaskar,2020,1,3435000,27012000,30447000
Madagaskar,2020,2,3306000,12507000,15813000
Madagaskar,2020,3,2972000,9983000,12955000
Madagaskar,2020,4,1801000,13700000,15501000
Madagaskar,2020,5,3418000,10560000,13978000
Madagaskar,2020,6,3052000,22482000,25534000
Madagaskar,2020,7,4007000,20277000,24284000
Madagaskar,2020,8,1367000,22989000,24356000
Madagaskar,2020,9,2605000,10270000,12875000
Madagaskar,2020,10,3014000,11370000,14384000
Madagaskar,2020,11,2086000,10884000,12970000
Madagaskar,2020,12,2983000,18749000,21732000
Madagaskar,2021,1,1409000,22815000,24224000
Madagaskar,2021,2,2069000,16196000,18265000
Madagaskar,2021,3,3077000,19600000,22677000
Madagaskar,2021,4,4074000,12912000,16986000
Madagaskar,2021,5,2571000,10587000,13158000
Madagaskar,2021,6,5270000,9954000,15224000
Madagaskar,2021,7,3829000,11272000,15101000
Madagaskar,2021,8,3824000,30495000,34319000
Madagaskar,2021,9,2762000,15888000,18650000
Madagaskar,2021,10,2503000,11905000,14408000
Madagaskar,2021,11,2837000,8629000,11466000
Madagaskar,2021,12,2509000,19178000,21687000
Madagaskar,2022,1,1905000,32954000,34859000
Madagaskar,2022,2,3453000,24400000,27853000
Madagaskar,2022,3,4759000,15475000,20234000
Madagaskar,2022,4,2923000,9369000,12292000
Madagaskar,2022,5,4119000,9537000,13656000
Madagaskar,2022,6,3580000,11094000,14674000
Madagaskar,2022,7,2994000,20775000,23769000
Madagaskar,2022,8,2992000,29350000,32342000
Madagaskar,2022,9,3949000,15247000,19196000
Madagaskar,2022,10,4366000,10050000,14416000
Madagaskar,2022,11,3500000,8939000,12439000
Madagaskar,2022,12,4360000,13728000,18088000
Madagaskar,2023,1,12496000,12565000,25061000
Madagaskar,2023,2,2837000,19864000,22701000
Madagaskar,2023,3,7102000,17349000,24451000
Madagaskar,2023,4,3635000,15392000,19027000
Madagaskar,2023,5,2795000,11040000,13835000
Madagaskar,2023,6,7787000,10492000,18279000
Madagaskar,2023,7,3389000,8921000,12310000
Madagaskar,2023,8,3362000,11203000,14565000
Madagaskar,2023,9,3195000,13123000,16318000
Madagaskar,2023,10,6099000,9223000,15322000
Madagaskar,2023,11,3477000,9226000,12703000
Madagaskar,2023,12,3465000,12172000,15637000
Madagaskar,2024,1,3082000,14982000,18064000
Madagaskar,2024,2,2471000,9085000,11556000
Madagaskar,2024,3,4994000,8974000,13968000
Madagaskar,2024,4,4368000,15363000,19731000
Madagaskar,2024,5,4299000,17477000,21776000
Madagaskar,2024,6,10589000,8947000,19536000
Madagaskar,2024,7,3814000,13633000,17447000
Madagaskar,2024,8,11545000,10695000,22240000
Madagaskar,2024,9,4213000,12418000,16631000
Madagaskar,2024,10,3453000,12294000,15747000
Madagaskar,2024,11,3049000,12461000,15510000
Madagaskar,2024,12,3656000,11810000,15466000
Malawi,2008,1,2189000,4964000,7153000
Malawi,2008,2,1039000,2490000,3529000
Malawi,2008,3,654000,2817000,3471000
Malawi,2008,4,1280000,2814000,4094000
Malawi,2008,5,789000,1973000,2762000
Malawi,2008,6,4072000,2991000,7063000
Malawi,2008,7,4607000,3686000,8293000
Malawi,2008,8,2255000,1884000,4139000
Malawi,2008,9,2593000,3994000,6587000
Malawi,2008,10,2525000,3527000,6052000
Malawi,2008,11,2065000,4363000,6428000
Malawi,2008,12,951000,1751000,2702000
Malawi,2009,1,2160000,6781000,8941000
Malawi,2009,2,862000,9194000,10056000
Malawi,2009,3,1325000,7909000,9234000
Malawi,2009,4,472000,8360000,8832000
Malawi,2009,5,333000,6214000,6547000
Malawi,2009,6,622000,14357000,14979000
Malawi,2009,7,648000,6761000,7409000
Malawi,2009,8,1057000,6599000,7656000
Malawi,2009,9,2978000,3884000,6862000
Malawi,2009,10,590000,6306000,6896000
Malawi,2009,11,575000,3412000,3987000
Malawi,2009,12,1134000,4890000,6024000
Malawi,2010,1,980000,8379000,9359000
Malawi,2010,2,3643000,8607000,12250000
Malawi,2010,3,478000,9423000,9901000
Malawi,2010,4,222000,17413000,17635000
Malawi,2010,5,493000,6709000,7202000
Malawi,2010,6,3170000,9715000,12885000
Malawi,2010,7,772000,6610000,7382000
Malawi,2010,8,2882000,5128000,8010000
Malawi,2010,9,641000,5137000,5778000
Malawi,2010,10,2460000,5667000,8127000
Malawi,2010,11,903000,4767000,5670000
Malawi,2010,12,979000,4621000,5600000
Malawi,2011,1,339000,7042000,7381000
Malawi,2011,2,400000,6599000,6999000
Malawi,2011,3,762000,5657000,6419000
Malawi,2011,4,554000,9560000,10114000
Malawi,2011,5,3372000,6451000,9823000
Malawi,2011,6,1573000,8049000,9622000
Malawi,2011,7,881000,5527000,6408000
Malawi,2011,8,3950000,7198000,11148000
Malawi,2011,9,399000,5201000,5600000
Malawi,2011,10,1947000,3983000,5930000
Malawi,2011,11,1427000,6937000,8364000
Malawi,2011,12,564000,4656000,5220000
Malawi,2012,1,773000,8666000,9439000
Malawi,2012,2,400000,6890000,7290000
Malawi,2012,3,442000,5532000,5974000
Malawi,2012,4,3700000,4253000,7953000
Malawi,2012,5,2854000,5898000,8752000
Malawi,2012,6,687000,6803000,7490000
Malawi,2012,7,942000,7245000,8187000
Malawi,2012,8,2616000,4768000,7384000
Malawi,2012,9,4365000,5858000,10223000
Malawi,2012,10,852000,5582000,6434000
Malawi,2012,11,2311000,4822000,7133000
Malawi,2012,12,1345000,2818000,4163000
Malawi,2013,1,3649000,5187000,8836000
Malawi,2013,2,1265000,4154000,5419000
Malawi,2013,3,2490000,3924000,6414000
Malawi,2013,4,1035000,4187000,5222000
Malawi,2013,5,1136000,3914000,5050000
Malawi,2013,6,2942000,3429000,6371000
Malawi,2013,7,2549000,6544000,9093000
Malawi,2013,8,766000,4552000,5318000
Malawi,2013,9,2630000,7913000,10543000
Malawi,2013,10,940000,5575000,6515000
Malawi,2013,11,6605000,5094000,11699000
Malawi,2013,12,918000,3229000,4147000
Malawi,2014,1,1472000,6127000,7599000
Malawi,2014,2,830000,5289000,6119000
Malawi,2014,3,984000,5549000,6533000
Malawi,2014,4,675000,6306000,6981000
Malawi,2014,5,1121000,3914000,5035000
Malawi,2014,6,2076000,6940000,9016000
Malawi,2014,7,1612000,7461000,9073000
Malawi,2014,8,482000,6493000,6975000
Malawi,2014,9,506000,9585000,10091000
Malawi,2014,10,1537000,9502000,11039000
Malawi,2014,11,432000,11261000,11693000
Malawi,2014,12,540000,8442000,8982000
Malawi,2015,1,389000,16748000,17137000
Malawi,2015,2,2234000,15081000,17315000
Malawi,2015,3,1202000,12521000,13723000
Malawi,2015,4,4431000,15244000,19675000
Malawi,2015,5,2996000,6019000,9015000
Malawi,2015,6,2003000,7519000,9522000
Malawi,2015,7,1242000,11136000,12378000
Malawi,2015,8,1584000,7949000,9533000
Malawi,2015,9,840000,11869000,12709000
Malawi,2015,10,719000,12940000,13659000
Malawi,2015,11,1383000,7360000,8743000
Malawi,2015,12,524000,10634000,11158000
Malawi,2016,1,1443000,11651000,13094000
Malawi,2016,2,230000,8754000,8984000
Malawi,2016,3,1501000,7008000,8509000
Malawi,2016,4,2809000,7042000,9851000
Malawi,2016,5,512000,4888000,5400000
Malawi,2016,6,2062000,7487000,9549000
Malawi,2016,7,562000,6309000,6871000
Malawi,2016,8,2077000,5603000,7680000
Malawi,2016,9,1192000,9761000,10953000
Malawi,2016,10,2153000,9865000,12018000
Malawi,2016,11,1146000,11061000,12207000
Malawi,2016,12,1716000,10558000,12274000
Malawi,2017,1,1834000,7647000,9481000
Malawi,2017,2,1463000,6012000,7475000
Malawi,2017,3,1009000,9025000,10034000
Malawi,2017,4,1809000,7688000,9497000
Malawi,2017,5,2788000,11100000,13888000
Malawi,2017,6,1903000,9356000,11259000
Malawi,2017,7,1028000,9283000,10311000
Malawi,2017,8,2567000,12432000,14999000
Malawi,2017,9,2033000,11866000,13899000
Malawi,2017,10,3062000,18281000,21343000
Malawi,2017,11,1331000,11998000,13329000
Malawi,2017,12,3492000,10558000,14050000
Malawi,2018,1,1166000,9452000,10618000
Malawi,2018,2,3506000,9128000,12634000
Malawi,2018,3,2218000,7597000,9815000
Malawi,2018,4,775000,8062000,8837000
Malawi,2018,5,911000,9923000,10834000
Malawi,2018,6,1879000,11773000,13652000
Malawi,2018,7,1355000,7476000,8831000
Malawi,2018,8,1168000,7850000,9018000
Malawi,2018,9,2192000,13378000,15570000
Malawi,2018,10,2079000,12301000,14380000
Malawi,2018,11,1204000,11834000,13038000
Malawi,2018,12,649000,5780000,6429000
Malawi,2019,1,1476000,8436000,9912000
Malawi,2019,2,1387000,5154000,6541000
Malawi,2019,3,2120000,9577000,11697000
Malawi,2019,4,6472000,6303000,12775000
Malawi,2019,5,935000,8917000,9852000
Malawi,2019,6,1937000,5882000,7819000
Malawi,2019,7,2803000,8279000,11082000
Malawi,2019,8,1769000,4010000,5779000
Malawi,2019,9,1428000,7579000,9007000
Malawi,2019,10,1607000,10698000,12305000
Malawi,2019,11,8024000,5601000,13625000
Malawi,2019,12,506000,6363000,6869000
Malawi,2020,1,464000,6684000,7148000
Malawi,2020,2,1949000,5808000,7757000
Malawi,2020,3,2078000,3911000,5989000
Malawi,2020,4,3766000,5395000,9161000
Malawi,2020,5,446000,7802000,8248000
Malawi,2020,6,2912000,5102000,8014000
Malawi,2020,7,954000,4349000,5303000
Malawi,2020,8,496000,4878000,5374000
Malawi,2020,9,2184000,5938000,8122000
Malawi,2020,10,4090000,8048000,12138000
Malawi,2020,11,1342000,12148000,13490000
Malawi,2020,12,2743000,7129000,9872000
Malawi,2021,1,622000,3870000,4492000
Malawi,2021,2,2414000,7792000,10206000
Malawi,2021,3,3414000,6922000,10336000
Malawi,2021,4,3782000,6298000,10080000
Malawi,2021,5,431000,5602000,6033000
Malawi,2021,6,897000,9362000,10259000
Malawi,2021,7,1112000,9627000,10739000
Malawi,2021,8,713000,7284000,7997000
Malawi,2021,9,1199000,3683000,4882000
Malawi,2021,10,3008000,9238000,12246000
Malawi,2021,11,3272000,11034000,14306000
Malawi,2021,12,3488000,6148000,9636000
Malawi,2022,1,2594000,7361000,9955000
Malawi,2022,2,2963000,7420000,10383000
Malawi,2022,3,1347000,6196000,7543000
Malawi,2022,4,928000,4753000,5681000
Malawi,2022,5,3573000,8379000,11952000
Malawi,2022,6,4613000,5374000,9987000
Malawi,2022,7,2120000,7090000,9210000
Malawi,2022,8,610000,7406000,8016000
Malawi,2022,9,3697000,10503000,14200000
Malawi,2022,10,4036000,9703000,13739000
Malawi,2022,11,7150000,7569000,14719000
Malawi,2022,12,4644000,5141000,9785000
Malawi,2023,1,1703000,12219000,13922000
Malawi,2023,2,5354000,10029000,15383000
Malawi,2023,3,1723000,6731000,8454000
Malawi,2023,4,1292000,6776000,8068000
Malawi,2023,5,2923000,10264000,13187000
Malawi,2023,6,3762000,7106000,10868000
Malawi,2023,7,719000,8798000,9517000
Malawi,2023,8,661000,7270000,7931000
Malawi,2023,9,3112000,8041000,11153000
Malawi,2023,10,1280000,5881000,7161000
Malawi,2023,11,4299000,8766000,13065000
Malawi,2023,12,550000,5571000,6121000
Malawi,2024,1,551000,7891000,8442000
Malawi,2024,2,3083000,10415000,13498000
Malawi,2024,3,4216000,11478000,15694000
Malawi,2024,4,3119000,6359000,9478000
Malawi,2024,5,1611000,7025000,8636000
Malawi,2024,6,2351000,7304000,9655000
Malawi,2024,7,1260000,7433000,8693000
Malawi,2024,8,641000,6610000,7251000
Malawi,2024,9,7476000,6506000,13982000
Malawi,2024,10,2106000,4109000,6215000
Malawi,2024,11,1674000,8135000,9809000
Malawi,2024,12,3858000,6941000,10799000
Malaysia,2008,1,340797000,379942000,720739000
Malaysia,2008,2,353164000,350976000,704140000
Malaysia,2008,3,324043000,379393000,703436000
Malaysia,2008,4,343040000,367957000,710997000
Malaysia,2008,5,310018000,357901000,667919000
Malaysia,2008,6,283045000,371033000,654078000
Malaysia,2008,7,301153000,377324000,678477000
Malaysia,2008,8,361515000,351628000,713143000
Malaysia,2008,9,324838000,368997000,693835000
Malaysia,2008,10,404117000,407644000,811761000
Malaysia,2008,11,324367000,419904000,744271000
Malaysia,2008,12,278449000,341964000,620413000
Malaysia,2009,1,301277000,343133000,644410000
Malaysia,2009,2,216561000,288967000,505528000
Malaysia,2009,3,247857000,329849000,577706000
Malaysia,2009,4,220371000,295214000,515585000
Malaysia,2009,5,256476000,271452000,527928000
Malaysia,2009,6,248656000,293750000,542406000
Malaysia,2009,7,359501000,311469000,670970000
Malaysia,2009,8,257529000,295979000,553508000
Malaysia,2009,9,240114000,338486000,578600000
Malaysia,2009,10,342427000,448962000,791389000
Malaysia,2009,11,286229000,401310000,687539000
Malaysia,2009,12,304947000,422445000,727392000
Malaysia,2010,1,247490000,375708000,623198000
Malaysia,2010,2,295647000,380083000,675730000
Malaysia,2010,3,352531000,482191000,834722000
Malaysia,2010,4,322613000,445429000,768042000
Malaysia,2010,5,368653000,451197000,819850000
Malaysia,2010,6,412448000,488401000,900849000
Malaysia,2010,7,425109000,466051000,891160000
Malaysia,2010,8,371901000,509574000,881475000
Malaysia,2010,9,378829000,517308000,896137000
Malaysia,2010,10,374064000,500992000,875056000
Malaysia,2010,11,372138000,607882000,980020000
Malaysia,2010,12,383235000,515913000,899148000
Malaysia,2011,1,351565000,566006000,917571000
Malaysia,2011,2,341952000,496769000,838721000
Malaysia,2011,3,375939000,614921000,990860000
Malaysia,2011,4,346246000,540545000,886791000
Malaysia,2011,5,346468000,546996000,893464000
Malaysia,2011,6,337033000,481817000,818850000
Malaysia,2011,7,377009000,516228000,893237000
Malaysia,2011,8,346476000,562768000,909244000
Malaysia,2011,9,335144000,513247000,848391000
Malaysia,2011,10,360005000,497901000,857906000
Malaysia,2011,11,365489000,493779000,859268000
Malaysia,2011,12,460449000,404589000,865038000
Malaysia,2012,1,386636000,472165000,858801000
Malaysia,2012,2,438228000,448756000,886984000
Malaysia,2012,3,422870000,479119000,901989000
Malaysia,2012,4,382667000,450123000,832790000
Malaysia,2012,5,447102000,462073000,909175000
Malaysia,2012,6,383503000,476994000,860497000
Malaysia,2012,7,465013000,476950000,941963000
Malaysia,2012,8,456084000,438896000,894980000
Malaysia,2012,9,339271000,433709000,772980000
Malaysia,2012,10,428148000,486520000,914668000
Malaysia,2012,11,358260000,428604000,786864000
Malaysia,2012,12,450268000,366544000,816812000
Malaysia,2013,1,362706000,481599000,844305000
Malaysia,2013,2,426473000,394343000,820816000
Malaysia,2013,3,403210000,415869000,819079000
Malaysia,2013,4,401666000,508690000,910356000
Malaysia,2013,5,417275000,458991000,876266000
Malaysia,2013,6,454229000,448845000,903074000
Malaysia,2013,7,414798000,505904000,920702000
Malaysia,2013,8,353622000,452028000,805650000
Malaysia,2013,9,416202000,493036000,909238000
Malaysia,2013,10,430719000,514116000,944835000
Malaysia,2013,11,366646000,468941000,835587000
Malaysia,2013,12,350309000,445207000,795516000
Malaysia,2014,1,357841000,526321000,884162000
Malaysia,2014,2,332749000,473562000,806311000
Malaysia,2014,3,354645000,517082000,871727000
Malaysia,2014,4,415228000,511451000,926679000
Malaysia,2014,5,391783000,483672000,875455000
Malaysia,2014,6,431044000,501564000,932608000
Malaysia,2014,7,507771000,507962000,1015733000
Malaysia,2014,8,366937000,495717000,862654000
Malaysia,2014,9,442098000,554113000,996211000
Malaysia,2014,10,403857000,551853000,955710000
Malaysia,2014,11,405263000,526187000,931450000
Malaysia,2014,12,383985000,495779000,879764000
Malaysia,2015,1,394273000,586613000,980886000
Malaysia,2015,2,380552000,521422000,901974000
Malaysia,2015,3,412966000,619110000,1032076000
Malaysia,2015,4,482347000,594778000,1077125000
Malaysia,2015,5,398113000,556168000,954281000
Malaysia,2015,6,381288000,613221000,994509000
Malaysia,2015,7,488878000,614117000,1102995000
Malaysia,2015,8,370653000,573929000,944582000
Malaysia,2015,9,357258000,605101000,962359000
Malaysia,2015,10,420535000,641813000,1062348000
Malaysia,2015,11,337345000,555226000,892571000
Malaysia,2015,12,375258000,530334000,905592000
Malaysia,2016,1,326576000,606388000,932964000
Malaysia,2016,2,414242000,577714000,991956000
Malaysia,2016,3,396421000,595679000,992100000
Malaysia,2016,4,402911000,633796000,1036707000
Malaysia,2016,5,350872000,586080000,936952000
Malaysia,2016,6,444748000,646882000,1091630000
Malaysia,2016,7,334963000,624136000,959099000
Malaysia,2016,8,458077000,631089000,1089166000
Malaysia,2016,9,462031000,653554000,1115585000
Malaysia,2016,10,367295000,694298000,1061593000
Malaysia,2016,11,419416000,720257000,1139673000
Malaysia,2016,12,372524000,673580000,1046104000
Malaysia,2017,1,389288000,702051000,1091339000
Malaysia,2017,2,369464000,674170000,1043634000
Malaysia,2017,3,489645000,766177000,1255822000
Malaysia,2017,4,379583000,680884000,1060467000
Malaysia,2017,5,405336000,747827000,1153163000
Malaysia,2017,6,400700000,713400000,1114100000
Malaysia,2017,7,417851000,727395000,1145246000
Malaysia,2017,8,438880000,762902000,1201782000
Malaysia,2017,9,441052000,738514000,1179566000
Malaysia,2017,10,425345000,736201000,1161546000
Malaysia,2017,11,460062000,740071000,1200133000
Malaysia,2017,12,405867000,675285000,1081152000
Malaysia,2018,1,454595000,793627000,1248222000
Malaysia,2018,2,366175000,772001000,1138176000
Malaysia,2018,3,426142000,741510000,1167652000
Malaysia,2018,4,408356000,775675000,1184031000
Malaysia,2018,5,390640000,687658000,1078298000
Malaysia,2018,6,427209000,718365000,1145574000
Malaysia,2018,7,428469000,765479000,1193948000
Malaysia,2018,8,493465000,712175000,1205640000
Malaysia,2018,9,390716000,731106000,1121822000
Malaysia,2018,10,450891000,799447000,1250338000
Malaysia,2018,11,516633000,781355000,1297988000
Malaysia,2018,12,432405000,661389000,1093794000
Malaysia,2019,1,451097000,808237000,1259334000
Malaysia,2019,2,506081000,771823000,1277904000
Malaysia,2019,3,458177000,767697000,1225874000
Malaysia,2019,4,469382000,726436000,1195818000
Malaysia,2019,5,504165000,744517000,1248682000
Malaysia,2019,6,394448000,664082000,1058530000
Malaysia,2019,7,543532000,707855000,1251387000
Malaysia,2019,8,414149000,739819000,1153968000
Malaysia,2019,9,395134000,688132000,1083266000
Malaysia,2019,10,441036000,738219000,1179255000
Malaysia,2019,11,503177000,716625000,1219802000
Malaysia,2019,12,487777000,624102000,1111879000
Malaysia,2020,1,529646000,730425000,1260071000
Malaysia,2020,2,430891000,693077000,1123968000
Malaysia,2020,3,384783000,725438000,1110221000
Malaysia,2020,4,397725000,526905000,924630000
Malaysia,2020,5,359189000,523401000,882590000
Malaysia,2020,6,370341000,662617000,1032958000
Malaysia,2020,7,387010000,741145000,1128155000
Malaysia,2020,8,307385000,695795000,1003180000
Malaysia,2020,9,345932000,767809000,1113741000
Malaysia,2020,10,374619000,790883000,1165502000
Malaysia,2020,11,388561000,766128000,1154689000
Malaysia,2020,12,374656000,737591000,1112247000
Malaysia,2021,1,399293000,707137000,1106430000
Malaysia,2021,2,443081000,753888000,1196969000
Malaysia,2021,3,469252000,902274000,1371526000
Malaysia,2021,4,431528000,962457000,1393985000
Malaysia,2021,5,397720000,844873000,1242593000
Malaysia,2021,6,405287000,843648000,1248935000
Malaysia,2021,7,459540000,791915000,1251455000
Malaysia,2021,8,417137000,754301000,1171438000
Malaysia,2021,9,439067000,815177000,1254244000
Malaysia,2021,10,467247000,833532000,1300779000
Malaysia,2021,11,446455000,879480000,1325935000
Malaysia,2021,12,392734000,867336000,1260070000
Malaysia,2022,1,487391000,881318000,1368709000
Malaysia,2022,2,450243000,918302000,1368545000
Malaysia,2022,3,536526000,1034014000,1570540000
Malaysia,2022,4,488045000,984180000,1472225000
Malaysia,2022,5,545421000,1076925000,1622346000
Malaysia,2022,6,509863000,1064006000,1573869000
Malaysia,2022,7,488415000,1046000000,1534415000
Malaysia,2022,8,530410000,1119392000,1649802000
Malaysia,2022,9,546539000,1115573000,1662112000
Malaysia,2022,10,530141000,1096213000,1626354000
Malaysia,2022,11,580248000,1169940000,1750188000
Malaysia,2022,12,525746000,997305000,1523051000
Malaysia,2023,1,524014000,1048381000,1572395000
Malaysia,2023,2,531650000,955256000,1486906000
Malaysia,2023,3,607451000,1082896000,1690347000
Malaysia,2023,4,463031000,925502000,1388533000
Malaysia,2023,5,514004000,947017000,1461021000
Malaysia,2023,6,534986000,931280000,1466266000
Malaysia,2023,7,510609000,909300000,1419909000
Malaysia,2023,8,496327000,905469000,1401796000
Malaysia,2023,9,527701000,959495000,1487196000
Malaysia,2023,10,556775000,998608000,1555383000
Malaysia,2023,11,522906000,986839000,1509745000
Malaysia,2023,12,490545000,828473000,1319018000
Malaysia,2024,1,518783000,862609000,1381392000
Malaysia,2024,2,473011000,874167000,1347178000
Malaysia,2024,3,485900000,862615000,1348515000
Malaysia,2024,4,622709000,897778000,1520487000
Malaysia,2024,5,455465000,849215000,1304680000
Malaysia,2024,6,474411000,829574000,1303985000
Malaysia,2024,7,739934000,940400000,1680334000
Malaysia,2024,8,496345000,809508000,1305853000
Malaysia,2024,9,503975000,995658000,1499633000
Malaysia,2024,10,593097000,1084466000,1677563000
Malaysia,2024,11,540189000,946710000,1486899000
Malaysia,2024,12,696628000,868868000,1565496000
Malediven,2008,1,1675000,529000,2204000
Malediven,2008,2,1851000,432000,2283000
Malediven,2008,3,904000,503000,1407000
Malediven,2008,4,1409000,376000,1785000
Malediven,2008,5,1361000,415000,1776000
Malediven,2008,6,2529000,322000,2851000
Malediven,2008,7,10266000,272000,10538000
Malediven,2008,8,1344000,578000,1922000
Malediven,2008,9,1167000,365000,1532000
Malediven,2008,10,10493000,331000,10824000
Malediven,2008,11,1447000,462000,1909000
Malediven,2008,12,1015000,183000,1198000
Malediven,2009,1,1101000,171000,1272000
Malediven,2009,2,938000,267000,1205000
Malediven,2009,3,957000,251000,1208000
Malediven,2009,4,873000,278000,1151000
Malediven,2009,5,818000,209000,1027000
Malediven,2009,6,2022000,249000,2271000
Malediven,2009,7,939000,185000,1124000
Malediven,2009,8,903000,268000,1171000
Malediven,2009,9,621000,320000,941000
Malediven,2009,10,945000,512000,1457000
Malediven,2009,11,1061000,424000,1485000
Malediven,2009,12,1089000,292000,1381000
Malediven,2010,1,961000,152000,1113000
Malediven,2010,2,1621000,223000,1844000
Malediven,2010,3,1662000,173000,1835000
Malediven,2010,4,810000,147000,957000
Malediven,2010,5,954000,148000,1102000
Malediven,2010,6,1122000,138000,1260000
Malediven,2010,7,839000,199000,1038000
Malediven,2010,8,966000,224000,1190000
Malediven,2010,9,952000,276000,1228000
Malediven,2010,10,1414000,202000,1616000
Malediven,2010,11,1011000,597000,1608000
Malediven,2010,12,1411000,358000,1769000
Malediven,2011,1,928000,464000,1392000
Malediven,2011,2,1073000,520000,1593000
Malediven,2011,3,1247000,432000,1679000
Malediven,2011,4,2438000,303000,2741000
Malediven,2011,5,932000,273000,1205000
Malediven,2011,6,2939000,293000,3232000
Malediven,2011,7,1322000,419000,1741000
Malediven,2011,8,962000,400000,1362000
Malediven,2011,9,1207000,643000,1850000
Malediven,2011,10,1034000,2058000,3092000
Malediven,2011,11,1453000,1120000,2573000
Malediven,2011,12,1990000,1220000,3210000
Malediven,2012,1,7299000,866000,8165000
Malediven,2012,2,1258000,1003000,2261000
Malediven,2012,3,1633000,956000,2589000
Malediven,2012,4,1300000,1070000,2370000
Malediven,2012,5,1351000,1006000,2357000
Malediven,2012,6,1539000,1005000,2544000
Malediven,2012,7,951000,1008000,1959000
Malediven,2012,8,1604000,985000,2589000
Malediven,2012,9,916000,1096000,2012000
Malediven,2012,10,1704000,1130000,2834000
Malediven,2012,11,1387000,979000,2366000
Malediven,2012,12,1648000,898000,2546000
Malediven,2013,1,1004000,1254000,2258000
Malediven,2013,2,1437000,848000,2285000
Malediven,2013,3,1550000,968000,2518000
Malediven,2013,4,1182000,916000,2098000
Malediven,2013,5,2159000,598000,2757000
Malediven,2013,6,1694000,960000,2654000
Malediven,2013,7,1417000,636000,2053000
Malediven,2013,8,1367000,891000,2258000
Malediven,2013,9,1088000,797000,1885000
Malediven,2013,10,1887000,915000,2802000
Malediven,2013,11,1798000,1237000,3035000
Malediven,2013,12,2295000,974000,3269000
Malediven,2014,1,2734000,769000,3503000
Malediven,2014,2,2762000,2184000,4946000
Malediven,2014,3,2142000,696000,2838000
Malediven,2014,4,1644000,823000,2467000
Malediven,2014,5,1597000,597000,2194000
Malediven,2014,6,1366000,567000,1933000
Malediven,2014,7,2058000,357000,2415000
Malediven,2014,8,1890000,755000,2645000
Malediven,2014,9,1670000,1039000,2709000
Malediven,2014,10,2238000,997000,3235000
Malediven,2014,11,3508000,1467000,4975000
Malediven,2014,12,2679000,1903000,4582000
Malediven,2015,1,1588000,1517000,3105000
Malediven,2015,2,2430000,1494000,3924000
Malediven,2015,3,3626000,2337000,5963000
Malediven,2015,4,2487000,2464000,4951000
Malediven,2015,5,1631000,1951000,3582000
Malediven,2015,6,1509000,2006000,3515000
Malediven,2015,7,2929000,1594000,4523000
Malediven,2015,8,2183000,2156000,4339000
Malediven,2015,9,2265000,1533000,3798000
Malediven,2015,10,3717000,1535000,5252000
Malediven,2015,11,4003000,2040000,6043000
Malediven,2015,12,3405000,2558000,5963000
Malediven,2016,1,4780000,1676000,6456000
Malediven,2016,2,2690000,2663000,5353000
Malediven,2016,3,2532000,2652000,5184000
Malediven,2016,4,2558000,3036000,5594000
Malediven,2016,5,2436000,2682000,5118000
Malediven,2016,6,2477000,1407000,3884000
Malediven,2016,7,2294000,848000,3142000
Malediven,2016,8,2187000,1338000,3525000
Malediven,2016,9,3904000,879000,4783000
Malediven,2016,10,3734000,1581000,5315000
Malediven,2016,11,4277000,1635000,5912000
Malediven,2016,12,3260000,2303000,5563000
Malediven,2017,1,4368000,1707000,6075000
Malediven,2017,2,5276000,1385000,6661000
Malediven,2017,3,3443000,1683000,5126000
Malediven,2017,4,4399000,2184000,6583000
Malediven,2017,5,3218000,1747000,4965000
Malediven,2017,6,3503000,1024000,4527000
Malediven,2017,7,4265000,1381000,5646000
Malediven,2017,8,3671000,1506000,5177000
Malediven,2017,9,2539000,1042000,3581000
Malediven,2017,10,2484000,1859000,4343000
Malediven,2017,11,4811000,1409000,6220000
Malediven,2017,12,2794000,1969000,4763000
Malediven,2018,1,2387000,1005000,3392000
Malediven,2018,2,2913000,1276000,4189000
Malediven,2018,3,3488000,1361000,4849000
Malediven,2018,4,5205000,2102000,7307000
Malediven,2018,5,3963000,1921000,5884000
Malediven,2018,6,3274000,702000,3976000
Malediven,2018,7,4969000,1409000,6378000
Malediven,2018,8,3527000,1678000,5205000
Malediven,2018,9,4134000,1623000,5757000
Malediven,2018,10,3897000,1802000,5699000
Malediven,2018,11,5227000,2463000,7690000
Malediven,2018,12,3186000,2147000,5333000
Malediven,2019,1,3511000,2488000,5999000
Malediven,2019,2,4012000,2274000,6286000
Malediven,2019,3,5017000,1895000,6912000
Malediven,2019,4,2709000,1942000,4651000
Malediven,2019,5,2791000,3010000,5801000
Malediven,2019,6,2913000,1038000,3951000
Malediven,2019,7,2881000,2788000,5669000
Malediven,2019,8,3716000,2196000,5912000
Malediven,2019,9,3625000,1643000,5268000
Malediven,2019,10,3207000,2583000,5790000
Malediven,2019,11,4490000,1628000,6118000
Malediven,2019,12,3693000,1745000,5438000
Malediven,2020,1,3780000,1944000,5724000
Malediven,2020,2,3176000,2110000,5286000
Malediven,2020,3,2600000,2310000,4910000
Malediven,2020,4,1637000,1761000,3398000
Malediven,2020,5,1390000,1773000,3163000
Malediven,2020,6,1113000,2134000,3247000
Malediven,2020,7,1193000,1753000,2946000
Malediven,2020,8,918000,1859000,2777000
Malediven,2020,9,1885000,2008000,3893000
Malediven,2020,10,1297000,1871000,3168000
Malediven,2020,11,2081000,1866000,3947000
Malediven,2020,12,2510000,1847000,4357000
Malediven,2021,1,2077000,1250000,3327000
Malediven,2021,2,2299000,2135000,4434000
Malediven,2021,3,3405000,1260000,4665000
Malediven,2021,4,2881000,2072000,4953000
Malediven,2021,5,2676000,1083000,3759000
Malediven,2021,6,2470000,1115000,3585000
Malediven,2021,7,2254000,2516000,4770000
Malediven,2021,8,2638000,2168000,4806000
Malediven,2021,9,2876000,2157000,5033000
Malediven,2021,10,2901000,1981000,4882000
Malediven,2021,11,5103000,1780000,6883000
Malediven,2021,12,3078000,2175000,5253000
Malediven,2022,1,3366000,2991000,6357000
Malediven,2022,2,2907000,2615000,5522000
Malediven,2022,3,4024000,1417000,5441000
Malediven,2022,4,3459000,1409000,4868000
Malediven,2022,5,2701000,1035000,3736000
Malediven,2022,6,3101000,1685000,4786000
Malediven,2022,7,9819000,1447000,11266000
Malediven,2022,8,5101000,2134000,7235000
Malediven,2022,9,2964000,1762000,4726000
Malediven,2022,10,3219000,1977000,5196000
Malediven,2022,11,4062000,2151000,6213000
Malediven,2022,12,3259000,2471000,5730000
Malediven,2023,1,2809000,2259000,5068000
Malediven,2023,2,3539000,1585000,5124000
Malediven,2023,3,3681000,1375000,5056000
Malediven,2023,4,2201000,497000,2698000
Malediven,2023,5,5029000,728000,5757000
Malediven,2023,6,2747000,1662000,4409000
Malediven,2023,7,2655000,1080000,3735000
Malediven,2023,8,3368000,1499000,4867000
Malediven,2023,9,3045000,1323000,4368000
Malediven,2023,10,3800000,1648000,5448000
Malediven,2023,11,3943000,1190000,5133000
Malediven,2023,12,3498000,1222000,4720000
Malediven,2024,1,3749000,2506000,6255000
Malediven,2024,2,4183000,1511000,5694000
Malediven,2024,3,4230000,1218000,5448000
Malediven,2024,4,3460000,2347000,5807000
Malediven,2024,5,2882000,1545000,4427000
Malediven,2024,6,3334000,1490000,4824000
Malediven,2024,7,2699000,1729000,4428000
Malediven,2024,8,3580000,857000,4437000
Malediven,2024,9,4680000,968000,5648000
Malediven,2024,10,4040000,895000,4935000
Malediven,2024,11,3715000,908000,4623000
Malediven,2024,12,4027000,1223000,5250000
Mali,2008,1,6753000,35000,6788000
Mali,2008,2,6936000,229000,7165000
Mali,2008,3,8129000,25000,8154000
Mali,2008,4,5524000,61000,5585000
Mali,2008,5,5279000,169000,5448000
Mali,2008,6,4986000,368000,5354000
Mali,2008,7,7682000,50000,7732000
Mali,2008,8,6319000,206000,6525000
Mali,2008,9,3504000,167000,3671000
Mali,2008,10,9742000,147000,9889000
Mali,2008,11,4172000,246000,4418000
Mali,2008,12,4763000,73000,4836000
Mali,2009,1,4720000,135000,4855000
Mali,2009,2,6536000,651000,7187000
Mali,2009,3,5884000,400000,6284000
Mali,2009,4,6231000,769000,7000000
Mali,2009,5,2516000,730000,3246000
Mali,2009,6,5910000,1160000,7070000
Mali,2009,7,10933000,811000,11744000
Mali,2009,8,5647000,235000,5882000
Mali,2009,9,5631000,130000,5761000
Mali,2009,10,5925000,937000,6862000
Mali,2009,11,3530000,11000,3541000
Mali,2009,12,6864000,37000,6901000
Mali,2010,1,2593000,83000,2676000
Mali,2010,2,5116000,22000,5138000
Mali,2010,3,6591000,542000,7133000
Mali,2010,4,5688000,317000,6005000
Mali,2010,5,6268000,212000,6480000
Mali,2010,6,6675000,579000,7254000
Mali,2010,7,6103000,725000,6828000
Mali,2010,8,5012000,372000,5384000
Mali,2010,9,5335000,186000,5521000
Mali,2010,10,6182000,96000,6278000
Mali,2010,11,3615000,10000,3625000
Mali,2010,12,6841000,7000,6848000
Mali,2011,1,3007000,19000,3026000
Mali,2011,2,5813000,49000,5862000
Mali,2011,3,7619000,26000,7645000
Mali,2011,4,7887000,63000,7950000
Mali,2011,5,7665000,395000,8060000
Mali,2011,6,10197000,288000,10485000
Mali,2011,7,4900000,506000,5406000
Mali,2011,8,6852000,257000,7109000
Mali,2011,9,4395000,228000,4623000
Mali,2011,10,7281000,116000,7397000
Mali,2011,11,4748000,149000,4897000
Mali,2011,12,11624000,52000,11676000
Mali,2012,1,3605000,83000,3688000
Mali,2012,2,8657000,501000,9158000
Mali,2012,3,8783000,66000,8849000
Mali,2012,4,7095000,962000,8057000
Mali,2012,5,11116000,62000,11178000
Mali,2012,6,5579000,860000,6439000
Mali,2012,7,3791000,568000,4359000
Mali,2012,8,6953000,140000,7093000
Mali,2012,9,5082000,31000,5113000
Mali,2012,10,9322000,14000,9336000
Mali,2012,11,6699000,99000,6798000
Mali,2012,12,5631000,33000,5664000
Mali,2013,1,6850000,103000,6953000
Mali,2013,2,11100000,8000,11108000
Mali,2013,3,7304000,290000,7594000
Mali,2013,4,6955000,31000,6986000
Mali,2013,5,5723000,355000,6078000
Mali,2013,6,12209000,523000,12732000
Mali,2013,7,11311000,757000,12068000
Mali,2013,8,7218000,231000,7449000
Mali,2013,9,11036000,41000,11077000
Mali,2013,10,7602000,206000,7808000
Mali,2013,11,6858000,97000,6955000
Mali,2013,12,11421000,46000,11467000
Mali,2014,1,7278000,65000,7343000
Mali,2014,2,12519000,37000,12556000
Mali,2014,3,5465000,11000,5476000
Mali,2014,4,13893000,1157000,15050000
Mali,2014,5,7516000,352000,7868000
Mali,2014,6,6520000,886000,7406000
Mali,2014,7,9411000,507000,9918000
Mali,2014,8,4664000,235000,4899000
Mali,2014,9,6160000,122000,6282000
Mali,2014,10,11372000,87000,11459000
Mali,2014,11,7747000,114000,7861000
Mali,2014,12,6253000,51000,6304000
Mali,2015,1,6093000,295000,6388000
Mali,2015,2,6335000,127000,6462000
Mali,2015,3,7641000,166000,7807000
Mali,2015,4,7893000,222000,8115000
Mali,2015,5,12822000,409000,13231000
Mali,2015,6,10190000,440000,10630000
Mali,2015,7,12496000,1086000,13582000
Mali,2015,8,10206000,115000,10321000
Mali,2015,9,5987000,65000,6052000
Mali,2015,10,15532000,40000,15572000
Mali,2015,11,11184000,48000,11232000
Mali,2015,12,11606000,101000,11707000
Mali,2016,1,5363000,102000,5465000
Mali,2016,2,9572000,34000,9606000
Mali,2016,3,10879000,117000,10996000
Mali,2016,4,11298000,105000,11403000
Mali,2016,5,5008000,1154000,6162000
Mali,2016,6,9978000,1208000,11186000
Mali,2016,7,10551000,1394000,11945000
Mali,2016,8,11652000,275000,11927000
Mali,2016,9,15630000,166000,15796000
Mali,2016,10,5720000,53000,5773000
Mali,2016,11,27726000,59000,27785000
Mali,2016,12,10580000,18000,10598000
Mali,2017,1,7329000,141000,7470000
Mali,2017,2,9102000,777000,9879000
Mali,2017,3,6573000,121000,6694000
Mali,2017,4,8570000,54000,8624000
Mali,2017,5,6371000,1125000,7496000
Mali,2017,6,10812000,1016000,11828000
Mali,2017,7,8031000,1290000,9321000
Mali,2017,8,9870000,123000,9993000
Mali,2017,9,6372000,108000,6480000
Mali,2017,10,7523000,66000,7589000
Mali,2017,11,11525000,29000,11554000
Mali,2017,12,16986000,25000,17011000
Mali,2018,1,9053000,725000,9778000
Mali,2018,2,25773000,331000,26104000
Mali,2018,3,9910000,475000,10385000
Mali,2018,4,9932000,2173000,12105000
Mali,2018,5,5458000,308000,5766000
Mali,2018,6,7149000,1093000,8242000
Mali,2018,7,8045000,1547000,9592000
Mali,2018,8,5552000,199000,5751000
Mali,2018,9,6305000,78000,6383000
Mali,2018,10,3845000,154000,3999000
Mali,2018,11,5188000,56000,5244000
Mali,2018,12,7924000,479000,8403000
Mali,2019,1,4711000,19000,4730000
Mali,2019,2,5684000,153000,5837000
Mali,2019,3,9543000,452000,9995000
Mali,2019,4,5053000,1174000,6227000
Mali,2019,5,6886000,538000,7424000
Mali,2019,6,7785000,1008000,8793000
Mali,2019,7,8037000,1080000,9117000
Mali,2019,8,8061000,1029000,9090000
Mali,2019,9,8336000,48000,8384000
Mali,2019,10,7738000,101000,7839000
Mali,2019,11,9260000,66000,9326000
Mali,2019,12,4796000,796000,5592000
Mali,2020,1,8101000,41000,8142000
Mali,2020,2,9290000,11000,9301000
Mali,2020,3,6905000,127000,7032000
Mali,2020,4,6719000,23000,6742000
Mali,2020,5,5006000,615000,5621000
Mali,2020,6,6379000,1653000,8032000
Mali,2020,7,12643000,471000,13114000
Mali,2020,8,5573000,120000,5693000
Mali,2020,9,6109000,46000,6155000
Mali,2020,10,10402000,52000,10454000
Mali,2020,11,9644000,45000,9689000
Mali,2020,12,7809000,55000,7864000
Mali,2021,1,6262000,75000,6337000
Mali,2021,2,5801000,530000,6331000
Mali,2021,3,10714000,252000,10966000
Mali,2021,4,6455000,30000,6485000
Mali,2021,5,3782000,351000,4133000
Mali,2021,6,6806000,1727000,8533000
Mali,2021,7,9779000,323000,10102000
Mali,2021,8,6180000,399000,6579000
Mali,2021,9,6813000,368000,7181000
Mali,2021,10,13765000,160000,13925000
Mali,2021,11,9153000,1110000,10263000
Mali,2021,12,6548000,452000,7000000
Mali,2022,1,5279000,54000,5333000
Mali,2022,2,18711000,169000,18880000
Mali,2022,3,16088000,71000,16159000
Mali,2022,4,6768000,84000,6852000
Mali,2022,5,7184000,509000,7693000
Mali,2022,6,11132000,2072000,13204000
Mali,2022,7,7769000,1864000,9633000
Mali,2022,8,6094000,587000,6681000
Mali,2022,9,8372000,1111000,9483000
Mali,2022,10,7884000,1654000,9538000
Mali,2022,11,7851000,1109000,8960000
Mali,2022,12,23612000,302000,23914000
Mali,2023,1,8210000,288000,8498000
Mali,2023,2,9649000,1061000,10710000
Mali,2023,3,12548000,107000,12655000
Mali,2023,4,9879000,249000,10128000
Mali,2023,5,8152000,526000,8678000
Mali,2023,6,7392000,2246000,9638000
Mali,2023,7,11157000,1041000,12198000
Mali,2023,8,6086000,212000,6298000
Mali,2023,9,11465000,438000,11903000
Mali,2023,10,8416000,184000,8600000
Mali,2023,11,7948000,645000,8593000
Mali,2023,12,18661000,1087000,19748000
Mali,2024,1,4673000,75000,4748000
Mali,2024,2,6776000,55000,6831000
Mali,2024,3,15908000,211000,16119000
Mali,2024,4,4928000,174000,5102000
Mali,2024,5,5666000,431000,6097000
Mali,2024,6,5566000,1254000,6820000
Mali,2024,7,4677000,1054000,5731000
Mali,2024,8,5388000,586000,5974000
Mali,2024,9,3781000,338000,4119000
Mali,2024,10,8116000,258000,8374000
Mali,2024,11,4550000,63000,4613000
Mali,2024,12,4214000,106000,4320000
Malta,2008,1,28161000,21523000,49684000
Malta,2008,2,23907000,18093000,42000000
Malta,2008,3,54620000,23120000,77740000
Malta,2008,4,28104000,18673000,46777000
Malta,2008,5,21810000,19920000,41730000
Malta,2008,6,21551000,20434000,41985000
Malta,2008,7,22730000,133837000,156567000
Malta,2008,8,19670000,135147000,154817000
Malta,2008,9,20662000,25818000,46480000
Malta,2008,10,35058000,20760000,55818000
Malta,2008,11,45117000,74924000,120041000
Malta,2008,12,30568000,116071000,146639000
Malta,2009,1,50288000,17336000,67624000
Malta,2009,2,18668000,18773000,37441000
Malta,2009,3,20357000,88823000,109180000
Malta,2009,4,22648000,35675000,58323000
Malta,2009,5,24104000,16673000,40777000
Malta,2009,6,23550000,31461000,55011000
Malta,2009,7,21028000,18207000,39235000
Malta,2009,8,16590000,17787000,34377000
Malta,2009,9,22617000,16844000,39461000
Malta,2009,10,27180000,19759000,46939000
Malta,2009,11,25284000,21327000,46611000
Malta,2009,12,23349000,16115000,39464000
Malta,2010,1,21785000,19313000,41098000
Malta,2010,2,17417000,16980000,34397000
Malta,2010,3,29921000,24582000,54503000
Malta,2010,4,20961000,19289000,40250000
Malta,2010,5,21299000,21627000,42926000
Malta,2010,6,40906000,22717000,63623000
Malta,2010,7,19749000,21972000,41721000
Malta,2010,8,41110000,32708000,73818000
Malta,2010,9,72920000,22384000,95304000
Malta,2010,10,63511000,21140000,84651000
Malta,2010,11,32510000,22018000,54528000
Malta,2010,12,35050000,17499000,52549000
Malta,2011,1,26040000,23903000,49943000
Malta,2011,2,39152000,21290000,60442000
Malta,2011,3,33278000,98002000,131280000
Malta,2011,4,23763000,23361000,47124000
Malta,2011,5,34138000,25496000,59634000
Malta,2011,6,25014000,24582000,49596000
Malta,2011,7,23881000,23735000,47616000
Malta,2011,8,23922000,25592000,49514000
Malta,2011,9,23872000,28825000,52697000
Malta,2011,10,19514000,80218000,99732000
Malta,2011,11,23351000,23134000,46485000
Malta,2011,12,27272000,19942000,47214000
Malta,2012,1,22658000,24873000,47531000
Malta,2012,2,25172000,27811000,52983000
Malta,2012,3,36597000,27464000,64061000
Malta,2012,4,22343000,28681000,51024000
Malta,2012,5,25583000,27463000,53046000
Malta,2012,6,25974000,31246000,57220000
Malta,2012,7,24077000,31162000,55239000
Malta,2012,8,26353000,26470000,52823000
Malta,2012,9,25980000,28707000,54687000
Malta,2012,10,37071000,28738000,65809000
Malta,2012,11,24832000,27058000,51890000
Malta,2012,12,26553000,21619000,48172000
Malta,2013,1,27112000,29539000,56651000
Malta,2013,2,29042000,23611000,52653000
Malta,2013,3,27710000,29434000,57144000
Malta,2013,4,31187000,39402000,70589000
Malta,2013,5,29035000,32353000,61388000
Malta,2013,6,36292000,28857000,65149000
Malta,2013,7,28052000,28281000,56333000
Malta,2013,8,27658000,32586000,60244000
Malta,2013,9,32262000,25547000,57809000
Malta,2013,10,34163000,30274000,64437000
Malta,2013,11,35314000,163120000,198434000
Malta,2013,12,20929000,20262000,41191000
Malta,2014,1,41010000,28223000,69233000
Malta,2014,2,43208000,27782000,70990000
Malta,2014,3,47526000,28441000,75967000
Malta,2014,4,42946000,28566000,71512000
Malta,2014,5,36694000,29410000,66104000
Malta,2014,6,61702000,34296000,95998000
Malta,2014,7,44205000,27059000,71264000
Malta,2014,8,47145000,22680000,69825000
Malta,2014,9,37916000,23551000,61467000
Malta,2014,10,92864000,32073000,124937000
Malta,2014,11,40267000,27474000,67741000
Malta,2014,12,42400000,19950000,62350000
Malta,2015,1,45237000,27479000,72716000
Malta,2015,2,44956000,24870000,69826000
Malta,2015,3,56951000,27717000,84668000
Malta,2015,4,45458000,27347000,72805000
Malta,2015,5,46419000,25237000,71656000
Malta,2015,6,49643000,29515000,79158000
Malta,2015,7,40378000,30409000,70787000
Malta,2015,8,38328000,23088000,61416000
Malta,2015,9,71662000,27508000,99170000
Malta,2015,10,66601000,29052000,95653000
Malta,2015,11,58940000,24330000,83270000
Malta,2015,12,102102000,21327000,123429000
Malta,2016,1,63017000,27431000,90448000
Malta,2016,2,68397000,29273000,97670000
Malta,2016,3,70801000,45607000,116408000
Malta,2016,4,39384000,31154000,70538000
Malta,2016,5,45180000,29282000,74462000
Malta,2016,6,39071000,44227000,83298000
Malta,2016,7,46432000,29505000,75937000
Malta,2016,8,33487000,32254000,65741000
Malta,2016,9,47222000,31720000,78942000
Malta,2016,10,47380000,29107000,76487000
Malta,2016,11,47760000,29816000,77576000
Malta,2016,12,49987000,21865000,71852000
Malta,2017,1,53878000,30551000,84429000
Malta,2017,2,37373000,31024000,68397000
Malta,2017,3,46882000,33855000,80737000
Malta,2017,4,65208000,30588000,95796000
Malta,2017,5,52450000,32255000,84705000
Malta,2017,6,73587000,30664000,104251000
Malta,2017,7,47987000,29465000,77452000
Malta,2017,8,49030000,27703000,76733000
Malta,2017,9,46284000,29474000,75758000
Malta,2017,10,62161000,29227000,91388000
Malta,2017,11,47946000,30146000,78092000
Malta,2017,12,55541000,22513000,78054000
Malta,2018,1,73782000,27914000,101696000
Malta,2018,2,47708000,32019000,79727000
Malta,2018,3,72542000,33784000,106326000
Malta,2018,4,51969000,32492000,84461000
Malta,2018,5,56304000,43602000,99906000
Malta,2018,6,52153000,40213000,92366000
Malta,2018,7,50969000,30649000,81618000
Malta,2018,8,44203000,33138000,77341000
Malta,2018,9,59493000,32004000,91497000
Malta,2018,10,65713000,36789000,102502000
Malta,2018,11,66553000,26516000,93069000
Malta,2018,12,44810000,22219000,67029000
Malta,2019,1,75533000,28446000,103979000
Malta,2019,2,61036000,29005000,90041000
Malta,2019,3,105422000,35254000,140676000
Malta,2019,4,72252000,20365000,92617000
Malta,2019,5,52446000,49736000,102182000
Malta,2019,6,56010000,36257000,92267000
Malta,2019,7,115376000,34112000,149488000
Malta,2019,8,46165000,32372000,78537000
Malta,2019,9,116294000,34358000,150652000
Malta,2019,10,81558000,41786000,123344000
Malta,2019,11,56857000,33542000,90399000
Malta,2019,12,47083000,23328000,70411000
Malta,2020,1,53486000,30616000,84102000
Malta,2020,2,62441000,32910000,95351000
Malta,2020,3,56478000,32964000,89442000
Malta,2020,4,33627000,27114000,60741000
Malta,2020,5,28721000,28759000,57480000
Malta,2020,6,40669000,25519000,66188000
Malta,2020,7,33041000,29270000,62311000
Malta,2020,8,30067000,32924000,62991000
Malta,2020,9,41999000,27668000,69667000
Malta,2020,10,37720000,36376000,74096000
Malta,2020,11,41735000,33779000,75514000
Malta,2020,12,34126000,31328000,65454000
Malta,2021,1,34557000,31670000,66227000
Malta,2021,2,36515000,34345000,70860000
Malta,2021,3,41992000,39478000,81470000
Malta,2021,4,41377000,39885000,81262000
Malta,2021,5,36658000,43577000,80235000
Malta,2021,6,113685000,38172000,151857000
Malta,2021,7,106129000,42085000,148214000
Malta,2021,8,41021000,33669000,74690000
Malta,2021,9,43715000,31221000,74936000
Malta,2021,10,50915000,38909000,89824000
Malta,2021,11,43791000,30335000,74126000
Malta,2021,12,46300000,31832000,78132000
Malta,2022,1,38830000,30188000,69018000
Malta,2022,2,40820000,32932000,73752000
Malta,2022,3,59519000,40716000,100235000
Malta,2022,4,46107000,38740000,84847000
Malta,2022,5,64928000,38873000,103801000
Malta,2022,6,836081000,43516000,879597000
Malta,2022,7,83483000,55070000,138553000
Malta,2022,8,56287000,45537000,101824000
Malta,2022,9,61634000,53562000,115196000
Malta,2022,10,180188000,57609000,237797000
Malta,2022,11,89788000,66334000,156122000
Malta,2022,12,45727000,50250000,95977000
Malta,2023,1,104290000,55860000,160150000
Malta,2023,2,51034000,59180000,110214000
Malta,2023,3,65482000,96576000,162058000
Malta,2023,4,54943000,49604000,104547000
Malta,2023,5,69036000,65664000,134700000
Malta,2023,6,77257000,97026000,174283000
Malta,2023,7,70702000,60966000,131668000
Malta,2023,8,268159000,58595000,326754000
Malta,2023,9,103661000,79555000,183216000
Malta,2023,10,66547000,58991000,125538000
Malta,2023,11,64525000,71493000,136018000
Malta,2023,12,48800000,61556000,110356000
Malta,2024,1,59890000,82719000,142609000
Malta,2024,2,89484000,65454000,154938000
Malta,2024,3,86770000,90368000,177138000
Malta,2024,4,112124000,65712000,177836000
Malta,2024,5,78785000,66925000,145710000
Malta,2024,6,62159000,73041000,135200000
Malta,2024,7,74106000,66110000,140216000
Malta,2024,8,60012000,61715000,121727000
Malta,2024,9,62139000,73151000,135290000
Malta,2024,10,69328000,48751000,118079000
Malta,2024,11,64573000,43001000,107574000
Malta,2024,12,75167000,65396000,140563000
Marokko,2008,1,131696000,52733000,184429000
Marokko,2008,2,115722000,47444000,163166000
Marokko,2008,3,112506000,53427000,165933000
Marokko,2008,4,133899000,52995000,186894000
Marokko,2008,5,119840000,41466000,161306000
Marokko,2008,6,141004000,42098000,183102000
Marokko,2008,7,110154000,46542000,156696000
Marokko,2008,8,125367000,37325000,162692000
Marokko,2008,9,135445000,39209000,174654000
Marokko,2008,10,136637000,35858000,172495000
Marokko,2008,11,90868000,45840000,136708000
Marokko,2008,12,123824000,43449000,167273000
Marokko,2009,1,87677000,45992000,133669000
Marokko,2009,2,95187000,50834000,146021000
Marokko,2009,3,107219000,51812000,159031000
Marokko,2009,4,89500000,44071000,133571000
Marokko,2009,5,116659000,43859000,160518000
Marokko,2009,6,135047000,44115000,179162000
Marokko,2009,7,125662000,51884000,177546000
Marokko,2009,8,101305000,33187000,134492000
Marokko,2009,9,92883000,34943000,127826000
Marokko,2009,10,113444000,34348000,147792000
Marokko,2009,11,122437000,46365000,168802000
Marokko,2009,12,109600000,44421000,154021000
Marokko,2010,1,81133000,47235000,128368000
Marokko,2010,2,94223000,56740000,150963000
Marokko,2010,3,113176000,60614000,173790000
Marokko,2010,4,115419000,48453000,163872000
Marokko,2010,5,133650000,47989000,181639000
Marokko,2010,6,124509000,63084000,187593000
Marokko,2010,7,116290000,56206000,172496000
Marokko,2010,8,121076000,39219000,160295000
Marokko,2010,9,115858000,42527000,158385000
Marokko,2010,10,109594000,43407000,153001000
Marokko,2010,11,137713000,46969000,184682000
Marokko,2010,12,111479000,59955000,171434000
Marokko,2011,1,111603000,75534000,187137000
Marokko,2011,2,123602000,62463000,186065000
Marokko,2011,3,159179000,91979000,251158000
Marokko,2011,4,128824000,63908000,192732000
Marokko,2011,5,132941000,65377000,198318000
Marokko,2011,6,121389000,63879000,185268000
Marokko,2011,7,133769000,52420000,186189000
Marokko,2011,8,112196000,58740000,170936000
Marokko,2011,9,130500000,48771000,179271000
Marokko,2011,10,120598000,43194000,163792000
Marokko,2011,11,115349000,57840000,173189000
Marokko,2011,12,134631000,63704000,198335000
Marokko,2012,1,109468000,67102000,176570000
Marokko,2012,2,115261000,71145000,186406000
Marokko,2012,3,135754000,90706000,226460000
Marokko,2012,4,133059000,69765000,202824000
Marokko,2012,5,142174000,68515000,210689000
Marokko,2012,6,143213000,72220000,215433000
Marokko,2012,7,124364000,73329000,197693000
Marokko,2012,8,163151000,55584000,218735000
Marokko,2012,9,129861000,49822000,179683000
Marokko,2012,10,163631000,53803000,217434000
Marokko,2012,11,140981000,60032000,201013000
Marokko,2012,12,116489000,62360000,178849000
Marokko,2013,1,110210000,84967000,195177000
Marokko,2013,2,121979000,71723000,193702000
Marokko,2013,3,172639000,85449000,258088000
Marokko,2013,4,165060000,81367000,246427000
Marokko,2013,5,128887000,82249000,211136000
Marokko,2013,6,153147000,75117000,228264000
Marokko,2013,7,136663000,81183000,217846000
Marokko,2013,8,100111000,45571000,145682000
Marokko,2013,9,125331000,60595000,185926000
Marokko,2013,10,134477000,70080000,204557000
Marokko,2013,11,125412000,53433000,178845000
Marokko,2013,12,126075000,69248000,195323000
Marokko,2014,1,137804000,97511000,235315000
Marokko,2014,2,168503000,81641000,250144000
Marokko,2014,3,144668000,84126000,228794000
Marokko,2014,4,133725000,77431000,211156000
Marokko,2014,5,125679000,70004000,195683000
Marokko,2014,6,139714000,73191000,212905000
Marokko,2014,7,131771000,77433000,209204000
Marokko,2014,8,116460000,58626000,175086000
Marokko,2014,9,136951000,68026000,204977000
Marokko,2014,10,156648000,60858000,217506000
Marokko,2014,11,152645000,71021000,223666000
Marokko,2014,12,155579000,87672000,243251000
Marokko,2015,1,119551000,96610000,216161000
Marokko,2015,2,149712000,107735000,257447000
Marokko,2015,3,197776000,109318000,307094000
Marokko,2015,4,198631000,83633000,282264000
Marokko,2015,5,182646000,76467000,259113000
Marokko,2015,6,149472000,97788000,247260000
Marokko,2015,7,150713000,81597000,232310000
Marokko,2015,8,117580000,61253000,178833000
Marokko,2015,9,140987000,69369000,210356000
Marokko,2015,10,176093000,71811000,247904000
Marokko,2015,11,137233000,80007000,217240000
Marokko,2015,12,161412000,93879000,255291000
Marokko,2016,1,137671000,91434000,229105000
Marokko,2016,2,154164000,109183000,263347000
Marokko,2016,3,175265000,98993000,274258000
Marokko,2016,4,211421000,90997000,302418000
Marokko,2016,5,159872000,94763000,254635000
Marokko,2016,6,185092000,87559000,272651000
Marokko,2016,7,149002000,77370000,226372000
Marokko,2016,8,142262000,75786000,218048000
Marokko,2016,9,172176000,76611000,248787000
Marokko,2016,10,125927000,69299000,195226000
Marokko,2016,11,178849000,82807000,261656000
Marokko,2016,12,182430000,99769000,282199000
Marokko,2017,1,179773000,105958000,285731000
Marokko,2017,2,179365000,109745000,289110000
Marokko,2017,3,226309000,108313000,334622000
Marokko,2017,4,182527000,93262000,275789000
Marokko,2017,5,184128000,106496000,290624000
Marokko,2017,6,154531000,88560000,243091000
Marokko,2017,7,153420000,75152000,228572000
Marokko,2017,8,148685000,94050000,242735000
Marokko,2017,9,143553000,60766000,204319000
Marokko,2017,10,165564000,74585000,240149000
Marokko,2017,11,182749000,99393000,282142000
Marokko,2017,12,154159000,91371000,245530000
Marokko,2018,1,138654000,121837000,260491000
Marokko,2018,2,179144000,106162000,285306000
Marokko,2018,3,201783000,114866000,316649000
Marokko,2018,4,174010000,104831000,278841000
Marokko,2018,5,158125000,111237000,269362000
Marokko,2018,6,181662000,106675000,288337000
Marokko,2018,7,168386000,109012000,277398000
Marokko,2018,8,186098000,85399000,271497000
Marokko,2018,9,150791000,81387000,232178000
Marokko,2018,10,173264000,100595000,273859000
Marokko,2018,11,166151000,95393000,261544000
Marokko,2018,12,154308000,99453000,253761000
Marokko,2019,1,181003000,122352000,303355000
Marokko,2019,2,180104000,123540000,303644000
Marokko,2019,3,196589000,151019000,347608000
Marokko,2019,4,184372000,143741000,328113000
Marokko,2019,5,191314000,122574000,313888000
Marokko,2019,6,153926000,110877000,264803000
Marokko,2019,7,190198000,127065000,317263000
Marokko,2019,8,147499000,90991000,238490000
Marokko,2019,9,194051000,100501000,294552000
Marokko,2019,10,202602000,123736000,326338000
Marokko,2019,11,196065000,98035000,294100000
Marokko,2019,12,177539000,110500000,288039000
Marokko,2020,1,185088000,145356000,330444000
Marokko,2020,2,180346000,144470000,324816000
Marokko,2020,3,202736000,152012000,354748000
Marokko,2020,4,114068000,92775000,206843000
Marokko,2020,5,91134000,99483000,190617000
Marokko,2020,6,122590000,88804000,211394000
Marokko,2020,7,143533000,114329000,257862000
Marokko,2020,8,142944000,81884000,224828000
Marokko,2020,9,173036000,109788000,282824000
Marokko,2020,10,171026000,125454000,296480000
Marokko,2020,11,188758000,115032000,303790000
Marokko,2020,12,187321000,101903000,289224000
Marokko,2021,1,163632000,129393000,293025000
Marokko,2021,2,192275000,124102000,316377000
Marokko,2021,3,226427000,170235000,396662000
Marokko,2021,4,175769000,131664000,307433000
Marokko,2021,5,155124000,140596000,295720000
Marokko,2021,6,185735000,142114000,327849000
Marokko,2021,7,175972000,123011000,298983000
Marokko,2021,8,154940000,103749000,258689000
Marokko,2021,9,165400000,115245000,280645000
Marokko,2021,10,168530000,116421000,284951000
Marokko,2021,11,192384000,131202000,323586000
Marokko,2021,12,223434000,135787000,359221000
Marokko,2022,1,193975000,168997000,362972000
Marokko,2022,2,219689000,154844000,374533000
Marokko,2022,3,257326000,199218000,456544000
Marokko,2022,4,221979000,195577000,417556000
Marokko,2022,5,223110000,183340000,406450000
Marokko,2022,6,241480000,197286000,438766000
Marokko,2022,7,238843000,154100000,392943000
Marokko,2022,8,225727000,138745000,364472000
Marokko,2022,9,255146000,153718000,408864000
Marokko,2022,10,230282000,174975000,405257000
Marokko,2022,11,241161000,193770000,434931000
Marokko,2022,12,283787000,186794000,470581000
Marokko,2023,1,254171000,215038000,469209000
Marokko,2023,2,307914000,231570000,539484000
Marokko,2023,3,313501000,298469000,611970000
Marokko,2023,4,279891000,246657000,526548000
Marokko,2023,5,280990000,273848000,554838000
Marokko,2023,6,236744000,252394000,489138000
Marokko,2023,7,251651000,182489000,434140000
Marokko,2023,8,235148000,201361000,436509000
Marokko,2023,9,255516000,197399000,452915000
Marokko,2023,10,277748000,219725000,497473000
Marokko,2023,11,274031000,245292000,519323000
Marokko,2023,12,264889000,235564000,500453000
Marokko,2024,1,278634000,286553000,565187000
Marokko,2024,2,283769000,276029000,559798000
Marokko,2024,3,298415000,324298000,622713000
Marokko,2024,4,290544000,279869000,570413000
Marokko,2024,5,285974000,301813000,587787000
Marokko,2024,6,299754000,260506000,560260000
Marokko,2024,7,334050000,229982000,564032000
Marokko,2024,8,266882000,205051000,471933000
Marokko,2024,9,276174000,219417000,495591000
Marokko,2024,10,296977000,267182000,564159000
Marokko,2024,11,301303000,282663000,583966000
Marokko,2024,12,276009000,304088000,580097000
Marshallinseln (ab 1992),2008,1,8000,0,8000
Marshallinseln (ab 1992),2008,2,20000,0,20000
Marshallinseln (ab 1992),2008,3,34000,5000,39000
Marshallinseln (ab 1992),2008,4,80000,13000,93000
Marshallinseln (ab 1992),2008,5,25000,23000,48000
Marshallinseln (ab 1992),2008,6,100000,0,100000
Marshallinseln (ab 1992),2008,7,106000,1000,107000
Marshallinseln (ab 1992),2008,8,36427000,65699000,102126000
Marshallinseln (ab 1992),2008,9,44000,4000,48000
Marshallinseln (ab 1992),2008,10,5000,0,5000
Marshallinseln (ab 1992),2008,11,2000,1000,3000
Marshallinseln (ab 1992),2008,12,74016000,102166000,176182000
Marshallinseln (ab 1992),2009,1,1000,0,1000
Marshallinseln (ab 1992),2009,2,108000,118297000,118405000
Marshallinseln (ab 1992),2009,3,35000,95000,130000
Marshallinseln (ab 1992),2009,4,33000,5000,38000
Marshallinseln (ab 1992),2009,5,89000,6000,95000
Marshallinseln (ab 1992),2009,6,23000,1000,24000
Marshallinseln (ab 1992),2009,7,27000,6000,33000
Marshallinseln (ab 1992),2009,8,262000,0,262000
Marshallinseln (ab 1992),2009,9,85000,0,85000
Marshallinseln (ab 1992),2009,10,10146000,0,10146000
Marshallinseln (ab 1992),2009,11,403000,0,403000
Marshallinseln (ab 1992),2009,12,165000,54000,219000
Marshallinseln (ab 1992),2010,1,2373000,0,2373000
Marshallinseln (ab 1992),2010,2,198000,0,198000
Marshallinseln (ab 1992),2010,3,64000,2000,66000
Marshallinseln (ab 1992),2010,4,653000,8000,661000
Marshallinseln (ab 1992),2010,5,373000,0,373000
Marshallinseln (ab 1992),2010,6,171000,19640000,19811000
Marshallinseln (ab 1992),2010,7,49077000,0,49077000
Marshallinseln (ab 1992),2010,8,171586000,0,171586000
Marshallinseln (ab 1992),2010,9,41784000,0,41784000
Marshallinseln (ab 1992),2010,10,66000,64965000,65031000
Marshallinseln (ab 1992),2010,11,9000,0,9000
Marshallinseln (ab 1992),2010,12,27000,2000,29000
Marshallinseln (ab 1992),2011,1,21000,3000,24000
Marshallinseln (ab 1992),2011,2,74000,0,74000
Marshallinseln (ab 1992),2011,3,64000,58000,122000
Marshallinseln (ab 1992),2011,4,27000,24800000,24827000
Marshallinseln (ab 1992),2011,5,37585000,74000,37659000
Marshallinseln (ab 1992),2011,6,138000,58000,196000
Marshallinseln (ab 1992),2011,7,58000,30000,88000
Marshallinseln (ab 1992),2011,8,88000,0,88000
Marshallinseln (ab 1992),2011,9,313000,0,313000
Marshallinseln (ab 1992),2011,10,600000,0,600000
Marshallinseln (ab 1992),2011,11,72000,4000,76000
Marshallinseln (ab 1992),2011,12,31173000,0,31173000
Marshallinseln (ab 1992),2012,1,19561000,0,19561000
Marshallinseln (ab 1992),2012,2,20610000,2000,20612000
Marshallinseln (ab 1992),2012,3,22866000,0,22866000
Marshallinseln (ab 1992),2012,4,51131000,0,51131000
Marshallinseln (ab 1992),2012,5,552000,2000,554000
Marshallinseln (ab 1992),2012,6,1959000,0,1959000
Marshallinseln (ab 1992),2012,7,184000,2000,186000
Marshallinseln (ab 1992),2012,8,3669000,10000,3679000
Marshallinseln (ab 1992),2012,9,139000,0,139000
Marshallinseln (ab 1992),2012,10,24352000,5000,24357000
Marshallinseln (ab 1992),2012,11,287000,0,287000
Marshallinseln (ab 1992),2012,12,4306000,0,4306000
Marshallinseln (ab 1992),2013,1,464000,1000,465000
Marshallinseln (ab 1992),2013,2,4185000,1000,4186000
Marshallinseln (ab 1992),2013,3,80248000,0,80248000
Marshallinseln (ab 1992),2013,4,24699000,0,24699000
Marshallinseln (ab 1992),2013,5,15006000,41000,15047000
Marshallinseln (ab 1992),2013,6,102000,2000,104000
Marshallinseln (ab 1992),2013,7,128000,0,128000
Marshallinseln (ab 1992),2013,8,15286000,0,15286000
Marshallinseln (ab 1992),2013,9,744000,0,744000
Marshallinseln (ab 1992),2013,10,4031000,0,4031000
Marshallinseln (ab 1992),2013,11,43000,0,43000
Marshallinseln (ab 1992),2013,12,8129000,0,8129000
Marshallinseln (ab 1992),2014,1,17001000,1000,17002000
Marshallinseln (ab 1992),2014,2,75512000,5000,75517000
Marshallinseln (ab 1992),2014,3,84440000,0,84440000
Marshallinseln (ab 1992),2014,4,16000,0,16000
Marshallinseln (ab 1992),2014,5,20689000,0,20689000
Marshallinseln (ab 1992),2014,6,34158000,0,34158000
Marshallinseln (ab 1992),2014,7,54146000,0,54146000
Marshallinseln (ab 1992),2014,8,67155000,0,67155000
Marshallinseln (ab 1992),2014,9,54607000,0,54607000
Marshallinseln (ab 1992),2014,10,84046000,0,84046000
Marshallinseln (ab 1992),2014,11,48892000,0,48892000
Marshallinseln (ab 1992),2014,12,28633000,0,28633000
Marshallinseln (ab 1992),2015,1,57879000,21000,57900000
Marshallinseln (ab 1992),2015,2,6396000,0,6396000
Marshallinseln (ab 1992),2015,3,16749000,0,16749000
Marshallinseln (ab 1992),2015,4,54688000,12000,54700000
Marshallinseln (ab 1992),2015,5,45678000,10101000,55779000
Marshallinseln (ab 1992),2015,6,2150000,12000,2162000
Marshallinseln (ab 1992),2015,7,79594000,1000,79595000
Marshallinseln (ab 1992),2015,8,117346000,0,117346000
Marshallinseln (ab 1992),2015,9,77132000,1000,77133000
Marshallinseln (ab 1992),2015,10,69164000,0,69164000
Marshallinseln (ab 1992),2015,11,17197000,1000,17198000
Marshallinseln (ab 1992),2015,12,40254000,0,40254000
Marshallinseln (ab 1992),2016,1,9577000,0,9577000
Marshallinseln (ab 1992),2016,2,14084000,0,14084000
Marshallinseln (ab 1992),2016,3,7539000,0,7539000
Marshallinseln (ab 1992),2016,4,3337000,0,3337000
Marshallinseln (ab 1992),2016,5,9373000,0,9373000
Marshallinseln (ab 1992),2016,6,6408000,0,6408000
Marshallinseln (ab 1992),2016,7,14889000,0,14889000
Marshallinseln (ab 1992),2016,8,55080000,0,55080000
Marshallinseln (ab 1992),2016,9,13471000,1000,13472000
Marshallinseln (ab 1992),2016,10,7082000,0,7082000
Marshallinseln (ab 1992),2016,11,25000,0,25000
Marshallinseln (ab 1992),2016,12,5162000,0,5162000
Marshallinseln (ab 1992),2017,1,4733000,8000,4741000
Marshallinseln (ab 1992),2017,2,44000,17000,61000
Marshallinseln (ab 1992),2017,3,14566000,8000,14574000
Marshallinseln (ab 1992),2017,4,27877000,0,27877000
Marshallinseln (ab 1992),2017,5,7556000,2459000,10015000
Marshallinseln (ab 1992),2017,6,44000,4000,48000
Marshallinseln (ab 1992),2017,7,15985000,8253000,24238000
Marshallinseln (ab 1992),2017,8,6398000,6000,6404000
Marshallinseln (ab 1992),2017,9,68215000,8000,68223000
Marshallinseln (ab 1992),2017,10,36632000,4111000,40743000
Marshallinseln (ab 1992),2017,11,55448000,20000,55468000
Marshallinseln (ab 1992),2017,12,158358000,1000,158359000
Marshallinseln (ab 1992),2018,1,256808000,8314000,265122000
Marshallinseln (ab 1992),2018,2,25825000,1000,25826000
Marshallinseln (ab 1992),2018,3,79551000,0,79551000
Marshallinseln (ab 1992),2018,4,21802000,0,21802000
Marshallinseln (ab 1992),2018,5,17156000,2000,17158000
Marshallinseln (ab 1992),2018,6,46563000,0,46563000
Marshallinseln (ab 1992),2018,7,47751000,10000,47761000
Marshallinseln (ab 1992),2018,8,60936000,12764000,73700000
Marshallinseln (ab 1992),2018,9,29047000,1000,29048000
Marshallinseln (ab 1992),2018,10,27069000,5000,27074000
Marshallinseln (ab 1992),2018,11,24000,12754000,12778000
Marshallinseln (ab 1992),2018,12,58421000,12468000,70889000
Marshallinseln (ab 1992),2019,1,7179000,14000,7193000
Marshallinseln (ab 1992),2019,2,18229000,0,18229000
Marshallinseln (ab 1992),2019,3,113000,0,113000
Marshallinseln (ab 1992),2019,4,1141000,54000,1195000
Marshallinseln (ab 1992),2019,5,12000,28000,40000
Marshallinseln (ab 1992),2019,6,15659000,5825000,21484000
Marshallinseln (ab 1992),2019,7,16524000,0,16524000
Marshallinseln (ab 1992),2019,8,34000,6640000,6674000
Marshallinseln (ab 1992),2019,9,28000,0,28000
Marshallinseln (ab 1992),2019,10,10251000,0,10251000
Marshallinseln (ab 1992),2019,11,35141000,0,35141000
Marshallinseln (ab 1992),2019,12,51565000,0,51565000
Marshallinseln (ab 1992),2020,1,48556000,0,48556000
Marshallinseln (ab 1992),2020,2,29273000,0,29273000
Marshallinseln (ab 1992),2020,3,15899000,0,15899000
Marshallinseln (ab 1992),2020,4,166000,0,166000
Marshallinseln (ab 1992),2020,5,592239000,0,592239000
Marshallinseln (ab 1992),2020,6,10090000,0,10090000
Marshallinseln (ab 1992),2020,7,1298000,29000,1327000
Marshallinseln (ab 1992),2020,8,268000,0,268000
Marshallinseln (ab 1992),2020,9,12473000,0,12473000
Marshallinseln (ab 1992),2020,10,90808000,21000,90829000
Marshallinseln (ab 1992),2020,11,2984000,0,2984000
Marshallinseln (ab 1992),2020,12,101730000,7021000,108751000
Marshallinseln (ab 1992),2021,1,2777000,0,2777000
Marshallinseln (ab 1992),2021,2,16975000,0,16975000
Marshallinseln (ab 1992),2021,3,61312000,22918000,84230000
Marshallinseln (ab 1992),2021,4,51000,0,51000
Marshallinseln (ab 1992),2021,5,9989000,0,9989000
Marshallinseln (ab 1992),2021,6,2250000,5942000,8192000
Marshallinseln (ab 1992),2021,7,22405000,16343000,38748000
Marshallinseln (ab 1992),2021,8,21986000,31606000,53592000
Marshallinseln (ab 1992),2021,9,1390000,0,1390000
Marshallinseln (ab 1992),2021,10,16249000,10750000,26999000
Marshallinseln (ab 1992),2021,11,5464000,39144000,44608000
Marshallinseln (ab 1992),2021,12,568000,58615000,59183000
Marshallinseln (ab 1992),2022,1,12139000,49987000,62126000
Marshallinseln (ab 1992),2022,2,37681000,46680000,84361000
Marshallinseln (ab 1992),2022,3,11406000,58754000,70160000
Marshallinseln (ab 1992),2022,4,18569000,28000,18597000
Marshallinseln (ab 1992),2022,5,59774000,18783000,78557000
Marshallinseln (ab 1992),2022,6,27373000,44559000,71932000
Marshallinseln (ab 1992),2022,7,18068000,77217000,95285000
Marshallinseln (ab 1992),2022,8,18226000,29283000,47509000
Marshallinseln (ab 1992),2022,9,8702000,0,8702000
Marshallinseln (ab 1992),2022,10,39965000,0,39965000
Marshallinseln (ab 1992),2022,11,3129000,16920000,20049000
Marshallinseln (ab 1992),2022,12,5038000,0,5038000
Marshallinseln (ab 1992),2023,1,48475000,16901000,65376000
Marshallinseln (ab 1992),2023,2,30339000,0,30339000
Marshallinseln (ab 1992),2023,3,93412000,31019000,124431000
Marshallinseln (ab 1992),2023,4,82473000,7845000,90318000
Marshallinseln (ab 1992),2023,5,11095000,109000,11204000
Marshallinseln (ab 1992),2023,6,16305000,131000,16436000
Marshallinseln (ab 1992),2023,7,4597000,1000,4598000
Marshallinseln (ab 1992),2023,8,4540000,37192000,41732000
Marshallinseln (ab 1992),2023,9,24000,0,24000
Marshallinseln (ab 1992),2023,10,17114000,2000,17116000
Marshallinseln (ab 1992),2023,11,36650000,13354000,50004000
Marshallinseln (ab 1992),2023,12,14575000,0,14575000
Marshallinseln (ab 1992),2024,1,48000,0,48000
Marshallinseln (ab 1992),2024,2,26694000,386167000,412861000
Marshallinseln (ab 1992),2024,3,0,372222000,372222000
Marshallinseln (ab 1992),2024,4,26046000,12316000,38362000
Marshallinseln (ab 1992),2024,5,15993000,12321000,28314000
Marshallinseln (ab 1992),2024,6,579000,65521000,66100000
Marshallinseln (ab 1992),2024,7,17480000,2209000,19689000
Marshallinseln (ab 1992),2024,8,21987000,21000,22008000
Marshallinseln (ab 1992),2024,9,165000,20700000,20865000
Marshallinseln (ab 1992),2024,10,756000,0,756000
Marshallinseln (ab 1992),2024,11,6133000,10000,6143000
Marshallinseln (ab 1992),2024,12,4849000,44889000,49738000
Martinique (bis 1996),2008,1,0,0,0
Martinique (bis 1996),2008,2,0,0,0
Martinique (bis 1996),2008,3,0,0,0
Martinique (bis 1996),2008,4,0,0,0
Martinique (bis 1996),2008,5,0,0,0
Martinique (bis 1996),2008,6,0,0,0
Martinique (bis 1996),2008,7,0,0,0
Martinique (bis 1996),2008,8,0,0,0
Martinique (bis 1996),2008,9,0,0,0
Martinique (bis 1996),2008,10,0,0,0
Martinique (bis 1996),2008,11,0,0,0
Martinique (bis 1996),2008,12,0,0,0
Martinique (bis 1996),2009,1,0,0,0
Martinique (bis 1996),2009,2,0,0,0
Martinique (bis 1996),2009,3,0,0,0
Martinique (bis 1996),2009,4,0,0,0
Martinique (bis 1996),2009,5,0,0,0
Martinique (bis 1996),2009,6,0,0,0
Martinique (bis 1996),2009,7,0,0,0
Martinique (bis 1996),2009,8,0,0,0
Martinique (bis 1996),2009,9,0,0,0
Martinique (bis 1996),2009,10,0,0,0
Martinique (bis 1996),2009,11,0,0,0
Martinique (bis 1996),2009,12,0,0,0
Martinique (bis 1996),2010,1,0,0,0
Martinique (bis 1996),2010,2,0,0,0
Martinique (bis 1996),2010,3,0,0,0
Martinique (bis 1996),2010,4,0,0,0
Martinique (bis 1996),2010,5,0,0,0
Martinique (bis 1996),2010,6,0,0,0
Martinique (bis 1996),2010,7,0,0,0
Martinique (bis 1996),2010,8,0,0,0
Martinique (bis 1996),2010,9,0,0,0
Martinique (bis 1996),2010,10,0,0,0
Martinique (bis 1996),2010,11,0,0,0
Martinique (bis 1996),2010,12,0,0,0
Martinique (bis 1996),2011,1,0,0,0
Martinique (bis 1996),2011,2,0,0,0
Martinique (bis 1996),2011,3,0,0,0
Martinique (bis 1996),2011,4,0,0,0
Martinique (bis 1996),2011,5,0,0,0
Martinique (bis 1996),2011,6,0,0,0
Martinique (bis 1996),2011,7,0,0,0
Martinique (bis 1996),2011,8,0,0,0
Martinique (bis 1996),2011,9,0,0,0
Martinique (bis 1996),2011,10,0,0,0
Martinique (bis 1996),2011,11,0,0,0
Martinique (bis 1996),2011,12,0,0,0
Martinique (bis 1996),2012,1,0,0,0
Martinique (bis 1996),2012,2,0,0,0
Martinique (bis 1996),2012,3,0,0,0
Martinique (bis 1996),2012,4,0,0,0
Martinique (bis 1996),2012,5,0,0,0
Martinique (bis 1996),2012,6,0,0,0
Martinique (bis 1996),2012,7,0,0,0
Martinique (bis 1996),2012,8,0,0,0
Martinique (bis 1996),2012,9,0,0,0
Martinique (bis 1996),2012,10,0,0,0
Martinique (bis 1996),2012,11,0,0,0
Martinique (bis 1996),2012,12,0,0,0
Martinique (bis 1996),2013,1,0,0,0
Martinique (bis 1996),2013,2,0,0,0
Martinique (bis 1996),2013,3,0,0,0
Martinique (bis 1996),2013,4,0,0,0
Martinique (bis 1996),2013,5,0,0,0
Martinique (bis 1996),2013,6,0,0,0
Martinique (bis 1996),2013,7,0,0,0
Martinique (bis 1996),2013,8,0,0,0
Martinique (bis 1996),2013,9,0,0,0
Martinique (bis 1996),2013,10,0,0,0
Martinique (bis 1996),2013,11,0,0,0
Martinique (bis 1996),2013,12,0,0,0
Martinique (bis 1996),2014,1,0,0,0
Martinique (bis 1996),2014,2,0,0,0
Martinique (bis 1996),2014,3,0,0,0
Martinique (bis 1996),2014,4,0,0,0
Martinique (bis 1996),2014,5,0,0,0
Martinique (bis 1996),2014,6,0,0,0
Martinique (bis 1996),2014,7,0,0,0
Martinique (bis 1996),2014,8,0,0,0
Martinique (bis 1996),2014,9,0,0,0
Martinique (bis 1996),2014,10,0,0,0
Martinique (bis 1996),2014,11,0,0,0
Martinique (bis 1996),2014,12,0,0,0
Martinique (bis 1996),2015,1,0,0,0
Martinique (bis 1996),2015,2,0,0,0
Martinique (bis 1996),2015,3,0,0,0
Martinique (bis 1996),2015,4,0,0,0
Martinique (bis 1996),2015,5,0,0,0
Martinique (bis 1996),2015,6,0,0,0
Martinique (bis 1996),2015,7,0,0,0
Martinique (bis 1996),2015,8,0,0,0
Martinique (bis 1996),2015,9,0,0,0
Martinique (bis 1996),2015,10,0,0,0
Martinique (bis 1996),2015,11,0,0,0
Martinique (bis 1996),2015,12,0,0,0
Martinique (bis 1996),2016,1,0,0,0
Martinique (bis 1996),2016,2,0,0,0
Martinique (bis 1996),2016,3,0,0,0
Martinique (bis 1996),2016,4,0,0,0
Martinique (bis 1996),2016,5,0,0,0
Martinique (bis 1996),2016,6,0,0,0
Martinique (bis 1996),2016,7,0,0,0
Martinique (bis 1996),2016,8,0,0,0
Martinique (bis 1996),2016,9,0,0,0
Martinique (bis 1996),2016,10,0,0,0
Martinique (bis 1996),2016,11,0,0,0
Martinique (bis 1996),2016,12,0,0,0
Martinique (bis 1996),2017,1,0,0,0
Martinique (bis 1996),2017,2,0,0,0
Martinique (bis 1996),2017,3,0,0,0
Martinique (bis 1996),2017,4,0,0,0
Martinique (bis 1996),2017,5,0,0,0
Martinique (bis 1996),2017,6,0,0,0
Martinique (bis 1996),2017,7,0,0,0
Martinique (bis 1996),2017,8,0,0,0
Martinique (bis 1996),2017,9,0,0,0
Martinique (bis 1996),2017,10,0,0,0
Martinique (bis 1996),2017,11,0,0,0
Martinique (bis 1996),2017,12,0,0,0
Martinique (bis 1996),2018,1,0,0,0
Martinique (bis 1996),2018,2,0,0,0
Martinique (bis 1996),2018,3,0,0,0
Martinique (bis 1996),2018,4,0,0,0
Martinique (bis 1996),2018,5,0,0,0
Martinique (bis 1996),2018,6,0,0,0
Martinique (bis 1996),2018,7,0,0,0
Martinique (bis 1996),2018,8,0,0,0
Martinique (bis 1996),2018,9,0,0,0
Martinique (bis 1996),2018,10,0,0,0
Martinique (bis 1996),2018,11,0,0,0
Martinique (bis 1996),2018,12,0,0,0
Martinique (bis 1996),2019,1,0,0,0
Martinique (bis 1996),2019,2,0,0,0
Martinique (bis 1996),2019,3,0,0,0
Martinique (bis 1996),2019,4,0,0,0
Martinique (bis 1996),2019,5,0,0,0
Martinique (bis 1996),2019,6,0,0,0
Martinique (bis 1996),2019,7,0,0,0
Martinique (bis 1996),2019,8,0,0,0
Martinique (bis 1996),2019,9,0,0,0
Martinique (bis 1996),2019,10,0,0,0
Martinique (bis 1996),2019,11,0,0,0
Martinique (bis 1996),2019,12,0,0,0
Martinique (bis 1996),2020,1,0,0,0
Martinique (bis 1996),2020,2,0,0,0
Martinique (bis 1996),2020,3,0,0,0
Martinique (bis 1996),2020,4,0,0,0
Martinique (bis 1996),2020,5,0,0,0
Martinique (bis 1996),2020,6,0,0,0
Martinique (bis 1996),2020,7,0,0,0
Martinique (bis 1996),2020,8,0,0,0
Martinique (bis 1996),2020,9,0,0,0
Martinique (bis 1996),2020,10,0,0,0
Martinique (bis 1996),2020,11,0,0,0
Martinique (bis 1996),2020,12,0,0,0
Martinique (bis 1996),2021,1,0,0,0
Martinique (bis 1996),2021,2,0,0,0
Martinique (bis 1996),2021,3,0,0,0
Martinique (bis 1996),2021,4,0,0,0
Martinique (bis 1996),2021,5,0,0,0
Martinique (bis 1996),2021,6,0,0,0
Martinique (bis 1996),2021,7,0,0,0
Martinique (bis 1996),2021,8,0,0,0
Martinique (bis 1996),2021,9,0,0,0
Martinique (bis 1996),2021,10,0,0,0
Martinique (bis 1996),2021,11,0,0,0
Martinique (bis 1996),2021,12,0,0,0
Martinique (bis 1996),2022,1,0,0,0
Martinique (bis 1996),2022,2,0,0,0
Martinique (bis 1996),2022,3,0,0,0
Martinique (bis 1996),2022,4,0,0,0
Martinique (bis 1996),2022,5,0,0,0
Martinique (bis 1996),2022,6,0,0,0
Martinique (bis 1996),2022,7,0,0,0
Martinique (bis 1996),2022,8,0,0,0
Martinique (bis 1996),2022,9,0,0,0
Martinique (bis 1996),2022,10,0,0,0
Martinique (bis 1996),2022,11,0,0,0
Martinique (bis 1996),2022,12,0,0,0
Martinique (bis 1996),2023,1,0,0,0
Martinique (bis 1996),2023,2,0,0,0
Martinique (bis 1996),2023,3,0,0,0
Martinique (bis 1996),2023,4,0,0,0
Martinique (bis 1996),2023,5,0,0,0
Martinique (bis 1996),2023,6,0,0,0
Martinique (bis 1996),2023,7,0,0,0
Martinique (bis 1996),2023,8,0,0,0
Martinique (bis 1996),2023,9,0,0,0
Martinique (bis 1996),2023,10,0,0,0
Martinique (bis 1996),2023,11,0,0,0
Martinique (bis 1996),2023,12,0,0,0
Martinique (bis 1996),2024,1,0,0,0
Martinique (bis 1996),2024,2,0,0,0
Martinique (bis 1996),2024,3,0,0,0
Martinique (bis 1996),2024,4,0,0,0
Martinique (bis 1996),2024,5,0,0,0
Martinique (bis 1996),2024,6,0,0,0
Martinique (bis 1996),2024,7,0,0,0
Martinique (bis 1996),2024,8,0,0,0
Martinique (bis 1996),2024,9,0,0,0
Martinique (bis 1996),2024,10,0,0,0
Martinique (bis 1996),2024,11,0,0,0
Martinique (bis 1996),2024,12,0,0,0
Mauretanien,2008,1,3934000,13427000,17361000
Mauretanien,2008,2,4084000,2337000,6421000
Mauretanien,2008,3,4748000,17806000,22554000
Mauretanien,2008,4,3511000,11296000,14807000
Mauretanien,2008,5,4467000,5455000,9922000
Mauretanien,2008,6,4681000,10274000,14955000
Mauretanien,2008,7,4581000,21260000,25841000
Mauretanien,2008,8,4738000,10345000,15083000
Mauretanien,2008,9,2454000,11583000,14037000
Mauretanien,2008,10,4653000,12830000,17483000
Mauretanien,2008,11,2734000,9734000,12468000
Mauretanien,2008,12,3794000,16384000,20178000
Mauretanien,2009,1,5817000,7425000,13242000
Mauretanien,2009,2,2879000,6040000,8919000
Mauretanien,2009,3,4751000,4328000,9079000
Mauretanien,2009,4,4471000,3735000,8206000
Mauretanien,2009,5,5080000,3261000,8341000
Mauretanien,2009,6,4116000,1751000,5867000
Mauretanien,2009,7,5794000,1524000,7318000
Mauretanien,2009,8,5836000,14905000,20741000
Mauretanien,2009,9,3102000,6001000,9103000
Mauretanien,2009,10,4235000,9865000,14100000
Mauretanien,2009,11,4432000,5730000,10162000
Mauretanien,2009,12,3362000,6427000,9789000
Mauretanien,2010,1,1542000,7523000,9065000
Mauretanien,2010,2,2800000,11039000,13839000
Mauretanien,2010,3,2963000,6734000,9697000
Mauretanien,2010,4,2779000,10640000,13419000
Mauretanien,2010,5,4043000,9825000,13868000
Mauretanien,2010,6,4511000,6458000,10969000
Mauretanien,2010,7,3045000,6540000,9585000
Mauretanien,2010,8,3137000,7889000,11026000
Mauretanien,2010,9,8857000,3565000,12422000
Mauretanien,2010,10,8161000,4656000,12817000
Mauretanien,2010,11,7170000,4019000,11189000
Mauretanien,2010,12,8894000,14292000,23186000
Mauretanien,2011,1,8319000,13654000,21973000
Mauretanien,2011,2,3553000,24965000,28518000
Mauretanien,2011,3,8366000,10761000,19127000
Mauretanien,2011,4,26200000,6094000,32294000
Mauretanien,2011,5,16872000,8395000,25267000
Mauretanien,2011,6,17086000,7067000,24153000
Mauretanien,2011,7,21111000,7397000,28508000
Mauretanien,2011,8,6949000,11313000,18262000
Mauretanien,2011,9,14191000,10065000,24256000
Mauretanien,2011,10,10463000,9753000,20216000
Mauretanien,2011,11,5119000,11251000,16370000
Mauretanien,2011,12,18431000,11838000,30269000
Mauretanien,2012,1,7837000,11613000,19450000
Mauretanien,2012,2,7415000,18395000,25810000
Mauretanien,2012,3,40945000,14726000,55671000
Mauretanien,2012,4,19941000,7380000,27321000
Mauretanien,2012,5,11651000,13718000,25369000
Mauretanien,2012,6,5331000,10591000,15922000
Mauretanien,2012,7,6945000,18547000,25492000
Mauretanien,2012,8,4613000,9823000,14436000
Mauretanien,2012,9,5885000,6063000,11948000
Mauretanien,2012,10,5316000,13076000,18392000
Mauretanien,2012,11,25463000,5147000,30610000
Mauretanien,2012,12,31320000,12437000,43757000
Mauretanien,2013,1,8660000,19857000,28517000
Mauretanien,2013,2,3345000,4749000,8094000
Mauretanien,2013,3,4215000,14949000,19164000
Mauretanien,2013,4,22724000,4662000,27386000
Mauretanien,2013,5,12409000,3403000,15812000
Mauretanien,2013,6,14702000,13668000,28370000
Mauretanien,2013,7,9541000,6727000,16268000
Mauretanien,2013,8,4877000,3110000,7987000
Mauretanien,2013,9,6171000,13154000,19325000
Mauretanien,2013,10,7532000,8450000,15982000
Mauretanien,2013,11,6097000,9399000,15496000
Mauretanien,2013,12,6626000,10320000,16946000
Mauretanien,2014,1,6355000,9229000,15584000
Mauretanien,2014,2,4011000,8377000,12388000
Mauretanien,2014,3,6044000,8271000,14315000
Mauretanien,2014,4,6067000,10933000,17000000
Mauretanien,2014,5,13015000,9146000,22161000
Mauretanien,2014,6,7293000,10852000,18145000
Mauretanien,2014,7,8068000,7958000,16026000
Mauretanien,2014,8,9769000,11403000,21172000
Mauretanien,2014,9,7634000,6515000,14149000
Mauretanien,2014,10,12428000,19305000,31733000
Mauretanien,2014,11,15018000,7757000,22775000
Mauretanien,2014,12,7777000,7789000,15566000
Mauretanien,2015,1,5757000,7927000,13684000
Mauretanien,2015,2,5281000,11822000,17103000
Mauretanien,2015,3,6744000,14737000,21481000
Mauretanien,2015,4,12441000,6085000,18526000
Mauretanien,2015,5,14238000,9392000,23630000
Mauretanien,2015,6,5126000,6883000,12009000
Mauretanien,2015,7,10007000,5340000,15347000
Mauretanien,2015,8,4772000,3960000,8732000
Mauretanien,2015,9,5065000,3587000,8652000
Mauretanien,2015,10,4757000,4912000,9669000
Mauretanien,2015,11,5903000,8881000,14784000
Mauretanien,2015,12,4654000,2853000,7507000
Mauretanien,2016,1,4696000,6571000,11267000
Mauretanien,2016,2,11249000,4966000,16215000
Mauretanien,2016,3,4464000,3352000,7816000
Mauretanien,2016,4,5372000,6769000,12141000
Mauretanien,2016,5,4566000,3843000,8409000
Mauretanien,2016,6,6535000,4094000,10629000
Mauretanien,2016,7,4019000,4416000,8435000
Mauretanien,2016,8,3839000,2266000,6105000
Mauretanien,2016,9,4733000,1496000,6229000
Mauretanien,2016,10,3090000,15705000,18795000
Mauretanien,2016,11,4795000,6390000,11185000
Mauretanien,2016,12,5480000,12461000,17941000
Mauretanien,2017,1,3247000,8738000,11985000
Mauretanien,2017,2,6710000,5229000,11939000
Mauretanien,2017,3,5290000,12342000,17632000
Mauretanien,2017,4,5536000,5638000,11174000
Mauretanien,2017,5,6149000,10685000,16834000
Mauretanien,2017,6,5796000,7616000,13412000
Mauretanien,2017,7,6930000,7521000,14451000
Mauretanien,2017,8,5188000,9273000,14461000
Mauretanien,2017,9,4486000,9251000,13737000
Mauretanien,2017,10,4521000,11364000,15885000
Mauretanien,2017,11,5604000,7419000,13023000
Mauretanien,2017,12,8663000,4640000,13303000
Mauretanien,2018,1,5884000,9333000,15217000
Mauretanien,2018,2,5588000,11243000,16831000
Mauretanien,2018,3,5983000,8848000,14831000
Mauretanien,2018,4,7081000,6493000,13574000
Mauretanien,2018,5,5154000,7526000,12680000
Mauretanien,2018,6,5058000,8809000,13867000
Mauretanien,2018,7,5467000,4811000,10278000
Mauretanien,2018,8,6256000,6298000,12554000
Mauretanien,2018,9,3920000,7456000,11376000
Mauretanien,2018,10,6310000,7294000,13604000
Mauretanien,2018,11,8083000,8769000,16852000
Mauretanien,2018,12,6183000,6798000,12981000
Mauretanien,2019,1,3037000,9917000,12954000
Mauretanien,2019,2,7905000,11352000,19257000
Mauretanien,2019,3,6123000,11145000,17268000
Mauretanien,2019,4,5507000,4108000,9615000
Mauretanien,2019,5,7691000,8741000,16432000
Mauretanien,2019,6,4274000,11437000,15711000
Mauretanien,2019,7,6768000,5535000,12303000
Mauretanien,2019,8,5366000,2776000,8142000
Mauretanien,2019,9,4998000,4567000,9565000
Mauretanien,2019,10,5981000,4129000,10110000
Mauretanien,2019,11,5128000,6110000,11238000
Mauretanien,2019,12,5019000,6960000,11979000
Mauretanien,2020,1,4137000,6887000,11024000
Mauretanien,2020,2,11382000,7327000,18709000
Mauretanien,2020,3,6489000,8735000,15224000
Mauretanien,2020,4,4661000,8673000,13334000
Mauretanien,2020,5,3869000,4145000,8014000
Mauretanien,2020,6,4110000,1426000,5536000
Mauretanien,2020,7,3877000,182000,4059000
Mauretanien,2020,8,2496000,8000,2504000
Mauretanien,2020,9,2465000,592000,3057000
Mauretanien,2020,10,4984000,14154000,19138000
Mauretanien,2020,11,5061000,3287000,8348000
Mauretanien,2020,12,4726000,59569000,64295000
Mauretanien,2021,1,3792000,8639000,12431000
Mauretanien,2021,2,3443000,8217000,11660000
Mauretanien,2021,3,7156000,24270000,31426000
Mauretanien,2021,4,6618000,9617000,16235000
Mauretanien,2021,5,5765000,9763000,15528000
Mauretanien,2021,6,5950000,3311000,9261000
Mauretanien,2021,7,5648000,2308000,7956000
Mauretanien,2021,8,3988000,16401000,20389000
Mauretanien,2021,9,5506000,9445000,14951000
Mauretanien,2021,10,4939000,9386000,14325000
Mauretanien,2021,11,4039000,3361000,7400000
Mauretanien,2021,12,5287000,4555000,9842000
Mauretanien,2022,1,3758000,3999000,7757000
Mauretanien,2022,2,4406000,10033000,14439000
Mauretanien,2022,3,6795000,2008000,8803000
Mauretanien,2022,4,6535000,2860000,9395000
Mauretanien,2022,5,17568000,2262000,19830000
Mauretanien,2022,6,6083000,7751000,13834000
Mauretanien,2022,7,17569000,1105000,18674000
Mauretanien,2022,8,18811000,847000,19658000
Mauretanien,2022,9,20455000,1092000,21547000
Mauretanien,2022,10,19269000,1078000,20347000
Mauretanien,2022,11,10240000,153000,10393000
Mauretanien,2022,12,7260000,16000,7276000
Mauretanien,2023,1,4441000,5000,4446000
Mauretanien,2023,2,5091000,10252000,15343000
Mauretanien,2023,3,17084000,162000,17246000
Mauretanien,2023,4,13651000,10310000,23961000
Mauretanien,2023,5,5375000,36000,5411000
Mauretanien,2023,6,7120000,6943000,14063000
Mauretanien,2023,7,5956000,179000,6135000
Mauretanien,2023,8,5934000,10102000,16036000
Mauretanien,2023,9,7230000,4074000,11304000
Mauretanien,2023,10,7258000,8000,7266000
Mauretanien,2023,11,8013000,97000,8110000
Mauretanien,2023,12,7612000,4492000,12104000
Mauretanien,2024,1,12171000,13605000,25776000
Mauretanien,2024,2,6594000,5373000,11967000
Mauretanien,2024,3,7262000,316000,7578000
Mauretanien,2024,4,4102000,8857000,12959000
Mauretanien,2024,5,5932000,15174000,21106000
Mauretanien,2024,6,12456000,1890000,14346000
Mauretanien,2024,7,8017000,5502000,13519000
Mauretanien,2024,8,12776000,4582000,17358000
Mauretanien,2024,9,7396000,7675000,15071000
Mauretanien,2024,10,4686000,1172000,5858000
Mauretanien,2024,11,5278000,9000,5287000
Mauretanien,2024,12,14039000,409000,14448000
Mauritius,2008,1,7102000,4108000,11210000
Mauritius,2008,2,6896000,4039000,10935000
Mauritius,2008,3,5577000,4328000,9905000
Mauritius,2008,4,5174000,4038000,9212000
Mauritius,2008,5,5738000,5135000,10873000
Mauritius,2008,6,7309000,3068000,10377000
Mauritius,2008,7,5666000,3621000,9287000
Mauritius,2008,8,5390000,2902000,8292000
Mauritius,2008,9,8249000,2890000,11139000
Mauritius,2008,10,6497000,3108000,9605000
Mauritius,2008,11,5773000,3105000,8878000
Mauritius,2008,12,6030000,3502000,9532000
Mauritius,2009,1,4580000,3661000,8241000
Mauritius,2009,2,6067000,3713000,9780000
Mauritius,2009,3,7197000,3085000,10282000
Mauritius,2009,4,3907000,3853000,7760000
Mauritius,2009,5,6068000,3622000,9690000
Mauritius,2009,6,6289000,3127000,9416000
Mauritius,2009,7,7202000,3789000,10991000
Mauritius,2009,8,5320000,3363000,8683000
Mauritius,2009,9,7085000,4005000,11090000
Mauritius,2009,10,7433000,3052000,10485000
Mauritius,2009,11,6749000,3116000,9865000
Mauritius,2009,12,6104000,2454000,8558000
Mauritius,2010,1,5707000,3103000,8810000
Mauritius,2010,2,6984000,2464000,9448000
Mauritius,2010,3,7529000,4109000,11638000
Mauritius,2010,4,7020000,3209000,10229000
Mauritius,2010,5,5930000,2964000,8894000
Mauritius,2010,6,6483000,2697000,9180000
Mauritius,2010,7,7431000,3839000,11270000
Mauritius,2010,8,8854000,4698000,13552000
Mauritius,2010,9,7231000,3727000,10958000
Mauritius,2010,10,8331000,4535000,12866000
Mauritius,2010,11,9087000,2871000,11958000
Mauritius,2010,12,8302000,2543000,10845000
Mauritius,2011,1,5649000,3778000,9427000
Mauritius,2011,2,8518000,3682000,12200000
Mauritius,2011,3,8487000,4136000,12623000
Mauritius,2011,4,8523000,2928000,11451000
Mauritius,2011,5,8223000,4041000,12264000
Mauritius,2011,6,6735000,3296000,10031000
Mauritius,2011,7,7125000,2657000,9782000
Mauritius,2011,8,7890000,2439000,10329000
Mauritius,2011,9,8871000,2156000,11027000
Mauritius,2011,10,9387000,1422000,10809000
Mauritius,2011,11,8231000,2109000,10340000
Mauritius,2011,12,8208000,2947000,11155000
Mauritius,2012,1,6446000,3073000,9519000
Mauritius,2012,2,9359000,2118000,11477000
Mauritius,2012,3,6448000,3160000,9608000
Mauritius,2012,4,5864000,2753000,8617000
Mauritius,2012,5,6981000,2241000,9222000
Mauritius,2012,6,7460000,2710000,10170000
Mauritius,2012,7,8405000,3440000,11845000
Mauritius,2012,8,10170000,3449000,13619000
Mauritius,2012,9,7880000,3480000,11360000
Mauritius,2012,10,9298000,2915000,12213000
Mauritius,2012,11,10673000,3463000,14136000
Mauritius,2012,12,5336000,6145000,11481000
Mauritius,2013,1,6458000,2783000,9241000
Mauritius,2013,2,7132000,2620000,9752000
Mauritius,2013,3,7625000,2383000,10008000
Mauritius,2013,4,6344000,3248000,9592000
Mauritius,2013,5,9466000,3129000,12595000
Mauritius,2013,6,6611000,4427000,11038000
Mauritius,2013,7,5950000,3894000,9844000
Mauritius,2013,8,7060000,2480000,9540000
Mauritius,2013,9,10541000,3820000,14361000
Mauritius,2013,10,8419000,3439000,11858000
Mauritius,2013,11,9159000,1910000,11069000
Mauritius,2013,12,6255000,2519000,8774000
Mauritius,2014,1,5647000,3333000,8980000
Mauritius,2014,2,6390000,3826000,10216000
Mauritius,2014,3,7463000,3042000,10505000
Mauritius,2014,4,7525000,3493000,11018000
Mauritius,2014,5,7496000,2585000,10081000
Mauritius,2014,6,9126000,2774000,11900000
Mauritius,2014,7,7756000,3939000,11695000
Mauritius,2014,8,6901000,2776000,9677000
Mauritius,2014,9,8496000,2942000,11438000
Mauritius,2014,10,8561000,3362000,11923000
Mauritius,2014,11,7380000,2651000,10031000
Mauritius,2014,12,6192000,3161000,9353000
Mauritius,2015,1,6339000,2836000,9175000
Mauritius,2015,2,6546000,4933000,11479000
Mauritius,2015,3,8574000,2691000,11265000
Mauritius,2015,4,6423000,3451000,9874000
Mauritius,2015,5,6747000,3204000,9951000
Mauritius,2015,6,6485000,3612000,10097000
Mauritius,2015,7,7190000,4887000,12077000
Mauritius,2015,8,7725000,3557000,11282000
Mauritius,2015,9,7818000,3579000,11397000
Mauritius,2015,10,9262000,4634000,13896000
Mauritius,2015,11,7373000,6033000,13406000
Mauritius,2015,12,7634000,4468000,12102000
Mauritius,2016,1,6910000,5835000,12745000
Mauritius,2016,2,8780000,4640000,13420000
Mauritius,2016,3,8858000,5939000,14797000
Mauritius,2016,4,9483000,3677000,13160000
Mauritius,2016,5,13943000,5447000,19390000
Mauritius,2016,6,11710000,5665000,17375000
Mauritius,2016,7,9662000,4580000,14242000
Mauritius,2016,8,8638000,4154000,12792000
Mauritius,2016,9,10563000,5863000,16426000
Mauritius,2016,10,12417000,5486000,17903000
Mauritius,2016,11,9032000,6097000,15129000
Mauritius,2016,12,10750000,5544000,16294000
Mauritius,2017,1,8815000,5328000,14143000
Mauritius,2017,2,6861000,7102000,13963000
Mauritius,2017,3,10190000,7372000,17562000
Mauritius,2017,4,8064000,8205000,16269000
Mauritius,2017,5,9020000,6163000,15183000
Mauritius,2017,6,10561000,4742000,15303000
Mauritius,2017,7,12360000,4566000,16926000
Mauritius,2017,8,10015000,5023000,15038000
Mauritius,2017,9,10917000,3793000,14710000
Mauritius,2017,10,11770000,4223000,15993000
Mauritius,2017,11,14602000,3532000,18134000
Mauritius,2017,12,8550000,4997000,13547000
Mauritius,2018,1,12494000,4597000,17091000
Mauritius,2018,2,9277000,4989000,14266000
Mauritius,2018,3,11769000,4617000,16386000
Mauritius,2018,4,11025000,3444000,14469000
Mauritius,2018,5,10936000,7770000,18706000
Mauritius,2018,6,10210000,3923000,14133000
Mauritius,2018,7,11098000,4888000,15986000
Mauritius,2018,8,11190000,5281000,16471000
Mauritius,2018,9,10646000,2920000,13566000
Mauritius,2018,10,8449000,5215000,13664000
Mauritius,2018,11,11820000,3779000,15599000
Mauritius,2018,12,12285000,3711000,15996000
Mauritius,2019,1,9261000,5430000,14691000
Mauritius,2019,2,12930000,4458000,17388000
Mauritius,2019,3,11581000,4897000,16478000
Mauritius,2019,4,8903000,6155000,15058000
Mauritius,2019,5,11917000,5189000,17106000
Mauritius,2019,6,11900000,4830000,16730000
Mauritius,2019,7,12749000,4717000,17466000
Mauritius,2019,8,12768000,4154000,16922000
Mauritius,2019,9,13118000,4726000,17844000
Mauritius,2019,10,13871000,4147000,18018000
Mauritius,2019,11,11180000,3598000,14778000
Mauritius,2019,12,14856000,3733000,18589000
Mauritius,2020,1,9632000,3748000,13380000
Mauritius,2020,2,10497000,3589000,14086000
Mauritius,2020,3,12512000,3423000,15935000
Mauritius,2020,4,3366000,3533000,6899000
Mauritius,2020,5,5024000,2346000,7370000
Mauritius,2020,6,9122000,2942000,12064000
Mauritius,2020,7,7451000,3635000,11086000
Mauritius,2020,8,10838000,3804000,14642000
Mauritius,2020,9,10391000,3590000,13981000
Mauritius,2020,10,8949000,3915000,12864000
Mauritius,2020,11,9892000,5316000,15208000
Mauritius,2020,12,11212000,2788000,14000000
Mauritius,2021,1,7407000,2330000,9737000
Mauritius,2021,2,6360000,3506000,9866000
Mauritius,2021,3,8954000,5125000,14079000
Mauritius,2021,4,6882000,3810000,10692000
Mauritius,2021,5,9516000,3326000,12842000
Mauritius,2021,6,6813000,3378000,10191000
Mauritius,2021,7,10691000,3924000,14615000
Mauritius,2021,8,7638000,3239000,10877000
Mauritius,2021,9,9047000,3523000,12570000
Mauritius,2021,10,8396000,3879000,12275000
Mauritius,2021,11,10776000,3988000,14764000
Mauritius,2021,12,10021000,4323000,14344000
Mauritius,2022,1,8678000,2526000,11204000
Mauritius,2022,2,10524000,3670000,14194000
Mauritius,2022,3,9541000,4506000,14047000
Mauritius,2022,4,8070000,3694000,11764000
Mauritius,2022,5,11538000,4391000,15929000
Mauritius,2022,6,9900000,3967000,13867000
Mauritius,2022,7,11323000,3721000,15044000
Mauritius,2022,8,11393000,3849000,15242000
Mauritius,2022,9,14240000,3586000,17826000
Mauritius,2022,10,11679000,5279000,16958000
Mauritius,2022,11,13236000,4397000,17633000
Mauritius,2022,12,17098000,4229000,21327000
Mauritius,2023,1,14837000,4719000,19556000
Mauritius,2023,2,16451000,3987000,20438000
Mauritius,2023,3,15583000,6635000,22218000
Mauritius,2023,4,14026000,6928000,20954000
Mauritius,2023,5,14561000,4078000,18639000
Mauritius,2023,6,13849000,5164000,19013000
Mauritius,2023,7,13866000,5053000,18919000
Mauritius,2023,8,18701000,3942000,22643000
Mauritius,2023,9,12080000,5480000,17560000
Mauritius,2023,10,16058000,6402000,22460000
Mauritius,2023,11,20023000,3863000,23886000
Mauritius,2023,12,9868000,3682000,13550000
Mauritius,2024,1,12324000,4171000,16495000
Mauritius,2024,2,17457000,3367000,20824000
Mauritius,2024,3,11138000,3560000,14698000
Mauritius,2024,4,14890000,4357000,19247000
Mauritius,2024,5,11853000,4481000,16334000
Mauritius,2024,6,11862000,4908000,16770000
Mauritius,2024,7,13086000,5323000,18409000
Mauritius,2024,8,13294000,5107000,18401000
Mauritius,2024,9,14664000,3557000,18221000
Mauritius,2024,10,15386000,3641000,19027000
Mauritius,2024,11,13415000,3215000,16630000
Mauritius,2024,12,11042000,2519000,13561000
Mayotte (bis 2013),2008,1,179000,0,179000
Mayotte (bis 2013),2008,2,510000,0,510000
Mayotte (bis 2013),2008,3,859000,0,859000
Mayotte (bis 2013),2008,4,288000,0,288000
Mayotte (bis 2013),2008,5,441000,0,441000
Mayotte (bis 2013),2008,6,300000,0,300000
Mayotte (bis 2013),2008,7,388000,0,388000
Mayotte (bis 2013),2008,8,197000,0,197000
Mayotte (bis 2013),2008,9,572000,0,572000
Mayotte (bis 2013),2008,10,270000,0,270000
Mayotte (bis 2013),2008,11,465000,0,465000
Mayotte (bis 2013),2008,12,298000,1000,299000
Mayotte (bis 2013),2009,1,624000,0,624000
Mayotte (bis 2013),2009,2,264000,0,264000
Mayotte (bis 2013),2009,3,238000,6000,244000
Mayotte (bis 2013),2009,4,197000,0,197000
Mayotte (bis 2013),2009,5,349000,8000,357000
Mayotte (bis 2013),2009,6,290000,0,290000
Mayotte (bis 2013),2009,7,210000,0,210000
Mayotte (bis 2013),2009,8,127000,0,127000
Mayotte (bis 2013),2009,9,251000,0,251000
Mayotte (bis 2013),2009,10,198000,6000,204000
Mayotte (bis 2013),2009,11,277000,0,277000
Mayotte (bis 2013),2009,12,165000,0,165000
Mayotte (bis 2013),2010,1,135000,0,135000
Mayotte (bis 2013),2010,2,2301000,0,2301000
Mayotte (bis 2013),2010,3,310000,0,310000
Mayotte (bis 2013),2010,4,435000,0,435000
Mayotte (bis 2013),2010,5,242000,0,242000
Mayotte (bis 2013),2010,6,235000,0,235000
Mayotte (bis 2013),2010,7,276000,0,276000
Mayotte (bis 2013),2010,8,515000,0,515000
Mayotte (bis 2013),2010,9,178000,0,178000
Mayotte (bis 2013),2010,10,151000,0,151000
Mayotte (bis 2013),2010,11,143000,0,143000
Mayotte (bis 2013),2010,12,279000,0,279000
Mayotte (bis 2013),2011,1,255000,16000,271000
Mayotte (bis 2013),2011,2,1261000,0,1261000
Mayotte (bis 2013),2011,3,665000,0,665000
Mayotte (bis 2013),2011,4,159000,0,159000
Mayotte (bis 2013),2011,5,173000,0,173000
Mayotte (bis 2013),2011,6,144000,0,144000
Mayotte (bis 2013),2011,7,112000,11000,123000
Mayotte (bis 2013),2011,8,125000,0,125000
Mayotte (bis 2013),2011,9,212000,0,212000
Mayotte (bis 2013),2011,10,156000,0,156000
Mayotte (bis 2013),2011,11,267000,0,267000
Mayotte (bis 2013),2011,12,224000,9000,233000
Mayotte (bis 2013),2012,1,331000,0,331000
Mayotte (bis 2013),2012,2,163000,0,163000
Mayotte (bis 2013),2012,3,142000,0,142000
Mayotte (bis 2013),2012,4,267000,0,267000
Mayotte (bis 2013),2012,5,377000,0,377000
Mayotte (bis 2013),2012,6,466000,0,466000
Mayotte (bis 2013),2012,7,588000,0,588000
Mayotte (bis 2013),2012,8,236000,0,236000
Mayotte (bis 2013),2012,9,288000,0,288000
Mayotte (bis 2013),2012,10,187000,0,187000
Mayotte (bis 2013),2012,11,528000,0,528000
Mayotte (bis 2013),2012,12,420000,0,420000
Mayotte (bis 2013),2013,1,450000,0,450000
Mayotte (bis 2013),2013,2,118000,0,118000
Mayotte (bis 2013),2013,3,211000,0,211000
Mayotte (bis 2013),2013,4,426000,0,426000
Mayotte (bis 2013),2013,5,137000,0,137000
Mayotte (bis 2013),2013,6,213000,0,213000
Mayotte (bis 2013),2013,7,197000,5000,202000
Mayotte (bis 2013),2013,8,315000,0,315000
Mayotte (bis 2013),2013,9,182000,0,182000
Mayotte (bis 2013),2013,10,284000,0,284000
Mayotte (bis 2013),2013,11,219000,0,219000
Mayotte (bis 2013),2013,12,166000,0,166000
Mayotte (bis 2013),2014,1,0,0,0
Mayotte (bis 2013),2014,2,0,0,0
Mayotte (bis 2013),2014,3,0,0,0
Mayotte (bis 2013),2014,4,0,0,0
Mayotte (bis 2013),2014,5,0,0,0
Mayotte (bis 2013),2014,6,0,0,0
Mayotte (bis 2013),2014,7,0,0,0
Mayotte (bis 2013),2014,8,0,0,0
Mayotte (bis 2013),2014,9,0,0,0
Mayotte (bis 2013),2014,10,0,0,0
Mayotte (bis 2013),2014,11,0,0,0
Mayotte (bis 2013),2014,12,0,0,0
Mayotte (bis 2013),2015,1,0,0,0
Mayotte (bis 2013),2015,2,0,0,0
Mayotte (bis 2013),2015,3,0,0,0
Mayotte (bis 2013),2015,4,0,0,0
Mayotte (bis 2013),2015,5,0,0,0
Mayotte (bis 2013),2015,6,0,0,0
Mayotte (bis 2013),2015,7,0,0,0
Mayotte (bis 2013),2015,8,0,0,0
Mayotte (bis 2013),2015,9,0,0,0
Mayotte (bis 2013),2015,10,0,0,0
Mayotte (bis 2013),2015,11,0,0,0
Mayotte (bis 2013),2015,12,0,0,0
Mayotte (bis 2013),2016,1,0,0,0
Mayotte (bis 2013),2016,2,0,0,0
Mayotte (bis 2013),2016,3,0,0,0
Mayotte (bis 2013),2016,4,0,0,0
Mayotte (bis 2013),2016,5,0,0,0
Mayotte (bis 2013),2016,6,0,0,0
Mayotte (bis 2013),2016,7,0,0,0
Mayotte (bis 2013),2016,8,0,0,0
Mayotte (bis 2013),2016,9,0,0,0
Mayotte (bis 2013),2016,10,0,0,0
Mayotte (bis 2013),2016,11,0,0,0
Mayotte (bis 2013),2016,12,0,0,0
Mayotte (bis 2013),2017,1,0,0,0
Mayotte (bis 2013),2017,2,0,0,0
Mayotte (bis 2013),2017,3,0,0,0
Mayotte (bis 2013),2017,4,0,0,0
Mayotte (bis 2013),2017,5,0,0,0
Mayotte (bis 2013),2017,6,0,0,0
Mayotte (bis 2013),2017,7,0,0,0
Mayotte (bis 2013),2017,8,0,0,0
Mayotte (bis 2013),2017,9,0,0,0
Mayotte (bis 2013),2017,10,0,0,0
Mayotte (bis 2013),2017,11,0,0,0
Mayotte (bis 2013),2017,12,0,0,0
Mayotte (bis 2013),2018,1,0,0,0
Mayotte (bis 2013),2018,2,0,0,0
Mayotte (bis 2013),2018,3,0,0,0
Mayotte (bis 2013),2018,4,0,0,0
Mayotte (bis 2013),2018,5,0,0,0
Mayotte (bis 2013),2018,6,0,0,0
Mayotte (bis 2013),2018,7,0,0,0
Mayotte (bis 2013),2018,8,0,0,0
Mayotte (bis 2013),2018,9,0,0,0
Mayotte (bis 2013),2018,10,0,0,0
Mayotte (bis 2013),2018,11,0,0,0
Mayotte (bis 2013),2018,12,0,0,0
Mayotte (bis 2013),2019,1,0,0,0
Mayotte (bis 2013),2019,2,0,0,0
Mayotte (bis 2013),2019,3,0,0,0
Mayotte (bis 2013),2019,4,0,0,0
Mayotte (bis 2013),2019,5,0,0,0
Mayotte (bis 2013),2019,6,0,0,0
Mayotte (bis 2013),2019,7,0,0,0
Mayotte (bis 2013),2019,8,0,0,0
Mayotte (bis 2013),2019,9,0,0,0
Mayotte (bis 2013),2019,10,0,0,0
Mayotte (bis 2013),2019,11,0,0,0
Mayotte (bis 2013),2019,12,0,0,0
Mayotte (bis 2013),2020,1,0,0,0
Mayotte (bis 2013),2020,2,0,0,0
Mayotte (bis 2013),2020,3,0,0,0
Mayotte (bis 2013),2020,4,0,0,0
Mayotte (bis 2013),2020,5,0,0,0
Mayotte (bis 2013),2020,6,0,0,0
Mayotte (bis 2013),2020,7,0,0,0
Mayotte (bis 2013),2020,8,0,0,0
Mayotte (bis 2013),2020,9,0,0,0
Mayotte (bis 2013),2020,10,0,0,0
Mayotte (bis 2013),2020,11,0,0,0
Mayotte (bis 2013),2020,12,0,0,0
Mayotte (bis 2013),2021,1,0,0,0
Mayotte (bis 2013),2021,2,0,0,0
Mayotte (bis 2013),2021,3,0,0,0
Mayotte (bis 2013),2021,4,0,0,0
Mayotte (bis 2013),2021,5,0,0,0
Mayotte (bis 2013),2021,6,0,0,0
Mayotte (bis 2013),2021,7,0,0,0
Mayotte (bis 2013),2021,8,0,0,0
Mayotte (bis 2013),2021,9,0,0,0
Mayotte (bis 2013),2021,10,0,0,0
Mayotte (bis 2013),2021,11,0,0,0
Mayotte (bis 2013),2021,12,0,0,0
Mayotte (bis 2013),2022,1,0,0,0
Mayotte (bis 2013),2022,2,0,0,0
Mayotte (bis 2013),2022,3,0,0,0
Mayotte (bis 2013),2022,4,0,0,0
Mayotte (bis 2013),2022,5,0,0,0
Mayotte (bis 2013),2022,6,0,0,0
Mayotte (bis 2013),2022,7,0,0,0
Mayotte (bis 2013),2022,8,0,0,0
Mayotte (bis 2013),2022,9,0,0,0
Mayotte (bis 2013),2022,10,0,0,0
Mayotte (bis 2013),2022,11,0,0,0
Mayotte (bis 2013),2022,12,0,0,0
Mayotte (bis 2013),2023,1,0,0,0
Mayotte (bis 2013),2023,2,0,0,0
Mayotte (bis 2013),2023,3,0,0,0
Mayotte (bis 2013),2023,4,0,0,0
Mayotte (bis 2013),2023,5,0,0,0
Mayotte (bis 2013),2023,6,0,0,0
Mayotte (bis 2013),2023,7,0,0,0
Mayotte (bis 2013),2023,8,0,0,0
Mayotte (bis 2013),2023,9,0,0,0
Mayotte (bis 2013),2023,10,0,0,0
Mayotte (bis 2013),2023,11,0,0,0
Mayotte (bis 2013),2023,12,0,0,0
Mayotte (bis 2013),2024,1,0,0,0
Mayotte (bis 2013),2024,2,0,0,0
Mayotte (bis 2013),2024,3,0,0,0
Mayotte (bis 2013),2024,4,0,0,0
Mayotte (bis 2013),2024,5,0,0,0
Mayotte (bis 2013),2024,6,0,0,0
Mayotte (bis 2013),2024,7,0,0,0
Mayotte (bis 2013),2024,8,0,0,0
Mayotte (bis 2013),2024,9,0,0,0
Mayotte (bis 2013),2024,10,0,0,0
Mayotte (bis 2013),2024,11,0,0,0
Mayotte (bis 2013),2024,12,0,0,0
Melilla (ab 1999),2008,1,1192000,0,1192000
Melilla (ab 1999),2008,2,601000,0,601000
Melilla (ab 1999),2008,3,520000,0,520000
Melilla (ab 1999),2008,4,948000,0,948000
Melilla (ab 1999),2008,5,628000,3000,631000
Melilla (ab 1999),2008,6,476000,2000,478000
Melilla (ab 1999),2008,7,460000,0,460000
Melilla (ab 1999),2008,8,382000,0,382000
Melilla (ab 1999),2008,9,241000,0,241000
Melilla (ab 1999),2008,10,665000,0,665000
Melilla (ab 1999),2008,11,879000,1000,880000
Melilla (ab 1999),2008,12,559000,0,559000
Melilla (ab 1999),2009,1,603000,0,603000
Melilla (ab 1999),2009,2,714000,13000,727000
Melilla (ab 1999),2009,3,602000,0,602000
Melilla (ab 1999),2009,4,661000,0,661000
Melilla (ab 1999),2009,5,700000,2000,702000
Melilla (ab 1999),2009,6,856000,0,856000
Melilla (ab 1999),2009,7,1020000,0,1020000
Melilla (ab 1999),2009,8,607000,0,607000
Melilla (ab 1999),2009,9,632000,0,632000
Melilla (ab 1999),2009,10,694000,0,694000
Melilla (ab 1999),2009,11,1023000,0,1023000
Melilla (ab 1999),2009,12,710000,0,710000
Melilla (ab 1999),2010,1,704000,0,704000
Melilla (ab 1999),2010,2,842000,0,842000
Melilla (ab 1999),2010,3,905000,58000,963000
Melilla (ab 1999),2010,4,632000,18000,650000
Melilla (ab 1999),2010,5,639000,0,639000
Melilla (ab 1999),2010,6,929000,0,929000
Melilla (ab 1999),2010,7,801000,0,801000
Melilla (ab 1999),2010,8,544000,0,544000
Melilla (ab 1999),2010,9,647000,0,647000
Melilla (ab 1999),2010,10,862000,0,862000
Melilla (ab 1999),2010,11,598000,0,598000
Melilla (ab 1999),2010,12,804000,0,804000
Melilla (ab 1999),2011,1,519000,0,519000
Melilla (ab 1999),2011,2,803000,0,803000
Melilla (ab 1999),2011,3,1075000,0,1075000
Melilla (ab 1999),2011,4,783000,0,783000
Melilla (ab 1999),2011,5,914000,0,914000
Melilla (ab 1999),2011,6,816000,0,816000
Melilla (ab 1999),2011,7,630000,0,630000
Melilla (ab 1999),2011,8,575000,0,575000
Melilla (ab 1999),2011,9,862000,0,862000
Melilla (ab 1999),2011,10,593000,0,593000
Melilla (ab 1999),2011,11,646000,0,646000
Melilla (ab 1999),2011,12,851000,0,851000
Melilla (ab 1999),2012,1,351000,0,351000
Melilla (ab 1999),2012,2,874000,0,874000
Melilla (ab 1999),2012,3,666000,0,666000
Melilla (ab 1999),2012,4,605000,0,605000
Melilla (ab 1999),2012,5,847000,0,847000
Melilla (ab 1999),2012,6,1580000,0,1580000
Melilla (ab 1999),2012,7,628000,0,628000
Melilla (ab 1999),2012,8,639000,0,639000
Melilla (ab 1999),2012,9,342000,0,342000
Melilla (ab 1999),2012,10,617000,0,617000
Melilla (ab 1999),2012,11,709000,0,709000
Melilla (ab 1999),2012,12,522000,0,522000
Melilla (ab 1999),2013,1,672000,3000,675000
Melilla (ab 1999),2013,2,551000,0,551000
Melilla (ab 1999),2013,3,502000,0,502000
Melilla (ab 1999),2013,4,495000,0,495000
Melilla (ab 1999),2013,5,725000,0,725000
Melilla (ab 1999),2013,6,652000,0,652000
Melilla (ab 1999),2013,7,616000,0,616000
Melilla (ab 1999),2013,8,546000,0,546000
Melilla (ab 1999),2013,9,535000,0,535000
Melilla (ab 1999),2013,10,638000,0,638000
Melilla (ab 1999),2013,11,863000,0,863000
Melilla (ab 1999),2013,12,636000,0,636000
Melilla (ab 1999),2014,1,648000,0,648000
Melilla (ab 1999),2014,2,573000,0,573000
Melilla (ab 1999),2014,3,581000,0,581000
Melilla (ab 1999),2014,4,685000,0,685000
Melilla (ab 1999),2014,5,746000,0,746000
Melilla (ab 1999),2014,6,1217000,0,1217000
Melilla (ab 1999),2014,7,594000,0,594000
Melilla (ab 1999),2014,8,699000,0,699000
Melilla (ab 1999),2014,9,491000,0,491000
Melilla (ab 1999),2014,10,761000,0,761000
Melilla (ab 1999),2014,11,1184000,0,1184000
Melilla (ab 1999),2014,12,558000,0,558000
Melilla (ab 1999),2015,1,477000,0,477000
Melilla (ab 1999),2015,2,548000,0,548000
Melilla (ab 1999),2015,3,832000,0,832000
Melilla (ab 1999),2015,4,3229000,3000,3232000
Melilla (ab 1999),2015,5,767000,0,767000
Melilla (ab 1999),2015,6,705000,0,705000
Melilla (ab 1999),2015,7,888000,0,888000
Melilla (ab 1999),2015,8,564000,0,564000
Melilla (ab 1999),2015,9,609000,0,609000
Melilla (ab 1999),2015,10,575000,0,575000
Melilla (ab 1999),2015,11,418000,0,418000
Melilla (ab 1999),2015,12,723000,0,723000
Melilla (ab 1999),2016,1,319000,0,319000
Melilla (ab 1999),2016,2,575000,0,575000
Melilla (ab 1999),2016,3,555000,0,555000
Melilla (ab 1999),2016,4,640000,0,640000
Melilla (ab 1999),2016,5,533000,0,533000
Melilla (ab 1999),2016,6,511000,0,511000
Melilla (ab 1999),2016,7,525000,0,525000
Melilla (ab 1999),2016,8,394000,0,394000
Melilla (ab 1999),2016,9,638000,0,638000
Melilla (ab 1999),2016,10,1181000,0,1181000
Melilla (ab 1999),2016,11,566000,0,566000
Melilla (ab 1999),2016,12,712000,0,712000
Melilla (ab 1999),2017,1,520000,0,520000
Melilla (ab 1999),2017,2,637000,0,637000
Melilla (ab 1999),2017,3,850000,0,850000
Melilla (ab 1999),2017,4,630000,0,630000
Melilla (ab 1999),2017,5,711000,0,711000
Melilla (ab 1999),2017,6,545000,0,545000
Melilla (ab 1999),2017,7,407000,0,407000
Melilla (ab 1999),2017,8,497000,0,497000
Melilla (ab 1999),2017,9,482000,0,482000
Melilla (ab 1999),2017,10,554000,0,554000
Melilla (ab 1999),2017,11,280000,0,280000
Melilla (ab 1999),2017,12,262000,0,262000
Melilla (ab 1999),2018,1,582000,0,582000
Melilla (ab 1999),2018,2,337000,0,337000
Melilla (ab 1999),2018,3,654000,0,654000
Melilla (ab 1999),2018,4,346000,0,346000
Melilla (ab 1999),2018,5,497000,0,497000
Melilla (ab 1999),2018,6,456000,0,456000
Melilla (ab 1999),2018,7,300000,0,300000
Melilla (ab 1999),2018,8,322000,0,322000
Melilla (ab 1999),2018,9,344000,0,344000
Melilla (ab 1999),2018,10,805000,0,805000
Melilla (ab 1999),2018,11,983000,0,983000
Melilla (ab 1999),2018,12,337000,2000,339000
Melilla (ab 1999),2019,1,402000,0,402000
Melilla (ab 1999),2019,2,562000,0,562000
Melilla (ab 1999),2019,3,808000,0,808000
Melilla (ab 1999),2019,4,477000,0,477000
Melilla (ab 1999),2019,5,736000,12000,748000
Melilla (ab 1999),2019,6,531000,0,531000
Melilla (ab 1999),2019,7,978000,0,978000
Melilla (ab 1999),2019,8,366000,0,366000
Melilla (ab 1999),2019,9,662000,1000,663000
Melilla (ab 1999),2019,10,749000,0,749000
Melilla (ab 1999),2019,11,684000,1000,685000
Melilla (ab 1999),2019,12,310000,0,310000
Melilla (ab 1999),2020,1,454000,0,454000
Melilla (ab 1999),2020,2,568000,0,568000
Melilla (ab 1999),2020,3,172000,0,172000
Melilla (ab 1999),2020,4,34000,0,34000
Melilla (ab 1999),2020,5,114000,0,114000
Melilla (ab 1999),2020,6,223000,0,223000
Melilla (ab 1999),2020,7,151000,0,151000
Melilla (ab 1999),2020,8,186000,0,186000
Melilla (ab 1999),2020,9,373000,1000,374000
Melilla (ab 1999),2020,10,281000,0,281000
Melilla (ab 1999),2020,11,1614000,0,1614000
Melilla (ab 1999),2020,12,175000,0,175000
Melilla (ab 1999),2021,1,78000,0,78000
Melilla (ab 1999),2021,2,421000,0,421000
Melilla (ab 1999),2021,3,400000,0,400000
Melilla (ab 1999),2021,4,234000,0,234000
Melilla (ab 1999),2021,5,144000,0,144000
Melilla (ab 1999),2021,6,179000,0,179000
Melilla (ab 1999),2021,7,2977000,0,2977000
Melilla (ab 1999),2021,8,139000,0,139000
Melilla (ab 1999),2021,9,235000,0,235000
Melilla (ab 1999),2021,10,136000,1000,137000
Melilla (ab 1999),2021,11,40000,0,40000
Melilla (ab 1999),2021,12,116000,0,116000
Melilla (ab 1999),2022,1,155000,0,155000
Melilla (ab 1999),2022,2,262000,0,262000
Melilla (ab 1999),2022,3,72000,13000,85000
Melilla (ab 1999),2022,4,117000,0,117000
Melilla (ab 1999),2022,5,253000,1000,254000
Melilla (ab 1999),2022,6,158000,8000,166000
Melilla (ab 1999),2022,7,268000,0,268000
Melilla (ab 1999),2022,8,111000,0,111000
Melilla (ab 1999),2022,9,222000,0,222000
Melilla (ab 1999),2022,10,599000,0,599000
Melilla (ab 1999),2022,11,407000,0,407000
Melilla (ab 1999),2022,12,227000,0,227000
Melilla (ab 1999),2023,1,464000,0,464000
Melilla (ab 1999),2023,2,373000,0,373000
Melilla (ab 1999),2023,3,370000,2000,372000
Melilla (ab 1999),2023,4,180000,0,180000
Melilla (ab 1999),2023,5,81000,0,81000
Melilla (ab 1999),2023,6,335000,0,335000
Melilla (ab 1999),2023,7,195000,0,195000
Melilla (ab 1999),2023,8,55000,0,55000
Melilla (ab 1999),2023,9,99000,0,99000
Melilla (ab 1999),2023,10,46000,5000,51000
Melilla (ab 1999),2023,11,80000,0,80000
Melilla (ab 1999),2023,12,138000,0,138000
Melilla (ab 1999),2024,1,123000,0,123000
Melilla (ab 1999),2024,2,61000,0,61000
Melilla (ab 1999),2024,3,144000,0,144000
Melilla (ab 1999),2024,4,103000,0,103000
Melilla (ab 1999),2024,5,173000,0,173000
Melilla (ab 1999),2024,6,32000,0,32000
Melilla (ab 1999),2024,7,144000,0,144000
Melilla (ab 1999),2024,8,84000,0,84000
Melilla (ab 1999),2024,9,98000,0,98000
Melilla (ab 1999),2024,10,726000,0,726000
Melilla (ab 1999),2024,11,86000,0,86000
Melilla (ab 1999),2024,12,275000,0,275000
Mexiko,2008,1,544862000,399381000,944243000
Mexiko,2008,2,507971000,285283000,793254000
Mexiko,2008,3,540640000,376801000,917441000
Mexiko,2008,4,626861000,308403000,935264000
Mexiko,2008,5,530246000,375489000,905735000
Mexiko,2008,6,563456000,415841000,979297000
Mexiko,2008,7,618041000,277496000,895537000
Mexiko,2008,8,597300000,441169000,1038469000
Mexiko,2008,9,594100000,409717000,1003817000
Mexiko,2008,10,696492000,412875000,1109367000
Mexiko,2008,11,513523000,383229000,896752000
Mexiko,2008,12,495981000,391926000,887907000
Mexiko,2009,1,426154000,273800000,699954000
Mexiko,2009,2,397769000,251701000,649470000
Mexiko,2009,3,387989000,337015000,725004000
Mexiko,2009,4,410979000,277055000,688034000
Mexiko,2009,5,313371000,192183000,505554000
Mexiko,2009,6,347589000,304463000,652052000
Mexiko,2009,7,483489000,286006000,769495000
Mexiko,2009,8,515205000,224085000,739290000
Mexiko,2009,9,428022000,251860000,679882000
Mexiko,2009,10,459139000,279934000,739073000
Mexiko,2009,11,444581000,269601000,714182000
Mexiko,2009,12,480851000,268231000,749082000
Mexiko,2010,1,446661000,251816000,698477000
Mexiko,2010,2,520160000,216438000,736598000
Mexiko,2010,3,611365000,389896000,1001261000
Mexiko,2010,4,540471000,293859000,834330000
Mexiko,2010,5,594554000,309474000,904028000
Mexiko,2010,6,605819000,332111000,937930000
Mexiko,2010,7,627717000,321259000,948976000
Mexiko,2010,8,671792000,326976000,998768000
Mexiko,2010,9,605387000,312829000,918216000
Mexiko,2010,10,559664000,318395000,878059000
Mexiko,2010,11,588186000,330065000,918251000
Mexiko,2010,12,511842000,299659000,811501000
Mexiko,2011,1,540777000,311338000,852115000
Mexiko,2011,2,581321000,269549000,850870000
Mexiko,2011,3,655318000,398484000,1053802000
Mexiko,2011,4,592360000,354460000,946820000
Mexiko,2011,5,689432000,335266000,1024698000
Mexiko,2011,6,620192000,387754000,1007946000
Mexiko,2011,7,691740000,340363000,1032103000
Mexiko,2011,8,651522000,482914000,1134436000
Mexiko,2011,9,651316000,396263000,1047579000
Mexiko,2011,10,572858000,342882000,915740000
Mexiko,2011,11,698712000,369490000,1068202000
Mexiko,2011,12,648124000,373072000,1021196000
Mexiko,2012,1,632303000,259348000,891651000
Mexiko,2012,2,718492000,247658000,966150000
Mexiko,2012,3,747549000,386170000,1133719000
Mexiko,2012,4,610893000,389928000,1000821000
Mexiko,2012,5,695181000,344176000,1039357000
Mexiko,2012,6,824489000,438201000,1262690000
Mexiko,2012,7,786584000,416817000,1203401000
Mexiko,2012,8,880981000,474088000,1355069000
Mexiko,2012,9,695211000,364648000,1059859000
Mexiko,2012,10,820278000,396060000,1216338000
Mexiko,2012,11,800809000,320393000,1121202000
Mexiko,2012,12,657837000,292317000,950154000
Mexiko,2013,1,735525000,353983000,1089508000
Mexiko,2013,2,780097000,324628000,1104725000
Mexiko,2013,3,803252000,370727000,1173979000
Mexiko,2013,4,747065000,418433000,1165498000
Mexiko,2013,5,762141000,370786000,1132927000
Mexiko,2013,6,811733000,329930000,1141663000
Mexiko,2013,7,774882000,316441000,1091323000
Mexiko,2013,8,648501000,274981000,923482000
Mexiko,2013,9,712886000,302586000,1015472000
Mexiko,2013,10,728899000,307734000,1036633000
Mexiko,2013,11,738248000,257111000,995359000
Mexiko,2013,12,702127000,289685000,991812000
Mexiko,2014,1,704377000,246474000,950851000
Mexiko,2014,2,703634000,235131000,938765000
Mexiko,2014,3,756226000,377692000,1133918000
Mexiko,2014,4,702466000,323265000,1025731000
Mexiko,2014,5,741885000,284926000,1026811000
Mexiko,2014,6,753321000,374910000,1128231000
Mexiko,2014,7,776751000,319135000,1095886000
Mexiko,2014,8,701700000,273469000,975169000
Mexiko,2014,9,790212000,319532000,1109744000
Mexiko,2014,10,851914000,309887000,1161801000
Mexiko,2014,11,775969000,302483000,1078452000
Mexiko,2014,12,804312000,315087000,1119399000
Mexiko,2015,1,765071000,333622000,1098693000
Mexiko,2015,2,848185000,281735000,1129920000
Mexiko,2015,3,963699000,396728000,1360427000
Mexiko,2015,4,1007081000,439166000,1446247000
Mexiko,2015,5,880620000,385644000,1266264000
Mexiko,2015,6,937688000,384693000,1322381000
Mexiko,2015,7,1057307000,399902000,1457209000
Mexiko,2015,8,880887000,335996000,1216883000
Mexiko,2015,9,977375000,365660000,1343035000
Mexiko,2015,10,883538000,402994000,1286532000
Mexiko,2015,11,865008000,355569000,1220577000
Mexiko,2015,12,999881000,391524000,1391405000
Mexiko,2016,1,716862000,339379000,1056241000
Mexiko,2016,2,811152000,360688000,1171840000
Mexiko,2016,3,857251000,420459000,1277710000
Mexiko,2016,4,848230000,423347000,1271577000
Mexiko,2016,5,944644000,401460000,1346104000
Mexiko,2016,6,937104000,449653000,1386757000
Mexiko,2016,7,898726000,422821000,1321547000
Mexiko,2016,8,873405000,402056000,1275461000
Mexiko,2016,9,1144720000,405104000,1549824000
Mexiko,2016,10,963324000,417136000,1380460000
Mexiko,2016,11,1045152000,547467000,1592619000
Mexiko,2016,12,1059706000,566560000,1626266000
Mexiko,2017,1,937805000,567898000,1505703000
Mexiko,2017,2,973117000,481940000,1455057000
Mexiko,2017,3,1099216000,577484000,1676700000
Mexiko,2017,4,874872000,582129000,1457001000
Mexiko,2017,5,1201251000,650562000,1851813000
Mexiko,2017,6,1181665000,646956000,1828621000
Mexiko,2017,7,1092768000,611651000,1704419000
Mexiko,2017,8,1203138000,595377000,1798515000
Mexiko,2017,9,1097059000,544213000,1641272000
Mexiko,2017,10,1059754000,709271000,1769025000
Mexiko,2017,11,1121864000,811570000,1933434000
Mexiko,2017,12,1052102000,731553000,1783655000
Mexiko,2018,1,1122006000,592365000,1714371000
Mexiko,2018,2,1081220000,532073000,1613293000
Mexiko,2018,3,1085599000,677981000,1763580000
Mexiko,2018,4,1153567000,792591000,1946158000
Mexiko,2018,5,1218345000,781928000,2000273000
Mexiko,2018,6,1180402000,851698000,2032100000
Mexiko,2018,7,1182525000,840173000,2022698000
Mexiko,2018,8,1225399000,459950000,1685349000
Mexiko,2018,9,1116607000,534472000,1651079000
Mexiko,2018,10,1250755000,524765000,1775520000
Mexiko,2018,11,1259482000,663499000,1922981000
Mexiko,2018,12,1020003000,584690000,1604693000
Mexiko,2019,1,1062495000,680152000,1742647000
Mexiko,2019,2,1082089000,621430000,1703519000
Mexiko,2019,3,1153328000,752958000,1906286000
Mexiko,2019,4,1052157000,767744000,1819901000
Mexiko,2019,5,1257026000,777432000,2034458000
Mexiko,2019,6,1027740000,751926000,1779666000
Mexiko,2019,7,1315181000,764177000,2079358000
Mexiko,2019,8,1262015000,652876000,1914891000
Mexiko,2019,9,1171302000,675746000,1847048000
Mexiko,2019,10,1217939000,802427000,2020366000
Mexiko,2019,11,1041026000,657677000,1698703000
Mexiko,2019,12,1048858000,791152000,1840010000
Mexiko,2020,1,1096427000,741858000,1838285000
Mexiko,2020,2,1056778000,585565000,1642343000
Mexiko,2020,3,1091589000,726320000,1817909000
Mexiko,2020,4,586142000,366265000,952407000
Mexiko,2020,5,492002000,535271000,1027273000
Mexiko,2020,6,688221000,357547000,1045768000
Mexiko,2020,7,984403000,534325000,1518728000
Mexiko,2020,8,974705000,737768000,1712473000
Mexiko,2020,9,1094986000,802667000,1897653000
Mexiko,2020,10,1191973000,922783000,2114756000
Mexiko,2020,11,1005882000,912821000,1918703000
Mexiko,2020,12,1012487000,640076000,1652563000
Mexiko,2021,1,1035376000,645365000,1680741000
Mexiko,2021,2,982867000,609716000,1592583000
Mexiko,2021,3,1293607000,661293000,1954900000
Mexiko,2021,4,1140896000,806229000,1947125000
Mexiko,2021,5,1061829000,650378000,1712207000
Mexiko,2021,6,1095551000,709903000,1805454000
Mexiko,2021,7,1151350000,666176000,1817526000
Mexiko,2021,8,1123150000,498737000,1621887000
Mexiko,2021,9,1052308000,655206000,1707514000
Mexiko,2021,10,1123671000,599597000,1723268000
Mexiko,2021,11,1052110000,642422000,1694532000
Mexiko,2021,12,1077018000,637893000,1714911000
Mexiko,2022,1,1050107000,597229000,1647336000
Mexiko,2022,2,1139412000,575528000,1714940000
Mexiko,2022,3,1292783000,781259000,2074042000
Mexiko,2022,4,1354595000,742924000,2097519000
Mexiko,2022,5,1434096000,802053000,2236149000
Mexiko,2022,6,1498558000,836982000,2335540000
Mexiko,2022,7,1355664000,655955000,2011619000
Mexiko,2022,8,1453845000,821779000,2275624000
Mexiko,2022,9,1499176000,853272000,2352448000
Mexiko,2022,10,1485716000,858553000,2344269000
Mexiko,2022,11,1563804000,885471000,2449275000
Mexiko,2022,12,1222116000,740939000,1963055000
Mexiko,2023,1,1368494000,858825000,2227319000
Mexiko,2023,2,1325848000,799235000,2125083000
Mexiko,2023,3,1669866000,846042000,2515908000
Mexiko,2023,4,1330039000,737918000,2067957000
Mexiko,2023,5,1675696000,934958000,2610654000
Mexiko,2023,6,1810164000,778654000,2588818000
Mexiko,2023,7,1633483000,847839000,2481322000
Mexiko,2023,8,1716961000,941373000,2658334000
Mexiko,2023,9,1632760000,779337000,2412097000
Mexiko,2023,10,1751433000,975837000,2727270000
Mexiko,2023,11,1618885000,929006000,2547891000
Mexiko,2023,12,1425504000,720112000,2145616000
Mexiko,2024,1,1563362000,846652000,2410014000
Mexiko,2024,2,1572893000,635550000,2208443000
Mexiko,2024,3,1564733000,829947000,2394680000
Mexiko,2024,4,1614993000,945311000,2560304000
Mexiko,2024,5,1446741000,730172000,2176913000
Mexiko,2024,6,1639064000,800366000,2439430000
Mexiko,2024,7,1554421000,779491000,2333912000
Mexiko,2024,8,1437121000,898372000,2335493000
Mexiko,2024,9,1426027000,805939000,2231966000
Mexiko,2024,10,1471180000,937766000,2408946000
Mexiko,2024,11,1159722000,741490000,1901212000
Mexiko,2024,12,1084279000,779878000,1864157000
Mongolei,2008,1,3688000,1659000,5347000
Mongolei,2008,2,7433000,1661000,9094000
Mongolei,2008,3,5642000,897000,6539000
Mongolei,2008,4,4831000,1577000,6408000
Mongolei,2008,5,3009000,1666000,4675000
Mongolei,2008,6,5103000,766000,5869000
Mongolei,2008,7,10678000,1243000,11921000
Mongolei,2008,8,5533000,659000,6192000
Mongolei,2008,9,7025000,1685000,8710000
Mongolei,2008,10,5384000,2170000,7554000
Mongolei,2008,11,5036000,515000,5551000
Mongolei,2008,12,2954000,893000,3847000
Mongolei,2009,1,1777000,2109000,3886000
Mongolei,2009,2,2052000,1414000,3466000
Mongolei,2009,3,4097000,1238000,5335000
Mongolei,2009,4,2438000,782000,3220000
Mongolei,2009,5,4859000,217000,5076000
Mongolei,2009,6,2402000,316000,2718000
Mongolei,2009,7,3042000,967000,4009000
Mongolei,2009,8,4084000,673000,4757000
Mongolei,2009,9,5092000,369000,5461000
Mongolei,2009,10,2759000,586000,3345000
Mongolei,2009,11,2916000,829000,3745000
Mongolei,2009,12,2929000,915000,3844000
Mongolei,2010,1,4555000,650000,5205000
Mongolei,2010,2,4721000,872000,5593000
Mongolei,2010,3,6591000,918000,7509000
Mongolei,2010,4,3677000,547000,4224000
Mongolei,2010,5,25370000,683000,26053000
Mongolei,2010,6,8321000,812000,9133000
Mongolei,2010,7,4695000,222000,4917000
Mongolei,2010,8,5600000,1242000,6842000
Mongolei,2010,9,6400000,292000,6692000
Mongolei,2010,10,4292000,724000,5016000
Mongolei,2010,11,8576000,487000,9063000
Mongolei,2010,12,5918000,1485000,7403000
Mongolei,2011,1,4467000,485000,4952000
Mongolei,2011,2,10269000,377000,10646000
Mongolei,2011,3,9783000,1254000,11037000
Mongolei,2011,4,19744000,2724000,22468000
Mongolei,2011,5,12710000,1404000,14114000
Mongolei,2011,6,16888000,424000,17312000
Mongolei,2011,7,18935000,321000,19256000
Mongolei,2011,8,10429000,1068000,11497000
Mongolei,2011,9,8024000,288000,8312000
Mongolei,2011,10,8672000,3243000,11915000
Mongolei,2011,11,11178000,1085000,12263000
Mongolei,2011,12,12910000,341000,13251000
Mongolei,2012,1,11456000,553000,12009000
Mongolei,2012,2,12582000,1150000,13732000
Mongolei,2012,3,10685000,303000,10988000
Mongolei,2012,4,9511000,1409000,10920000
Mongolei,2012,5,11253000,521000,11774000
Mongolei,2012,6,19005000,303000,19308000
Mongolei,2012,7,13774000,1597000,15371000
Mongolei,2012,8,17658000,1294000,18952000
Mongolei,2012,9,15433000,194000,15627000
Mongolei,2012,10,10911000,691000,11602000
Mongolei,2012,11,10075000,902000,10977000
Mongolei,2012,12,7677000,418000,8095000
Mongolei,2013,1,11612000,1008000,12620000
Mongolei,2013,2,8416000,48000,8464000
Mongolei,2013,3,11838000,1259000,13097000
Mongolei,2013,4,19638000,409000,20047000
Mongolei,2013,5,13320000,836000,14156000
Mongolei,2013,6,12116000,1384000,13500000
Mongolei,2013,7,16112000,1276000,17388000
Mongolei,2013,8,20516000,1384000,21900000
Mongolei,2013,9,19220000,1131000,20351000
Mongolei,2013,10,13885000,925000,14810000
Mongolei,2013,11,12994000,278000,13272000
Mongolei,2013,12,9777000,1093000,10870000
Mongolei,2014,1,6211000,1495000,7706000
Mongolei,2014,2,11525000,75000,11600000
Mongolei,2014,3,10048000,289000,10337000
Mongolei,2014,4,13281000,457000,13738000
Mongolei,2014,5,9283000,570000,9853000
Mongolei,2014,6,8023000,1215000,9238000
Mongolei,2014,7,12586000,838000,13424000
Mongolei,2014,8,9396000,2207000,11603000
Mongolei,2014,9,7998000,348000,8346000
Mongolei,2014,10,14882000,354000,15236000
Mongolei,2014,11,7172000,824000,7996000
Mongolei,2014,12,6460000,626000,7086000
Mongolei,2015,1,5739000,297000,6036000
Mongolei,2015,2,5964000,388000,6352000
Mongolei,2015,3,8060000,1635000,9695000
Mongolei,2015,4,8613000,3364000,11977000
Mongolei,2015,5,8730000,730000,9460000
Mongolei,2015,6,8843000,1437000,10280000
Mongolei,2015,7,7776000,1751000,9527000
Mongolei,2015,8,7500000,680000,8180000
Mongolei,2015,9,8952000,416000,9368000
Mongolei,2015,10,8978000,1373000,10351000
Mongolei,2015,11,7623000,682000,8305000
Mongolei,2015,12,5741000,386000,6127000
Mongolei,2016,1,4654000,1847000,6501000
Mongolei,2016,2,9155000,1003000,10158000
Mongolei,2016,3,7905000,106000,8011000
Mongolei,2016,4,8185000,911000,9096000
Mongolei,2016,5,8182000,566000,8748000
Mongolei,2016,6,7846000,2076000,9922000
Mongolei,2016,7,7138000,1420000,8558000
Mongolei,2016,8,9747000,997000,10744000
Mongolei,2016,9,11502000,729000,12231000
Mongolei,2016,10,8932000,1670000,10602000
Mongolei,2016,11,7747000,1577000,9324000
Mongolei,2016,12,7987000,837000,8824000
Mongolei,2017,1,7154000,743000,7897000
Mongolei,2017,2,9982000,282000,10264000
Mongolei,2017,3,9005000,482000,9487000
Mongolei,2017,4,7073000,823000,7896000
Mongolei,2017,5,9577000,574000,10151000
Mongolei,2017,6,7981000,917000,8898000
Mongolei,2017,7,8171000,652000,8823000
Mongolei,2017,8,10477000,1176000,11653000
Mongolei,2017,9,10196000,324000,10520000
Mongolei,2017,10,9294000,717000,10011000
Mongolei,2017,11,7563000,645000,8208000
Mongolei,2017,12,7036000,905000,7941000
Mongolei,2018,1,10207000,484000,10691000
Mongolei,2018,2,8660000,257000,8917000
Mongolei,2018,3,9831000,322000,10153000
Mongolei,2018,4,10057000,1167000,11224000
Mongolei,2018,5,9831000,1638000,11469000
Mongolei,2018,6,11312000,1032000,12344000
Mongolei,2018,7,14404000,827000,15231000
Mongolei,2018,8,14024000,658000,14682000
Mongolei,2018,9,10175000,642000,10817000
Mongolei,2018,10,13087000,838000,13925000
Mongolei,2018,11,15203000,1467000,16670000
Mongolei,2018,12,7468000,1296000,8764000
Mongolei,2019,1,12466000,1450000,13916000
Mongolei,2019,2,8595000,159000,8754000
Mongolei,2019,3,13776000,3240000,17016000
Mongolei,2019,4,10560000,651000,11211000
Mongolei,2019,5,12093000,3008000,15101000
Mongolei,2019,6,10460000,411000,10871000
Mongolei,2019,7,10802000,1690000,12492000
Mongolei,2019,8,18639000,867000,19506000
Mongolei,2019,9,11747000,1003000,12750000
Mongolei,2019,10,20361000,1029000,21390000
Mongolei,2019,11,9492000,2736000,12228000
Mongolei,2019,12,10111000,1405000,11516000
Mongolei,2020,1,8439000,1563000,10002000
Mongolei,2020,2,12123000,901000,13024000
Mongolei,2020,3,10149000,1871000,12020000
Mongolei,2020,4,18803000,68000,18871000
Mongolei,2020,5,11177000,506000,11683000
Mongolei,2020,6,9021000,337000,9358000
Mongolei,2020,7,13309000,654000,13963000
Mongolei,2020,8,14709000,3094000,17803000
Mongolei,2020,9,14661000,1292000,15953000
Mongolei,2020,10,12501000,949000,13450000
Mongolei,2020,11,17690000,1975000,19665000
Mongolei,2020,12,14454000,574000,15028000
Mongolei,2021,1,10643000,261000,10904000
Mongolei,2021,2,10059000,1031000,11090000
Mongolei,2021,3,14021000,732000,14753000
Mongolei,2021,4,11061000,796000,11857000
Mongolei,2021,5,11552000,352000,11904000
Mongolei,2021,6,14083000,450000,14533000
Mongolei,2021,7,11342000,655000,11997000
Mongolei,2021,8,16262000,1028000,17290000
Mongolei,2021,9,12403000,1719000,14122000
Mongolei,2021,10,12007000,1219000,13226000
Mongolei,2021,11,14946000,2106000,17052000
Mongolei,2021,12,10031000,746000,10777000
Mongolei,2022,1,10508000,2252000,12760000
Mongolei,2022,2,11691000,2493000,14184000
Mongolei,2022,3,13387000,444000,13831000
Mongolei,2022,4,13816000,1322000,15138000
Mongolei,2022,5,16822000,403000,17225000
Mongolei,2022,6,10487000,948000,11435000
Mongolei,2022,7,12939000,1812000,14751000
Mongolei,2022,8,15384000,1274000,16658000
Mongolei,2022,9,16224000,580000,16804000
Mongolei,2022,10,13053000,2483000,15536000
Mongolei,2022,11,14707000,2491000,17198000
Mongolei,2022,12,13955000,1018000,14973000
Mongolei,2023,1,13797000,2902000,16699000
Mongolei,2023,2,12530000,468000,12998000
Mongolei,2023,3,22951000,511000,23462000
Mongolei,2023,4,12725000,1085000,13810000
Mongolei,2023,5,14844000,1400000,16244000
Mongolei,2023,6,14305000,476000,14781000
Mongolei,2023,7,12951000,754000,13705000
Mongolei,2023,8,16109000,1549000,17658000
Mongolei,2023,9,12671000,2164000,14835000
Mongolei,2023,10,14781000,2386000,17167000
Mongolei,2023,11,16986000,1945000,18931000
Mongolei,2023,12,11948000,2464000,14412000
Mongolei,2024,1,10736000,591000,11327000
Mongolei,2024,2,13095000,1053000,14148000
Mongolei,2024,3,12475000,628000,13103000
Mongolei,2024,4,24416000,323000,24739000
Mongolei,2024,5,20290000,223000,20513000
Mongolei,2024,6,21065000,1046000,22111000
Mongolei,2024,7,20300000,301000,20601000
Mongolei,2024,8,24059000,287000,24346000
Mongolei,2024,9,14701000,699000,15400000
Mongolei,2024,10,25179000,487000,25666000
Mongolei,2024,11,21904000,1866000,23770000
Mongolei,2024,12,14672000,456000,15128000
Montenegro (ab 06/2005),2008,1,8514000,234000,8748000
Montenegro (ab 06/2005),2008,2,12928000,629000,13557000
Montenegro (ab 06/2005),2008,3,13156000,411000,13567000
Montenegro (ab 06/2005),2008,4,12870000,438000,13308000
Montenegro (ab 06/2005),2008,5,10318000,623000,10941000
Montenegro (ab 06/2005),2008,6,15984000,99000,16083000
Montenegro (ab 06/2005),2008,7,14083000,152000,14235000
Montenegro (ab 06/2005),2008,8,11686000,651000,12337000
Montenegro (ab 06/2005),2008,9,17862000,827000,18689000
Montenegro (ab 06/2005),2008,10,14468000,561000,15029000
Montenegro (ab 06/2005),2008,11,9072000,601000,9673000
Montenegro (ab 06/2005),2008,12,9389000,981000,10370000
Montenegro (ab 06/2005),2009,1,8119000,500000,8619000
Montenegro (ab 06/2005),2009,2,5780000,586000,6366000
Montenegro (ab 06/2005),2009,3,6955000,312000,7267000
Montenegro (ab 06/2005),2009,4,5469000,542000,6011000
Montenegro (ab 06/2005),2009,5,5923000,98000,6021000
Montenegro (ab 06/2005),2009,6,6367000,617000,6984000
Montenegro (ab 06/2005),2009,7,6502000,312000,6814000
Montenegro (ab 06/2005),2009,8,5255000,333000,5588000
Montenegro (ab 06/2005),2009,9,6662000,299000,6961000
Montenegro (ab 06/2005),2009,10,5238000,155000,5393000
Montenegro (ab 06/2005),2009,11,4829000,66000,4895000
Montenegro (ab 06/2005),2009,12,4233000,87000,4320000
Montenegro (ab 06/2005),2010,1,3194000,99000,3293000
Montenegro (ab 06/2005),2010,2,3763000,147000,3910000
Montenegro (ab 06/2005),2010,3,4592000,275000,4867000
Montenegro (ab 06/2005),2010,4,4661000,314000,4975000
Montenegro (ab 06/2005),2010,5,4837000,578000,5415000
Montenegro (ab 06/2005),2010,6,7438000,702000,8140000
Montenegro (ab 06/2005),2010,7,4509000,355000,4864000
Montenegro (ab 06/2005),2010,8,6807000,424000,7231000
Montenegro (ab 06/2005),2010,9,6306000,539000,6845000
Montenegro (ab 06/2005),2010,10,4611000,476000,5087000
Montenegro (ab 06/2005),2010,11,5010000,499000,5509000
Montenegro (ab 06/2005),2010,12,4515000,1086000,5601000
Montenegro (ab 06/2005),2011,1,3446000,335000,3781000
Montenegro (ab 06/2005),2011,2,3900000,528000,4428000
Montenegro (ab 06/2005),2011,3,5745000,437000,6182000
Montenegro (ab 06/2005),2011,4,4641000,556000,5197000
Montenegro (ab 06/2005),2011,5,5116000,388000,5504000
Montenegro (ab 06/2005),2011,6,6680000,698000,7378000
Montenegro (ab 06/2005),2011,7,6190000,715000,6905000
Montenegro (ab 06/2005),2011,8,5667000,1633000,7300000
Montenegro (ab 06/2005),2011,9,5126000,2024000,7150000
Montenegro (ab 06/2005),2011,10,4613000,5713000,10326000
Montenegro (ab 06/2005),2011,11,4653000,2574000,7227000
Montenegro (ab 06/2005),2011,12,5572000,1398000,6970000
Montenegro (ab 06/2005),2012,1,3666000,1368000,5034000
Montenegro (ab 06/2005),2012,2,4114000,1127000,5241000
Montenegro (ab 06/2005),2012,3,5586000,1918000,7504000
Montenegro (ab 06/2005),2012,4,5283000,3196000,8479000
Montenegro (ab 06/2005),2012,5,7224000,1937000,9161000
Montenegro (ab 06/2005),2012,6,9312000,597000,9909000
Montenegro (ab 06/2005),2012,7,8255000,273000,8528000
Montenegro (ab 06/2005),2012,8,6861000,2722000,9583000
Montenegro (ab 06/2005),2012,9,5006000,10555000,15561000
Montenegro (ab 06/2005),2012,10,5729000,5626000,11355000
Montenegro (ab 06/2005),2012,11,6225000,2078000,8303000
Montenegro (ab 06/2005),2012,12,4908000,887000,5795000
Montenegro (ab 06/2005),2013,1,4555000,5457000,10012000
Montenegro (ab 06/2005),2013,2,5198000,2303000,7501000
Montenegro (ab 06/2005),2013,3,5868000,1943000,7811000
Montenegro (ab 06/2005),2013,4,7071000,1985000,9056000
Montenegro (ab 06/2005),2013,5,6789000,2408000,9197000
Montenegro (ab 06/2005),2013,6,6698000,2053000,8751000
Montenegro (ab 06/2005),2013,7,7114000,2731000,9845000
Montenegro (ab 06/2005),2013,8,7835000,4213000,12048000
Montenegro (ab 06/2005),2013,9,6754000,1495000,8249000
Montenegro (ab 06/2005),2013,10,6200000,3780000,9980000
Montenegro (ab 06/2005),2013,11,5961000,6038000,11999000
Montenegro (ab 06/2005),2013,12,5083000,739000,5822000
Montenegro (ab 06/2005),2014,1,4472000,2184000,6656000
Montenegro (ab 06/2005),2014,2,6037000,1460000,7497000
Montenegro (ab 06/2005),2014,3,5735000,3702000,9437000
Montenegro (ab 06/2005),2014,4,6896000,1371000,8267000
Montenegro (ab 06/2005),2014,5,5829000,1611000,7440000
Montenegro (ab 06/2005),2014,6,7243000,2765000,10008000
Montenegro (ab 06/2005),2014,7,8902000,3730000,12632000
Montenegro (ab 06/2005),2014,8,6275000,1131000,7406000
Montenegro (ab 06/2005),2014,9,6473000,756000,7229000
Montenegro (ab 06/2005),2014,10,6541000,1303000,7844000
Montenegro (ab 06/2005),2014,11,6707000,1298000,8005000
Montenegro (ab 06/2005),2014,12,6546000,712000,7258000
Montenegro (ab 06/2005),2015,1,3915000,812000,4727000
Montenegro (ab 06/2005),2015,2,4406000,1435000,5841000
Montenegro (ab 06/2005),2015,3,6875000,2065000,8940000
Montenegro (ab 06/2005),2015,4,6397000,2246000,8643000
Montenegro (ab 06/2005),2015,5,6654000,1232000,7886000
Montenegro (ab 06/2005),2015,6,7795000,2095000,9890000
Montenegro (ab 06/2005),2015,7,8082000,1914000,9996000
Montenegro (ab 06/2005),2015,8,5695000,1875000,7570000
Montenegro (ab 06/2005),2015,9,8039000,1162000,9201000
Montenegro (ab 06/2005),2015,10,5824000,1608000,7432000
Montenegro (ab 06/2005),2015,11,7041000,1570000,8611000
Montenegro (ab 06/2005),2015,12,5795000,1614000,7409000
Montenegro (ab 06/2005),2016,1,5002000,1233000,6235000
Montenegro (ab 06/2005),2016,2,5568000,2260000,7828000
Montenegro (ab 06/2005),2016,3,7287000,1087000,8374000
Montenegro (ab 06/2005),2016,4,36399000,1015000,37414000
Montenegro (ab 06/2005),2016,5,13913000,1020000,14933000
Montenegro (ab 06/2005),2016,6,12241000,779000,13020000
Montenegro (ab 06/2005),2016,7,12302000,731000,13033000
Montenegro (ab 06/2005),2016,8,12175000,990000,13165000
Montenegro (ab 06/2005),2016,9,7382000,1366000,8748000
Montenegro (ab 06/2005),2016,10,7600000,806000,8406000
Montenegro (ab 06/2005),2016,11,7354000,952000,8306000
Montenegro (ab 06/2005),2016,12,7386000,853000,8239000
Montenegro (ab 06/2005),2017,1,5087000,1486000,6573000
Montenegro (ab 06/2005),2017,2,7650000,716000,8366000
Montenegro (ab 06/2005),2017,3,7586000,994000,8580000
Montenegro (ab 06/2005),2017,4,7632000,1111000,8743000
Montenegro (ab 06/2005),2017,5,9005000,901000,9906000
Montenegro (ab 06/2005),2017,6,11989000,1306000,13295000
Montenegro (ab 06/2005),2017,7,8829000,1058000,9887000
Montenegro (ab 06/2005),2017,8,9414000,1726000,11140000
Montenegro (ab 06/2005),2017,9,10944000,1226000,12170000
Montenegro (ab 06/2005),2017,10,8783000,1483000,10266000
Montenegro (ab 06/2005),2017,11,12327000,938000,13265000
Montenegro (ab 06/2005),2017,12,8096000,541000,8637000
Montenegro (ab 06/2005),2018,1,5614000,1337000,6951000
Montenegro (ab 06/2005),2018,2,7159000,1291000,8450000
Montenegro (ab 06/2005),2018,3,10393000,1791000,12184000
Montenegro (ab 06/2005),2018,4,10738000,954000,11692000
Montenegro (ab 06/2005),2018,5,11258000,1811000,13069000
Montenegro (ab 06/2005),2018,6,13544000,1381000,14925000
Montenegro (ab 06/2005),2018,7,11702000,983000,12685000
Montenegro (ab 06/2005),2018,8,15009000,983000,15992000
Montenegro (ab 06/2005),2018,9,9570000,1690000,11260000
Montenegro (ab 06/2005),2018,10,11392000,2624000,14016000
Montenegro (ab 06/2005),2018,11,11376000,2008000,13384000
Montenegro (ab 06/2005),2018,12,8023000,1489000,9512000
Montenegro (ab 06/2005),2019,1,9057000,1999000,11056000
Montenegro (ab 06/2005),2019,2,9375000,1346000,10721000
Montenegro (ab 06/2005),2019,3,8295000,1547000,9842000
Montenegro (ab 06/2005),2019,4,8791000,1390000,10181000
Montenegro (ab 06/2005),2019,5,11339000,1229000,12568000
Montenegro (ab 06/2005),2019,6,8993000,1312000,10305000
Montenegro (ab 06/2005),2019,7,10938000,2087000,13025000
Montenegro (ab 06/2005),2019,8,9452000,2051000,11503000
Montenegro (ab 06/2005),2019,9,9915000,1592000,11507000
Montenegro (ab 06/2005),2019,10,11738000,2099000,13837000
Montenegro (ab 06/2005),2019,11,13081000,1928000,15009000
Montenegro (ab 06/2005),2019,12,8463000,1038000,9501000
Montenegro (ab 06/2005),2020,1,6399000,1803000,8202000
Montenegro (ab 06/2005),2020,2,8849000,1654000,10503000
Montenegro (ab 06/2005),2020,3,11195000,1621000,12816000
Montenegro (ab 06/2005),2020,4,4650000,2418000,7068000
Montenegro (ab 06/2005),2020,5,5794000,3297000,9091000
Montenegro (ab 06/2005),2020,6,7517000,2910000,10427000
Montenegro (ab 06/2005),2020,7,11240000,2142000,13382000
Montenegro (ab 06/2005),2020,8,10995000,2089000,13084000
Montenegro (ab 06/2005),2020,9,8421000,2187000,10608000
Montenegro (ab 06/2005),2020,10,10029000,2161000,12190000
Montenegro (ab 06/2005),2020,11,8783000,2615000,11398000
Montenegro (ab 06/2005),2020,12,9396000,2201000,11597000
Montenegro (ab 06/2005),2021,1,6466000,1458000,7924000
Montenegro (ab 06/2005),2021,2,8430000,1623000,10053000
Montenegro (ab 06/2005),2021,3,10569000,2434000,13003000
Montenegro (ab 06/2005),2021,4,9894000,1717000,11611000
Montenegro (ab 06/2005),2021,5,9273000,2231000,11504000
Montenegro (ab 06/2005),2021,6,10166000,1908000,12074000
Montenegro (ab 06/2005),2021,7,9049000,2639000,11688000
Montenegro (ab 06/2005),2021,8,9135000,2169000,11304000
Montenegro (ab 06/2005),2021,9,10778000,2269000,13047000
Montenegro (ab 06/2005),2021,10,9001000,1799000,10800000
Montenegro (ab 06/2005),2021,11,9383000,2475000,11858000
Montenegro (ab 06/2005),2021,12,9019000,2230000,11249000
Montenegro (ab 06/2005),2022,1,6815000,1801000,8616000
Montenegro (ab 06/2005),2022,2,7992000,2611000,10603000
Montenegro (ab 06/2005),2022,3,10335000,2676000,13011000
Montenegro (ab 06/2005),2022,4,9374000,2234000,11608000
Montenegro (ab 06/2005),2022,5,10669000,2550000,13219000
Montenegro (ab 06/2005),2022,6,11325000,2521000,13846000
Montenegro (ab 06/2005),2022,7,10928000,1453000,12381000
Montenegro (ab 06/2005),2022,8,10997000,3135000,14132000
Montenegro (ab 06/2005),2022,9,12264000,2570000,14834000
Montenegro (ab 06/2005),2022,10,11906000,2139000,14045000
Montenegro (ab 06/2005),2022,11,15792000,2261000,18053000
Montenegro (ab 06/2005),2022,12,15090000,3394000,18484000
Montenegro (ab 06/2005),2023,1,11814000,1772000,13586000
Montenegro (ab 06/2005),2023,2,12925000,2746000,15671000
Montenegro (ab 06/2005),2023,3,17188000,2462000,19650000
Montenegro (ab 06/2005),2023,4,12839000,2589000,15428000
Montenegro (ab 06/2005),2023,5,13257000,2329000,15586000
Montenegro (ab 06/2005),2023,6,17638000,3283000,20921000
Montenegro (ab 06/2005),2023,7,13879000,2656000,16535000
Montenegro (ab 06/2005),2023,8,17616000,2636000,20252000
Montenegro (ab 06/2005),2023,9,14757000,2830000,17587000
Montenegro (ab 06/2005),2023,10,14946000,3209000,18155000
Montenegro (ab 06/2005),2023,11,16642000,4682000,21324000
Montenegro (ab 06/2005),2023,12,15676000,4356000,20032000
Montenegro (ab 06/2005),2024,1,16060000,1702000,17762000
Montenegro (ab 06/2005),2024,2,16556000,4669000,21225000
Montenegro (ab 06/2005),2024,3,18704000,2677000,21381000
Montenegro (ab 06/2005),2024,4,19509000,4003000,23512000
Montenegro (ab 06/2005),2024,5,15779000,4254000,20033000
Montenegro (ab 06/2005),2024,6,18190000,1773000,19963000
Montenegro (ab 06/2005),2024,7,17764000,2447000,20211000
Montenegro (ab 06/2005),2024,8,16283000,2050000,18333000
Montenegro (ab 06/2005),2024,9,18102000,1841000,19943000
Montenegro (ab 06/2005),2024,10,19763000,2335000,22098000
Montenegro (ab 06/2005),2024,11,25267000,3456000,28723000
Montenegro (ab 06/2005),2024,12,19066000,3805000,22871000
Montserrat (ab 1995),2008,1,17000,0,17000
Montserrat (ab 1995),2008,2,15000,11000,26000
Montserrat (ab 1995),2008,3,90000,0,90000
Montserrat (ab 1995),2008,4,12000,0,12000
Montserrat (ab 1995),2008,5,195000,0,195000
Montserrat (ab 1995),2008,6,3000,1000,4000
Montserrat (ab 1995),2008,7,8000,0,8000
Montserrat (ab 1995),2008,8,18000,4000,22000
Montserrat (ab 1995),2008,9,0,6000,6000
Montserrat (ab 1995),2008,10,0,6000,6000
Montserrat (ab 1995),2008,11,14000,0,14000
Montserrat (ab 1995),2008,12,10000,1000,11000
Montserrat (ab 1995),2009,1,333000,11000,344000
Montserrat (ab 1995),2009,2,42000,2000,44000
Montserrat (ab 1995),2009,3,42000,5000,47000
Montserrat (ab 1995),2009,4,20000,10000,30000
Montserrat (ab 1995),2009,5,19000,5000,24000
Montserrat (ab 1995),2009,6,10000,0,10000
Montserrat (ab 1995),2009,7,13000,0,13000
Montserrat (ab 1995),2009,8,7000,0,7000
Montserrat (ab 1995),2009,9,2000,0,2000
Montserrat (ab 1995),2009,10,5000,0,5000
Montserrat (ab 1995),2009,11,20000,0,20000
Montserrat (ab 1995),2009,12,0,0,0
Montserrat (ab 1995),2010,1,0,0,0
Montserrat (ab 1995),2010,2,0,0,0
Montserrat (ab 1995),2010,3,4000,0,4000
Montserrat (ab 1995),2010,4,1000,0,1000
Montserrat (ab 1995),2010,5,2000,0,2000
Montserrat (ab 1995),2010,6,0,0,0
Montserrat (ab 1995),2010,7,0,0,0
Montserrat (ab 1995),2010,8,0,0,0
Montserrat (ab 1995),2010,9,0,11000,11000
Montserrat (ab 1995),2010,10,0,0,0
Montserrat (ab 1995),2010,11,0,1000,1000
Montserrat (ab 1995),2010,12,0,0,0
Montserrat (ab 1995),2011,1,9000,0,9000
Montserrat (ab 1995),2011,2,0,0,0
Montserrat (ab 1995),2011,3,0,0,0
Montserrat (ab 1995),2011,4,0,0,0
Montserrat (ab 1995),2011,5,0,0,0
Montserrat (ab 1995),2011,6,0,0,0
Montserrat (ab 1995),2011,7,5000,0,5000
Montserrat (ab 1995),2011,8,46000,0,46000
Montserrat (ab 1995),2011,9,8000,0,8000
Montserrat (ab 1995),2011,10,342000,0,342000
Montserrat (ab 1995),2011,11,3000,0,3000
Montserrat (ab 1995),2011,12,0,0,0
Montserrat (ab 1995),2012,1,4000,3000,7000
Montserrat (ab 1995),2012,2,2000,0,2000
Montserrat (ab 1995),2012,3,1000,0,1000
Montserrat (ab 1995),2012,4,30000,0,30000
Montserrat (ab 1995),2012,5,8000,0,8000
Montserrat (ab 1995),2012,6,99000,0,99000
Montserrat (ab 1995),2012,7,12000,0,12000
Montserrat (ab 1995),2012,8,0,0,0
Montserrat (ab 1995),2012,9,9000,0,9000
Montserrat (ab 1995),2012,10,0,0,0
Montserrat (ab 1995),2012,11,2000,0,2000
Montserrat (ab 1995),2012,12,0,0,0
Montserrat (ab 1995),2013,1,4000,0,4000
Montserrat (ab 1995),2013,2,9000,0,9000
Montserrat (ab 1995),2013,3,6000,0,6000
Montserrat (ab 1995),2013,4,0,0,0
Montserrat (ab 1995),2013,5,0,0,0
Montserrat (ab 1995),2013,6,0,0,0
Montserrat (ab 1995),2013,7,38000,0,38000
Montserrat (ab 1995),2013,8,4000,0,4000
Montserrat (ab 1995),2013,9,2000,0,2000
Montserrat (ab 1995),2013,10,2000,0,2000
Montserrat (ab 1995),2013,11,0,0,0
Montserrat (ab 1995),2013,12,5000,0,5000
Montserrat (ab 1995),2014,1,15000,0,15000
Montserrat (ab 1995),2014,2,1000,19000,20000
Montserrat (ab 1995),2014,3,0,0,0
Montserrat (ab 1995),2014,4,8000,0,8000
Montserrat (ab 1995),2014,5,0,0,0
Montserrat (ab 1995),2014,6,4000,0,4000
Montserrat (ab 1995),2014,7,2000,0,2000
Montserrat (ab 1995),2014,8,5000,0,5000
Montserrat (ab 1995),2014,9,60000,0,60000
Montserrat (ab 1995),2014,10,7000,0,7000
Montserrat (ab 1995),2014,11,136000,0,136000
Montserrat (ab 1995),2014,12,0,0,0
Montserrat (ab 1995),2015,1,5000,0,5000
Montserrat (ab 1995),2015,2,0,0,0
Montserrat (ab 1995),2015,3,0,0,0
Montserrat (ab 1995),2015,4,1000,0,1000
Montserrat (ab 1995),2015,5,2000,0,2000
Montserrat (ab 1995),2015,6,5000,0,5000
Montserrat (ab 1995),2015,7,16000,0,16000
Montserrat (ab 1995),2015,8,0,0,0
Montserrat (ab 1995),2015,9,3000,0,3000
Montserrat (ab 1995),2015,10,0,0,0
Montserrat (ab 1995),2015,11,4000,0,4000
Montserrat (ab 1995),2015,12,0,0,0
Montserrat (ab 1995),2016,1,0,0,0
Montserrat (ab 1995),2016,2,4000,0,4000
Montserrat (ab 1995),2016,3,11000,0,11000
Montserrat (ab 1995),2016,4,0,0,0
Montserrat (ab 1995),2016,5,4000,0,4000
Montserrat (ab 1995),2016,6,0,0,0
Montserrat (ab 1995),2016,7,3000,0,3000
Montserrat (ab 1995),2016,8,0,0,0
Montserrat (ab 1995),2016,9,2000,0,2000
Montserrat (ab 1995),2016,10,2000,0,2000
Montserrat (ab 1995),2016,11,3000,0,3000
Montserrat (ab 1995),2016,12,4000,0,4000
Montserrat (ab 1995),2017,1,2000,0,2000
Montserrat (ab 1995),2017,2,0,0,0
Montserrat (ab 1995),2017,3,25000,0,25000
Montserrat (ab 1995),2017,4,0,0,0
Montserrat (ab 1995),2017,5,13000,0,13000
Montserrat (ab 1995),2017,6,2000,0,2000
Montserrat (ab 1995),2017,7,0,0,0
Montserrat (ab 1995),2017,8,3000,0,3000
Montserrat (ab 1995),2017,9,4000,0,4000
Montserrat (ab 1995),2017,10,0,0,0
Montserrat (ab 1995),2017,11,5000,0,5000
Montserrat (ab 1995),2017,12,0,0,0
Montserrat (ab 1995),2018,1,3000,0,3000
Montserrat (ab 1995),2018,2,1000,0,1000
Montserrat (ab 1995),2018,3,0,0,0
Montserrat (ab 1995),2018,4,9000,0,9000
Montserrat (ab 1995),2018,5,13000,0,13000
Montserrat (ab 1995),2018,6,3000,0,3000
Montserrat (ab 1995),2018,7,2000,0,2000
Montserrat (ab 1995),2018,8,0,0,0
Montserrat (ab 1995),2018,9,8000,0,8000
Montserrat (ab 1995),2018,10,4000,0,4000
Montserrat (ab 1995),2018,11,9000,1000,10000
Montserrat (ab 1995),2018,12,36000,0,36000
Montserrat (ab 1995),2019,1,1000,0,1000
Montserrat (ab 1995),2019,2,8000,0,8000
Montserrat (ab 1995),2019,3,5000,0,5000
Montserrat (ab 1995),2019,4,9000,0,9000
Montserrat (ab 1995),2019,5,8000,0,8000
Montserrat (ab 1995),2019,6,4000,1000,5000
Montserrat (ab 1995),2019,7,0,0,0
Montserrat (ab 1995),2019,8,22000,0,22000
Montserrat (ab 1995),2019,9,12000,0,12000
Montserrat (ab 1995),2019,10,12000,0,12000
Montserrat (ab 1995),2019,11,12000,0,12000
Montserrat (ab 1995),2019,12,8000,0,8000
Montserrat (ab 1995),2020,1,6000,0,6000
Montserrat (ab 1995),2020,2,0,0,0
Montserrat (ab 1995),2020,3,0,0,0
Montserrat (ab 1995),2020,4,0,0,0
Montserrat (ab 1995),2020,5,24000,0,24000
Montserrat (ab 1995),2020,6,0,0,0
Montserrat (ab 1995),2020,7,74000,0,74000
Montserrat (ab 1995),2020,8,10000,0,10000
Montserrat (ab 1995),2020,9,11000,6000,17000
Montserrat (ab 1995),2020,10,31000,0,31000
Montserrat (ab 1995),2020,11,0,0,0
Montserrat (ab 1995),2020,12,230000,0,230000
Montserrat (ab 1995),2021,1,1000,0,1000
Montserrat (ab 1995),2021,2,3000,0,3000
Montserrat (ab 1995),2021,3,0,0,0
Montserrat (ab 1995),2021,4,11000,0,11000
Montserrat (ab 1995),2021,5,0,0,0
Montserrat (ab 1995),2021,6,21000,0,21000
Montserrat (ab 1995),2021,7,0,19000,19000
Montserrat (ab 1995),2021,8,1000,0,1000
Montserrat (ab 1995),2021,9,61000,0,61000
Montserrat (ab 1995),2021,10,4000,7000,11000
Montserrat (ab 1995),2021,11,11000,0,11000
Montserrat (ab 1995),2021,12,2000,0,2000
Montserrat (ab 1995),2022,1,0,1000,1000
Montserrat (ab 1995),2022,2,7000,0,7000
Montserrat (ab 1995),2022,3,7000,28000,35000
Montserrat (ab 1995),2022,4,10000,0,10000
Montserrat (ab 1995),2022,5,2000,0,2000
Montserrat (ab 1995),2022,6,2000,0,2000
Montserrat (ab 1995),2022,7,35000,0,35000
Montserrat (ab 1995),2022,8,0,0,0
Montserrat (ab 1995),2022,9,0,0,0
Montserrat (ab 1995),2022,10,33000,0,33000
Montserrat (ab 1995),2022,11,1000,0,1000
Montserrat (ab 1995),2022,12,5000,0,5000
Montserrat (ab 1995),2023,1,1000,0,1000
Montserrat (ab 1995),2023,2,0,0,0
Montserrat (ab 1995),2023,3,22000,0,22000
Montserrat (ab 1995),2023,4,0,0,0
Montserrat (ab 1995),2023,5,7000,0,7000
Montserrat (ab 1995),2023,6,30000,0,30000
Montserrat (ab 1995),2023,7,0,0,0
Montserrat (ab 1995),2023,8,5000,0,5000
Montserrat (ab 1995),2023,9,0,0,0
Montserrat (ab 1995),2023,10,5000,0,5000
Montserrat (ab 1995),2023,11,0,0,0
Montserrat (ab 1995),2023,12,0,0,0
Montserrat (ab 1995),2024,1,0,0,0
Montserrat (ab 1995),2024,2,0,0,0
Montserrat (ab 1995),2024,3,0,0,0
Montserrat (ab 1995),2024,4,7000,0,7000
Montserrat (ab 1995),2024,5,0,0,0
Montserrat (ab 1995),2024,6,3000,0,3000
Montserrat (ab 1995),2024,7,0,0,0
Montserrat (ab 1995),2024,8,2000,1000,3000
Montserrat (ab 1995),2024,9,1000,0,1000
Montserrat (ab 1995),2024,10,21000,0,21000
Montserrat (ab 1995),2024,11,36000,0,36000
Montserrat (ab 1995),2024,12,0,0,0
Mosambik,2008,1,1652000,6537000,8189000
Mosambik,2008,2,1930000,6332000,8262000
Mosambik,2008,3,3382000,1921000,5303000
Mosambik,2008,4,6205000,9089000,15294000
Mosambik,2008,5,4637000,4558000,9195000
Mosambik,2008,6,1625000,10533000,12158000
Mosambik,2008,7,2952000,8833000,11785000
Mosambik,2008,8,7306000,8160000,15466000
Mosambik,2008,9,2114000,6361000,8475000
Mosambik,2008,10,5695000,6365000,12060000
Mosambik,2008,11,1771000,12363000,14134000
Mosambik,2008,12,1977000,3130000,5107000
Mosambik,2009,1,2129000,4634000,6763000
Mosambik,2009,2,2375000,2537000,4912000
Mosambik,2009,3,11943000,3782000,15725000
Mosambik,2009,4,12365000,5585000,17950000
Mosambik,2009,5,16496000,4281000,20777000
Mosambik,2009,6,10115000,3335000,13450000
Mosambik,2009,7,11183000,5978000,17161000
Mosambik,2009,8,6409000,6251000,12660000
Mosambik,2009,9,7481000,7794000,15275000
Mosambik,2009,10,2075000,10354000,12429000
Mosambik,2009,11,4068000,7887000,11955000
Mosambik,2009,12,6206000,8056000,14262000
Mosambik,2010,1,3669000,9561000,13230000
Mosambik,2010,2,2370000,9098000,11468000
Mosambik,2010,3,8828000,21605000,30433000
Mosambik,2010,4,5779000,11971000,17750000
Mosambik,2010,5,10534000,10393000,20927000
Mosambik,2010,6,8460000,15215000,23675000
Mosambik,2010,7,2691000,12547000,15238000
Mosambik,2010,8,2187000,11986000,14173000
Mosambik,2010,9,10777000,10094000,20871000
Mosambik,2010,10,2346000,11705000,14051000
Mosambik,2010,11,2722000,10578000,13300000
Mosambik,2010,12,2119000,5933000,8052000
Mosambik,2011,1,2813000,6362000,9175000
Mosambik,2011,2,2344000,12271000,14615000
Mosambik,2011,3,2140000,13482000,15622000
Mosambik,2011,4,2048000,15209000,17257000
Mosambik,2011,5,5869000,12280000,18149000
Mosambik,2011,6,2788000,7443000,10231000
Mosambik,2011,7,2091000,12105000,14196000
Mosambik,2011,8,3989000,12529000,16518000
Mosambik,2011,9,11987000,8637000,20624000
Mosambik,2011,10,3506000,9295000,12801000
Mosambik,2011,11,14378000,12942000,27320000
Mosambik,2011,12,3322000,5935000,9257000
Mosambik,2012,1,2402000,8972000,11374000
Mosambik,2012,2,3414000,7658000,11072000
Mosambik,2012,3,6894000,9370000,16264000
Mosambik,2012,4,2041000,17000000,19041000
Mosambik,2012,5,3114000,19777000,22891000
Mosambik,2012,6,4138000,10938000,15076000
Mosambik,2012,7,5924000,9219000,15143000
Mosambik,2012,8,5884000,11189000,17073000
Mosambik,2012,9,16037000,8625000,24662000
Mosambik,2012,10,3851000,8154000,12005000
Mosambik,2012,11,5764000,9320000,15084000
Mosambik,2012,12,4054000,4716000,8770000
Mosambik,2013,1,4716000,8378000,13094000
Mosambik,2013,2,3416000,58359000,61775000
Mosambik,2013,3,3704000,6412000,10116000
Mosambik,2013,4,5980000,11239000,17219000
Mosambik,2013,5,4312000,3957000,8269000
Mosambik,2013,6,14892000,11551000,26443000
Mosambik,2013,7,17534000,6885000,24419000
Mosambik,2013,8,10670000,7137000,17807000
Mosambik,2013,9,11683000,9868000,21551000
Mosambik,2013,10,4009000,14048000,18057000
Mosambik,2013,11,4167000,7879000,12046000
Mosambik,2013,12,6570000,7834000,14404000
Mosambik,2014,1,4301000,12298000,16599000
Mosambik,2014,2,20696000,8715000,29411000
Mosambik,2014,3,19822000,10225000,30047000
Mosambik,2014,4,7691000,9168000,16859000
Mosambik,2014,5,5458000,7777000,13235000
Mosambik,2014,6,5165000,12607000,17772000
Mosambik,2014,7,7956000,13363000,21319000
Mosambik,2014,8,5278000,5956000,11234000
Mosambik,2014,9,4027000,9290000,13317000
Mosambik,2014,10,5667000,13692000,19359000
Mosambik,2014,11,3642000,10696000,14338000
Mosambik,2014,12,2699000,7008000,9707000
Mosambik,2015,1,4024000,7923000,11947000
Mosambik,2015,2,5548000,12181000,17729000
Mosambik,2015,3,12398000,12909000,25307000
Mosambik,2015,4,10487000,8148000,18635000
Mosambik,2015,5,3523000,9562000,13085000
Mosambik,2015,6,3892000,11704000,15596000
Mosambik,2015,7,16062000,20897000,36959000
Mosambik,2015,8,4582000,20176000,24758000
Mosambik,2015,9,4087000,13437000,17524000
Mosambik,2015,10,31680000,12314000,43994000
Mosambik,2015,11,17704000,12261000,29965000
Mosambik,2015,12,7190000,8608000,15798000
Mosambik,2016,1,5466000,12207000,17673000
Mosambik,2016,2,1313000,10203000,11516000
Mosambik,2016,3,9322000,12770000,22092000
Mosambik,2016,4,5610000,11904000,17514000
Mosambik,2016,5,4021000,11349000,15370000
Mosambik,2016,6,4798000,8571000,13369000
Mosambik,2016,7,4356000,7267000,11623000
Mosambik,2016,8,3522000,12662000,16184000
Mosambik,2016,9,3963000,10488000,14451000
Mosambik,2016,10,5808000,5958000,11766000
Mosambik,2016,11,5710000,19463000,25173000
Mosambik,2016,12,1799000,13490000,15289000
Mosambik,2017,1,2974000,12806000,15780000
Mosambik,2017,2,3720000,29115000,32835000
Mosambik,2017,3,10465000,11269000,21734000
Mosambik,2017,4,1620000,16325000,17945000
Mosambik,2017,5,2242000,18613000,20855000
Mosambik,2017,6,10665000,22895000,33560000
Mosambik,2017,7,4489000,18763000,23252000
Mosambik,2017,8,2369000,18676000,21045000
Mosambik,2017,9,2423000,35144000,37567000
Mosambik,2017,10,2306000,13686000,15992000
Mosambik,2017,11,9990000,21588000,31578000
Mosambik,2017,12,3385000,22779000,26164000
Mosambik,2018,1,8562000,28639000,37201000
Mosambik,2018,2,10705000,23366000,34071000
Mosambik,2018,3,9667000,22909000,32576000
Mosambik,2018,4,3571000,15835000,19406000
Mosambik,2018,5,7018000,17298000,24316000
Mosambik,2018,6,9148000,24081000,33229000
Mosambik,2018,7,11009000,26345000,37354000
Mosambik,2018,8,5786000,15245000,21031000
Mosambik,2018,9,2678000,14274000,16952000
Mosambik,2018,10,4828000,20576000,25404000
Mosambik,2018,11,17248000,15124000,32372000
Mosambik,2018,12,14736000,13217000,27953000
Mosambik,2019,1,10006000,32439000,42445000
Mosambik,2019,2,9186000,41361000,50547000
Mosambik,2019,3,4873000,29915000,34788000
Mosambik,2019,4,10075000,32711000,42786000
Mosambik,2019,5,17879000,14016000,31895000
Mosambik,2019,6,5103000,17628000,22731000
Mosambik,2019,7,5591000,16348000,21939000
Mosambik,2019,8,7360000,9931000,17291000
Mosambik,2019,9,7857000,17838000,25695000
Mosambik,2019,10,4210000,22878000,27088000
Mosambik,2019,11,10300000,19976000,30276000
Mosambik,2019,12,5601000,10627000,16228000
Mosambik,2020,1,5521000,26841000,32362000
Mosambik,2020,2,5769000,14553000,20322000
Mosambik,2020,3,4963000,14424000,19387000
Mosambik,2020,4,2224000,9038000,11262000
Mosambik,2020,5,4508000,11990000,16498000
Mosambik,2020,6,4984000,9369000,14353000
Mosambik,2020,7,7774000,6423000,14197000
Mosambik,2020,8,9003000,3873000,12876000
Mosambik,2020,9,2821000,5824000,8645000
Mosambik,2020,10,4166000,11734000,15900000
Mosambik,2020,11,5285000,13845000,19130000
Mosambik,2020,12,4311000,6820000,11131000
Mosambik,2021,1,3175000,10493000,13668000
Mosambik,2021,2,7192000,9015000,16207000
Mosambik,2021,3,5605000,13767000,19372000
Mosambik,2021,4,3895000,10941000,14836000
Mosambik,2021,5,2794000,15724000,18518000
Mosambik,2021,6,3918000,17595000,21513000
Mosambik,2021,7,4067000,11102000,15169000
Mosambik,2021,8,3293000,19809000,23102000
Mosambik,2021,9,3840000,12736000,16576000
Mosambik,2021,10,3164000,16603000,19767000
Mosambik,2021,11,5615000,13813000,19428000
Mosambik,2021,12,5957000,10711000,16668000
Mosambik,2022,1,2688000,11350000,14038000
Mosambik,2022,2,7114000,10072000,17186000
Mosambik,2022,3,4491000,10350000,14841000
Mosambik,2022,4,5743000,17839000,23582000
Mosambik,2022,5,4420000,10239000,14659000
Mosambik,2022,6,3204000,18138000,21342000
Mosambik,2022,7,2968000,13363000,16331000
Mosambik,2022,8,2861000,14183000,17044000
Mosambik,2022,9,4089000,10957000,15046000
Mosambik,2022,10,2331000,20620000,22951000
Mosambik,2022,11,4439000,12569000,17008000
Mosambik,2022,12,5376000,13756000,19132000
Mosambik,2023,1,17538000,9486000,27024000
Mosambik,2023,2,8023000,13032000,21055000
Mosambik,2023,3,10775000,12957000,23732000
Mosambik,2023,4,17445000,11628000,29073000
Mosambik,2023,5,5460000,18926000,24386000
Mosambik,2023,6,11873000,12434000,24307000
Mosambik,2023,7,3593000,16785000,20378000
Mosambik,2023,8,8646000,16187000,24833000
Mosambik,2023,9,4569000,12284000,16853000
Mosambik,2023,10,12953000,10428000,23381000
Mosambik,2023,11,6399000,7850000,14249000
Mosambik,2023,12,8912000,14249000,23161000
Mosambik,2024,1,3352000,12592000,15944000
Mosambik,2024,2,3496000,12576000,16072000
Mosambik,2024,3,6309000,16426000,22735000
Mosambik,2024,4,3775000,15783000,19558000
Mosambik,2024,5,11175000,20994000,32169000
Mosambik,2024,6,5976000,12224000,18200000
Mosambik,2024,7,9076000,16357000,25433000
Mosambik,2024,8,5682000,12155000,17837000
Mosambik,2024,9,4624000,18874000,23498000
Mosambik,2024,10,3205000,14137000,17342000
Mosambik,2024,11,3026000,13439000,16465000
Mosambik,2024,12,3397000,9391000,12788000
Myanmar,2008,1,2421000,7169000,9590000
Myanmar,2008,2,2137000,7160000,9297000
Myanmar,2008,3,2902000,9314000,12216000
Myanmar,2008,4,3717000,5418000,9135000
Myanmar,2008,5,1398000,4810000,6208000
Myanmar,2008,6,1548000,1802000,3350000
Myanmar,2008,7,2363000,6139000,8502000
Myanmar,2008,8,2581000,8170000,10751000
Myanmar,2008,9,7644000,8061000,15705000
Myanmar,2008,10,2560000,5143000,7703000
Myanmar,2008,11,6755000,3916000,10671000
Myanmar,2008,12,1455000,2083000,3538000
Myanmar,2009,1,4259000,4715000,8974000
Myanmar,2009,2,838000,7214000,8052000
Myanmar,2009,3,3796000,5720000,9516000
Myanmar,2009,4,2228000,4956000,7184000
Myanmar,2009,5,3950000,3849000,7799000
Myanmar,2009,6,2992000,3246000,6238000
Myanmar,2009,7,5705000,5316000,11021000
Myanmar,2009,8,875000,7986000,8861000
Myanmar,2009,9,1672000,4856000,6528000
Myanmar,2009,10,1576000,5262000,6838000
Myanmar,2009,11,3122000,3057000,6179000
Myanmar,2009,12,6910000,2379000,9289000
Myanmar,2010,1,1573000,7141000,8714000
Myanmar,2010,2,621000,5414000,6035000
Myanmar,2010,3,2082000,5261000,7343000
Myanmar,2010,4,2557000,4287000,6844000
Myanmar,2010,5,936000,2427000,3363000
Myanmar,2010,6,1068000,3196000,4264000
Myanmar,2010,7,1705000,4425000,6130000
Myanmar,2010,8,965000,8249000,9214000
Myanmar,2010,9,2954000,7390000,10344000
Myanmar,2010,10,1426000,5501000,6927000
Myanmar,2010,11,4012000,3382000,7394000
Myanmar,2010,12,2906000,2545000,5451000
Myanmar,2011,1,5878000,5416000,11294000
Myanmar,2011,2,4380000,8246000,12626000
Myanmar,2011,3,1814000,6643000,8457000
Myanmar,2011,4,2293000,3157000,5450000
Myanmar,2011,5,2956000,2205000,5161000
Myanmar,2011,6,2230000,4038000,6268000
Myanmar,2011,7,2920000,5089000,8009000
Myanmar,2011,8,3265000,8622000,11887000
Myanmar,2011,9,3116000,7050000,10166000
Myanmar,2011,10,3288000,5149000,8437000
Myanmar,2011,11,2583000,2756000,5339000
Myanmar,2011,12,8205000,2261000,10466000
Myanmar,2012,1,6806000,5036000,11842000
Myanmar,2012,2,5745000,4925000,10670000
Myanmar,2012,3,16480000,3764000,20244000
Myanmar,2012,4,5664000,2921000,8585000
Myanmar,2012,5,6125000,1927000,8052000
Myanmar,2012,6,3898000,1971000,5869000
Myanmar,2012,7,6542000,2713000,9255000
Myanmar,2012,8,8226000,8385000,16611000
Myanmar,2012,9,21952000,4294000,26246000
Myanmar,2012,10,3444000,4455000,7899000
Myanmar,2012,11,10152000,2592000,12744000
Myanmar,2012,12,9977000,1708000,11685000
Myanmar,2013,1,24032000,3896000,27928000
Myanmar,2013,2,8179000,3854000,12033000
Myanmar,2013,3,11063000,6372000,17435000
Myanmar,2013,4,8527000,3630000,12157000
Myanmar,2013,5,3128000,2143000,5271000
Myanmar,2013,6,4481000,3681000,8162000
Myanmar,2013,7,18127000,3708000,21835000
Myanmar,2013,8,8538000,6675000,15213000
Myanmar,2013,9,9565000,7759000,17324000
Myanmar,2013,10,4842000,7252000,12094000
Myanmar,2013,11,9437000,4186000,13623000
Myanmar,2013,12,15673000,2673000,18346000
Myanmar,2014,1,12060000,10147000,22207000
Myanmar,2014,2,11374000,4807000,16181000
Myanmar,2014,3,7360000,7231000,14591000
Myanmar,2014,4,13136000,7228000,20364000
Myanmar,2014,5,4153000,4467000,8620000
Myanmar,2014,6,10478000,4053000,14531000
Myanmar,2014,7,13234000,8350000,21584000
Myanmar,2014,8,14563000,9516000,24079000
Myanmar,2014,9,5820000,17046000,22866000
Myanmar,2014,10,11441000,11400000,22841000
Myanmar,2014,11,11481000,7899000,19380000
Myanmar,2014,12,15579000,8756000,24335000
Myanmar,2015,1,10159000,15740000,25899000
Myanmar,2015,2,12766000,12786000,25552000
Myanmar,2015,3,8623000,15927000,24550000
Myanmar,2015,4,4723000,9240000,13963000
Myanmar,2015,5,5576000,13608000,19184000
Myanmar,2015,6,12047000,8814000,20861000
Myanmar,2015,7,38764000,19782000,58546000
Myanmar,2015,8,6790000,22096000,28886000
Myanmar,2015,9,9241000,25333000,34574000
Myanmar,2015,10,8737000,16551000,25288000
Myanmar,2015,11,18253000,17113000,35366000
Myanmar,2015,12,11729000,20833000,32562000
Myanmar,2016,1,6327000,20371000,26698000
Myanmar,2016,2,23596000,24540000,48136000
Myanmar,2016,3,7139000,21528000,28667000
Myanmar,2016,4,14735000,16893000,31628000
Myanmar,2016,5,5413000,20488000,25901000
Myanmar,2016,6,12882000,17204000,30086000
Myanmar,2016,7,5876000,29371000,35247000
Myanmar,2016,8,19730000,36255000,55985000
Myanmar,2016,9,10610000,34113000,44723000
Myanmar,2016,10,5692000,42000000,47692000
Myanmar,2016,11,18939000,27394000,46333000
Myanmar,2016,12,11544000,30208000,41752000
Myanmar,2017,1,12804000,34748000,47552000
Myanmar,2017,2,11780000,32170000,43950000
Myanmar,2017,3,11222000,42889000,54111000
Myanmar,2017,4,10520000,32085000,42605000
Myanmar,2017,5,8900000,26995000,35895000
Myanmar,2017,6,7421000,38131000,45552000
Myanmar,2017,7,7289000,39875000,47164000
Myanmar,2017,8,11095000,64568000,75663000
Myanmar,2017,9,7286000,75159000,82445000
Myanmar,2017,10,7871000,66822000,74693000
Myanmar,2017,11,12929000,51099000,64028000
Myanmar,2017,12,9517000,47030000,56547000
Myanmar,2018,1,8536000,68659000,77195000
Myanmar,2018,2,15654000,58653000,74307000
Myanmar,2018,3,12678000,65564000,78242000
Myanmar,2018,4,7816000,44176000,51992000
Myanmar,2018,5,5046000,42850000,47896000
Myanmar,2018,6,9847000,49939000,59786000
Myanmar,2018,7,6900000,91090000,97990000
Myanmar,2018,8,8075000,115113000,123188000
Myanmar,2018,9,7139000,95387000,102526000
Myanmar,2018,10,6352000,91748000,98100000
Myanmar,2018,11,17684000,80827000,98511000
Myanmar,2018,12,16610000,56282000,72892000
Myanmar,2019,1,6881000,98005000,104886000
Myanmar,2019,2,9383000,66775000,76158000
Myanmar,2019,3,12408000,71698000,84106000
Myanmar,2019,4,20461000,55903000,76364000
Myanmar,2019,5,14614000,61768000,76382000
Myanmar,2019,6,10519000,54704000,65223000
Myanmar,2019,7,18601000,93872000,112473000
Myanmar,2019,8,10169000,118143000,128312000
Myanmar,2019,9,9887000,127271000,137158000
Myanmar,2019,10,15442000,127810000,143252000
Myanmar,2019,11,7511000,95256000,102767000
Myanmar,2019,12,15503000,74455000,89958000
Myanmar,2020,1,10080000,110216000,120296000
Myanmar,2020,2,10431000,70981000,81412000
Myanmar,2020,3,8475000,105007000,113482000
Myanmar,2020,4,8209000,63610000,71819000
Myanmar,2020,5,6694000,49478000,56172000
Myanmar,2020,6,13980000,45496000,59476000
Myanmar,2020,7,14808000,89846000,104654000
Myanmar,2020,8,12662000,120918000,133580000
Myanmar,2020,9,10803000,166282000,177085000
Myanmar,2020,10,10255000,129440000,139695000
Myanmar,2020,11,15774000,86165000,101939000
Myanmar,2020,12,17449000,70855000,88304000
Myanmar,2021,1,10547000,80940000,91487000
Myanmar,2021,2,6203000,71390000,77593000
Myanmar,2021,3,6028000,93892000,99920000
Myanmar,2021,4,2307000,62741000,65048000
Myanmar,2021,5,7651000,62826000,70477000
Myanmar,2021,6,4918000,52564000,57482000
Myanmar,2021,7,10088000,79657000,89745000
Myanmar,2021,8,9352000,80956000,90308000
Myanmar,2021,9,8702000,99628000,108330000
Myanmar,2021,10,6909000,107066000,113975000
Myanmar,2021,11,6379000,89286000,95665000
Myanmar,2021,12,5813000,66575000,72388000
Myanmar,2022,1,7453000,83082000,90535000
Myanmar,2022,2,6512000,100547000,107059000
Myanmar,2022,3,19345000,115283000,134628000
Myanmar,2022,4,7440000,107381000,114821000
Myanmar,2022,5,8013000,97671000,105684000
Myanmar,2022,6,9404000,93558000,102962000
Myanmar,2022,7,5336000,113285000,118621000
Myanmar,2022,8,5233000,150870000,156103000
Myanmar,2022,9,4862000,225610000,230472000
Myanmar,2022,10,4525000,189397000,193922000
Myanmar,2022,11,4650000,169250000,173900000
Myanmar,2022,12,3787000,135553000,139340000
Myanmar,2023,1,2919000,134849000,137768000
Myanmar,2023,2,7125000,120564000,127689000
Myanmar,2023,3,4850000,105742000,110592000
Myanmar,2023,4,3636000,72219000,75855000
Myanmar,2023,5,5232000,62380000,67612000
Myanmar,2023,6,7899000,72153000,80052000
Myanmar,2023,7,4671000,106954000,111625000
Myanmar,2023,8,6602000,126761000,133363000
Myanmar,2023,9,7232000,136761000,143993000
Myanmar,2023,10,6672000,113358000,120030000
Myanmar,2023,11,6412000,107286000,113698000
Myanmar,2023,12,9671000,75491000,85162000
Myanmar,2024,1,6998000,92146000,99144000
Myanmar,2024,2,5592000,96727000,102319000
Myanmar,2024,3,5668000,89100000,94768000
Myanmar,2024,4,4577000,106395000,110972000
Myanmar,2024,5,4008000,59741000,63749000
Myanmar,2024,6,6086000,54407000,60493000
Myanmar,2024,7,3945000,68376000,72321000
Myanmar,2024,8,20862000,123365000,144227000
Myanmar,2024,9,4458000,145075000,149533000
Myanmar,2024,10,5398000,134878000,140276000
Myanmar,2024,11,2105000,116777000,118882000
Myanmar,2024,12,5678000,89347000,95025000
Namibia,2008,1,5117000,1609000,6726000
Namibia,2008,2,3376000,2864000,6240000
Namibia,2008,3,5210000,4341000,9551000
Namibia,2008,4,4551000,3814000,8365000
Namibia,2008,5,6455000,4840000,11295000
Namibia,2008,6,10292000,759000,11051000
Namibia,2008,7,4480000,1241000,5721000
Namibia,2008,8,3282000,3228000,6510000
Namibia,2008,9,11355000,2981000,14336000
Namibia,2008,10,10219000,3313000,13532000
Namibia,2008,11,5313000,1156000,6469000
Namibia,2008,12,4913000,4671000,9584000
Namibia,2009,1,3195000,2922000,6117000
Namibia,2009,2,5815000,13159000,18974000
Namibia,2009,3,10938000,14648000,25586000
Namibia,2009,4,7053000,6110000,13163000
Namibia,2009,5,3747000,7664000,11411000
Namibia,2009,6,5169000,2982000,8151000
Namibia,2009,7,5956000,5136000,11092000
Namibia,2009,8,7182000,11539000,18721000
Namibia,2009,9,7619000,8171000,15790000
Namibia,2009,10,16098000,16192000,32290000
Namibia,2009,11,7010000,4887000,11897000
Namibia,2009,12,8405000,27220000,35625000
Namibia,2010,1,4202000,9379000,13581000
Namibia,2010,2,4185000,11166000,15351000
Namibia,2010,3,5752000,3323000,9075000
Namibia,2010,4,5831000,12093000,17924000
Namibia,2010,5,8480000,10190000,18670000
Namibia,2010,6,14135000,17281000,31416000
Namibia,2010,7,7947000,15809000,23756000
Namibia,2010,8,5918000,18825000,24743000
Namibia,2010,9,5740000,3784000,9524000
Namibia,2010,10,7541000,9016000,16557000
Namibia,2010,11,5262000,9093000,14355000
Namibia,2010,12,7234000,14250000,21484000
Namibia,2011,1,7710000,16638000,24348000
Namibia,2011,2,17467000,3503000,20970000
Namibia,2011,3,10945000,16930000,27875000
Namibia,2011,4,8890000,26291000,35181000
Namibia,2011,5,9195000,12518000,21713000
Namibia,2011,6,8405000,19418000,27823000
Namibia,2011,7,8112000,24693000,32805000
Namibia,2011,8,5277000,25070000,30347000
Namibia,2011,9,59453000,15504000,74957000
Namibia,2011,10,7035000,11913000,18948000
Namibia,2011,11,10689000,5278000,15967000
Namibia,2011,12,6504000,13313000,19817000
Namibia,2012,1,7084000,10851000,17935000
Namibia,2012,2,3548000,3389000,6937000
Namibia,2012,3,6345000,10170000,16515000
Namibia,2012,4,5514000,4535000,10049000
Namibia,2012,5,11015000,6765000,17780000
Namibia,2012,6,7951000,10784000,18735000
Namibia,2012,7,7192000,7427000,14619000
Namibia,2012,8,7839000,3790000,11629000
Namibia,2012,9,5792000,18634000,24426000
Namibia,2012,10,6495000,8552000,15047000
Namibia,2012,11,8639000,8446000,17085000
Namibia,2012,12,55944000,10569000,66513000
Namibia,2013,1,5298000,13038000,18336000
Namibia,2013,2,33312000,9642000,42954000
Namibia,2013,3,46517000,9061000,55578000
Namibia,2013,4,4832000,4847000,9679000
Namibia,2013,5,4738000,5853000,10591000
Namibia,2013,6,7301000,6891000,14192000
Namibia,2013,7,12471000,13520000,25991000
Namibia,2013,8,7140000,5001000,12141000
Namibia,2013,9,8503000,5687000,14190000
Namibia,2013,10,13573000,10579000,24152000
Namibia,2013,11,5360000,9345000,14705000
Namibia,2013,12,17250000,12639000,29889000
Namibia,2014,1,7868000,20007000,27875000
Namibia,2014,2,7568000,9432000,17000000
Namibia,2014,3,5791000,11534000,17325000
Namibia,2014,4,22815000,9678000,32493000
Namibia,2014,5,9417000,15313000,24730000
Namibia,2014,6,7751000,11199000,18950000
Namibia,2014,7,14571000,17099000,31670000
Namibia,2014,8,5628000,11801000,17429000
Namibia,2014,9,11791000,14835000,26626000
Namibia,2014,10,10131000,8503000,18634000
Namibia,2014,11,8238000,13216000,21454000
Namibia,2014,12,7530000,15432000,22962000
Namibia,2015,1,10064000,5289000,15353000
Namibia,2015,2,7095000,12223000,19318000
Namibia,2015,3,5709000,20301000,26010000
Namibia,2015,4,5497000,7505000,13002000
Namibia,2015,5,5676000,13889000,19565000
Namibia,2015,6,8325000,2333000,10658000
Namibia,2015,7,6505000,9782000,16287000
Namibia,2015,8,7198000,23178000,30376000
Namibia,2015,9,8346000,13451000,21797000
Namibia,2015,10,7715000,14400000,22115000
Namibia,2015,11,7930000,15467000,23397000
Namibia,2015,12,7121000,12825000,19946000
Namibia,2016,1,6829000,4166000,10995000
Namibia,2016,2,5565000,8924000,14489000
Namibia,2016,3,5163000,3416000,8579000
Namibia,2016,4,5261000,14911000,20172000
Namibia,2016,5,4168000,12399000,16567000
Namibia,2016,6,6526000,10611000,17137000
Namibia,2016,7,6574000,11395000,17969000
Namibia,2016,8,7013000,7297000,14310000
Namibia,2016,9,7376000,12880000,20256000
Namibia,2016,10,5820000,12500000,18320000
Namibia,2016,11,5447000,12752000,18199000
Namibia,2016,12,7811000,8627000,16438000
Namibia,2017,1,2614000,13981000,16595000
Namibia,2017,2,6807000,23487000,30294000
Namibia,2017,3,9777000,14973000,24750000
Namibia,2017,4,4053000,2870000,6923000
Namibia,2017,5,7151000,3120000,10271000
Namibia,2017,6,4900000,5636000,10536000
Namibia,2017,7,7777000,9935000,17712000
Namibia,2017,8,6048000,10257000,16305000
Namibia,2017,9,5070000,25620000,30690000
Namibia,2017,10,4793000,4426000,9219000
Namibia,2017,11,4476000,17664000,22140000
Namibia,2017,12,4131000,12895000,17026000
Namibia,2018,1,3126000,21620000,24746000
Namibia,2018,2,5423000,17162000,22585000
Namibia,2018,3,4481000,15092000,19573000
Namibia,2018,4,4000000,3652000,7652000
Namibia,2018,5,5301000,10697000,15998000
Namibia,2018,6,5791000,21312000,27103000
Namibia,2018,7,5339000,11302000,16641000
Namibia,2018,8,4900000,3044000,7944000
Namibia,2018,9,4417000,3757000,8174000
Namibia,2018,10,4596000,9101000,13697000
Namibia,2018,11,6069000,15473000,21542000
Namibia,2018,12,3832000,10718000,14550000
Namibia,2019,1,4178000,13401000,17579000
Namibia,2019,2,4585000,14079000,18664000
Namibia,2019,3,3918000,21648000,25566000
Namibia,2019,4,5924000,5677000,11601000
Namibia,2019,5,3368000,4263000,7631000
Namibia,2019,6,5465000,3592000,9057000
Namibia,2019,7,7327000,20286000,27613000
Namibia,2019,8,4593000,4951000,9544000
Namibia,2019,9,5659000,3536000,9195000
Namibia,2019,10,5735000,4326000,10061000
Namibia,2019,11,4436000,4740000,9176000
Namibia,2019,12,4092000,29215000,33307000
Namibia,2020,1,4778000,34072000,38850000
Namibia,2020,2,4516000,6348000,10864000
Namibia,2020,3,6783000,14405000,21188000
Namibia,2020,4,2229000,2457000,4686000
Namibia,2020,5,3178000,8724000,11902000
Namibia,2020,6,2068000,36436000,38504000
Namibia,2020,7,2933000,20922000,23855000
Namibia,2020,8,2756000,14952000,17708000
Namibia,2020,9,4084000,3482000,7566000
Namibia,2020,10,4131000,8062000,12193000
Namibia,2020,11,4587000,14267000,18854000
Namibia,2020,12,3024000,6950000,9974000
Namibia,2021,1,2640000,4995000,7635000
Namibia,2021,2,2994000,3067000,6061000
Namibia,2021,3,2799000,4121000,6920000
Namibia,2021,4,6076000,3299000,9375000
Namibia,2021,5,2718000,7442000,10160000
Namibia,2021,6,3723000,8252000,11975000
Namibia,2021,7,9153000,2189000,11342000
Namibia,2021,8,3522000,2965000,6487000
Namibia,2021,9,4715000,3404000,8119000
Namibia,2021,10,8408000,211920000,220328000
Namibia,2021,11,3950000,4538000,8488000
Namibia,2021,12,4785000,5809000,10594000
Namibia,2022,1,7635000,9994000,17629000
Namibia,2022,2,5053000,6896000,11949000
Namibia,2022,3,5256000,4744000,10000000
Namibia,2022,4,3397000,3536000,6933000
Namibia,2022,5,4142000,5444000,9586000
Namibia,2022,6,5786000,3837000,9623000
Namibia,2022,7,5460000,4698000,10158000
Namibia,2022,8,4718000,6494000,11212000
Namibia,2022,9,4594000,4362000,8956000
Namibia,2022,10,4923000,3125000,8048000
Namibia,2022,11,6417000,3868000,10285000
Namibia,2022,12,4974000,6800000,11774000
Namibia,2023,1,4976000,14506000,19482000
Namibia,2023,2,4552000,12863000,17415000
Namibia,2023,3,5322000,6660000,11982000
Namibia,2023,4,8747000,3468000,12215000
Namibia,2023,5,4620000,4269000,8889000
Namibia,2023,6,5542000,3401000,8943000
Namibia,2023,7,6409000,8290000,14699000
Namibia,2023,8,6485000,4569000,11054000
Namibia,2023,9,6240000,2406000,8646000
Namibia,2023,10,4640000,3133000,7773000
Namibia,2023,11,5069000,4520000,9589000
Namibia,2023,12,4632000,10769000,15401000
Namibia,2024,1,6742000,19940000,26682000
Namibia,2024,2,4934000,9074000,14008000
Namibia,2024,3,6803000,3917000,10720000
Namibia,2024,4,8673000,4227000,12900000
Namibia,2024,5,11859000,4521000,16380000
Namibia,2024,6,11436000,3625000,15061000
Namibia,2024,7,8460000,4847000,13307000
Namibia,2024,8,12742000,5565000,18307000
Namibia,2024,9,7649000,4283000,11932000
Namibia,2024,10,8606000,4339000,12945000
Namibia,2024,11,6510000,3817000,10327000
Namibia,2024,12,3526000,12480000,16006000
Nauru,2008,1,3000,0,3000
Nauru,2008,2,0,0,0
Nauru,2008,3,4000,0,4000
Nauru,2008,4,0,0,0
Nauru,2008,5,4000,2000,6000
Nauru,2008,6,3000,0,3000
Nauru,2008,7,4000,0,4000
Nauru,2008,8,1000,0,1000
Nauru,2008,9,0,0,0
Nauru,2008,10,0,0,0
Nauru,2008,11,0,0,0
Nauru,2008,12,5000,1000,6000
Nauru,2009,1,480000,1000,481000
Nauru,2009,2,447000,0,447000
Nauru,2009,3,20000,0,20000
Nauru,2009,4,61000,0,61000
Nauru,2009,5,0,0,0
Nauru,2009,6,18000,0,18000
Nauru,2009,7,12000,0,12000
Nauru,2009,8,0,22000,22000
Nauru,2009,9,0,0,0
Nauru,2009,10,0,0,0
Nauru,2009,11,0,0,0
Nauru,2009,12,0,0,0
Nauru,2010,1,2000,0,2000
Nauru,2010,2,0,0,0
Nauru,2010,3,0,0,0
Nauru,2010,4,0,0,0
Nauru,2010,5,0,0,0
Nauru,2010,6,0,0,0
Nauru,2010,7,0,0,0
Nauru,2010,8,0,0,0
Nauru,2010,9,0,0,0
Nauru,2010,10,0,0,0
Nauru,2010,11,0,0,0
Nauru,2010,12,0,0,0
Nauru,2011,1,0,0,0
Nauru,2011,2,0,0,0
Nauru,2011,3,0,0,0
Nauru,2011,4,0,0,0
Nauru,2011,5,2000,0,2000
Nauru,2011,6,0,0,0
Nauru,2011,7,0,0,0
Nauru,2011,8,38000,0,38000
Nauru,2011,9,0,0,0
Nauru,2011,10,0,0,0
Nauru,2011,11,2000,0,2000
Nauru,2011,12,0,0,0
Nauru,2012,1,0,0,0
Nauru,2012,2,0,0,0
Nauru,2012,3,0,0,0
Nauru,2012,4,0,0,0
Nauru,2012,5,0,0,0
Nauru,2012,6,0,0,0
Nauru,2012,7,0,0,0
Nauru,2012,8,2000,0,2000
Nauru,2012,9,0,0,0
Nauru,2012,10,0,0,0
Nauru,2012,11,0,0,0
Nauru,2012,12,0,0,0
Nauru,2013,1,0,0,0
Nauru,2013,2,0,0,0
Nauru,2013,3,0,0,0
Nauru,2013,4,0,0,0
Nauru,2013,5,0,0,0
Nauru,2013,6,0,0,0
Nauru,2013,7,0,1000,1000
Nauru,2013,8,2000,0,2000
Nauru,2013,9,0,0,0
Nauru,2013,10,0,1000,1000
Nauru,2013,11,0,3000,3000
Nauru,2013,12,0,0,0
Nauru,2014,1,0,0,0
Nauru,2014,2,0,0,0
Nauru,2014,3,0,0,0
Nauru,2014,4,0,0,0
Nauru,2014,5,0,0,0
Nauru,2014,6,0,0,0
Nauru,2014,7,0,0,0
Nauru,2014,8,0,0,0
Nauru,2014,9,0,0,0
Nauru,2014,10,0,0,0
Nauru,2014,11,0,0,0
Nauru,2014,12,0,4000,4000
Nauru,2015,1,0,14000,14000
Nauru,2015,2,0,0,0
Nauru,2015,3,0,0,0
Nauru,2015,4,0,0,0
Nauru,2015,5,0,0,0
Nauru,2015,6,14000,0,14000
Nauru,2015,7,25000,0,25000
Nauru,2015,8,0,0,0
Nauru,2015,9,0,1000,1000
Nauru,2015,10,0,0,0
Nauru,2015,11,0,0,0
Nauru,2015,12,0,0,0
Nauru,2016,1,0,11000,11000
Nauru,2016,2,0,1000,1000
Nauru,2016,3,0,1000,1000
Nauru,2016,4,0,0,0
Nauru,2016,5,0,0,0
Nauru,2016,6,16000,0,16000
Nauru,2016,7,0,0,0
Nauru,2016,8,0,0,0
Nauru,2016,9,0,1000,1000
Nauru,2016,10,0,0,0
Nauru,2016,11,0,0,0
Nauru,2016,12,0,1000,1000
Nauru,2017,1,0,5000,5000
Nauru,2017,2,0,1000,1000
Nauru,2017,3,0,1000,1000
Nauru,2017,4,0,1000,1000
Nauru,2017,5,0,0,0
Nauru,2017,6,4000,0,4000
Nauru,2017,7,0,1000,1000
Nauru,2017,8,0,1000,1000
Nauru,2017,9,0,0,0
Nauru,2017,10,0,0,0
Nauru,2017,11,0,0,0
Nauru,2017,12,0,2000,2000
Nauru,2018,1,0,0,0
Nauru,2018,2,31000,0,31000
Nauru,2018,3,0,1000,1000
Nauru,2018,4,0,0,0
Nauru,2018,5,0,0,0
Nauru,2018,6,0,0,0
Nauru,2018,7,0,1000,1000
Nauru,2018,8,0,0,0
Nauru,2018,9,0,0,0
Nauru,2018,10,2000,0,2000
Nauru,2018,11,0,0,0
Nauru,2018,12,0,0,0
Nauru,2019,1,0,0,0
Nauru,2019,2,6000,0,6000
Nauru,2019,3,35000,0,35000
Nauru,2019,4,65000,0,65000
Nauru,2019,5,0,0,0
Nauru,2019,6,38000,0,38000
Nauru,2019,7,0,0,0
Nauru,2019,8,0,0,0
Nauru,2019,9,0,10000,10000
Nauru,2019,10,0,0,0
Nauru,2019,11,0,0,0
Nauru,2019,12,0,11000,11000
Nauru,2020,1,0,4000,4000
Nauru,2020,2,0,0,0
Nauru,2020,3,0,9000,9000
Nauru,2020,4,0,0,0
Nauru,2020,5,0,0,0
Nauru,2020,6,0,7000,7000
Nauru,2020,7,0,0,0
Nauru,2020,8,0,11000,11000
Nauru,2020,9,0,0,0
Nauru,2020,10,0,0,0
Nauru,2020,11,0,0,0
Nauru,2020,12,0,0,0
Nauru,2021,1,0,0,0
Nauru,2021,2,0,0,0
Nauru,2021,3,0,0,0
Nauru,2021,4,0,5000,5000
Nauru,2021,5,0,0,0
Nauru,2021,6,4000,0,4000
Nauru,2021,7,0,0,0
Nauru,2021,8,7000,0,7000
Nauru,2021,9,28000,29000,57000
Nauru,2021,10,0,2000,2000
Nauru,2021,11,0,4000,4000
Nauru,2021,12,0,0,0
Nauru,2022,1,16000,19000,35000
Nauru,2022,2,24000,4000,28000
Nauru,2022,3,44000,37000,81000
Nauru,2022,4,55000,0,55000
Nauru,2022,5,0,0,0
Nauru,2022,6,0,4000,4000
Nauru,2022,7,0,0,0
Nauru,2022,8,0,7000,7000
Nauru,2022,9,104000,36000,140000
Nauru,2022,10,0,6000,6000
Nauru,2022,11,12000,0,12000
Nauru,2022,12,0,0,0
Nauru,2023,1,9000,0,9000
Nauru,2023,2,0,8000,8000
Nauru,2023,3,8000,1000,9000
Nauru,2023,4,120000,0,120000
Nauru,2023,5,0,0,0
Nauru,2023,6,0,0,0
Nauru,2023,7,12000,0,12000
Nauru,2023,8,23000,0,23000
Nauru,2023,9,26000,3000,29000
Nauru,2023,10,0,0,0
Nauru,2023,11,10000,0,10000
Nauru,2023,12,0,0,0
Nauru,2024,1,0,0,0
Nauru,2024,2,0,0,0
Nauru,2024,3,0,0,0
Nauru,2024,4,0,0,0
Nauru,2024,5,0,0,0
Nauru,2024,6,0,0,0
Nauru,2024,7,15000,0,15000
Nauru,2024,8,0,0,0
Nauru,2024,9,21000,0,21000
Nauru,2024,10,1000,0,1000
Nauru,2024,11,0,0,0
Nauru,2024,12,2000,0,2000
Nepal,2008,1,1590000,2119000,3709000
Nepal,2008,2,1397000,1998000,3395000
Nepal,2008,3,1430000,1682000,3112000
Nepal,2008,4,1820000,1994000,3814000
Nepal,2008,5,1357000,2841000,4198000
Nepal,2008,6,1851000,3199000,5050000
Nepal,2008,7,3162000,2849000,6011000
Nepal,2008,8,1289000,2580000,3869000
Nepal,2008,9,2380000,3408000,5788000
Nepal,2008,10,2054000,3449000,5503000
Nepal,2008,11,1605000,2544000,4149000
Nepal,2008,12,1266000,2631000,3897000
Nepal,2009,1,835000,1890000,2725000
Nepal,2009,2,1150000,1564000,2714000
Nepal,2009,3,936000,2340000,3276000
Nepal,2009,4,1361000,2221000,3582000
Nepal,2009,5,2506000,2401000,4907000
Nepal,2009,6,1451000,2711000,4162000
Nepal,2009,7,2925000,2630000,5555000
Nepal,2009,8,2650000,2057000,4707000
Nepal,2009,9,1382000,2722000,4104000
Nepal,2009,10,1227000,2116000,3343000
Nepal,2009,11,860000,2110000,2970000
Nepal,2009,12,1162000,2542000,3704000
Nepal,2010,1,1213000,2126000,3339000
Nepal,2010,2,1680000,2356000,4036000
Nepal,2010,3,1500000,2343000,3843000
Nepal,2010,4,1492000,2036000,3528000
Nepal,2010,5,1018000,2117000,3135000
Nepal,2010,6,1812000,2948000,4760000
Nepal,2010,7,2973000,2280000,5253000
Nepal,2010,8,4008000,3341000,7349000
Nepal,2010,9,2202000,3006000,5208000
Nepal,2010,10,1299000,3387000,4686000
Nepal,2010,11,2274000,3240000,5514000
Nepal,2010,12,1059000,2311000,3370000
Nepal,2011,1,1347000,2786000,4133000
Nepal,2011,2,1032000,2111000,3143000
Nepal,2011,3,1894000,2279000,4173000
Nepal,2011,4,1169000,2479000,3648000
Nepal,2011,5,1423000,2534000,3957000
Nepal,2011,6,875000,3014000,3889000
Nepal,2011,7,1398000,2846000,4244000
Nepal,2011,8,1327000,3740000,5067000
Nepal,2011,9,1152000,3354000,4506000
Nepal,2011,10,1482000,3921000,5403000
Nepal,2011,11,2364000,3508000,5872000
Nepal,2011,12,1040000,2977000,4017000
Nepal,2012,1,3330000,2484000,5814000
Nepal,2012,2,1598000,1760000,3358000
Nepal,2012,3,1006000,2129000,3135000
Nepal,2012,4,994000,2466000,3460000
Nepal,2012,5,1728000,2625000,4353000
Nepal,2012,6,1819000,2541000,4360000
Nepal,2012,7,1252000,3201000,4453000
Nepal,2012,8,1241000,3552000,4793000
Nepal,2012,9,2095000,3228000,5323000
Nepal,2012,10,1709000,3373000,5082000
Nepal,2012,11,1807000,2040000,3847000
Nepal,2012,12,2635000,2081000,4716000
Nepal,2013,1,999000,2128000,3127000
Nepal,2013,2,930000,1665000,2595000
Nepal,2013,3,2634000,2080000,4714000
Nepal,2013,4,1321000,2350000,3671000
Nepal,2013,5,2089000,2106000,4195000
Nepal,2013,6,1907000,2600000,4507000
Nepal,2013,7,3638000,2371000,6009000
Nepal,2013,8,1945000,2309000,4254000
Nepal,2013,9,2486000,2930000,5416000
Nepal,2013,10,1390000,2888000,4278000
Nepal,2013,11,2227000,2082000,4309000
Nepal,2013,12,10372000,2878000,13250000
Nepal,2014,1,1935000,1984000,3919000
Nepal,2014,2,1179000,1781000,2960000
Nepal,2014,3,1588000,1640000,3228000
Nepal,2014,4,5298000,2122000,7420000
Nepal,2014,5,1811000,2079000,3890000
Nepal,2014,6,2420000,2771000,5191000
Nepal,2014,7,2379000,2720000,5099000
Nepal,2014,8,2222000,2643000,4865000
Nepal,2014,9,2250000,2833000,5083000
Nepal,2014,10,2571000,2685000,5256000
Nepal,2014,11,2503000,2895000,5398000
Nepal,2014,12,2832000,2337000,5169000
Nepal,2015,1,2810000,2708000,5518000
Nepal,2015,2,56443000,2291000,58734000
Nepal,2015,3,5932000,2994000,8926000
Nepal,2015,4,64056000,3047000,67103000
Nepal,2015,5,1716000,1400000,3116000
Nepal,2015,6,2504000,2935000,5439000
Nepal,2015,7,2588000,2590000,5178000
Nepal,2015,8,5118000,3036000,8154000
Nepal,2015,9,3698000,3266000,6964000
Nepal,2015,10,1422000,3858000,5280000
Nepal,2015,11,2982000,2439000,5421000
Nepal,2015,12,2104000,2784000,4888000
Nepal,2016,1,1578000,2028000,3606000
Nepal,2016,2,2366000,2126000,4492000
Nepal,2016,3,2254000,2050000,4304000
Nepal,2016,4,3151000,2152000,5303000
Nepal,2016,5,2042000,2190000,4232000
Nepal,2016,6,3204000,3304000,6508000
Nepal,2016,7,1348000,2310000,3658000
Nepal,2016,8,2431000,2744000,5175000
Nepal,2016,9,3350000,2605000,5955000
Nepal,2016,10,2058000,2798000,4856000
Nepal,2016,11,2521000,2883000,5404000
Nepal,2016,12,2897000,2598000,5495000
Nepal,2017,1,58264000,2555000,60819000
Nepal,2017,2,2125000,1888000,4013000
Nepal,2017,3,59688000,1955000,61643000
Nepal,2017,4,2320000,1913000,4233000
Nepal,2017,5,3423000,2593000,6016000
Nepal,2017,6,8081000,2566000,10647000
Nepal,2017,7,3083000,2503000,5586000
Nepal,2017,8,3232000,2447000,5679000
Nepal,2017,9,7137000,2551000,9688000
Nepal,2017,10,3674000,2313000,5987000
Nepal,2017,11,3938000,3499000,7437000
Nepal,2017,12,4334000,2237000,6571000
Nepal,2018,1,4224000,2444000,6668000
Nepal,2018,2,2377000,1748000,4125000
Nepal,2018,3,4043000,1515000,5558000
Nepal,2018,4,2289000,2218000,4507000
Nepal,2018,5,2252000,1788000,4040000
Nepal,2018,6,3818000,2661000,6479000
Nepal,2018,7,3038000,2519000,5557000
Nepal,2018,8,3688000,2787000,6475000
Nepal,2018,9,2944000,2341000,5285000
Nepal,2018,10,3637000,2770000,6407000
Nepal,2018,11,2790000,2734000,5524000
Nepal,2018,12,11247000,2406000,13653000
Nepal,2019,1,1994000,2638000,4632000
Nepal,2019,2,2457000,1862000,4319000
Nepal,2019,3,2801000,1575000,4376000
Nepal,2019,4,2963000,1927000,4890000
Nepal,2019,5,4742000,2440000,7182000
Nepal,2019,6,2501000,2087000,4588000
Nepal,2019,7,6050000,3455000,9505000
Nepal,2019,8,5656000,2786000,8442000
Nepal,2019,9,4603000,2604000,7207000
Nepal,2019,10,3607000,2891000,6498000
Nepal,2019,11,3070000,2922000,5992000
Nepal,2019,12,2925000,2360000,5285000
Nepal,2020,1,2336000,2250000,4586000
Nepal,2020,2,4578000,2091000,6669000
Nepal,2020,3,1734000,1756000,3490000
Nepal,2020,4,535000,361000,896000
Nepal,2020,5,946000,534000,1480000
Nepal,2020,6,1820000,1638000,3458000
Nepal,2020,7,3482000,1834000,5316000
Nepal,2020,8,2219000,2039000,4258000
Nepal,2020,9,2629000,2256000,4885000
Nepal,2020,10,1997000,3857000,5854000
Nepal,2020,11,3082000,1781000,4863000
Nepal,2020,12,2393000,2663000,5056000
Nepal,2021,1,1762000,1791000,3553000
Nepal,2021,2,2213000,1570000,3783000
Nepal,2021,3,5804000,2271000,8075000
Nepal,2021,4,2862000,2101000,4963000
Nepal,2021,5,3238000,1326000,4564000
Nepal,2021,6,3816000,1446000,5262000
Nepal,2021,7,3379000,2921000,6300000
Nepal,2021,8,2957000,2882000,5839000
Nepal,2021,9,2361000,3079000,5440000
Nepal,2021,10,3500000,3083000,6583000
Nepal,2021,11,2483000,2437000,4920000
Nepal,2021,12,2661000,3343000,6004000
Nepal,2022,1,2085000,2504000,4589000
Nepal,2022,2,2057000,2255000,4312000
Nepal,2022,3,2258000,3196000,5454000
Nepal,2022,4,1809000,3164000,4973000
Nepal,2022,5,3714000,3541000,7255000
Nepal,2022,6,4238000,3709000,7947000
Nepal,2022,7,4058000,4497000,8555000
Nepal,2022,8,4287000,3731000,8018000
Nepal,2022,9,4266000,3864000,8130000
Nepal,2022,10,1486000,3119000,4605000
Nepal,2022,11,2028000,2720000,4748000
Nepal,2022,12,2323000,2715000,5038000
Nepal,2023,1,2036000,2494000,4530000
Nepal,2023,2,37314000,2454000,39768000
Nepal,2023,3,13844000,3058000,16902000
Nepal,2023,4,1838000,2248000,4086000
Nepal,2023,5,3378000,2591000,5969000
Nepal,2023,6,3034000,3299000,6333000
Nepal,2023,7,11703000,4515000,16218000
Nepal,2023,8,2463000,2679000,5142000
Nepal,2023,9,3534000,3524000,7058000
Nepal,2023,10,3354000,4360000,7714000
Nepal,2023,11,7393000,2507000,9900000
Nepal,2023,12,2520000,2900000,5420000
Nepal,2024,1,2958000,2488000,5446000
Nepal,2024,2,2815000,2068000,4883000
Nepal,2024,3,1504000,3044000,4548000
Nepal,2024,4,2304000,2527000,4831000
Nepal,2024,5,6118000,2482000,8600000
Nepal,2024,6,2992000,2567000,5559000
Nepal,2024,7,4900000,4020000,8920000
Nepal,2024,8,2297000,2464000,4761000
Nepal,2024,9,1556000,3634000,5190000
Nepal,2024,10,3025000,2734000,5759000
Nepal,2024,11,1967000,2837000,4804000
Nepal,2024,12,2699000,2968000,5667000
Neukaledonien,2008,1,12045000,0,12045000
Neukaledonien,2008,2,7612000,41000,7653000
Neukaledonien,2008,3,5622000,11000,5633000
Neukaledonien,2008,4,3709000,22000,3731000
Neukaledonien,2008,5,4406000,70000,4476000
Neukaledonien,2008,6,3560000,31000,3591000
Neukaledonien,2008,7,4258000,42000,4300000
Neukaledonien,2008,8,2320000,28000,2348000
Neukaledonien,2008,9,3768000,53000,3821000
Neukaledonien,2008,10,3890000,28000,3918000
Neukaledonien,2008,11,3215000,40000,3255000
Neukaledonien,2008,12,5214000,69000,5283000
Neukaledonien,2009,1,2300000,43000,2343000
Neukaledonien,2009,2,4607000,35000,4642000
Neukaledonien,2009,3,4208000,95000,4303000
Neukaledonien,2009,4,2783000,78000,2861000
Neukaledonien,2009,5,4039000,4000,4043000
Neukaledonien,2009,6,4285000,225000,4510000
Neukaledonien,2009,7,5096000,52000,5148000
Neukaledonien,2009,8,2502000,47000,2549000
Neukaledonien,2009,9,3114000,42000,3156000
Neukaledonien,2009,10,2805000,88000,2893000
Neukaledonien,2009,11,3695000,17000,3712000
Neukaledonien,2009,12,2962000,22000,2984000
Neukaledonien,2010,1,4374000,3000,4377000
Neukaledonien,2010,2,4122000,7000,4129000
Neukaledonien,2010,3,7558000,63000,7621000
Neukaledonien,2010,4,3210000,109000,3319000
Neukaledonien,2010,5,7315000,93000,7408000
Neukaledonien,2010,6,4758000,16000,4774000
Neukaledonien,2010,7,5826000,64000,5890000
Neukaledonien,2010,8,2774000,30000,2804000
Neukaledonien,2010,9,8272000,0,8272000
Neukaledonien,2010,10,3581000,31000,3612000
Neukaledonien,2010,11,4058000,29000,4087000
Neukaledonien,2010,12,6147000,1000,6148000
Neukaledonien,2011,1,3680000,7000,3687000
Neukaledonien,2011,2,3046000,51000,3097000
Neukaledonien,2011,3,4295000,44000,4339000
Neukaledonien,2011,4,4636000,11000,4647000
Neukaledonien,2011,5,5503000,78000,5581000
Neukaledonien,2011,6,4109000,41000,4150000
Neukaledonien,2011,7,5192000,122000,5314000
Neukaledonien,2011,8,3694000,5000,3699000
Neukaledonien,2011,9,5178000,280000,5458000
Neukaledonien,2011,10,3553000,96000,3649000
Neukaledonien,2011,11,3730000,78000,3808000
Neukaledonien,2011,12,3994000,75000,4069000
Neukaledonien,2012,1,2460000,7000,2467000
Neukaledonien,2012,2,2605000,5000,2610000
Neukaledonien,2012,3,3738000,45000,3783000
Neukaledonien,2012,4,5032000,53000,5085000
Neukaledonien,2012,5,3553000,39000,3592000
Neukaledonien,2012,6,5115000,15000,5130000
Neukaledonien,2012,7,3703000,37000,3740000
Neukaledonien,2012,8,4973000,29000,5002000
Neukaledonien,2012,9,4526000,33000,4559000
Neukaledonien,2012,10,4772000,69000,4841000
Neukaledonien,2012,11,3431000,77000,3508000
Neukaledonien,2012,12,5525000,154000,5679000
Neukaledonien,2013,1,2981000,6000,2987000
Neukaledonien,2013,2,3044000,55000,3099000
Neukaledonien,2013,3,3643000,39000,3682000
Neukaledonien,2013,4,4991000,38000,5029000
Neukaledonien,2013,5,3087000,11000,3098000
Neukaledonien,2013,6,4019000,58000,4077000
Neukaledonien,2013,7,3806000,39000,3845000
Neukaledonien,2013,8,4597000,5000,4602000
Neukaledonien,2013,9,4230000,42000,4272000
Neukaledonien,2013,10,3781000,14000,3795000
Neukaledonien,2013,11,3272000,41000,3313000
Neukaledonien,2013,12,3711000,56000,3767000
Neukaledonien,2014,1,2487000,10000,2497000
Neukaledonien,2014,2,3171000,49000,3220000
Neukaledonien,2014,3,3357000,139000,3496000
Neukaledonien,2014,4,3686000,56000,3742000
Neukaledonien,2014,5,3163000,41000,3204000
Neukaledonien,2014,6,6791000,54000,6845000
Neukaledonien,2014,7,3574000,41000,3615000
Neukaledonien,2014,8,3712000,41000,3753000
Neukaledonien,2014,9,6242000,53000,6295000
Neukaledonien,2014,10,4248000,71000,4319000
Neukaledonien,2014,11,4775000,41000,4816000
Neukaledonien,2014,12,5892000,17000,5909000
Neukaledonien,2015,1,3303000,87000,3390000
Neukaledonien,2015,2,5067000,45000,5112000
Neukaledonien,2015,3,5797000,54000,5851000
Neukaledonien,2015,4,4873000,66000,4939000
Neukaledonien,2015,5,6513000,98000,6611000
Neukaledonien,2015,6,6111000,90000,6201000
Neukaledonien,2015,7,4466000,56000,4522000
Neukaledonien,2015,8,3042000,57000,3099000
Neukaledonien,2015,9,4404000,55000,4459000
Neukaledonien,2015,10,4300000,86000,4386000
Neukaledonien,2015,11,3642000,80000,3722000
Neukaledonien,2015,12,4465000,114000,4579000
Neukaledonien,2016,1,3156000,88000,3244000
Neukaledonien,2016,2,4711000,55000,4766000
Neukaledonien,2016,3,3100000,115000,3215000
Neukaledonien,2016,4,5519000,50000,5569000
Neukaledonien,2016,5,4397000,82000,4479000
Neukaledonien,2016,6,3661000,132000,3793000
Neukaledonien,2016,7,3568000,0,3568000
Neukaledonien,2016,8,2068000,84000,2152000
Neukaledonien,2016,9,3765000,0,3765000
Neukaledonien,2016,10,3574000,143000,3717000
Neukaledonien,2016,11,3072000,57000,3129000
Neukaledonien,2016,12,3483000,31000,3514000
Neukaledonien,2017,1,2687000,103000,2790000
Neukaledonien,2017,2,3518000,341000,3859000
Neukaledonien,2017,3,3922000,76000,3998000
Neukaledonien,2017,4,4424000,67000,4491000
Neukaledonien,2017,5,3441000,51000,3492000
Neukaledonien,2017,6,3440000,75000,3515000
Neukaledonien,2017,7,2765000,82000,2847000
Neukaledonien,2017,8,3287000,146000,3433000
Neukaledonien,2017,9,3455000,61000,3516000
Neukaledonien,2017,10,2839000,58000,2897000
Neukaledonien,2017,11,2730000,15000,2745000
Neukaledonien,2017,12,3661000,63000,3724000
Neukaledonien,2018,1,2131000,51000,2182000
Neukaledonien,2018,2,3485000,50000,3535000
Neukaledonien,2018,3,3988000,45000,4033000
Neukaledonien,2018,4,3160000,102000,3262000
Neukaledonien,2018,5,4173000,75000,4248000
Neukaledonien,2018,6,3981000,88000,4069000
Neukaledonien,2018,7,4139000,48000,4187000
Neukaledonien,2018,8,2903000,221000,3124000
Neukaledonien,2018,9,2493000,90000,2583000
Neukaledonien,2018,10,2894000,99000,2993000
Neukaledonien,2018,11,4408000,0,4408000
Neukaledonien,2018,12,3225000,44000,3269000
Neukaledonien,2019,1,3544000,0,3544000
Neukaledonien,2019,2,2741000,51000,2792000
Neukaledonien,2019,3,10519000,51000,10570000
Neukaledonien,2019,4,3082000,88000,3170000
Neukaledonien,2019,5,3247000,116000,3363000
Neukaledonien,2019,6,4073000,37000,4110000
Neukaledonien,2019,7,3250000,28000,3278000
Neukaledonien,2019,8,2877000,75000,2952000
Neukaledonien,2019,9,3511000,5000,3516000
Neukaledonien,2019,10,3165000,35000,3200000
Neukaledonien,2019,11,2563000,38000,2601000
Neukaledonien,2019,12,3404000,19000,3423000
Neukaledonien,2020,1,2666000,8000,2674000
Neukaledonien,2020,2,2877000,70000,2947000
Neukaledonien,2020,3,3654000,141000,3795000
Neukaledonien,2020,4,2016000,230000,2246000
Neukaledonien,2020,5,1787000,26000,1813000
Neukaledonien,2020,6,2436000,0,2436000
Neukaledonien,2020,7,4118000,90000,4208000
Neukaledonien,2020,8,7326000,12000,7338000
Neukaledonien,2020,9,2458000,19000,2477000
Neukaledonien,2020,10,3742000,12000,3754000
Neukaledonien,2020,11,3158000,3000,3161000
Neukaledonien,2020,12,3181000,26000,3207000
Neukaledonien,2021,1,2350000,207000,2557000
Neukaledonien,2021,2,3964000,107000,4071000
Neukaledonien,2021,3,2978000,129000,3107000
Neukaledonien,2021,4,2541000,5000,2546000
Neukaledonien,2021,5,2584000,153000,2737000
Neukaledonien,2021,6,2662000,0,2662000
Neukaledonien,2021,7,3069000,122000,3191000
Neukaledonien,2021,8,2288000,61000,2349000
Neukaledonien,2021,9,2264000,4000,2268000
Neukaledonien,2021,10,1815000,6000,1821000
Neukaledonien,2021,11,3331000,135000,3466000
Neukaledonien,2021,12,3802000,51000,3853000
Neukaledonien,2022,1,3223000,7000,3230000
Neukaledonien,2022,2,2693000,53000,2746000
Neukaledonien,2022,3,4119000,3208000,7327000
Neukaledonien,2022,4,3981000,1368000,5349000
Neukaledonien,2022,5,2646000,8043000,10689000
Neukaledonien,2022,6,2864000,4000,2868000
Neukaledonien,2022,7,2362000,862000,3224000
Neukaledonien,2022,8,4587000,1850000,6437000
Neukaledonien,2022,9,2829000,646000,3475000
Neukaledonien,2022,10,3274000,1650000,4924000
Neukaledonien,2022,11,4026000,3192000,7218000
Neukaledonien,2022,12,5958000,1196000,7154000
Neukaledonien,2023,1,6731000,3867000,10598000
Neukaledonien,2023,2,3888000,48000,3936000
Neukaledonien,2023,3,6133000,2488000,8621000
Neukaledonien,2023,4,3048000,1072000,4120000
Neukaledonien,2023,5,4423000,1236000,5659000
Neukaledonien,2023,6,3516000,919000,4435000
Neukaledonien,2023,7,3854000,453000,4307000
Neukaledonien,2023,8,3184000,929000,4113000
Neukaledonien,2023,9,4978000,660000,5638000
Neukaledonien,2023,10,4375000,473000,4848000
Neukaledonien,2023,11,3512000,218000,3730000
Neukaledonien,2023,12,4738000,28000,4766000
Neukaledonien,2024,1,4696000,173000,4869000
Neukaledonien,2024,2,1840000,291000,2131000
Neukaledonien,2024,3,3060000,4000,3064000
Neukaledonien,2024,4,2606000,629000,3235000
Neukaledonien,2024,5,1719000,373000,2092000
Neukaledonien,2024,6,1613000,913000,2526000
Neukaledonien,2024,7,1658000,53000,1711000
Neukaledonien,2024,8,1126000,874000,2000000
Neukaledonien,2024,9,8349000,763000,9112000
Neukaledonien,2024,10,1681000,0,1681000
Neukaledonien,2024,11,3001000,65000,3066000
Neukaledonien,2024,12,1725000,0,1725000
Neuseeland,2008,1,61308000,35658000,96966000
Neuseeland,2008,2,54013000,35281000,89294000
Neuseeland,2008,3,56919000,56242000,113161000
Neuseeland,2008,4,66962000,58314000,125276000
Neuseeland,2008,5,54502000,60735000,115237000
Neuseeland,2008,6,72339000,71267000,143606000
Neuseeland,2008,7,67493000,76935000,144428000
Neuseeland,2008,8,64517000,58523000,123040000
Neuseeland,2008,9,69602000,60397000,129999000
Neuseeland,2008,10,66001000,48056000,114057000
Neuseeland,2008,11,61502000,43668000,105170000
Neuseeland,2008,12,50838000,31506000,82344000
Neuseeland,2009,1,43827000,33299000,77126000
Neuseeland,2009,2,54009000,29805000,83814000
Neuseeland,2009,3,43677000,46317000,89994000
Neuseeland,2009,4,53987000,46056000,100043000
Neuseeland,2009,5,47992000,54273000,102265000
Neuseeland,2009,6,56004000,50456000,106460000
Neuseeland,2009,7,61299000,56692000,117991000
Neuseeland,2009,8,41456000,47793000,89249000
Neuseeland,2009,9,57437000,39245000,96682000
Neuseeland,2009,10,45857000,38236000,84093000
Neuseeland,2009,11,57340000,40105000,97445000
Neuseeland,2009,12,50295000,26579000,76874000
Neuseeland,2010,1,41945000,28216000,70161000
Neuseeland,2010,2,48617000,31694000,80311000
Neuseeland,2010,3,59095000,51269000,110364000
Neuseeland,2010,4,55462000,40370000,95832000
Neuseeland,2010,5,59467000,58431000,117898000
Neuseeland,2010,6,69503000,67179000,136682000
Neuseeland,2010,7,72340000,55596000,127936000
Neuseeland,2010,8,62969000,55525000,118494000
Neuseeland,2010,9,62587000,48127000,110714000
Neuseeland,2010,10,70076000,42341000,112417000
Neuseeland,2010,11,56788000,40873000,97661000
Neuseeland,2010,12,56874000,29084000,85958000
Neuseeland,2011,1,55913000,37431000,93344000
Neuseeland,2011,2,58692000,32910000,91602000
Neuseeland,2011,3,81166000,54456000,135622000
Neuseeland,2011,4,71070000,59458000,130528000
Neuseeland,2011,5,74562000,77672000,152234000
Neuseeland,2011,6,64615000,79054000,143669000
Neuseeland,2011,7,80380000,69380000,149760000
Neuseeland,2011,8,83459000,58588000,142047000
Neuseeland,2011,9,83311000,58889000,142200000
Neuseeland,2011,10,78844000,54364000,133208000
Neuseeland,2011,11,74969000,51057000,126026000
Neuseeland,2011,12,72362000,38273000,110635000
Neuseeland,2012,1,60470000,33631000,94101000
Neuseeland,2012,2,67177000,37950000,105127000
Neuseeland,2012,3,122878000,64103000,186981000
Neuseeland,2012,4,77574000,46561000,124135000
Neuseeland,2012,5,77372000,58622000,135994000
Neuseeland,2012,6,87347000,62729000,150076000
Neuseeland,2012,7,100754000,54913000,155667000
Neuseeland,2012,8,92656000,61238000,153894000
Neuseeland,2012,9,86263000,39302000,125565000
Neuseeland,2012,10,84620000,51070000,135690000
Neuseeland,2012,11,78918000,50164000,129082000
Neuseeland,2012,12,72774000,30171000,102945000
Neuseeland,2013,1,71345000,36545000,107890000
Neuseeland,2013,2,87945000,35636000,123581000
Neuseeland,2013,3,75527000,53737000,129264000
Neuseeland,2013,4,76268000,50222000,126490000
Neuseeland,2013,5,85607000,53954000,139561000
Neuseeland,2013,6,90392000,66096000,156488000
Neuseeland,2013,7,104139000,56783000,160922000
Neuseeland,2013,8,89509000,56166000,145675000
Neuseeland,2013,9,90730000,44439000,135169000
Neuseeland,2013,10,83436000,40528000,123964000
Neuseeland,2013,11,148263000,44424000,192687000
Neuseeland,2013,12,83132000,34178000,117310000
Neuseeland,2014,1,76207000,34154000,110361000
Neuseeland,2014,2,87472000,36133000,123605000
Neuseeland,2014,3,79479000,50721000,130200000
Neuseeland,2014,4,82484000,50296000,132780000
Neuseeland,2014,5,90402000,52745000,143147000
Neuseeland,2014,6,91481000,61672000,153153000
Neuseeland,2014,7,119721000,57053000,176774000
Neuseeland,2014,8,77769000,46756000,124525000
Neuseeland,2014,9,98552000,47866000,146418000
Neuseeland,2014,10,114053000,53278000,167331000
Neuseeland,2014,11,83115000,57321000,140436000
Neuseeland,2014,12,77761000,38068000,115829000
Neuseeland,2015,1,84958000,35311000,120269000
Neuseeland,2015,2,79549000,36844000,116393000
Neuseeland,2015,3,101874000,54220000,156094000
Neuseeland,2015,4,88771000,50733000,139504000
Neuseeland,2015,5,81080000,54534000,135614000
Neuseeland,2015,6,96158000,69714000,165872000
Neuseeland,2015,7,121166000,66913000,188079000
Neuseeland,2015,8,83727000,53017000,136744000
Neuseeland,2015,9,89867000,48337000,138204000
Neuseeland,2015,10,86962000,39694000,126656000
Neuseeland,2015,11,84774000,57372000,142146000
Neuseeland,2015,12,80686000,30977000,111663000
Neuseeland,2016,1,75930000,43799000,119729000
Neuseeland,2016,2,77119000,42398000,119517000
Neuseeland,2016,3,81371000,62222000,143593000
Neuseeland,2016,4,86199000,52544000,138743000
Neuseeland,2016,5,81085000,69752000,150837000
Neuseeland,2016,6,103674000,66958000,170632000
Neuseeland,2016,7,97630000,71995000,169625000
Neuseeland,2016,8,88646000,64604000,153250000
Neuseeland,2016,9,101629000,51665000,153294000
Neuseeland,2016,10,101393000,48641000,150034000
Neuseeland,2016,11,107276000,50772000,158048000
Neuseeland,2016,12,94449000,37427000,131876000
Neuseeland,2017,1,87597000,39580000,127177000
Neuseeland,2017,2,93695000,39465000,133160000
Neuseeland,2017,3,119746000,62019000,181765000
Neuseeland,2017,4,97831000,61322000,159153000
Neuseeland,2017,5,112368000,78244000,190612000
Neuseeland,2017,6,116923000,72486000,189409000
Neuseeland,2017,7,121629000,73862000,195491000
Neuseeland,2017,8,119438000,66049000,185487000
Neuseeland,2017,9,121334000,63706000,185040000
Neuseeland,2017,10,121436000,48603000,170039000
Neuseeland,2017,11,120411000,54179000,174590000
Neuseeland,2017,12,99541000,45056000,144597000
Neuseeland,2018,1,93702000,53471000,147173000
Neuseeland,2018,2,110988000,42690000,153678000
Neuseeland,2018,3,113601000,61909000,175510000
Neuseeland,2018,4,111169000,69697000,180866000
Neuseeland,2018,5,111180000,74007000,185187000
Neuseeland,2018,6,129977000,74051000,204028000
Neuseeland,2018,7,127915000,91221000,219136000
Neuseeland,2018,8,107969000,68770000,176739000
Neuseeland,2018,9,103328000,60733000,164061000
Neuseeland,2018,10,109936000,56833000,166769000
Neuseeland,2018,11,234069000,54671000,288740000
Neuseeland,2018,12,146491000,37155000,183646000
Neuseeland,2019,1,93309000,47473000,140782000
Neuseeland,2019,2,211137000,37768000,248905000
Neuseeland,2019,3,96282000,46692000,142974000
Neuseeland,2019,4,220687000,70809000,291496000
Neuseeland,2019,5,108878000,74826000,183704000
Neuseeland,2019,6,128429000,70958000,199387000
Neuseeland,2019,7,212515000,72063000,284578000
Neuseeland,2019,8,101807000,66783000,168590000
Neuseeland,2019,9,175436000,52294000,227730000
Neuseeland,2019,10,101388000,52661000,154049000
Neuseeland,2019,11,172623000,49989000,222612000
Neuseeland,2019,12,94079000,34963000,129042000
Neuseeland,2020,1,98608000,44178000,142786000
Neuseeland,2020,2,89845000,32951000,122796000
Neuseeland,2020,3,93886000,55527000,149413000
Neuseeland,2020,4,66394000,68164000,134558000
Neuseeland,2020,5,79543000,66695000,146238000
Neuseeland,2020,6,95714000,64828000,160542000
Neuseeland,2020,7,144040000,75115000,219155000
Neuseeland,2020,8,90507000,57666000,148173000
Neuseeland,2020,9,108879000,76535000,185414000
Neuseeland,2020,10,101306000,59148000,160454000
Neuseeland,2020,11,104867000,62900000,167767000
Neuseeland,2020,12,119644000,49791000,169435000
Neuseeland,2021,1,92534000,38612000,131146000
Neuseeland,2021,2,109260000,33705000,142965000
Neuseeland,2021,3,130251000,53248000,183499000
Neuseeland,2021,4,117642000,51664000,169306000
Neuseeland,2021,5,127589000,55347000,182936000
Neuseeland,2021,6,142161000,73875000,216036000
Neuseeland,2021,7,149626000,70302000,219928000
Neuseeland,2021,8,105503000,59838000,165341000
Neuseeland,2021,9,157697000,64108000,221805000
Neuseeland,2021,10,135918000,52083000,188001000
Neuseeland,2021,11,158363000,48356000,206719000
Neuseeland,2021,12,159468000,47028000,206496000
Neuseeland,2022,1,118645000,43803000,162448000
Neuseeland,2022,2,146718000,47268000,193986000
Neuseeland,2022,3,180401000,45860000,226261000
Neuseeland,2022,4,130926000,49026000,179952000
Neuseeland,2022,5,151479000,71636000,223115000
Neuseeland,2022,6,139556000,68933000,208489000
Neuseeland,2022,7,131428000,69997000,201425000
Neuseeland,2022,8,136129000,81896000,218025000
Neuseeland,2022,9,167143000,90218000,257361000
Neuseeland,2022,10,197719000,61974000,259693000
Neuseeland,2022,11,231847000,78370000,310217000
Neuseeland,2022,12,139229000,43550000,182779000
Neuseeland,2023,1,122421000,43496000,165917000
Neuseeland,2023,2,202434000,53275000,255709000
Neuseeland,2023,3,136297000,56044000,192341000
Neuseeland,2023,4,105765000,44877000,150642000
Neuseeland,2023,5,139058000,70831000,209889000
Neuseeland,2023,6,131445000,79867000,211312000
Neuseeland,2023,7,130688000,71977000,202665000
Neuseeland,2023,8,113543000,72023000,185566000
Neuseeland,2023,9,106326000,64291000,170617000
Neuseeland,2023,10,182554000,57630000,240184000
Neuseeland,2023,11,112989000,40942000,153931000
Neuseeland,2023,12,107601000,31846000,139447000
Neuseeland,2024,1,109344000,36940000,146284000
Neuseeland,2024,2,174263000,49198000,223461000
Neuseeland,2024,3,108607000,42675000,151282000
Neuseeland,2024,4,110995000,49069000,160064000
Neuseeland,2024,5,114030000,74628000,188658000
Neuseeland,2024,6,209626000,76789000,286415000
Neuseeland,2024,7,137196000,83570000,220766000
Neuseeland,2024,8,123359000,78173000,201532000
Neuseeland,2024,9,122181000,81198000,203379000
Neuseeland,2024,10,97617000,63599000,161216000
Neuseeland,2024,11,120715000,59249000,179964000
Neuseeland,2024,12,96678000,34923000,131601000
Neuseeländisch-Ozeanien (bis 2000),2008,1,0,0,0
Neuseeländisch-Ozeanien (bis 2000),2008,2,0,0,0
Neuseeländisch-Ozeanien (bis 2000),2008,3,0,0,0
Neuseeländisch-Ozeanien (bis 2000),2008,4,0,0,0
Neuseeländisch-Ozeanien (bis 2000),2008,5,0,0,0
Neuseeländisch-Ozeanien (bis 2000),2008,6,0,0,0
Neuseeländisch-Ozeanien (bis 2000),2008,7,0,0,0
Neuseeländisch-Ozeanien (bis 2000),2008,8,0,0,0
Neuseeländisch-Ozeanien (bis 2000),2008,9,0,0,0
Neuseeländisch-Ozeanien (bis 2000),2008,10,0,0,0
Neuseeländisch-Ozeanien (bis 2000),2008,11,0,0,0
Neuseeländisch-Ozeanien (bis 2000),2008,12,0,0,0
Neuseeländisch-Ozeanien (bis 2000),2009,1,0,0,0
Neuseeländisch-Ozeanien (bis 2000),2009,2,0,0,0
Neuseeländisch-Ozeanien (bis 2000),2009,3,0,0,0
Neuseeländisch-Ozeanien (bis 2000),2009,4,0,0,0
Neuseeländisch-Ozeanien (bis 2000),2009,5,0,0,0
Neuseeländisch-Ozeanien (bis 2000),2009,6,0,0,0
Neuseeländisch-Ozeanien (bis 2000),2009,7,0,0,0
Neuseeländisch-Ozeanien (bis 2000),2009,8,0,0,0
Neuseeländisch-Ozeanien (bis 2000),2009,9,0,0,0
Neuseeländisch-Ozeanien (bis 2000),2009,10,0,0,0
Neuseeländisch-Ozeanien (bis 2000),2009,11,0,0,0
Neuseeländisch-Ozeanien (bis 2000),2009,12,0,0,0
Neuseeländisch-Ozeanien (bis 2000),2010,1,0,0,0
Neuseeländisch-Ozeanien (bis 2000),2010,2,0,0,0
Neuseeländisch-Ozeanien (bis 2000),2010,3,0,0,0
Neuseeländisch-Ozeanien (bis 2000),2010,4,0,0,0
Neuseeländisch-Ozeanien (bis 2000),2010,5,0,0,0
Neuseeländisch-Ozeanien (bis 2000),2010,6,0,0,0
Neuseeländisch-Ozeanien (bis 2000),2010,7,0,0,0
Neuseeländisch-Ozeanien (bis 2000),2010,8,0,0,0
Neuseeländisch-Ozeanien (bis 2000),2010,9,0,0,0
Neuseeländisch-Ozeanien (bis 2000),2010,10,0,0,0
Neuseeländisch-Ozeanien (bis 2000),2010,11,0,0,0
Neuseeländisch-Ozeanien (bis 2000),2010,12,0,0,0
Neuseeländisch-Ozeanien (bis 2000),2011,1,0,0,0
Neuseeländisch-Ozeanien (bis 2000),2011,2,0,0,0
Neuseeländisch-Ozeanien (bis 2000),2011,3,0,0,0
Neuseeländisch-Ozeanien (bis 2000),2011,4,0,0,0
Neuseeländisch-Ozeanien (bis 2000),2011,5,0,0,0
Neuseeländisch-Ozeanien (bis 2000),2011,6,0,0,0
Neuseeländisch-Ozeanien (bis 2000),2011,7,0,0,0
Neuseeländisch-Ozeanien (bis 2000),2011,8,0,0,0
Neuseeländisch-Ozeanien (bis 2000),2011,9,0,0,0
Neuseeländisch-Ozeanien (bis 2000),2011,10,0,0,0
Neuseeländisch-Ozeanien (bis 2000),2011,11,0,0,0
Neuseeländisch-Ozeanien (bis 2000),2011,12,0,0,0
Neuseeländisch-Ozeanien (bis 2000),2012,1,0,0,0
Neuseeländisch-Ozeanien (bis 2000),2012,2,0,0,0
Neuseeländisch-Ozeanien (bis 2000),2012,3,0,0,0
Neuseeländisch-Ozeanien (bis 2000),2012,4,0,0,0
Neuseeländisch-Ozeanien (bis 2000),2012,5,0,0,0
Neuseeländisch-Ozeanien (bis 2000),2012,6,0,0,0
Neuseeländisch-Ozeanien (bis 2000),2012,7,0,0,0
Neuseeländisch-Ozeanien (bis 2000),2012,8,0,0,0
Neuseeländisch-Ozeanien (bis 2000),2012,9,0,0,0
Neuseeländisch-Ozeanien (bis 2000),2012,10,0,0,0
Neuseeländisch-Ozeanien (bis 2000),2012,11,0,0,0
Neuseeländisch-Ozeanien (bis 2000),2012,12,0,0,0
Neuseeländisch-Ozeanien (bis 2000),2013,1,0,0,0
Neuseeländisch-Ozeanien (bis 2000),2013,2,0,0,0
Neuseeländisch-Ozeanien (bis 2000),2013,3,0,0,0
Neuseeländisch-Ozeanien (bis 2000),2013,4,0,0,0
Neuseeländisch-Ozeanien (bis 2000),2013,5,0,0,0
Neuseeländisch-Ozeanien (bis 2000),2013,6,0,0,0
Neuseeländisch-Ozeanien (bis 2000),2013,7,0,0,0
Neuseeländisch-Ozeanien (bis 2000),2013,8,0,0,0
Neuseeländisch-Ozeanien (bis 2000),2013,9,0,0,0
Neuseeländisch-Ozeanien (bis 2000),2013,10,0,0,0
Neuseeländisch-Ozeanien (bis 2000),2013,11,0,0,0
Neuseeländisch-Ozeanien (bis 2000),2013,12,0,0,0
Neuseeländisch-Ozeanien (bis 2000),2014,1,0,0,0
Neuseeländisch-Ozeanien (bis 2000),2014,2,0,0,0
Neuseeländisch-Ozeanien (bis 2000),2014,3,0,0,0
Neuseeländisch-Ozeanien (bis 2000),2014,4,0,0,0
Neuseeländisch-Ozeanien (bis 2000),2014,5,0,0,0
Neuseeländisch-Ozeanien (bis 2000),2014,6,0,0,0
Neuseeländisch-Ozeanien (bis 2000),2014,7,0,0,0
Neuseeländisch-Ozeanien (bis 2000),2014,8,0,0,0
Neuseeländisch-Ozeanien (bis 2000),2014,9,0,0,0
Neuseeländisch-Ozeanien (bis 2000),2014,10,0,0,0
Neuseeländisch-Ozeanien (bis 2000),2014,11,0,0,0
Neuseeländisch-Ozeanien (bis 2000),2014,12,0,0,0
Neuseeländisch-Ozeanien (bis 2000),2015,1,0,0,0
Neuseeländisch-Ozeanien (bis 2000),2015,2,0,0,0
Neuseeländisch-Ozeanien (bis 2000),2015,3,0,0,0
Neuseeländisch-Ozeanien (bis 2000),2015,4,0,0,0
Neuseeländisch-Ozeanien (bis 2000),2015,5,0,0,0
Neuseeländisch-Ozeanien (bis 2000),2015,6,0,0,0
Neuseeländisch-Ozeanien (bis 2000),2015,7,0,0,0
Neuseeländisch-Ozeanien (bis 2000),2015,8,0,0,0
Neuseeländisch-Ozeanien (bis 2000),2015,9,0,0,0
Neuseeländisch-Ozeanien (bis 2000),2015,10,0,0,0
Neuseeländisch-Ozeanien (bis 2000),2015,11,0,0,0
Neuseeländisch-Ozeanien (bis 2000),2015,12,0,0,0
Neuseeländisch-Ozeanien (bis 2000),2016,1,0,0,0
Neuseeländisch-Ozeanien (bis 2000),2016,2,0,0,0
Neuseeländisch-Ozeanien (bis 2000),2016,3,0,0,0
Neuseeländisch-Ozeanien (bis 2000),2016,4,0,0,0
Neuseeländisch-Ozeanien (bis 2000),2016,5,0,0,0
Neuseeländisch-Ozeanien (bis 2000),2016,6,0,0,0
Neuseeländisch-Ozeanien (bis 2000),2016,7,0,0,0
Neuseeländisch-Ozeanien (bis 2000),2016,8,0,0,0
Neuseeländisch-Ozeanien (bis 2000),2016,9,0,0,0
Neuseeländisch-Ozeanien (bis 2000),2016,10,0,0,0
Neuseeländisch-Ozeanien (bis 2000),2016,11,0,0,0
Neuseeländisch-Ozeanien (bis 2000),2016,12,0,0,0
Neuseeländisch-Ozeanien (bis 2000),2017,1,0,0,0
Neuseeländisch-Ozeanien (bis 2000),2017,2,0,0,0
Neuseeländisch-Ozeanien (bis 2000),2017,3,0,0,0
Neuseeländisch-Ozeanien (bis 2000),2017,4,0,0,0
Neuseeländisch-Ozeanien (bis 2000),2017,5,0,0,0
Neuseeländisch-Ozeanien (bis 2000),2017,6,0,0,0
Neuseeländisch-Ozeanien (bis 2000),2017,7,0,0,0
Neuseeländisch-Ozeanien (bis 2000),2017,8,0,0,0
Neuseeländisch-Ozeanien (bis 2000),2017,9,0,0,0
Neuseeländisch-Ozeanien (bis 2000),2017,10,0,0,0
Neuseeländisch-Ozeanien (bis 2000),2017,11,0,0,0
Neuseeländisch-Ozeanien (bis 2000),2017,12,0,0,0
Neuseeländisch-Ozeanien (bis 2000),2018,1,0,0,0
Neuseeländisch-Ozeanien (bis 2000),2018,2,0,0,0
Neuseeländisch-Ozeanien (bis 2000),2018,3,0,0,0
Neuseeländisch-Ozeanien (bis 2000),2018,4,0,0,0
Neuseeländisch-Ozeanien (bis 2000),2018,5,0,0,0
Neuseeländisch-Ozeanien (bis 2000),2018,6,0,0,0
Neuseeländisch-Ozeanien (bis 2000),2018,7,0,0,0
Neuseeländisch-Ozeanien (bis 2000),2018,8,0,0,0
Neuseeländisch-Ozeanien (bis 2000),2018,9,0,0,0
Neuseeländisch-Ozeanien (bis 2000),2018,10,0,0,0
Neuseeländisch-Ozeanien (bis 2000),2018,11,0,0,0
Neuseeländisch-Ozeanien (bis 2000),2018,12,0,0,0
Neuseeländisch-Ozeanien (bis 2000),2019,1,0,0,0
Neuseeländisch-Ozeanien (bis 2000),2019,2,0,0,0
Neuseeländisch-Ozeanien (bis 2000),2019,3,0,0,0
Neuseeländisch-Ozeanien (bis 2000),2019,4,0,0,0
Neuseeländisch-Ozeanien (bis 2000),2019,5,0,0,0
Neuseeländisch-Ozeanien (bis 2000),2019,6,0,0,0
Neuseeländisch-Ozeanien (bis 2000),2019,7,0,0,0
Neuseeländisch-Ozeanien (bis 2000),2019,8,0,0,0
Neuseeländisch-Ozeanien (bis 2000),2019,9,0,0,0
Neuseeländisch-Ozeanien (bis 2000),2019,10,0,0,0
Neuseeländisch-Ozeanien (bis 2000),2019,11,0,0,0
Neuseeländisch-Ozeanien (bis 2000),2019,12,0,0,0
Neuseeländisch-Ozeanien (bis 2000),2020,1,0,0,0
Neuseeländisch-Ozeanien (bis 2000),2020,2,0,0,0
Neuseeländisch-Ozeanien (bis 2000),2020,3,0,0,0
Neuseeländisch-Ozeanien (bis 2000),2020,4,0,0,0
Neuseeländisch-Ozeanien (bis 2000),2020,5,0,0,0
Neuseeländisch-Ozeanien (bis 2000),2020,6,0,0,0
Neuseeländisch-Ozeanien (bis 2000),2020,7,0,0,0
Neuseeländisch-Ozeanien (bis 2000),2020,8,0,0,0
Neuseeländisch-Ozeanien (bis 2000),2020,9,0,0,0
Neuseeländisch-Ozeanien (bis 2000),2020,10,0,0,0
Neuseeländisch-Ozeanien (bis 2000),2020,11,0,0,0
Neuseeländisch-Ozeanien (bis 2000),2020,12,0,0,0
Neuseeländisch-Ozeanien (bis 2000),2021,1,0,0,0
Neuseeländisch-Ozeanien (bis 2000),2021,2,0,0,0
Neuseeländisch-Ozeanien (bis 2000),2021,3,0,0,0
Neuseeländisch-Ozeanien (bis 2000),2021,4,0,0,0
Neuseeländisch-Ozeanien (bis 2000),2021,5,0,0,0
Neuseeländisch-Ozeanien (bis 2000),2021,6,0,0,0
Neuseeländisch-Ozeanien (bis 2000),2021,7,0,0,0
Neuseeländisch-Ozeanien (bis 2000),2021,8,0,0,0
Neuseeländisch-Ozeanien (bis 2000),2021,9,0,0,0
Neuseeländisch-Ozeanien (bis 2000),2021,10,0,0,0
Neuseeländisch-Ozeanien (bis 2000),2021,11,0,0,0
Neuseeländisch-Ozeanien (bis 2000),2021,12,0,0,0
Neuseeländisch-Ozeanien (bis 2000),2022,1,0,0,0
Neuseeländisch-Ozeanien (bis 2000),2022,2,0,0,0
Neuseeländisch-Ozeanien (bis 2000),2022,3,0,0,0
Neuseeländisch-Ozeanien (bis 2000),2022,4,0,0,0
Neuseeländisch-Ozeanien (bis 2000),2022,5,0,0,0
Neuseeländisch-Ozeanien (bis 2000),2022,6,0,0,0
Neuseeländisch-Ozeanien (bis 2000),2022,7,0,0,0
Neuseeländisch-Ozeanien (bis 2000),2022,8,0,0,0
Neuseeländisch-Ozeanien (bis 2000),2022,9,0,0,0
Neuseeländisch-Ozeanien (bis 2000),2022,10,0,0,0
Neuseeländisch-Ozeanien (bis 2000),2022,11,0,0,0
Neuseeländisch-Ozeanien (bis 2000),2022,12,0,0,0
Neuseeländisch-Ozeanien (bis 2000),2023,1,0,0,0
Neuseeländisch-Ozeanien (bis 2000),2023,2,0,0,0
Neuseeländisch-Ozeanien (bis 2000),2023,3,0,0,0
Neuseeländisch-Ozeanien (bis 2000),2023,4,0,0,0
Neuseeländisch-Ozeanien (bis 2000),2023,5,0,0,0
Neuseeländisch-Ozeanien (bis 2000),2023,6,0,0,0
Neuseeländisch-Ozeanien (bis 2000),2023,7,0,0,0
Neuseeländisch-Ozeanien (bis 2000),2023,8,0,0,0
Neuseeländisch-Ozeanien (bis 2000),2023,9,0,0,0
Neuseeländisch-Ozeanien (bis 2000),2023,10,0,0,0
Neuseeländisch-Ozeanien (bis 2000),2023,11,0,0,0
Neuseeländisch-Ozeanien (bis 2000),2023,12,0,0,0
Neuseeländisch-Ozeanien (bis 2000),2024,1,0,0,0
Neuseeländisch-Ozeanien (bis 2000),2024,2,0,0,0
Neuseeländisch-Ozeanien (bis 2000),2024,3,0,0,0
Neuseeländisch-Ozeanien (bis 2000),2024,4,0,0,0
Neuseeländisch-Ozeanien (bis 2000),2024,5,0,0,0
Neuseeländisch-Ozeanien (bis 2000),2024,6,0,0,0
Neuseeländisch-Ozeanien (bis 2000),2024,7,0,0,0
Neuseeländisch-Ozeanien (bis 2000),2024,8,0,0,0
Neuseeländisch-Ozeanien (bis 2000),2024,9,0,0,0
Neuseeländisch-Ozeanien (bis 2000),2024,10,0,0,0
Neuseeländisch-Ozeanien (bis 2000),2024,11,0,0,0
Neuseeländisch-Ozeanien (bis 2000),2024,12,0,0,0
Nicaragua,2008,1,1642000,2838000,4480000
Nicaragua,2008,2,2164000,1960000,4124000
Nicaragua,2008,3,1435000,1161000,2596000
Nicaragua,2008,4,1952000,4697000,6649000
Nicaragua,2008,5,2848000,2694000,5542000
Nicaragua,2008,6,2053000,1706000,3759000
Nicaragua,2008,7,1950000,1401000,3351000
Nicaragua,2008,8,1862000,1582000,3444000
Nicaragua,2008,9,3621000,1514000,5135000
Nicaragua,2008,10,1359000,1788000,3147000
Nicaragua,2008,11,1272000,996000,2268000
Nicaragua,2008,12,2035000,753000,2788000
Nicaragua,2009,1,1913000,670000,2583000
Nicaragua,2009,2,1266000,1349000,2615000
Nicaragua,2009,3,2168000,1704000,3872000
Nicaragua,2009,4,1126000,7532000,8658000
Nicaragua,2009,5,1027000,2634000,3661000
Nicaragua,2009,6,966000,1463000,2429000
Nicaragua,2009,7,1815000,1789000,3604000
Nicaragua,2009,8,2344000,1434000,3778000
Nicaragua,2009,9,1122000,1324000,2446000
Nicaragua,2009,10,1742000,935000,2677000
Nicaragua,2009,11,2572000,624000,3196000
Nicaragua,2009,12,569000,482000,1051000
Nicaragua,2010,1,1273000,1076000,2349000
Nicaragua,2010,2,1485000,1739000,3224000
Nicaragua,2010,3,1484000,1910000,3394000
Nicaragua,2010,4,1334000,2143000,3477000
Nicaragua,2010,5,1150000,2320000,3470000
Nicaragua,2010,6,1126000,2747000,3873000
Nicaragua,2010,7,1147000,2605000,3752000
Nicaragua,2010,8,1394000,2835000,4229000
Nicaragua,2010,9,3682000,1256000,4938000
Nicaragua,2010,10,2086000,1858000,3944000
Nicaragua,2010,11,2431000,958000,3389000
Nicaragua,2010,12,2029000,1532000,3561000
Nicaragua,2011,1,2206000,1935000,4141000
Nicaragua,2011,2,2151000,4781000,6932000
Nicaragua,2011,3,2072000,3873000,5945000
Nicaragua,2011,4,1721000,4885000,6606000
Nicaragua,2011,5,2330000,3758000,6088000
Nicaragua,2011,6,1829000,4141000,5970000
Nicaragua,2011,7,2574000,3587000,6161000
Nicaragua,2011,8,2825000,2215000,5040000
Nicaragua,2011,9,1737000,2511000,4248000
Nicaragua,2011,10,2347000,1360000,3707000
Nicaragua,2011,11,1889000,1142000,3031000
Nicaragua,2011,12,2583000,835000,3418000
Nicaragua,2012,1,3044000,3253000,6297000
Nicaragua,2012,2,2922000,2495000,5417000
Nicaragua,2012,3,2358000,3736000,6094000
Nicaragua,2012,4,2115000,3630000,5745000
Nicaragua,2012,5,2121000,3037000,5158000
Nicaragua,2012,6,2337000,3866000,6203000
Nicaragua,2012,7,2237000,2798000,5035000
Nicaragua,2012,8,2887000,2895000,5782000
Nicaragua,2012,9,1801000,2674000,4475000
Nicaragua,2012,10,2746000,2485000,5231000
Nicaragua,2012,11,2729000,1770000,4499000
Nicaragua,2012,12,3310000,1257000,4567000
Nicaragua,2013,1,3310000,1407000,4717000
Nicaragua,2013,2,1784000,2442000,4226000
Nicaragua,2013,3,2076000,3056000,5132000
Nicaragua,2013,4,2906000,4329000,7235000
Nicaragua,2013,5,5361000,2949000,8310000
Nicaragua,2013,6,3426000,2984000,6410000
Nicaragua,2013,7,3835000,2824000,6659000
Nicaragua,2013,8,1879000,2795000,4674000
Nicaragua,2013,9,3797000,3082000,6879000
Nicaragua,2013,10,4455000,1323000,5778000
Nicaragua,2013,11,3159000,1630000,4789000
Nicaragua,2013,12,2995000,952000,3947000
Nicaragua,2014,1,3766000,1620000,5386000
Nicaragua,2014,2,5229000,2022000,7251000
Nicaragua,2014,3,5517000,3021000,8538000
Nicaragua,2014,4,3867000,2167000,6034000
Nicaragua,2014,5,5607000,2343000,7950000
Nicaragua,2014,6,5239000,3861000,9100000
Nicaragua,2014,7,4894000,3181000,8075000
Nicaragua,2014,8,4516000,2344000,6860000
Nicaragua,2014,9,5449000,2132000,7581000
Nicaragua,2014,10,8229000,1947000,10176000
Nicaragua,2014,11,4614000,2215000,6829000
Nicaragua,2014,12,4431000,1032000,5463000
Nicaragua,2015,1,5785000,1344000,7129000
Nicaragua,2015,2,5416000,4095000,9511000
Nicaragua,2015,3,5557000,7352000,12909000
Nicaragua,2015,4,4120000,6697000,10817000
Nicaragua,2015,5,4874000,4162000,9036000
Nicaragua,2015,6,4680000,4104000,8784000
Nicaragua,2015,7,4566000,7595000,12161000
Nicaragua,2015,8,5095000,3253000,8348000
Nicaragua,2015,9,3634000,3854000,7488000
Nicaragua,2015,10,5897000,2664000,8561000
Nicaragua,2015,11,5997000,2656000,8653000
Nicaragua,2015,12,4592000,3898000,8490000
Nicaragua,2016,1,6218000,2091000,8309000
Nicaragua,2016,2,4642000,5463000,10105000
Nicaragua,2016,3,4497000,2762000,7259000
Nicaragua,2016,4,5021000,4209000,9230000
Nicaragua,2016,5,5192000,3816000,9008000
Nicaragua,2016,6,5803000,3839000,9642000
Nicaragua,2016,7,5996000,4815000,10811000
Nicaragua,2016,8,5010000,2067000,7077000
Nicaragua,2016,9,3766000,3073000,6839000
Nicaragua,2016,10,5524000,3242000,8766000
Nicaragua,2016,11,5353000,2279000,7632000
Nicaragua,2016,12,5648000,1561000,7209000
Nicaragua,2017,1,4801000,2302000,7103000
Nicaragua,2017,2,3503000,3864000,7367000
Nicaragua,2017,3,5788000,5231000,11019000
Nicaragua,2017,4,6488000,4028000,10516000
Nicaragua,2017,5,5287000,8557000,13844000
Nicaragua,2017,6,6224000,6092000,12316000
Nicaragua,2017,7,4177000,9043000,13220000
Nicaragua,2017,8,4155000,5475000,9630000
Nicaragua,2017,9,4708000,6758000,11466000
Nicaragua,2017,10,5835000,4111000,9946000
Nicaragua,2017,11,4858000,6013000,10871000
Nicaragua,2017,12,4525000,3866000,8391000
Nicaragua,2018,1,6047000,5474000,11521000
Nicaragua,2018,2,4654000,3496000,8150000
Nicaragua,2018,3,5868000,7632000,13500000
Nicaragua,2018,4,4494000,8815000,13309000
Nicaragua,2018,5,6367000,6355000,12722000
Nicaragua,2018,6,4775000,8990000,13765000
Nicaragua,2018,7,4025000,7384000,11409000
Nicaragua,2018,8,2199000,8295000,10494000
Nicaragua,2018,9,2933000,5954000,8887000
Nicaragua,2018,10,4366000,7091000,11457000
Nicaragua,2018,11,4246000,6951000,11197000
Nicaragua,2018,12,3782000,3868000,7650000
Nicaragua,2019,1,5181000,4593000,9774000
Nicaragua,2019,2,4472000,3567000,8039000
Nicaragua,2019,3,4120000,6397000,10517000
Nicaragua,2019,4,4405000,6380000,10785000
Nicaragua,2019,5,3541000,9061000,12602000
Nicaragua,2019,6,3050000,6196000,9246000
Nicaragua,2019,7,4776000,5416000,10192000
Nicaragua,2019,8,3302000,6866000,10168000
Nicaragua,2019,9,3051000,10500000,13551000
Nicaragua,2019,10,4103000,6570000,10673000
Nicaragua,2019,11,4753000,5512000,10265000
Nicaragua,2019,12,3241000,3331000,6572000
Nicaragua,2020,1,3811000,6004000,9815000
Nicaragua,2020,2,3434000,3730000,7164000
Nicaragua,2020,3,4034000,8250000,12284000
Nicaragua,2020,4,3837000,10288000,14125000
Nicaragua,2020,5,4193000,8864000,13057000
Nicaragua,2020,6,3406000,7852000,11258000
Nicaragua,2020,7,4340000,5347000,9687000
Nicaragua,2020,8,4069000,6642000,10711000
Nicaragua,2020,9,3942000,6011000,9953000
Nicaragua,2020,10,5251000,6996000,12247000
Nicaragua,2020,11,3237000,4156000,7393000
Nicaragua,2020,12,4630000,3883000,8513000
Nicaragua,2021,1,3062000,4228000,7290000
Nicaragua,2021,2,3844000,5811000,9655000
Nicaragua,2021,3,6185000,6749000,12934000
Nicaragua,2021,4,4666000,7264000,11930000
Nicaragua,2021,5,3538000,9591000,13129000
Nicaragua,2021,6,5608000,9809000,15417000
Nicaragua,2021,7,3413000,7640000,11053000
Nicaragua,2021,8,3614000,10085000,13699000
Nicaragua,2021,9,6262000,6999000,13261000
Nicaragua,2021,10,2620000,11264000,13884000
Nicaragua,2021,11,3792000,10752000,14544000
Nicaragua,2021,12,9868000,5814000,15682000
Nicaragua,2022,1,3345000,7859000,11204000
Nicaragua,2022,2,3070000,6737000,9807000
Nicaragua,2022,3,4852000,10291000,15143000
Nicaragua,2022,4,2757000,10316000,13073000
Nicaragua,2022,5,3532000,9704000,13236000
Nicaragua,2022,6,4355000,11967000,16322000
Nicaragua,2022,7,4625000,9060000,13685000
Nicaragua,2022,8,5093000,14175000,19268000
Nicaragua,2022,9,6676000,8170000,14846000
Nicaragua,2022,10,3695000,8363000,12058000
Nicaragua,2022,11,4072000,6180000,10252000
Nicaragua,2022,12,3956000,8174000,12130000
Nicaragua,2023,1,4505000,3507000,8012000
Nicaragua,2023,2,4345000,5920000,10265000
Nicaragua,2023,3,5080000,5356000,10436000
Nicaragua,2023,4,3984000,11802000,15786000
Nicaragua,2023,5,6147000,6882000,13029000
Nicaragua,2023,6,3823000,9497000,13320000
Nicaragua,2023,7,5121000,6890000,12011000
Nicaragua,2023,8,8050000,8476000,16526000
Nicaragua,2023,9,4021000,5428000,9449000
Nicaragua,2023,10,4810000,4387000,9197000
Nicaragua,2023,11,4982000,5598000,10580000
Nicaragua,2023,12,3919000,5473000,9392000
Nicaragua,2024,1,7035000,4360000,11395000
Nicaragua,2024,2,3318000,4404000,7722000
Nicaragua,2024,3,4688000,3630000,8318000
Nicaragua,2024,4,7591000,5742000,13333000
Nicaragua,2024,5,5354000,8880000,14234000
Nicaragua,2024,6,6852000,7811000,14663000
Nicaragua,2024,7,6643000,9625000,16268000
Nicaragua,2024,8,5637000,10422000,16059000
Nicaragua,2024,9,5863000,6933000,12796000
Nicaragua,2024,10,5723000,7607000,13330000
Nicaragua,2024,11,7304000,6557000,13861000
Nicaragua,2024,12,3720000,7544000,11264000
Nicht ermittelte Länder (innergem. Warenverkehr),2008,1,0,0,0
Nicht ermittelte Länder (innergem. Warenverkehr),2008,2,0,0,0
Nicht ermittelte Länder (innergem. Warenverkehr),2008,3,0,0,0
Nicht ermittelte Länder (innergem. Warenverkehr),2008,4,0,0,0
Nicht ermittelte Länder (innergem. Warenverkehr),2008,5,0,0,0
Nicht ermittelte Länder (innergem. Warenverkehr),2008,6,0,0,0
Nicht ermittelte Länder (innergem. Warenverkehr),2008,7,0,0,0
Nicht ermittelte Länder (innergem. Warenverkehr),2008,8,0,0,0
Nicht ermittelte Länder (innergem. Warenverkehr),2008,9,0,0,0
Nicht ermittelte Länder (innergem. Warenverkehr),2008,10,0,0,0
Nicht ermittelte Länder (innergem. Warenverkehr),2008,11,0,0,0
Nicht ermittelte Länder (innergem. Warenverkehr),2008,12,0,0,0
Nicht ermittelte Länder (innergem. Warenverkehr),2009,1,0,0,0
Nicht ermittelte Länder (innergem. Warenverkehr),2009,2,0,0,0
Nicht ermittelte Länder (innergem. Warenverkehr),2009,3,0,0,0
Nicht ermittelte Länder (innergem. Warenverkehr),2009,4,0,0,0
Nicht ermittelte Länder (innergem. Warenverkehr),2009,5,0,0,0
Nicht ermittelte Länder (innergem. Warenverkehr),2009,6,0,0,0
Nicht ermittelte Länder (innergem. Warenverkehr),2009,7,0,0,0
Nicht ermittelte Länder (innergem. Warenverkehr),2009,8,0,0,0
Nicht ermittelte Länder (innergem. Warenverkehr),2009,9,0,0,0
Nicht ermittelte Länder (innergem. Warenverkehr),2009,10,0,0,0
Nicht ermittelte Länder (innergem. Warenverkehr),2009,11,0,0,0
Nicht ermittelte Länder (innergem. Warenverkehr),2009,12,0,0,0
Nicht ermittelte Länder (innergem. Warenverkehr),2010,1,0,0,0
Nicht ermittelte Länder (innergem. Warenverkehr),2010,2,0,0,0
Nicht ermittelte Länder (innergem. Warenverkehr),2010,3,0,0,0
Nicht ermittelte Länder (innergem. Warenverkehr),2010,4,0,0,0
Nicht ermittelte Länder (innergem. Warenverkehr),2010,5,0,0,0
Nicht ermittelte Länder (innergem. Warenverkehr),2010,6,0,0,0
Nicht ermittelte Länder (innergem. Warenverkehr),2010,7,0,0,0
Nicht ermittelte Länder (innergem. Warenverkehr),2010,8,0,0,0
Nicht ermittelte Länder (innergem. Warenverkehr),2010,9,0,0,0
Nicht ermittelte Länder (innergem. Warenverkehr),2010,10,0,0,0
Nicht ermittelte Länder (innergem. Warenverkehr),2010,11,0,0,0
Nicht ermittelte Länder (innergem. Warenverkehr),2010,12,0,0,0
Nicht ermittelte Länder (innergem. Warenverkehr),2011,1,0,0,0
Nicht ermittelte Länder (innergem. Warenverkehr),2011,2,0,0,0
Nicht ermittelte Länder (innergem. Warenverkehr),2011,3,0,0,0
Nicht ermittelte Länder (innergem. Warenverkehr),2011,4,0,0,0
Nicht ermittelte Länder (innergem. Warenverkehr),2011,5,0,0,0
Nicht ermittelte Länder (innergem. Warenverkehr),2011,6,0,0,0
Nicht ermittelte Länder (innergem. Warenverkehr),2011,7,0,0,0
Nicht ermittelte Länder (innergem. Warenverkehr),2011,8,0,0,0
Nicht ermittelte Länder (innergem. Warenverkehr),2011,9,0,0,0
Nicht ermittelte Länder (innergem. Warenverkehr),2011,10,0,0,0
Nicht ermittelte Länder (innergem. Warenverkehr),2011,11,0,0,0
Nicht ermittelte Länder (innergem. Warenverkehr),2011,12,0,0,0
Nicht ermittelte Länder (innergem. Warenverkehr),2012,1,0,0,0
Nicht ermittelte Länder (innergem. Warenverkehr),2012,2,0,0,0
Nicht ermittelte Länder (innergem. Warenverkehr),2012,3,0,0,0
Nicht ermittelte Länder (innergem. Warenverkehr),2012,4,0,0,0
Nicht ermittelte Länder (innergem. Warenverkehr),2012,5,0,0,0
Nicht ermittelte Länder (innergem. Warenverkehr),2012,6,0,0,0
Nicht ermittelte Länder (innergem. Warenverkehr),2012,7,0,0,0
Nicht ermittelte Länder (innergem. Warenverkehr),2012,8,0,0,0
Nicht ermittelte Länder (innergem. Warenverkehr),2012,9,0,0,0
Nicht ermittelte Länder (innergem. Warenverkehr),2012,10,0,0,0
Nicht ermittelte Länder (innergem. Warenverkehr),2012,11,0,0,0
Nicht ermittelte Länder (innergem. Warenverkehr),2012,12,0,0,0
Nicht ermittelte Länder (innergem. Warenverkehr),2013,1,0,0,0
Nicht ermittelte Länder (innergem. Warenverkehr),2013,2,0,0,0
Nicht ermittelte Länder (innergem. Warenverkehr),2013,3,0,0,0
Nicht ermittelte Länder (innergem. Warenverkehr),2013,4,0,0,0
Nicht ermittelte Länder (innergem. Warenverkehr),2013,5,0,0,0
Nicht ermittelte Länder (innergem. Warenverkehr),2013,6,0,0,0
Nicht ermittelte Länder (innergem. Warenverkehr),2013,7,0,0,0
Nicht ermittelte Länder (innergem. Warenverkehr),2013,8,0,0,0
Nicht ermittelte Länder (innergem. Warenverkehr),2013,9,0,0,0
Nicht ermittelte Länder (innergem. Warenverkehr),2013,10,0,0,0
Nicht ermittelte Länder (innergem. Warenverkehr),2013,11,0,0,0
Nicht ermittelte Länder (innergem. Warenverkehr),2013,12,0,0,0
Nicht ermittelte Länder (innergem. Warenverkehr),2014,1,0,0,0
Nicht ermittelte Länder (innergem. Warenverkehr),2014,2,0,0,0
Nicht ermittelte Länder (innergem. Warenverkehr),2014,3,0,0,0
Nicht ermittelte Länder (innergem. Warenverkehr),2014,4,0,0,0
Nicht ermittelte Länder (innergem. Warenverkehr),2014,5,0,0,0
Nicht ermittelte Länder (innergem. Warenverkehr),2014,6,0,0,0
Nicht ermittelte Länder (innergem. Warenverkehr),2014,7,0,0,0
Nicht ermittelte Länder (innergem. Warenverkehr),2014,8,0,0,0
Nicht ermittelte Länder (innergem. Warenverkehr),2014,9,0,0,0
Nicht ermittelte Länder (innergem. Warenverkehr),2014,10,0,0,0
Nicht ermittelte Länder (innergem. Warenverkehr),2014,11,0,0,0
Nicht ermittelte Länder (innergem. Warenverkehr),2014,12,0,0,0
Nicht ermittelte Länder (innergem. Warenverkehr),2015,1,0,0,0
Nicht ermittelte Länder (innergem. Warenverkehr),2015,2,0,0,0
Nicht ermittelte Länder (innergem. Warenverkehr),2015,3,0,0,0
Nicht ermittelte Länder (innergem. Warenverkehr),2015,4,0,0,0
Nicht ermittelte Länder (innergem. Warenverkehr),2015,5,0,0,0
Nicht ermittelte Länder (innergem. Warenverkehr),2015,6,0,0,0
Nicht ermittelte Länder (innergem. Warenverkehr),2015,7,0,0,0
Nicht ermittelte Länder (innergem. Warenverkehr),2015,8,0,0,0
Nicht ermittelte Länder (innergem. Warenverkehr),2015,9,0,0,0
Nicht ermittelte Länder (innergem. Warenverkehr),2015,10,0,0,0
Nicht ermittelte Länder (innergem. Warenverkehr),2015,11,0,0,0
Nicht ermittelte Länder (innergem. Warenverkehr),2015,12,0,0,0
Nicht ermittelte Länder (innergem. Warenverkehr),2016,1,0,0,0
Nicht ermittelte Länder (innergem. Warenverkehr),2016,2,0,0,0
Nicht ermittelte Länder (innergem. Warenverkehr),2016,3,0,0,0
Nicht ermittelte Länder (innergem. Warenverkehr),2016,4,0,0,0
Nicht ermittelte Länder (innergem. Warenverkehr),2016,5,0,0,0
Nicht ermittelte Länder (innergem. Warenverkehr),2016,6,0,0,0
Nicht ermittelte Länder (innergem. Warenverkehr),2016,7,0,0,0
Nicht ermittelte Länder (innergem. Warenverkehr),2016,8,0,0,0
Nicht ermittelte Länder (innergem. Warenverkehr),2016,9,0,0,0
Nicht ermittelte Länder (innergem. Warenverkehr),2016,10,0,0,0
Nicht ermittelte Länder (innergem. Warenverkehr),2016,11,0,0,0
Nicht ermittelte Länder (innergem. Warenverkehr),2016,12,0,0,0
Nicht ermittelte Länder (innergem. Warenverkehr),2017,1,0,0,0
Nicht ermittelte Länder (innergem. Warenverkehr),2017,2,0,0,0
Nicht ermittelte Länder (innergem. Warenverkehr),2017,3,0,0,0
Nicht ermittelte Länder (innergem. Warenverkehr),2017,4,0,0,0
Nicht ermittelte Länder (innergem. Warenverkehr),2017,5,0,0,0
Nicht ermittelte Länder (innergem. Warenverkehr),2017,6,0,0,0
Nicht ermittelte Länder (innergem. Warenverkehr),2017,7,0,0,0
Nicht ermittelte Länder (innergem. Warenverkehr),2017,8,0,0,0
Nicht ermittelte Länder (innergem. Warenverkehr),2017,9,0,0,0
Nicht ermittelte Länder (innergem. Warenverkehr),2017,10,0,0,0
Nicht ermittelte Länder (innergem. Warenverkehr),2017,11,0,0,0
Nicht ermittelte Länder (innergem. Warenverkehr),2017,12,0,0,0
Nicht ermittelte Länder (innergem. Warenverkehr),2018,1,0,0,0
Nicht ermittelte Länder (innergem. Warenverkehr),2018,2,0,0,0
Nicht ermittelte Länder (innergem. Warenverkehr),2018,3,0,0,0
Nicht ermittelte Länder (innergem. Warenverkehr),2018,4,0,0,0
Nicht ermittelte Länder (innergem. Warenverkehr),2018,5,0,0,0
Nicht ermittelte Länder (innergem. Warenverkehr),2018,6,0,0,0
Nicht ermittelte Länder (innergem. Warenverkehr),2018,7,0,0,0
Nicht ermittelte Länder (innergem. Warenverkehr),2018,8,0,0,0
Nicht ermittelte Länder (innergem. Warenverkehr),2018,9,0,0,0
Nicht ermittelte Länder (innergem. Warenverkehr),2018,10,0,0,0
Nicht ermittelte Länder (innergem. Warenverkehr),2018,11,0,0,0
Nicht ermittelte Länder (innergem. Warenverkehr),2018,12,0,0,0
Nicht ermittelte Länder (innergem. Warenverkehr),2019,1,0,0,0
Nicht ermittelte Länder (innergem. Warenverkehr),2019,2,0,0,0
Nicht ermittelte Länder (innergem. Warenverkehr),2019,3,0,0,0
Nicht ermittelte Länder (innergem. Warenverkehr),2019,4,0,0,0
Nicht ermittelte Länder (innergem. Warenverkehr),2019,5,0,0,0
Nicht ermittelte Länder (innergem. Warenverkehr),2019,6,0,0,0
Nicht ermittelte Länder (innergem. Warenverkehr),2019,7,0,0,0
Nicht ermittelte Länder (innergem. Warenverkehr),2019,8,0,0,0
Nicht ermittelte Länder (innergem. Warenverkehr),2019,9,0,0,0
Nicht ermittelte Länder (innergem. Warenverkehr),2019,10,0,0,0
Nicht ermittelte Länder (innergem. Warenverkehr),2019,11,0,0,0
Nicht ermittelte Länder (innergem. Warenverkehr),2019,12,0,0,0
Nicht ermittelte Länder (innergem. Warenverkehr),2020,1,0,0,0
Nicht ermittelte Länder (innergem. Warenverkehr),2020,2,0,0,0
Nicht ermittelte Länder (innergem. Warenverkehr),2020,3,0,0,0
Nicht ermittelte Länder (innergem. Warenverkehr),2020,4,0,0,0
Nicht ermittelte Länder (innergem. Warenverkehr),2020,5,0,0,0
Nicht ermittelte Länder (innergem. Warenverkehr),2020,6,0,0,0
Nicht ermittelte Länder (innergem. Warenverkehr),2020,7,0,0,0
Nicht ermittelte Länder (innergem. Warenverkehr),2020,8,0,0,0
Nicht ermittelte Länder (innergem. Warenverkehr),2020,9,0,0,0
Nicht ermittelte Länder (innergem. Warenverkehr),2020,10,0,0,0
Nicht ermittelte Länder (innergem. Warenverkehr),2020,11,0,0,0
Nicht ermittelte Länder (innergem. Warenverkehr),2020,12,0,0,0
Nicht ermittelte Länder (innergem. Warenverkehr),2021,1,0,0,0
Nicht ermittelte Länder (innergem. Warenverkehr),2021,2,0,0,0
Nicht ermittelte Länder (innergem. Warenverkehr),2021,3,0,0,0
Nicht ermittelte Länder (innergem. Warenverkehr),2021,4,0,0,0
Nicht ermittelte Länder (innergem. Warenverkehr),2021,5,0,0,0
Nicht ermittelte Länder (innergem. Warenverkehr),2021,6,0,0,0
Nicht ermittelte Länder (innergem. Warenverkehr),2021,7,0,0,0
Nicht ermittelte Länder (innergem. Warenverkehr),2021,8,0,0,0
Nicht ermittelte Länder (innergem. Warenverkehr),2021,9,0,0,0
Nicht ermittelte Länder (innergem. Warenverkehr),2021,10,0,0,0
Nicht ermittelte Länder (innergem. Warenverkehr),2021,11,0,0,0
Nicht ermittelte Länder (innergem. Warenverkehr),2021,12,0,0,0
Nicht ermittelte Länder (innergem. Warenverkehr),2022,1,0,0,0
Nicht ermittelte Länder (innergem. Warenverkehr),2022,2,0,0,0
Nicht ermittelte Länder (innergem. Warenverkehr),2022,3,0,0,0
Nicht ermittelte Länder (innergem. Warenverkehr),2022,4,0,0,0
Nicht ermittelte Länder (innergem. Warenverkehr),2022,5,0,0,0
Nicht ermittelte Länder (innergem. Warenverkehr),2022,6,0,0,0
Nicht ermittelte Länder (innergem. Warenverkehr),2022,7,0,0,0
Nicht ermittelte Länder (innergem. Warenverkehr),2022,8,0,0,0
Nicht ermittelte Länder (innergem. Warenverkehr),2022,9,0,0,0
Nicht ermittelte Länder (innergem. Warenverkehr),2022,10,0,0,0
Nicht ermittelte Länder (innergem. Warenverkehr),2022,11,0,0,0
Nicht ermittelte Länder (innergem. Warenverkehr),2022,12,0,0,0
Nicht ermittelte Länder (innergem. Warenverkehr),2023,1,0,0,0
Nicht ermittelte Länder (innergem. Warenverkehr),2023,2,0,0,0
Nicht ermittelte Länder (innergem. Warenverkehr),2023,3,0,0,0
Nicht ermittelte Länder (innergem. Warenverkehr),2023,4,0,0,0
Nicht ermittelte Länder (innergem. Warenverkehr),2023,5,0,0,0
Nicht ermittelte Länder (innergem. Warenverkehr),2023,6,0,0,0
Nicht ermittelte Länder (innergem. Warenverkehr),2023,7,0,0,0
Nicht ermittelte Länder (innergem. Warenverkehr),2023,8,0,0,0
Nicht ermittelte Länder (innergem. Warenverkehr),2023,9,0,0,0
Nicht ermittelte Länder (innergem. Warenverkehr),2023,10,0,0,0
Nicht ermittelte Länder (innergem. Warenverkehr),2023,11,0,0,0
Nicht ermittelte Länder (innergem. Warenverkehr),2023,12,0,0,0
Nicht ermittelte Länder (innergem. Warenverkehr),2024,1,0,0,0
Nicht ermittelte Länder (innergem. Warenverkehr),2024,2,0,0,0
Nicht ermittelte Länder (innergem. Warenverkehr),2024,3,0,0,0
Nicht ermittelte Länder (innergem. Warenverkehr),2024,4,0,0,0
Nicht ermittelte Länder (innergem. Warenverkehr),2024,5,0,0,0
Nicht ermittelte Länder (innergem. Warenverkehr),2024,6,0,0,0
Nicht ermittelte Länder (innergem. Warenverkehr),2024,7,0,0,0
Nicht ermittelte Länder (innergem. Warenverkehr),2024,8,0,0,0
Nicht ermittelte Länder (innergem. Warenverkehr),2024,9,0,0,0
Nicht ermittelte Länder (innergem. Warenverkehr),2024,10,0,0,0
Nicht ermittelte Länder (innergem. Warenverkehr),2024,11,0,0,0
Nicht ermittelte Länder (innergem. Warenverkehr),2024,12,0,0,0
Nicht ermittelte Länder und Gebiete,2008,1,75039000,60406000,135445000
Nicht ermittelte Länder und Gebiete,2008,2,74904000,58920000,133824000
Nicht ermittelte Länder und Gebiete,2008,3,73096000,57886000,130982000
Nicht ermittelte Länder und Gebiete,2008,4,79476000,62920000,142396000
Nicht ermittelte Länder und Gebiete,2008,5,70699000,57788000,128487000
Nicht ermittelte Länder und Gebiete,2008,6,77924000,57120000,135044000
Nicht ermittelte Länder und Gebiete,2008,7,80989000,65375000,146364000
Nicht ermittelte Länder und Gebiete,2008,8,71361000,60181000,131542000
Nicht ermittelte Länder und Gebiete,2008,9,78890000,63765000,142655000
Nicht ermittelte Länder und Gebiete,2008,10,82241000,64712000,146953000
Nicht ermittelte Länder und Gebiete,2008,11,72158000,64900000,137058000
Nicht ermittelte Länder und Gebiete,2008,12,67504000,56904000,124408000
Nicht ermittelte Länder und Gebiete,2009,1,56666000,53343000,110009000
Nicht ermittelte Länder und Gebiete,2009,2,59492000,49085000,108577000
Nicht ermittelte Länder und Gebiete,2009,3,64001000,51122000,115123000
Nicht ermittelte Länder und Gebiete,2009,4,59000000,47115000,106115000
Nicht ermittelte Länder und Gebiete,2009,5,54998000,44135000,99133000
Nicht ermittelte Länder und Gebiete,2009,6,63000000,46285000,109285000
Nicht ermittelte Länder und Gebiete,2009,7,72006000,49073000,121079000
Nicht ermittelte Länder und Gebiete,2009,8,59000000,46049000,105049000
Nicht ermittelte Länder und Gebiete,2009,9,63000000,54265000,117265000
Nicht ermittelte Länder und Gebiete,2009,10,66001000,51243000,117244000
Nicht ermittelte Länder und Gebiete,2009,11,71006000,50088000,121094000
Nicht ermittelte Länder und Gebiete,2009,12,66998000,49250000,116248000
Nicht ermittelte Länder und Gebiete,2010,1,0,0,0
Nicht ermittelte Länder und Gebiete,2010,2,0,0,0
Nicht ermittelte Länder und Gebiete,2010,3,0,0,0
Nicht ermittelte Länder und Gebiete,2010,4,0,0,0
Nicht ermittelte Länder und Gebiete,2010,5,0,0,0
Nicht ermittelte Länder und Gebiete,2010,6,0,0,0
Nicht ermittelte Länder und Gebiete,2010,7,0,0,0
Nicht ermittelte Länder und Gebiete,2010,8,0,0,0
Nicht ermittelte Länder und Gebiete,2010,9,0,0,0
Nicht ermittelte Länder und Gebiete,2010,10,0,0,0
Nicht ermittelte Länder und Gebiete,2010,11,0,0,0
Nicht ermittelte Länder und Gebiete,2010,12,0,0,0
Nicht ermittelte Länder und Gebiete,2011,1,0,0,0
Nicht ermittelte Länder und Gebiete,2011,2,0,0,0
Nicht ermittelte Länder und Gebiete,2011,3,0,0,0
Nicht ermittelte Länder und Gebiete,2011,4,0,0,0
Nicht ermittelte Länder und Gebiete,2011,5,0,0,0
Nicht ermittelte Länder und Gebiete,2011,6,0,0,0
Nicht ermittelte Länder und Gebiete,2011,7,0,0,0
Nicht ermittelte Länder und Gebiete,2011,8,0,0,0
Nicht ermittelte Länder und Gebiete,2011,9,0,0,0
Nicht ermittelte Länder und Gebiete,2011,10,0,0,0
Nicht ermittelte Länder und Gebiete,2011,11,0,0,0
Nicht ermittelte Länder und Gebiete,2011,12,0,0,0
Nicht ermittelte Länder und Gebiete,2012,1,0,0,0
Nicht ermittelte Länder und Gebiete,2012,2,0,0,0
Nicht ermittelte Länder und Gebiete,2012,3,0,0,0
Nicht ermittelte Länder und Gebiete,2012,4,0,0,0
Nicht ermittelte Länder und Gebiete,2012,5,0,0,0
Nicht ermittelte Länder und Gebiete,2012,6,4000,0,4000
Nicht ermittelte Länder und Gebiete,2012,7,623000,0,623000
Nicht ermittelte Länder und Gebiete,2012,8,68000,0,68000
Nicht ermittelte Länder und Gebiete,2012,9,840000,0,840000
Nicht ermittelte Länder und Gebiete,2012,10,1352000,0,1352000
Nicht ermittelte Länder und Gebiete,2012,11,784000,0,784000
Nicht ermittelte Länder und Gebiete,2012,12,848000,0,848000
Nicht ermittelte Länder und Gebiete,2013,1,7000,0,7000
Nicht ermittelte Länder und Gebiete,2013,2,15000,0,15000
Nicht ermittelte Länder und Gebiete,2013,3,42000,0,42000
Nicht ermittelte Länder und Gebiete,2013,4,413000,0,413000
Nicht ermittelte Länder und Gebiete,2013,5,189000,0,189000
Nicht ermittelte Länder und Gebiete,2013,6,151000,0,151000
Nicht ermittelte Länder und Gebiete,2013,7,538000,0,538000
Nicht ermittelte Länder und Gebiete,2013,8,442000,0,442000
Nicht ermittelte Länder und Gebiete,2013,9,115208000,0,115208000
Nicht ermittelte Länder und Gebiete,2013,10,280000,0,280000
Nicht ermittelte Länder und Gebiete,2013,11,346000,0,346000
Nicht ermittelte Länder und Gebiete,2013,12,220000,0,220000
Nicht ermittelte Länder und Gebiete,2014,1,122000,0,122000
Nicht ermittelte Länder und Gebiete,2014,2,201000,0,201000
Nicht ermittelte Länder und Gebiete,2014,3,89000,0,89000
Nicht ermittelte Länder und Gebiete,2014,4,1000,0,1000
Nicht ermittelte Länder und Gebiete,2014,5,30000,0,30000
Nicht ermittelte Länder und Gebiete,2014,6,85000,0,85000
Nicht ermittelte Länder und Gebiete,2014,7,133000,0,133000
Nicht ermittelte Länder und Gebiete,2014,8,206000,0,206000
Nicht ermittelte Länder und Gebiete,2014,9,363000,0,363000
Nicht ermittelte Länder und Gebiete,2014,10,86000,0,86000
Nicht ermittelte Länder und Gebiete,2014,11,0,0,0
Nicht ermittelte Länder und Gebiete,2014,12,5000,0,5000
Nicht ermittelte Länder und Gebiete,2015,1,4000,0,4000
Nicht ermittelte Länder und Gebiete,2015,2,59991000,0,59991000
Nicht ermittelte Länder und Gebiete,2015,3,54000,0,54000
Nicht ermittelte Länder und Gebiete,2015,4,673000,0,673000
Nicht ermittelte Länder und Gebiete,2015,5,70000,0,70000
Nicht ermittelte Länder und Gebiete,2015,6,33000,0,33000
Nicht ermittelte Länder und Gebiete,2015,7,60071000,0,60071000
Nicht ermittelte Länder und Gebiete,2015,8,117000,0,117000
Nicht ermittelte Länder und Gebiete,2015,9,992000,0,992000
Nicht ermittelte Länder und Gebiete,2015,10,60009000,0,60009000
Nicht ermittelte Länder und Gebiete,2015,11,56000,0,56000
Nicht ermittelte Länder und Gebiete,2015,12,112000,0,112000
Nicht ermittelte Länder und Gebiete,2016,1,131000,0,131000
Nicht ermittelte Länder und Gebiete,2016,2,155000,0,155000
Nicht ermittelte Länder und Gebiete,2016,3,10881000,0,10881000
Nicht ermittelte Länder und Gebiete,2016,4,64425000,0,64425000
Nicht ermittelte Länder und Gebiete,2016,5,3875000,0,3875000
Nicht ermittelte Länder und Gebiete,2016,6,5200000,0,5200000
Nicht ermittelte Länder und Gebiete,2016,7,4357000,0,4357000
Nicht ermittelte Länder und Gebiete,2016,8,487000,0,487000
Nicht ermittelte Länder und Gebiete,2016,9,60000,0,60000
Nicht ermittelte Länder und Gebiete,2016,10,174000,0,174000
Nicht ermittelte Länder und Gebiete,2016,11,392000,0,392000
Nicht ermittelte Länder und Gebiete,2016,12,34000,0,34000
Nicht ermittelte Länder und Gebiete,2017,1,0,197974000,197974000
Nicht ermittelte Länder und Gebiete,2017,2,7000,172626000,172633000
Nicht ermittelte Länder und Gebiete,2017,3,2000,215163000,215165000
Nicht ermittelte Länder und Gebiete,2017,4,360000,199736000,200096000
Nicht ermittelte Länder und Gebiete,2017,5,0,236717000,236717000
Nicht ermittelte Länder und Gebiete,2017,6,19000,224177000,224196000
Nicht ermittelte Länder und Gebiete,2017,7,1000,228192000,228193000
Nicht ermittelte Länder und Gebiete,2017,8,2000,237086000,237088000
Nicht ermittelte Länder und Gebiete,2017,9,25000,252483000,252508000
Nicht ermittelte Länder und Gebiete,2017,10,1000,256409000,256410000
Nicht ermittelte Länder und Gebiete,2017,11,1000,264646000,264647000
Nicht ermittelte Länder und Gebiete,2017,12,12000,243517000,243529000
Nicht ermittelte Länder und Gebiete,2018,1,10000,81952000,81962000
Nicht ermittelte Länder und Gebiete,2018,2,39000,83089000,83128000
Nicht ermittelte Länder und Gebiete,2018,3,57000,95338000,95395000
Nicht ermittelte Länder und Gebiete,2018,4,75000,106942000,107017000
Nicht ermittelte Länder und Gebiete,2018,5,72000,78738000,78810000
Nicht ermittelte Länder und Gebiete,2018,6,192000,103452000,103644000
Nicht ermittelte Länder und Gebiete,2018,7,83000,105115000,105198000
Nicht ermittelte Länder und Gebiete,2018,8,147000,103095000,103242000
Nicht ermittelte Länder und Gebiete,2018,9,0,97842000,97842000
Nicht ermittelte Länder und Gebiete,2018,10,67000,106086000,106153000
Nicht ermittelte Länder und Gebiete,2018,11,40000,101376000,101416000
Nicht ermittelte Länder und Gebiete,2018,12,32000,102074000,102106000
Nicht ermittelte Länder und Gebiete,2019,1,34000,65252000,65286000
Nicht ermittelte Länder und Gebiete,2019,2,41000,74422000,74463000
Nicht ermittelte Länder und Gebiete,2019,3,131000,66611000,66742000
Nicht ermittelte Länder und Gebiete,2019,4,131000,57107000,57238000
Nicht ermittelte Länder und Gebiete,2019,5,99000,80309000,80408000
Nicht ermittelte Länder und Gebiete,2019,6,105000,84462000,84567000
Nicht ermittelte Länder und Gebiete,2019,7,91000,77329000,77420000
Nicht ermittelte Länder und Gebiete,2019,8,79000,103659000,103738000
Nicht ermittelte Länder und Gebiete,2019,9,59000,122215000,122274000
Nicht ermittelte Länder und Gebiete,2019,10,60000,110441000,110501000
Nicht ermittelte Länder und Gebiete,2019,11,60000,116618000,116678000
Nicht ermittelte Länder und Gebiete,2019,12,36000,100356000,100392000
Nicht ermittelte Länder und Gebiete,2020,1,30000,67816000,67846000
Nicht ermittelte Länder und Gebiete,2020,2,23000,59695000,59718000
Nicht ermittelte Länder und Gebiete,2020,3,0,48944000,48944000
Nicht ermittelte Länder und Gebiete,2020,4,0,37035000,37035000
Nicht ermittelte Länder und Gebiete,2020,5,85000,46106000,46191000
Nicht ermittelte Länder und Gebiete,2020,6,4000,57297000,57301000
Nicht ermittelte Länder und Gebiete,2020,7,9000,55830000,55839000
Nicht ermittelte Länder und Gebiete,2020,8,5000,72432000,72437000
Nicht ermittelte Länder und Gebiete,2020,9,6000,65986000,65992000
Nicht ermittelte Länder und Gebiete,2020,10,5000,77265000,77270000
Nicht ermittelte Länder und Gebiete,2020,11,200000000,91711000,291711000
Nicht ermittelte Länder und Gebiete,2020,12,2000,73503000,73505000
Nicht ermittelte Länder und Gebiete,2021,1,37000,47617000,47654000
Nicht ermittelte Länder und Gebiete,2021,2,739000,62980000,63719000
Nicht ermittelte Länder und Gebiete,2021,3,1077000,46660000,47737000
Nicht ermittelte Länder und Gebiete,2021,4,522000,49828000,50350000
Nicht ermittelte Länder und Gebiete,2021,5,350000,57862000,58212000
Nicht ermittelte Länder und Gebiete,2021,6,497000,70343000,70840000
Nicht ermittelte Länder und Gebiete,2021,7,174000,60588000,60762000
Nicht ermittelte Länder und Gebiete,2021,8,231000,52097000,52328000
Nicht ermittelte Länder und Gebiete,2021,9,35000,66892000,66927000
Nicht ermittelte Länder und Gebiete,2021,10,159000,78657000,78816000
Nicht ermittelte Länder und Gebiete,2021,11,109000,84773000,84882000
Nicht ermittelte Länder und Gebiete,2021,12,161000,79576000,79737000
Nicht ermittelte Länder und Gebiete,2022,1,186000,52927000,53113000
Nicht ermittelte Länder und Gebiete,2022,2,86000,47780000,47866000
Nicht ermittelte Länder und Gebiete,2022,3,164000,87756000,87920000
Nicht ermittelte Länder und Gebiete,2022,4,157000,71904000,72061000
Nicht ermittelte Länder und Gebiete,2022,5,147000,85536000,85683000
Nicht ermittelte Länder und Gebiete,2022,6,126000,74377000,74503000
Nicht ermittelte Länder und Gebiete,2022,7,108000,88387000,88495000
Nicht ermittelte Länder und Gebiete,2022,8,69000,64613000,64682000
Nicht ermittelte Länder und Gebiete,2022,9,319000,87942000,88261000
Nicht ermittelte Länder und Gebiete,2022,10,395000,104161000,104556000
Nicht ermittelte Länder und Gebiete,2022,11,181000,92229000,92410000
Nicht ermittelte Länder und Gebiete,2022,12,222000,94885000,95107000
Nicht ermittelte Länder und Gebiete,2023,1,216000,52825000,53041000
Nicht ermittelte Länder und Gebiete,2023,2,256000,52359000,52615000
Nicht ermittelte Länder und Gebiete,2023,3,389000,72414000,72803000
Nicht ermittelte Länder und Gebiete,2023,4,402000,61790000,62192000
Nicht ermittelte Länder und Gebiete,2023,5,398000,88900000,89298000
Nicht ermittelte Länder und Gebiete,2023,6,500000,80962000,81462000
Nicht ermittelte Länder und Gebiete,2023,7,433000,101964000,102397000
Nicht ermittelte Länder und Gebiete,2023,8,456000,65596000,66052000
Nicht ermittelte Länder und Gebiete,2023,9,441000,89795000,90236000
Nicht ermittelte Länder und Gebiete,2023,10,438000,88135000,88573000
Nicht ermittelte Länder und Gebiete,2023,11,279000,94421000,94700000
Nicht ermittelte Länder und Gebiete,2023,12,285000,105297000,105582000
Nicht ermittelte Länder und Gebiete,2024,1,909000,98414000,99323000
Nicht ermittelte Länder und Gebiete,2024,2,438000,103785000,104223000
Nicht ermittelte Länder und Gebiete,2024,3,519000,120818000,121337000
Nicht ermittelte Länder und Gebiete,2024,4,75000,145318000,145393000
Nicht ermittelte Länder und Gebiete,2024,5,85000,83469000,83554000
Nicht ermittelte Länder und Gebiete,2024,6,36000,128064000,128100000
Nicht ermittelte Länder und Gebiete,2024,7,135000,121343000,121478000
Nicht ermittelte Länder und Gebiete,2024,8,72000,129159000,129231000
Nicht ermittelte Länder und Gebiete,2024,9,183000,157522000,157705000
Nicht ermittelte Länder und Gebiete,2024,10,62000,222992000,223054000
Nicht ermittelte Länder und Gebiete,2024,11,34000,157910000,157944000
Nicht ermittelte Länder und Gebiete,2024,12,147000,115793000,115940000
Niederlande,2008,1,5634886000,5501555000,11136441000
Niederlande,2008,2,5398998000,5644416000,11043414000
Niederlande,2008,3,5717033000,5705428000,11422461000
Niederlande,2008,4,5716716000,5511572000,11228288000
Niederlande,2008,5,5379655000,5582904000,10962559000
Niederlande,2008,6,5808625000,5384741000,11193366000
Niederlande,2008,7,5648856000,5762708000,11411564000
Niederlande,2008,8,5323665000,5689261000,11012926000
Niederlande,2008,9,5552706000,6160794000,11713500000
Niederlande,2008,10,5966399000,6660298000,12626697000
Niederlande,2008,11,5182749000,5388644000,10571393000
Niederlande,2008,12,4468491000,4978240000,9446731000
Niederlande,2009,1,4526555000,4991091000,9517646000
Niederlande,2009,2,4620233000,4830208000,9450441000
Niederlande,2009,3,4832313000,4917773000,9750086000
Niederlande,2009,4,4488338000,4446212000,8934550000
Niederlande,2009,5,4138298000,4002373000,8140671000
Niederlande,2009,6,4442483000,4275739000,8718222000
Niederlande,2009,7,4460173000,4484733000,8944906000
Niederlande,2009,8,3993503000,4424355000,8417858000
Niederlande,2009,9,4467975000,4699288000,9167263000
Niederlande,2009,10,4565342000,4894035000,9459377000
Niederlande,2009,11,4311127000,4624276000,8935403000
Niederlande,2009,12,4348705000,4993378000,9342083000
Niederlande,2010,1,4399325000,4725222000,9124547000
Niederlande,2010,2,4655365000,4886077000,9541442000
Niederlande,2010,3,5797472000,6142629000,11940101000
Niederlande,2010,4,4917346000,5287739000,10205085000
Niederlande,2010,5,5050875000,5512693000,10563568000
Niederlande,2010,6,5615262000,5958914000,11574176000
Niederlande,2010,7,5089518000,5237531000,10327049000
Niederlande,2010,8,5022517000,5523154000,10545671000
Niederlande,2010,9,5451798000,5763861000,11215659000
Niederlande,2010,10,5593708000,5951425000,11545133000
Niederlande,2010,11,5453849000,6006854000,11460703000
Niederlande,2010,12,5931221000,6209014000,12140235000
Niederlande,2011,1,5256965000,6180922000,11437887000
Niederlande,2011,2,5628518000,6478025000,12106543000
Niederlande,2011,3,6235765000,7355787000,13591552000
Niederlande,2011,4,5785867000,6989435000,12775302000
Niederlande,2011,5,5881011000,7079891000,12960902000
Niederlande,2011,6,6230962000,6898174000,13129136000
Niederlande,2011,7,5437024000,6797290000,12234314000
Niederlande,2011,8,5395464000,6650780000,12046244000
Niederlande,2011,9,6223698000,6956388000,13180086000
Niederlande,2011,10,5694884000,6532692000,12227576000
Niederlande,2011,11,5984359000,6908243000,12892602000
Niederlande,2011,12,5668285000,6976704000,12644989000
Niederlande,2012,1,5980089000,6689012000,12669101000
Niederlande,2012,2,5792666000,7204059000,12996725000
Niederlande,2012,3,6677026000,7447153000,14124179000
Niederlande,2012,4,5818592000,6629445000,12448037000
Niederlande,2012,5,5976723000,7559340000,13536063000
Niederlande,2012,6,5865949000,7249245000,13115194000
Niederlande,2012,7,5504254000,7025629000,12529883000
Niederlande,2012,8,5671958000,7182225000,12854183000
Niederlande,2012,9,5893453000,6788399000,12681852000
Niederlande,2012,10,6306010000,7777369000,14083379000
Niederlande,2012,11,5654023000,7355792000,13009815000
Niederlande,2012,12,5139661000,6856983000,11996644000
Niederlande,2013,1,5950091000,7297741000,13247832000
Niederlande,2013,2,5904426000,6777011000,12681437000
Niederlande,2013,3,6126451000,7506224000,13632675000
Niederlande,2013,4,5874985000,7602781000,13477766000
Niederlande,2013,5,5789979000,7717010000,13506989000
Niederlande,2013,6,5923798000,7661962000,13585760000
Niederlande,2013,7,5728215000,7457547000,13185762000
Niederlande,2013,8,5534935000,7142400000,12677335000
Niederlande,2013,9,6172240000,7225444000,13397684000
Niederlande,2013,10,6336899000,7777874000,14114773000
Niederlande,2013,11,5977708000,7461887000,13439595000
Niederlande,2013,12,5655353000,7070099000,12725452000
Niederlande,2014,1,6181376000,7631480000,13812856000
Niederlande,2014,2,6023612000,7395085000,13418697000
Niederlande,2014,3,6333176000,7261018000,13594194000
Niederlande,2014,4,6227081000,7379661000,13606742000
Niederlande,2014,5,5732251000,7452011000,13184262000
Niederlande,2014,6,5863666000,7082454000,12946120000
Niederlande,2014,7,5985124000,7149390000,13134514000
Niederlande,2014,8,5808804000,6777530000,12586334000
Niederlande,2014,9,6228685000,7650520000,13879205000
Niederlande,2014,10,6261146000,7534384000,13795530000
Niederlande,2014,11,6317207000,7566939000,13884146000
Niederlande,2014,12,5774099000,6915283000,12689382000
Niederlande,2015,1,6085146000,6713945000,12799091000
Niederlande,2015,2,5972623000,6946496000,12919119000
Niederlande,2015,3,7011079000,7762758000,14773837000
Niederlande,2015,4,6525790000,7525352000,14051142000
Niederlande,2015,5,6132804000,7471574000,13604378000
Niederlande,2015,6,7188461000,7509814000,14698275000
Niederlande,2015,7,7060399000,7434914000,14495313000
Niederlande,2015,8,6289055000,6914920000,13203975000
Niederlande,2015,9,6974582000,8050585000,15025167000
Niederlande,2015,10,7020662000,7691542000,14712204000
Niederlande,2015,11,6823004000,7173821000,13996825000
Niederlande,2015,12,6107809000,6692916000,12800725000
Niederlande,2016,1,6004397000,6657173000,12661570000
Niederlande,2016,2,6358509000,6614679000,12973188000
Niederlande,2016,3,6795020000,7242558000,14037578000
Niederlande,2016,4,6560772000,6769458000,13330230000
Niederlande,2016,5,6225050000,6804766000,13029816000
Niederlande,2016,6,6800174000,6951561000,13751735000
Niederlande,2016,7,6550540000,6782966000,13333506000
Niederlande,2016,8,6327952000,6770434000,13098386000
Niederlande,2016,9,6955905000,7019500000,13975405000
Niederlande,2016,10,6632950000,6899752000,13532702000
Niederlande,2016,11,6731109000,7335930000,14067039000
Niederlande,2016,12,6490133000,7292978000,13783111000
Niederlande,2017,1,6719169000,7320420000,14039589000
Niederlande,2017,2,6686000000,7467263000,14153263000
Niederlande,2017,3,7572393000,8108788000,15681181000
Niederlande,2017,4,6705296000,7545544000,14250840000
Niederlande,2017,5,7081632000,7576003000,14657635000
Niederlande,2017,6,6873103000,7166366000,14039469000
Niederlande,2017,7,6850665000,7385481000,14236146000
Niederlande,2017,8,6973189000,6937859000,13911048000
Niederlande,2017,9,7095196000,7234637000,14329833000
Niederlande,2017,10,7374827000,7766334000,15141161000
Niederlande,2017,11,7457642000,8188132000,15645774000
Niederlande,2017,12,7243268000,7895267000,15138535000
Niederlande,2018,1,7444447000,7951879000,15396326000
Niederlande,2018,2,7489847000,7940709000,15430556000
Niederlande,2018,3,8634977000,8936800000,17571777000
Niederlande,2018,4,7618543000,7780415000,15398958000
Niederlande,2018,5,7571747000,7869503000,15441250000
Niederlande,2018,6,7455737000,7907139000,15362876000
Niederlande,2018,7,7351673000,8160195000,15511868000
Niederlande,2018,8,7184367000,7831421000,15015788000
Niederlande,2018,9,7356225000,8094183000,15450408000
Niederlande,2018,10,8095362000,8762173000,16857535000
Niederlande,2018,11,8102126000,8337062000,16439188000
Niederlande,2018,12,6755536000,8137941000,14893477000
Niederlande,2019,1,7861209000,7635584000,15496793000
Niederlande,2019,2,7658177000,8716057000,16374234000
Niederlande,2019,3,8271148000,9102341000,17373489000
Niederlande,2019,4,7686963000,8086072000,15773035000
Niederlande,2019,5,7602066000,8364726000,15966792000
Niederlande,2019,6,7236484000,7938396000,15174880000
Niederlande,2019,7,7552152000,7980040000,15532192000
Niederlande,2019,8,7093090000,7842082000,14935172000
Niederlande,2019,9,8224796000,8221718000,16446514000
Niederlande,2019,10,7984467000,8142189000,16126656000
Niederlande,2019,11,7631502000,8143364000,15774866000
Niederlande,2019,12,6726347000,7643611000,14369958000
Niederlande,2020,1,7584783000,7779901000,15364684000
Niederlande,2020,2,7199405000,7997472000,15196877000
Niederlande,2020,3,7573607000,8332584000,15906191000
Niederlande,2020,4,6019121000,6490846000,12509967000
Niederlande,2020,5,6066613000,6548346000,12614959000
Niederlande,2020,6,6903063000,6695836000,13598899000
Niederlande,2020,7,6824742000,6798466000,13623208000
Niederlande,2020,8,6438954000,6596511000,13035465000
Niederlande,2020,9,7649828000,7299810000,14949638000
Niederlande,2020,10,7292644000,7581522000,14874166000
Niederlande,2020,11,7726406000,7501863000,15228269000
Niederlande,2020,12,7299804000,7400634000,14700438000
Niederlande,2021,1,6795371000,6311744000,13107115000
Niederlande,2021,2,7079045000,7119312000,14198357000
Niederlande,2021,3,8521776000,8349588000,16871364000
Niederlande,2021,4,7402789000,7417361000,14820150000
Niederlande,2021,5,7572374000,7769181000,15341555000
Niederlande,2021,6,7985868000,7815942000,15801810000
Niederlande,2021,7,7575670000,7802225000,15377895000
Niederlande,2021,8,7220939000,7366330000,14587269000
Niederlande,2021,9,8263727000,8165767000,16429494000
Niederlande,2021,10,7886094000,9215040000,17101134000
Niederlande,2021,11,8249722000,9861273000,18110995000
Niederlande,2021,12,8548032000,9368510000,17916542000
Niederlande,2022,1,8604208000,8845247000,17449455000
Niederlande,2022,2,8706814000,8200818000,16907632000
Niederlande,2022,3,10104879000,9808304000,19913183000
Niederlande,2022,4,8814992000,9028194000,17843186000
Niederlande,2022,5,9631175000,9926510000,19557685000
Niederlande,2022,6,9619091000,9957514000,19576605000
Niederlande,2022,7,9274520000,9696584000,18971104000
Niederlande,2022,8,8841160000,10340343000,19181503000
Niederlande,2022,9,9800793000,10657922000,20458715000
Niederlande,2022,10,9448632000,10546969000,19995601000
Niederlande,2022,11,10298229000,9740923000,20039152000
Niederlande,2022,12,9351564000,8367466000,17719030000
Niederlande,2023,1,9672864000,9089867000,18762731000
Niederlande,2023,2,9346104000,8275768000,17621872000
Niederlande,2023,3,10806399000,9990280000,20796679000
Niederlande,2023,4,8618667000,7778260000,16396927000
Niederlande,2023,5,9409352000,9177262000,18586614000
Niederlande,2023,6,9729705000,9312476000,19042181000
Niederlande,2023,7,9030276000,8424069000,17454345000
Niederlande,2023,8,8628829000,8028691000,16657520000
Niederlande,2023,9,9204848000,8186985000,17391833000
Niederlande,2023,10,9417678000,8335265000,17752943000
Niederlande,2023,11,9706837000,8329136000,18035973000
Niederlande,2023,12,8263641000,7983272000,16246913000
Niederlande,2024,1,9496554000,8554352000,18050906000
Niederlande,2024,2,9183719000,7871011000,17054730000
Niederlande,2024,3,9881278000,8392861000,18274139000
Niederlande,2024,4,9835275000,8420424000,18255699000
Niederlande,2024,5,9026538000,7745993000,16772531000
Niederlande,2024,6,9099088000,7835757000,16934845000
Niederlande,2024,7,9313503000,8256346000,17569849000
Niederlande,2024,8,8424838000,7628502000,16053340000
Niederlande,2024,9,9097178000,8013946000,17111124000
Niederlande,2024,10,9191359000,7857126000,17048485000
Niederlande,2024,11,9098008000,7549024000,16647032000
Niederlande,2024,12,8902843000,7280083000,16182926000
Niederländische Antillen (bis 2012),2008,1,2039000,49000,2088000
Niederländische Antillen (bis 2012),2008,2,2050000,187000,2237000
Niederländische Antillen (bis 2012),2008,3,2625000,21966000,24591000
Niederländische Antillen (bis 2012),2008,4,2350000,42000,2392000
Niederländische Antillen (bis 2012),2008,5,2146000,22000,2168000
Niederländische Antillen (bis 2012),2008,6,1482000,72000,1554000
Niederländische Antillen (bis 2012),2008,7,4503000,64000,4567000
Niederländische Antillen (bis 2012),2008,8,3637000,21000,3658000
Niederländische Antillen (bis 2012),2008,9,2264000,84000,2348000
Niederländische Antillen (bis 2012),2008,10,2512000,26000,2538000
Niederländische Antillen (bis 2012),2008,11,2264000,104000,2368000
Niederländische Antillen (bis 2012),2008,12,4359000,86000,4445000
Niederländische Antillen (bis 2012),2009,1,3008000,1355000,4363000
Niederländische Antillen (bis 2012),2009,2,1802000,130000,1932000
Niederländische Antillen (bis 2012),2009,3,2696000,175000,2871000
Niederländische Antillen (bis 2012),2009,4,2389000,157000,2546000
Niederländische Antillen (bis 2012),2009,5,4137000,763000,4900000
Niederländische Antillen (bis 2012),2009,6,2148000,127000,2275000
Niederländische Antillen (bis 2012),2009,7,1938000,293000,2231000
Niederländische Antillen (bis 2012),2009,8,2232000,150000,2382000
Niederländische Antillen (bis 2012),2009,9,1238000,173000,1411000
Niederländische Antillen (bis 2012),2009,10,1731000,105000,1836000
Niederländische Antillen (bis 2012),2009,11,1683000,129000,1812000
Niederländische Antillen (bis 2012),2009,12,2068000,85000,2153000
Niederländische Antillen (bis 2012),2010,1,1424000,120000,1544000
Niederländische Antillen (bis 2012),2010,2,4516000,53000,4569000
Niederländische Antillen (bis 2012),2010,3,1940000,145000,2085000
Niederländische Antillen (bis 2012),2010,4,1881000,57000,1938000
Niederländische Antillen (bis 2012),2010,5,1114000,342000,1456000
Niederländische Antillen (bis 2012),2010,6,1599000,50000,1649000
Niederländische Antillen (bis 2012),2010,7,3313000,34000,3347000
Niederländische Antillen (bis 2012),2010,8,2037000,38000,2075000
Niederländische Antillen (bis 2012),2010,9,1800000,41000,1841000
Niederländische Antillen (bis 2012),2010,10,2353000,29000,2382000
Niederländische Antillen (bis 2012),2010,11,1872000,4000,1876000
Niederländische Antillen (bis 2012),2010,12,1856000,41000,1897000
Niederländische Antillen (bis 2012),2011,1,1392000,130000,1522000
Niederländische Antillen (bis 2012),2011,2,2371000,36000,2407000
Niederländische Antillen (bis 2012),2011,3,1761000,85000,1846000
Niederländische Antillen (bis 2012),2011,4,1763000,12000,1775000
Niederländische Antillen (bis 2012),2011,5,2756000,22000,2778000
Niederländische Antillen (bis 2012),2011,6,1576000,39000,1615000
Niederländische Antillen (bis 2012),2011,7,1829000,52000,1881000
Niederländische Antillen (bis 2012),2011,8,1700000,44000,1744000
Niederländische Antillen (bis 2012),2011,9,5113000,16000,5129000
Niederländische Antillen (bis 2012),2011,10,2471000,25000,2496000
Niederländische Antillen (bis 2012),2011,11,2611000,40000,2651000
Niederländische Antillen (bis 2012),2011,12,2756000,41000,2797000
Niederländische Antillen (bis 2012),2012,1,2165000,96000,2261000
Niederländische Antillen (bis 2012),2012,2,2653000,27000,2680000
Niederländische Antillen (bis 2012),2012,3,2355000,24000,2379000
Niederländische Antillen (bis 2012),2012,4,1700000,75000,1775000
Niederländische Antillen (bis 2012),2012,5,2508000,3781000,6289000
Niederländische Antillen (bis 2012),2012,6,3513000,52000,3565000
Niederländische Antillen (bis 2012),2012,7,1766000,63000,1829000
Niederländische Antillen (bis 2012),2012,8,1720000,24000,1744000
Niederländische Antillen (bis 2012),2012,9,2630000,23000,2653000
Niederländische Antillen (bis 2012),2012,10,3200000,75000,3275000
Niederländische Antillen (bis 2012),2012,11,2127000,486000,2613000
Niederländische Antillen (bis 2012),2012,12,2476000,15227000,17703000
Niederländische Antillen (bis 2012),2013,1,0,0,0
Niederländische Antillen (bis 2012),2013,2,0,0,0
Niederländische Antillen (bis 2012),2013,3,0,0,0
Niederländische Antillen (bis 2012),2013,4,0,0,0
Niederländische Antillen (bis 2012),2013,5,0,0,0
Niederländische Antillen (bis 2012),2013,6,0,0,0
Niederländische Antillen (bis 2012),2013,7,0,0,0
Niederländische Antillen (bis 2012),2013,8,0,0,0
Niederländische Antillen (bis 2012),2013,9,0,0,0
Niederländische Antillen (bis 2012),2013,10,0,0,0
Niederländische Antillen (bis 2012),2013,11,0,0,0
Niederländische Antillen (bis 2012),2013,12,0,0,0
Niederländische Antillen (bis 2012),2014,1,0,0,0
Niederländische Antillen (bis 2012),2014,2,0,0,0
Niederländische Antillen (bis 2012),2014,3,0,0,0
Niederländische Antillen (bis 2012),2014,4,0,0,0
Niederländische Antillen (bis 2012),2014,5,0,0,0
Niederländische Antillen (bis 2012),2014,6,0,0,0
Niederländische Antillen (bis 2012),2014,7,0,0,0
Niederländische Antillen (bis 2012),2014,8,0,0,0
Niederländische Antillen (bis 2012),2014,9,0,0,0
Niederländische Antillen (bis 2012),2014,10,0,0,0
Niederländische Antillen (bis 2012),2014,11,0,0,0
Niederländische Antillen (bis 2012),2014,12,0,0,0
Niederländische Antillen (bis 2012),2015,1,0,0,0
Niederländische Antillen (bis 2012),2015,2,0,0,0
Niederländische Antillen (bis 2012),2015,3,0,0,0
Niederländische Antillen (bis 2012),2015,4,0,0,0
Niederländische Antillen (bis 2012),2015,5,0,0,0
Niederländische Antillen (bis 2012),2015,6,0,0,0
Niederländische Antillen (bis 2012),2015,7,0,0,0
Niederländische Antillen (bis 2012),2015,8,0,0,0
Niederländische Antillen (bis 2012),2015,9,0,0,0
Niederländische Antillen (bis 2012),2015,10,0,0,0
Niederländische Antillen (bis 2012),2015,11,0,0,0
Niederländische Antillen (bis 2012),2015,12,0,0,0
Niederländische Antillen (bis 2012),2016,1,0,0,0
Niederländische Antillen (bis 2012),2016,2,0,0,0
Niederländische Antillen (bis 2012),2016,3,0,0,0
Niederländische Antillen (bis 2012),2016,4,0,0,0
Niederländische Antillen (bis 2012),2016,5,0,0,0
Niederländische Antillen (bis 2012),2016,6,0,0,0
Niederländische Antillen (bis 2012),2016,7,0,0,0
Niederländische Antillen (bis 2012),2016,8,0,0,0
Niederländische Antillen (bis 2012),2016,9,0,0,0
Niederländische Antillen (bis 2012),2016,10,0,0,0
Niederländische Antillen (bis 2012),2016,11,0,0,0
Niederländische Antillen (bis 2012),2016,12,0,0,0
Niederländische Antillen (bis 2012),2017,1,0,0,0
Niederländische Antillen (bis 2012),2017,2,0,0,0
Niederländische Antillen (bis 2012),2017,3,0,0,0
Niederländische Antillen (bis 2012),2017,4,0,0,0
Niederländische Antillen (bis 2012),2017,5,0,0,0
Niederländische Antillen (bis 2012),2017,6,0,0,0
Niederländische Antillen (bis 2012),2017,7,0,0,0
Niederländische Antillen (bis 2012),2017,8,0,0,0
Niederländische Antillen (bis 2012),2017,9,0,0,0
Niederländische Antillen (bis 2012),2017,10,0,0,0
Niederländische Antillen (bis 2012),2017,11,0,0,0
Niederländische Antillen (bis 2012),2017,12,0,0,0
Niederländische Antillen (bis 2012),2018,1,0,0,0
Niederländische Antillen (bis 2012),2018,2,0,0,0
Niederländische Antillen (bis 2012),2018,3,0,0,0
Niederländische Antillen (bis 2012),2018,4,0,0,0
Niederländische Antillen (bis 2012),2018,5,0,0,0
Niederländische Antillen (bis 2012),2018,6,0,0,0
Niederländische Antillen (bis 2012),2018,7,0,0,0
Niederländische Antillen (bis 2012),2018,8,0,0,0
Niederländische Antillen (bis 2012),2018,9,0,0,0
Niederländische Antillen (bis 2012),2018,10,0,0,0
Niederländische Antillen (bis 2012),2018,11,0,0,0
Niederländische Antillen (bis 2012),2018,12,0,0,0
Niederländische Antillen (bis 2012),2019,1,0,0,0
Niederländische Antillen (bis 2012),2019,2,0,0,0
Niederländische Antillen (bis 2012),2019,3,0,0,0
Niederländische Antillen (bis 2012),2019,4,0,0,0
Niederländische Antillen (bis 2012),2019,5,0,0,0
Niederländische Antillen (bis 2012),2019,6,0,0,0
Niederländische Antillen (bis 2012),2019,7,0,0,0
Niederländische Antillen (bis 2012),2019,8,0,0,0
Niederländische Antillen (bis 2012),2019,9,0,0,0
Niederländische Antillen (bis 2012),2019,10,0,0,0
Niederländische Antillen (bis 2012),2019,11,0,0,0
Niederländische Antillen (bis 2012),2019,12,0,0,0
Niederländische Antillen (bis 2012),2020,1,0,0,0
Niederländische Antillen (bis 2012),2020,2,0,0,0
Niederländische Antillen (bis 2012),2020,3,0,0,0
Niederländische Antillen (bis 2012),2020,4,0,0,0
Niederländische Antillen (bis 2012),2020,5,0,0,0
Niederländische Antillen (bis 2012),2020,6,0,0,0
Niederländische Antillen (bis 2012),2020,7,0,0,0
Niederländische Antillen (bis 2012),2020,8,0,0,0
Niederländische Antillen (bis 2012),2020,9,0,0,0
Niederländische Antillen (bis 2012),2020,10,0,0,0
Niederländische Antillen (bis 2012),2020,11,0,0,0
Niederländische Antillen (bis 2012),2020,12,0,0,0
Niederländische Antillen (bis 2012),2021,1,0,0,0
Niederländische Antillen (bis 2012),2021,2,0,0,0
Niederländische Antillen (bis 2012),2021,3,0,0,0
Niederländische Antillen (bis 2012),2021,4,0,0,0
Niederländische Antillen (bis 2012),2021,5,0,0,0
Niederländische Antillen (bis 2012),2021,6,0,0,0
Niederländische Antillen (bis 2012),2021,7,0,0,0
Niederländische Antillen (bis 2012),2021,8,0,0,0
Niederländische Antillen (bis 2012),2021,9,0,0,0
Niederländische Antillen (bis 2012),2021,10,0,0,0
Niederländische Antillen (bis 2012),2021,11,0,0,0
Niederländische Antillen (bis 2012),2021,12,0,0,0
Niederländische Antillen (bis 2012),2022,1,0,0,0
Niederländische Antillen (bis 2012),2022,2,0,0,0
Niederländische Antillen (bis 2012),2022,3,0,0,0
Niederländische Antillen (bis 2012),2022,4,0,0,0
Niederländische Antillen (bis 2012),2022,5,0,0,0
Niederländische Antillen (bis 2012),2022,6,0,0,0
Niederländische Antillen (bis 2012),2022,7,0,0,0
Niederländische Antillen (bis 2012),2022,8,0,0,0
Niederländische Antillen (bis 2012),2022,9,0,0,0
Niederländische Antillen (bis 2012),2022,10,0,0,0
Niederländische Antillen (bis 2012),2022,11,0,0,0
Niederländische Antillen (bis 2012),2022,12,0,0,0
Niederländische Antillen (bis 2012),2023,1,0,0,0
Niederländische Antillen (bis 2012),2023,2,0,0,0
Niederländische Antillen (bis 2012),2023,3,0,0,0
Niederländische Antillen (bis 2012),2023,4,0,0,0
Niederländische Antillen (bis 2012),2023,5,0,0,0
Niederländische Antillen (bis 2012),2023,6,0,0,0
Niederländische Antillen (bis 2012),2023,7,0,0,0
Niederländische Antillen (bis 2012),2023,8,0,0,0
Niederländische Antillen (bis 2012),2023,9,0,0,0
Niederländische Antillen (bis 2012),2023,10,0,0,0
Niederländische Antillen (bis 2012),2023,11,0,0,0
Niederländische Antillen (bis 2012),2023,12,0,0,0
Niederländische Antillen (bis 2012),2024,1,0,0,0
Niederländische Antillen (bis 2012),2024,2,0,0,0
Niederländische Antillen (bis 2012),2024,3,0,0,0
Niederländische Antillen (bis 2012),2024,4,0,0,0
Niederländische Antillen (bis 2012),2024,5,0,0,0
Niederländische Antillen (bis 2012),2024,6,0,0,0
Niederländische Antillen (bis 2012),2024,7,0,0,0
Niederländische Antillen (bis 2012),2024,8,0,0,0
Niederländische Antillen (bis 2012),2024,9,0,0,0
Niederländische Antillen (bis 2012),2024,10,0,0,0
Niederländische Antillen (bis 2012),2024,11,0,0,0
Niederländische Antillen (bis 2012),2024,12,0,0,0
Niger,2008,1,1916000,0,1916000
Niger,2008,2,1590000,79000,1669000
Niger,2008,3,4093000,40000,4133000
Niger,2008,4,1465000,2000,1467000
Niger,2008,5,768000,0,768000
Niger,2008,6,5586000,2000,5588000
Niger,2008,7,2327000,1000,2328000
Niger,2008,8,2226000,5000,2231000
Niger,2008,9,1660000,1251000,2911000
Niger,2008,10,2011000,10000,2021000
Niger,2008,11,2696000,0,2696000
Niger,2008,12,4116000,0,4116000
Niger,2009,1,1609000,7000,1616000
Niger,2009,2,2670000,7000,2677000
Niger,2009,3,2292000,11000,2303000
Niger,2009,4,1725000,3000,1728000
Niger,2009,5,706000,15000,721000
Niger,2009,6,1102000,38000,1140000
Niger,2009,7,1661000,1000,1662000
Niger,2009,8,3026000,6000,3032000
Niger,2009,9,1209000,7000,1216000
Niger,2009,10,1338000,1000,1339000
Niger,2009,11,1914000,8000,1922000
Niger,2009,12,2539000,2000,2541000
Niger,2010,1,1460000,1000,1461000
Niger,2010,2,1766000,5000,1771000
Niger,2010,3,1831000,5000,1836000
Niger,2010,4,1692000,7000,1699000
Niger,2010,5,1823000,2000,1825000
Niger,2010,6,3160000,4000,3164000
Niger,2010,7,744000,2000,746000
Niger,2010,8,1593000,0,1593000
Niger,2010,9,1235000,2000,1237000
Niger,2010,10,1381000,5000,1386000
Niger,2010,11,992000,2000,994000
Niger,2010,12,948000,0,948000
Niger,2011,1,951000,2000,953000
Niger,2011,2,803000,2000,805000
Niger,2011,3,1262000,22000,1284000
Niger,2011,4,1166000,2000,1168000
Niger,2011,5,1171000,5000,1176000
Niger,2011,6,902000,2000,904000
Niger,2011,7,1320000,45000,1365000
Niger,2011,8,1592000,2000,1594000
Niger,2011,9,1547000,0,1547000
Niger,2011,10,2373000,2000,2375000
Niger,2011,11,2452000,0,2452000
Niger,2011,12,6353000,0,6353000
Niger,2012,1,7091000,36000,7127000
Niger,2012,2,1634000,0,1634000
Niger,2012,3,2136000,0,2136000
Niger,2012,4,1982000,3000,1985000
Niger,2012,5,1749000,5000,1754000
Niger,2012,6,1821000,0,1821000
Niger,2012,7,1573000,3000,1576000
Niger,2012,8,1697000,2000,1699000
Niger,2012,9,1519000,14000,1533000
Niger,2012,10,1725000,12000,1737000
Niger,2012,11,1288000,23000,1311000
Niger,2012,12,1695000,0,1695000
Niger,2013,1,3460000,1000,3461000
Niger,2013,2,1456000,0,1456000
Niger,2013,3,3162000,8000,3170000
Niger,2013,4,1493000,0,1493000
Niger,2013,5,3318000,0,3318000
Niger,2013,6,1673000,19000,1692000
Niger,2013,7,3621000,26000,3647000
Niger,2013,8,3844000,8000,3852000
Niger,2013,9,2219000,26000,2245000
Niger,2013,10,1978000,30000,2008000
Niger,2013,11,1474000,1000,1475000
Niger,2013,12,2722000,1000,2723000
Niger,2014,1,2463000,1000,2464000
Niger,2014,2,2205000,14000,2219000
Niger,2014,3,2395000,1000,2396000
Niger,2014,4,2406000,50000,2456000
Niger,2014,5,2278000,1000,2279000
Niger,2014,6,1806000,0,1806000
Niger,2014,7,2610000,1000,2611000
Niger,2014,8,3446000,1000,3447000
Niger,2014,9,2263000,5000,2268000
Niger,2014,10,2506000,1000,2507000
Niger,2014,11,3710000,2000,3712000
Niger,2014,12,2470000,16000,2486000
Niger,2015,1,1573000,4000,1577000
Niger,2015,2,7062000,1000,7063000
Niger,2015,3,2210000,5000,2215000
Niger,2015,4,1246000,0,1246000
Niger,2015,5,4833000,21000,4854000
Niger,2015,6,2291000,5000,2296000
Niger,2015,7,1965000,3000,1968000
Niger,2015,8,2429000,22000,2451000
Niger,2015,9,1579000,11000,1590000
Niger,2015,10,2107000,8000,2115000
Niger,2015,11,1872000,9000,1881000
Niger,2015,12,1537000,8000,1545000
Niger,2016,1,1058000,23000,1081000
Niger,2016,2,818000,3000,821000
Niger,2016,3,1176000,23000,1199000
Niger,2016,4,797000,9000,806000
Niger,2016,5,1063000,18000,1081000
Niger,2016,6,2046000,5000,2051000
Niger,2016,7,4130000,4000,4134000
Niger,2016,8,2346000,2000,2348000
Niger,2016,9,355000,3000,358000
Niger,2016,10,436000,27000,463000
Niger,2016,11,762000,6000,768000
Niger,2016,12,2224000,11000,2235000
Niger,2017,1,839000,41000,880000
Niger,2017,2,483000,5000,488000
Niger,2017,3,1147000,1000,1148000
Niger,2017,4,858000,10000,868000
Niger,2017,5,713000,73000,786000
Niger,2017,6,649000,8000,657000
Niger,2017,7,1853000,5000,1858000
Niger,2017,8,714000,13000,727000
Niger,2017,9,795000,8000,803000
Niger,2017,10,1010000,8000,1018000
Niger,2017,11,1205000,4000,1209000
Niger,2017,12,1005000,3000,1008000
Niger,2018,1,999000,7000,1006000
Niger,2018,2,828000,9000,837000
Niger,2018,3,2442000,0,2442000
Niger,2018,4,1211000,4000,1215000
Niger,2018,5,2327000,2000,2329000
Niger,2018,6,1588000,5000,1593000
Niger,2018,7,1046000,23000,1069000
Niger,2018,8,4157000,30000,4187000
Niger,2018,9,696000,19000,715000
Niger,2018,10,4770000,33000,4803000
Niger,2018,11,827000,55000,882000
Niger,2018,12,1202000,29000,1231000
Niger,2019,1,1352000,23000,1375000
Niger,2019,2,1114000,172000,1286000
Niger,2019,3,1795000,84000,1879000
Niger,2019,4,793000,45000,838000
Niger,2019,5,1425000,234000,1659000
Niger,2019,6,3512000,27000,3539000
Niger,2019,7,2314000,17000,2331000
Niger,2019,8,1807000,45000,1852000
Niger,2019,9,1984000,25000,2009000
Niger,2019,10,4303000,61000,4364000
Niger,2019,11,3712000,144000,3856000
Niger,2019,12,8147000,43000,8190000
Niger,2020,1,17176000,74000,17250000
Niger,2020,2,3301000,60000,3361000
Niger,2020,3,2454000,18000,2472000
Niger,2020,4,1647000,29000,1676000
Niger,2020,5,1378000,139000,1517000
Niger,2020,6,801000,2000,803000
Niger,2020,7,6441000,57000,6498000
Niger,2020,8,7071000,36000,7107000
Niger,2020,9,7364000,57000,7421000
Niger,2020,10,4745000,25000,4770000
Niger,2020,11,5496000,56000,5552000
Niger,2020,12,2687000,48000,2735000
Niger,2021,1,2538000,43000,2581000
Niger,2021,2,950000,36000,986000
Niger,2021,3,3938000,138000,4076000
Niger,2021,4,2036000,112000,2148000
Niger,2021,5,1245000,19000,1264000
Niger,2021,6,2336000,136000,2472000
Niger,2021,7,3808000,73000,3881000
Niger,2021,8,1420000,58000,1478000
Niger,2021,9,952000,106000,1058000
Niger,2021,10,1861000,316000,2177000
Niger,2021,11,2696000,61000,2757000
Niger,2021,12,2973000,37000,3010000
Niger,2022,1,4036000,44000,4080000
Niger,2022,2,2575000,161000,2736000
Niger,2022,3,6249000,67000,6316000
Niger,2022,4,1480000,64000,1544000
Niger,2022,5,2295000,77000,2372000
Niger,2022,6,2015000,78000,2093000
Niger,2022,7,3470000,205000,3675000
Niger,2022,8,4156000,400000,4556000
Niger,2022,9,2467000,223000,2690000
Niger,2022,10,2967000,281000,3248000
Niger,2022,11,3592000,180000,3772000
Niger,2022,12,1026000,58000,1084000
Niger,2023,1,4495000,1613000,6108000
Niger,2023,2,3077000,355000,3432000
Niger,2023,3,3248000,609000,3857000
Niger,2023,4,1378000,687000,2065000
Niger,2023,5,2286000,883000,3169000
Niger,2023,6,2546000,288000,2834000
Niger,2023,7,1197000,87000,1284000
Niger,2023,8,732000,346000,1078000
Niger,2023,9,295000,398000,693000
Niger,2023,10,405000,277000,682000
Niger,2023,11,313000,332000,645000
Niger,2023,12,583000,449000,1032000
Niger,2024,1,296000,1329000,1625000
Niger,2024,2,1418000,123000,1541000
Niger,2024,3,1326000,511000,1837000
Niger,2024,4,916000,719000,1635000
Niger,2024,5,432000,464000,896000
Niger,2024,6,652000,534000,1186000
Niger,2024,7,1247000,140000,1387000
Niger,2024,8,304000,503000,807000
Niger,2024,9,661000,210000,871000
Niger,2024,10,115000,408000,523000
Niger,2024,11,129000,297000,426000
Niger,2024,12,4519000,19210000,23729000
Nigeria,2008,1,96747000,175702000,272449000
Nigeria,2008,2,104903000,116999000,221902000
Nigeria,2008,3,93741000,120665000,214406000
Nigeria,2008,4,116028000,151270000,267298000
Nigeria,2008,5,85445000,186095000,271540000
Nigeria,2008,6,124518000,122599000,247117000
Nigeria,2008,7,96894000,121603000,218497000
Nigeria,2008,8,114230000,229069000,343299000
Nigeria,2008,9,147273000,239786000,387059000
Nigeria,2008,10,87879000,135231000,223110000
Nigeria,2008,11,104503000,75948000,180451000
Nigeria,2008,12,90173000,122159000,212332000
Nigeria,2009,1,81628000,109405000,191033000
Nigeria,2009,2,62946000,104887000,167833000
Nigeria,2009,3,104031000,85152000,189183000
Nigeria,2009,4,82029000,88324000,170353000
Nigeria,2009,5,88728000,120703000,209431000
Nigeria,2009,6,94792000,122880000,217672000
Nigeria,2009,7,137192000,36691000,173883000
Nigeria,2009,8,112566000,94886000,207452000
Nigeria,2009,9,101554000,109894000,211448000
Nigeria,2009,10,71567000,33939000,105506000
Nigeria,2009,11,75210000,108879000,184089000
Nigeria,2009,12,74426000,167662000,242088000
Nigeria,2010,1,56053000,166339000,222392000
Nigeria,2010,2,79591000,44138000,123729000
Nigeria,2010,3,98720000,63721000,162441000
Nigeria,2010,4,93237000,407902000,501139000
Nigeria,2010,5,76538000,103517000,180055000
Nigeria,2010,6,97353000,140783000,238136000
Nigeria,2010,7,90335000,194838000,285173000
Nigeria,2010,8,119387000,109415000,228802000
Nigeria,2010,9,106163000,186429000,292592000
Nigeria,2010,10,89197000,143824000,233021000
Nigeria,2010,11,93327000,252846000,346173000
Nigeria,2010,12,77338000,191443000,268781000
Nigeria,2011,1,79447000,202409000,281856000
Nigeria,2011,2,78603000,386134000,464737000
Nigeria,2011,3,105500000,176394000,281894000
Nigeria,2011,4,87169000,238030000,325199000
Nigeria,2011,5,94579000,146905000,241484000
Nigeria,2011,6,109563000,413242000,522805000
Nigeria,2011,7,151620000,292446000,444066000
Nigeria,2011,8,109981000,399229000,509210000
Nigeria,2011,9,125984000,383073000,509057000
Nigeria,2011,10,123412000,251080000,374492000
Nigeria,2011,11,120265000,256341000,376606000
Nigeria,2011,12,98460000,337070000,435530000
Nigeria,2012,1,86267000,377318000,463585000
Nigeria,2012,2,80151000,436340000,516491000
Nigeria,2012,3,134333000,422694000,557027000
Nigeria,2012,4,117347000,232933000,350280000
Nigeria,2012,5,105109000,217824000,322933000
Nigeria,2012,6,113431000,254173000,367604000
Nigeria,2012,7,112294000,440455000,552749000
Nigeria,2012,8,107577000,296260000,403837000
Nigeria,2012,9,98921000,442272000,541193000
Nigeria,2012,10,112191000,275547000,387738000
Nigeria,2012,11,104460000,489385000,593845000
Nigeria,2012,12,88892000,546578000,635470000
Nigeria,2013,1,78574000,266666000,345240000
Nigeria,2013,2,88699000,433738000,522437000
Nigeria,2013,3,100600000,348576000,449176000
Nigeria,2013,4,89305000,247365000,336670000
Nigeria,2013,5,133878000,235716000,369594000
Nigeria,2013,6,90728000,634907000,725635000
Nigeria,2013,7,145713000,161415000,307128000
Nigeria,2013,8,113591000,314438000,428029000
Nigeria,2013,9,136540000,300475000,437015000
Nigeria,2013,10,121503000,524651000,646154000
Nigeria,2013,11,107000000,336837000,443837000
Nigeria,2013,12,124558000,322203000,446761000
Nigeria,2014,1,95722000,399861000,495583000
Nigeria,2014,2,104027000,281510000,385537000
Nigeria,2014,3,116203000,508769000,624972000
Nigeria,2014,4,113831000,170071000,283902000
Nigeria,2014,5,144216000,329564000,473780000
Nigeria,2014,6,109816000,272727000,382543000
Nigeria,2014,7,135671000,439208000,574879000
Nigeria,2014,8,86811000,289735000,376546000
Nigeria,2014,9,125313000,445371000,570684000
Nigeria,2014,10,141869000,356384000,498253000
Nigeria,2014,11,110751000,287603000,398354000
Nigeria,2014,12,91133000,199940000,291073000
Nigeria,2015,1,64189000,196228000,260417000
Nigeria,2015,2,89404000,157987000,247391000
Nigeria,2015,3,83447000,250227000,333674000
Nigeria,2015,4,98016000,125960000,223976000
Nigeria,2015,5,69553000,222432000,291985000
Nigeria,2015,6,80862000,158753000,239615000
Nigeria,2015,7,111668000,178934000,290602000
Nigeria,2015,8,100823000,89474000,190297000
Nigeria,2015,9,78554000,197524000,276078000
Nigeria,2015,10,102139000,136257000,238396000
Nigeria,2015,11,78200000,139452000,217652000
Nigeria,2015,12,75439000,112669000,188108000
Nigeria,2016,1,48908000,231675000,280583000
Nigeria,2016,2,55095000,127872000,182967000
Nigeria,2016,3,49563000,126187000,175750000
Nigeria,2016,4,59259000,86176000,145435000
Nigeria,2016,5,53861000,109820000,163681000
Nigeria,2016,6,82871000,98968000,181839000
Nigeria,2016,7,53978000,155920000,209898000
Nigeria,2016,8,73360000,75150000,148510000
Nigeria,2016,9,57051000,14075000,71126000
Nigeria,2016,10,49653000,143303000,192956000
Nigeria,2016,11,109288000,73975000,183263000
Nigeria,2016,12,75091000,131636000,206727000
Nigeria,2017,1,64674000,114828000,179502000
Nigeria,2017,2,87326000,111449000,198775000
Nigeria,2017,3,82096000,118775000,200871000
Nigeria,2017,4,64868000,165076000,229944000
Nigeria,2017,5,91934000,127128000,219062000
Nigeria,2017,6,88838000,196228000,285066000
Nigeria,2017,7,77677000,74177000,151854000
Nigeria,2017,8,82784000,159783000,242567000
Nigeria,2017,9,91368000,143463000,234831000
Nigeria,2017,10,75682000,154753000,230435000
Nigeria,2017,11,71123000,172172000,243295000
Nigeria,2017,12,56964000,63585000,120549000
Nigeria,2018,1,45669000,42779000,88448000
Nigeria,2018,2,62709000,57678000,120387000
Nigeria,2018,3,68723000,167167000,235890000
Nigeria,2018,4,72257000,181143000,253400000
Nigeria,2018,5,67910000,185287000,253197000
Nigeria,2018,6,75776000,255461000,331237000
Nigeria,2018,7,81006000,237965000,318971000
Nigeria,2018,8,82322000,331107000,413429000
Nigeria,2018,9,63954000,199301000,263255000
Nigeria,2018,10,80914000,261073000,341987000
Nigeria,2018,11,96853000,212231000,309084000
Nigeria,2018,12,70569000,264069000,334638000
Nigeria,2019,1,71902000,160857000,232759000
Nigeria,2019,2,67035000,184612000,251647000
Nigeria,2019,3,104502000,106504000,211006000
Nigeria,2019,4,68548000,197912000,266460000
Nigeria,2019,5,91801000,145884000,237685000
Nigeria,2019,6,85984000,162720000,248704000
Nigeria,2019,7,77701000,267234000,344935000
Nigeria,2019,8,82706000,129958000,212664000
Nigeria,2019,9,79852000,173046000,252898000
Nigeria,2019,10,118313000,317850000,436163000
Nigeria,2019,11,82630000,160653000,243283000
Nigeria,2019,12,78205000,240287000,318492000
Nigeria,2020,1,83255000,174978000,258233000
Nigeria,2020,2,69597000,304516000,374113000
Nigeria,2020,3,116704000,138657000,255361000
Nigeria,2020,4,54739000,93336000,148075000
Nigeria,2020,5,68070000,96954000,165024000
Nigeria,2020,6,64125000,153641000,217766000
Nigeria,2020,7,85673000,61424000,147097000
Nigeria,2020,8,58081000,203398000,261479000
Nigeria,2020,9,80935000,121328000,202263000
Nigeria,2020,10,86621000,72810000,159431000
Nigeria,2020,11,57508000,97918000,155426000
Nigeria,2020,12,67368000,77610000,144978000
Nigeria,2021,1,45738000,73237000,118975000
Nigeria,2021,2,57608000,22658000,80266000
Nigeria,2021,3,105819000,74766000,180585000
Nigeria,2021,4,76402000,38896000,115298000
Nigeria,2021,5,98437000,72817000,171254000
Nigeria,2021,6,90826000,83051000,173877000
Nigeria,2021,7,80866000,95827000,176693000
Nigeria,2021,8,89884000,19443000,109327000
Nigeria,2021,9,78098000,122668000,200766000
Nigeria,2021,10,71863000,298642000,370505000
Nigeria,2021,11,99822000,162053000,261875000
Nigeria,2021,12,80165000,155709000,235874000
Nigeria,2022,1,61528000,106285000,167813000
Nigeria,2022,2,76677000,251927000,328604000
Nigeria,2022,3,82906000,318496000,401402000
Nigeria,2022,4,75522000,369928000,445450000
Nigeria,2022,5,106973000,141436000,248409000
Nigeria,2022,6,111781000,380272000,492053000
Nigeria,2022,7,89270000,167488000,256758000
Nigeria,2022,8,116885000,18901000,135786000
Nigeria,2022,9,82958000,31962000,114920000
Nigeria,2022,10,93816000,113618000,207434000
Nigeria,2022,11,83364000,171452000,254816000
Nigeria,2022,12,86295000,281635000,367930000
Nigeria,2023,1,50830000,190367000,241197000
Nigeria,2023,2,65620000,95112000,160732000
Nigeria,2023,3,74196000,115054000,189250000
Nigeria,2023,4,70677000,257778000,328455000
Nigeria,2023,5,72079000,122721000,194800000
Nigeria,2023,6,79172000,234239000,313411000
Nigeria,2023,7,73957000,90840000,164797000
Nigeria,2023,8,74516000,133108000,207624000
Nigeria,2023,9,72764000,170551000,243315000
Nigeria,2023,10,58700000,292522000,351222000
Nigeria,2023,11,83720000,160074000,243794000
Nigeria,2023,12,80612000,77457000,158069000
Nigeria,2024,1,50426000,113641000,164067000
Nigeria,2024,2,58302000,180961000,239263000
Nigeria,2024,3,63267000,177782000,241049000
Nigeria,2024,4,70477000,138034000,208511000
Nigeria,2024,5,65999000,130442000,196441000
Nigeria,2024,6,69173000,179411000,248584000
Nigeria,2024,7,83068000,212674000,295742000
Nigeria,2024,8,69695000,151796000,221491000
Nigeria,2024,9,97476000,221235000,318711000
Nigeria,2024,10,89298000,41770000,131068000
Nigeria,2024,11,84615000,142247000,226862000
Nigeria,2024,12,82649000,147729000,230378000
Niue (ab 2001),2008,1,7000,1000,8000
Niue (ab 2001),2008,2,20000,1000,21000
Niue (ab 2001),2008,3,15000,0,15000
Niue (ab 2001),2008,4,6000,0,6000
Niue (ab 2001),2008,5,34000,0,34000
Niue (ab 2001),2008,6,3000,0,3000
Niue (ab 2001),2008,7,0,0,0
Niue (ab 2001),2008,8,243000,0,243000
Niue (ab 2001),2008,9,2000,0,2000
Niue (ab 2001),2008,10,0,1000,1000
Niue (ab 2001),2008,11,36000,0,36000
Niue (ab 2001),2008,12,147000,2000,149000
Niue (ab 2001),2009,1,147000,49000,196000
Niue (ab 2001),2009,2,198000,0,198000
Niue (ab 2001),2009,3,609000,0,609000
Niue (ab 2001),2009,4,192000,0,192000
Niue (ab 2001),2009,5,264000,0,264000
Niue (ab 2001),2009,6,240000,0,240000
Niue (ab 2001),2009,7,0,0,0
Niue (ab 2001),2009,8,0,0,0
Niue (ab 2001),2009,9,0,0,0
Niue (ab 2001),2009,10,0,0,0
Niue (ab 2001),2009,11,0,0,0
Niue (ab 2001),2009,12,0,0,0
Niue (ab 2001),2010,1,0,0,0
Niue (ab 2001),2010,2,0,0,0
Niue (ab 2001),2010,3,0,0,0
Niue (ab 2001),2010,4,0,0,0
Niue (ab 2001),2010,5,0,0,0
Niue (ab 2001),2010,6,0,0,0
Niue (ab 2001),2010,7,0,0,0
Niue (ab 2001),2010,8,0,0,0
Niue (ab 2001),2010,9,0,0,0
Niue (ab 2001),2010,10,0,0,0
Niue (ab 2001),2010,11,0,1000,1000
Niue (ab 2001),2010,12,2000,272000,274000
Niue (ab 2001),2011,1,0,5000,5000
Niue (ab 2001),2011,2,0,10000,10000
Niue (ab 2001),2011,3,0,25000,25000
Niue (ab 2001),2011,4,0,0,0
Niue (ab 2001),2011,5,0,8000,8000
Niue (ab 2001),2011,6,0,0,0
Niue (ab 2001),2011,7,0,39000,39000
Niue (ab 2001),2011,8,0,0,0
Niue (ab 2001),2011,9,0,0,0
Niue (ab 2001),2011,10,0,0,0
Niue (ab 2001),2011,11,0,1000,1000
Niue (ab 2001),2011,12,0,5000,5000
Niue (ab 2001),2012,1,0,0,0
Niue (ab 2001),2012,2,0,0,0
Niue (ab 2001),2012,3,0,2000,2000
Niue (ab 2001),2012,4,0,3000,3000
Niue (ab 2001),2012,5,0,0,0
Niue (ab 2001),2012,6,0,1000,1000
Niue (ab 2001),2012,7,0,0,0
Niue (ab 2001),2012,8,0,0,0
Niue (ab 2001),2012,9,0,0,0
Niue (ab 2001),2012,10,0,0,0
Niue (ab 2001),2012,11,0,0,0
Niue (ab 2001),2012,12,0,0,0
Niue (ab 2001),2013,1,0,0,0
Niue (ab 2001),2013,2,0,3000,3000
Niue (ab 2001),2013,3,0,0,0
Niue (ab 2001),2013,4,0,6000,6000
Niue (ab 2001),2013,5,0,0,0
Niue (ab 2001),2013,6,0,2000,2000
Niue (ab 2001),2013,7,0,2000,2000
Niue (ab 2001),2013,8,0,0,0
Niue (ab 2001),2013,9,0,0,0
Niue (ab 2001),2013,10,0,0,0
Niue (ab 2001),2013,11,0,3000,3000
Niue (ab 2001),2013,12,0,4000,4000
Niue (ab 2001),2014,1,0,2000,2000
Niue (ab 2001),2014,2,0,0,0
Niue (ab 2001),2014,3,0,2000,2000
Niue (ab 2001),2014,4,0,11000,11000
Niue (ab 2001),2014,5,0,0,0
Niue (ab 2001),2014,6,0,5000,5000
Niue (ab 2001),2014,7,0,0,0
Niue (ab 2001),2014,8,0,5000,5000
Niue (ab 2001),2014,9,0,0,0
Niue (ab 2001),2014,10,0,9000,9000
Niue (ab 2001),2014,11,0,0,0
Niue (ab 2001),2014,12,0,0,0
Niue (ab 2001),2015,1,0,12000,12000
Niue (ab 2001),2015,2,0,1000,1000
Niue (ab 2001),2015,3,0,1000,1000
Niue (ab 2001),2015,4,0,19000,19000
Niue (ab 2001),2015,5,0,0,0
Niue (ab 2001),2015,6,0,1000,1000
Niue (ab 2001),2015,7,0,0,0
Niue (ab 2001),2015,8,0,0,0
Niue (ab 2001),2015,9,0,1000,1000
Niue (ab 2001),2015,10,0,6000,6000
Niue (ab 2001),2015,11,0,25000,25000
Niue (ab 2001),2015,12,0,3000,3000
Niue (ab 2001),2016,1,0,0,0
Niue (ab 2001),2016,2,0,10000,10000
Niue (ab 2001),2016,3,0,57000,57000
Niue (ab 2001),2016,4,0,1000,1000
Niue (ab 2001),2016,5,0,173000,173000
Niue (ab 2001),2016,6,0,2000,2000
Niue (ab 2001),2016,7,0,2000,2000
Niue (ab 2001),2016,8,65000,14000,79000
Niue (ab 2001),2016,9,0,1000,1000
Niue (ab 2001),2016,10,0,0,0
Niue (ab 2001),2016,11,0,0,0
Niue (ab 2001),2016,12,0,257000,257000
Niue (ab 2001),2017,1,0,155000,155000
Niue (ab 2001),2017,2,0,103000,103000
Niue (ab 2001),2017,3,0,174000,174000
Niue (ab 2001),2017,4,0,0,0
Niue (ab 2001),2017,5,0,6000,6000
Niue (ab 2001),2017,6,0,91000,91000
Niue (ab 2001),2017,7,0,0,0
Niue (ab 2001),2017,8,3000,0,3000
Niue (ab 2001),2017,9,0,3000,3000
Niue (ab 2001),2017,10,0,13000,13000
Niue (ab 2001),2017,11,0,2000,2000
Niue (ab 2001),2017,12,0,0,0
Niue (ab 2001),2018,1,0,0,0
Niue (ab 2001),2018,2,0,8000,8000
Niue (ab 2001),2018,3,0,19000,19000
Niue (ab 2001),2018,4,0,0,0
Niue (ab 2001),2018,5,0,28000,28000
Niue (ab 2001),2018,6,0,11000,11000
Niue (ab 2001),2018,7,0,427000,427000
Niue (ab 2001),2018,8,0,9000,9000
Niue (ab 2001),2018,9,0,110000,110000
Niue (ab 2001),2018,10,0,10000,10000
Niue (ab 2001),2018,11,0,30000,30000
Niue (ab 2001),2018,12,0,18000,18000
Niue (ab 2001),2019,1,0,0,0
Niue (ab 2001),2019,2,0,2000,2000
Niue (ab 2001),2019,3,0,1000,1000
Niue (ab 2001),2019,4,0,19000,19000
Niue (ab 2001),2019,5,0,1000,1000
Niue (ab 2001),2019,6,0,0,0
Niue (ab 2001),2019,7,0,1000,1000
Niue (ab 2001),2019,8,0,6000,6000
Niue (ab 2001),2019,9,0,2000,2000
Niue (ab 2001),2019,10,0,107000,107000
Niue (ab 2001),2019,11,0,91000,91000
Niue (ab 2001),2019,12,0,10000,10000
Niue (ab 2001),2020,1,27000,0,27000
Niue (ab 2001),2020,2,0,16000,16000
Niue (ab 2001),2020,3,0,3000,3000
Niue (ab 2001),2020,4,0,7000,7000
Niue (ab 2001),2020,5,0,4000,4000
Niue (ab 2001),2020,6,0,23000,23000
Niue (ab 2001),2020,7,0,23000,23000
Niue (ab 2001),2020,8,0,591000,591000
Niue (ab 2001),2020,9,0,140000,140000
Niue (ab 2001),2020,10,0,52000,52000
Niue (ab 2001),2020,11,0,0,0
Niue (ab 2001),2020,12,0,0,0
Niue (ab 2001),2021,1,0,441000,441000
Niue (ab 2001),2021,2,14000,0,14000
Niue (ab 2001),2021,3,7000,0,7000
Niue (ab 2001),2021,4,0,0,0
Niue (ab 2001),2021,5,0,0,0
Niue (ab 2001),2021,6,0,0,0
Niue (ab 2001),2021,7,0,0,0
Niue (ab 2001),2021,8,0,298000,298000
Niue (ab 2001),2021,9,0,0,0
Niue (ab 2001),2021,10,0,0,0
Niue (ab 2001),2021,11,0,86000,86000
Niue (ab 2001),2021,12,0,0,0
Niue (ab 2001),2022,1,0,29000,29000
Niue (ab 2001),2022,2,0,14000,14000
Niue (ab 2001),2022,3,0,3000,3000
Niue (ab 2001),2022,4,0,0,0
Niue (ab 2001),2022,5,0,1000,1000
Niue (ab 2001),2022,6,0,300000,300000
Niue (ab 2001),2022,7,0,0,0
Niue (ab 2001),2022,8,0,0,0
Niue (ab 2001),2022,9,0,0,0
Niue (ab 2001),2022,10,0,0,0
Niue (ab 2001),2022,11,0,0,0
Niue (ab 2001),2022,12,0,0,0
Niue (ab 2001),2023,1,0,1000,1000
Niue (ab 2001),2023,2,0,0,0
Niue (ab 2001),2023,3,0,0,0
Niue (ab 2001),2023,4,0,0,0
Niue (ab 2001),2023,5,0,0,0
Niue (ab 2001),2023,6,0,0,0
Niue (ab 2001),2023,7,0,0,0
Niue (ab 2001),2023,8,0,0,0
Niue (ab 2001),2023,9,18000,419000,437000
Niue (ab 2001),2023,10,0,0,0
Niue (ab 2001),2023,11,0,0,0
Niue (ab 2001),2023,12,0,2000,2000
Niue (ab 2001),2024,1,0,0,0
Niue (ab 2001),2024,2,0,0,0
Niue (ab 2001),2024,3,0,0,0
Niue (ab 2001),2024,4,0,0,0
Niue (ab 2001),2024,5,0,1000,1000
Niue (ab 2001),2024,6,0,3000,3000
Niue (ab 2001),2024,7,0,0,0
Niue (ab 2001),2024,8,0,67000,67000
Niue (ab 2001),2024,9,0,0,0
Niue (ab 2001),2024,10,0,0,0
Niue (ab 2001),2024,11,0,0,0
Niue (ab 2001),2024,12,0,0,0
Nordmazedonien (ab 1992),2008,1,36186000,72455000,108641000
Nordmazedonien (ab 1992),2008,2,35785000,43118000,78903000
Nordmazedonien (ab 1992),2008,3,37227000,42322000,79549000
Nordmazedonien (ab 1992),2008,4,39929000,36413000,76342000
Nordmazedonien (ab 1992),2008,5,35188000,32872000,68060000
Nordmazedonien (ab 1992),2008,6,48559000,31922000,80481000
Nordmazedonien (ab 1992),2008,7,55833000,42368000,98201000
Nordmazedonien (ab 1992),2008,8,26788000,28407000,55195000
Nordmazedonien (ab 1992),2008,9,34459000,37181000,71640000
Nordmazedonien (ab 1992),2008,10,42736000,31534000,74270000
Nordmazedonien (ab 1992),2008,11,40189000,32719000,72908000
Nordmazedonien (ab 1992),2008,12,39850000,29628000,69478000
Nordmazedonien (ab 1992),2009,1,28982000,32284000,61266000
Nordmazedonien (ab 1992),2009,2,29799000,33207000,63006000
Nordmazedonien (ab 1992),2009,3,34723000,35557000,70280000
Nordmazedonien (ab 1992),2009,4,33866000,30590000,64456000
Nordmazedonien (ab 1992),2009,5,35049000,29251000,64300000
Nordmazedonien (ab 1992),2009,6,39078000,27477000,66555000
Nordmazedonien (ab 1992),2009,7,39617000,31199000,70816000
Nordmazedonien (ab 1992),2009,8,26725000,26465000,53190000
Nordmazedonien (ab 1992),2009,9,29385000,27452000,56837000
Nordmazedonien (ab 1992),2009,10,38360000,27177000,65537000
Nordmazedonien (ab 1992),2009,11,36284000,28899000,65183000
Nordmazedonien (ab 1992),2009,12,33841000,26782000,60623000
Nordmazedonien (ab 1992),2010,1,26239000,37807000,64046000
Nordmazedonien (ab 1992),2010,2,30407000,36982000,67389000
Nordmazedonien (ab 1992),2010,3,40057000,45203000,85260000
Nordmazedonien (ab 1992),2010,4,37153000,35480000,72633000
Nordmazedonien (ab 1992),2010,5,38396000,39131000,77527000
Nordmazedonien (ab 1992),2010,6,40810000,48054000,88864000
Nordmazedonien (ab 1992),2010,7,39049000,48472000,87521000
Nordmazedonien (ab 1992),2010,8,33542000,47935000,81477000
Nordmazedonien (ab 1992),2010,9,39702000,59611000,99313000
Nordmazedonien (ab 1992),2010,10,45225000,52450000,97675000
Nordmazedonien (ab 1992),2010,11,42084000,79462000,121546000
Nordmazedonien (ab 1992),2010,12,44075000,60309000,104384000
Nordmazedonien (ab 1992),2011,1,32843000,76559000,109402000
Nordmazedonien (ab 1992),2011,2,39486000,85418000,124904000
Nordmazedonien (ab 1992),2011,3,45402000,86400000,131802000
Nordmazedonien (ab 1992),2011,4,43066000,75248000,118314000
Nordmazedonien (ab 1992),2011,5,51097000,88421000,139518000
Nordmazedonien (ab 1992),2011,6,49167000,80880000,130047000
Nordmazedonien (ab 1992),2011,7,42520000,61162000,103682000
Nordmazedonien (ab 1992),2011,8,39242000,73861000,113103000
Nordmazedonien (ab 1992),2011,9,44781000,89333000,134114000
Nordmazedonien (ab 1992),2011,10,41207000,82671000,123878000
Nordmazedonien (ab 1992),2011,11,45704000,70817000,116521000
Nordmazedonien (ab 1992),2011,12,52885000,83354000,136239000
Nordmazedonien (ab 1992),2012,1,34383000,79317000,113700000
Nordmazedonien (ab 1992),2012,2,33792000,84101000,117893000
Nordmazedonien (ab 1992),2012,3,41712000,88566000,130278000
Nordmazedonien (ab 1992),2012,4,39246000,69346000,108592000
Nordmazedonien (ab 1992),2012,5,45822000,87164000,132986000
Nordmazedonien (ab 1992),2012,6,44830000,73873000,118703000
Nordmazedonien (ab 1992),2012,7,39138000,76480000,115618000
Nordmazedonien (ab 1992),2012,8,45746000,72843000,118589000
Nordmazedonien (ab 1992),2012,9,48613000,74263000,122876000
Nordmazedonien (ab 1992),2012,10,47316000,89458000,136774000
Nordmazedonien (ab 1992),2012,11,50656000,86314000,136970000
Nordmazedonien (ab 1992),2012,12,41096000,81899000,122995000
Nordmazedonien (ab 1992),2013,1,42510000,104965000,147475000
Nordmazedonien (ab 1992),2013,2,35025000,98072000,133097000
Nordmazedonien (ab 1992),2013,3,41591000,95166000,136757000
Nordmazedonien (ab 1992),2013,4,51421000,95418000,146839000
Nordmazedonien (ab 1992),2013,5,49803000,90255000,140058000
Nordmazedonien (ab 1992),2013,6,49803000,96755000,146558000
Nordmazedonien (ab 1992),2013,7,46253000,104427000,150680000
Nordmazedonien (ab 1992),2013,8,37520000,98553000,136073000
Nordmazedonien (ab 1992),2013,9,41747000,97203000,138950000
Nordmazedonien (ab 1992),2013,10,54403000,100416000,154819000
Nordmazedonien (ab 1992),2013,11,50412000,96802000,147214000
Nordmazedonien (ab 1992),2013,12,46267000,107386000,153653000
Nordmazedonien (ab 1992),2014,1,46218000,130284000,176502000
Nordmazedonien (ab 1992),2014,2,48700000,121751000,170451000
Nordmazedonien (ab 1992),2014,3,50028000,130478000,180506000
Nordmazedonien (ab 1992),2014,4,60222000,111796000,172018000
Nordmazedonien (ab 1992),2014,5,60339000,116675000,177014000
Nordmazedonien (ab 1992),2014,6,56810000,143457000,200267000
Nordmazedonien (ab 1992),2014,7,58660000,126743000,185403000
Nordmazedonien (ab 1992),2014,8,47303000,104921000,152224000
Nordmazedonien (ab 1992),2014,9,62795000,139651000,202446000
Nordmazedonien (ab 1992),2014,10,70261000,145899000,216160000
Nordmazedonien (ab 1992),2014,11,60674000,148649000,209323000
Nordmazedonien (ab 1992),2014,12,56736000,141822000,198558000
Nordmazedonien (ab 1992),2015,1,49300000,135960000,185260000
Nordmazedonien (ab 1992),2015,2,54759000,133737000,188496000
Nordmazedonien (ab 1992),2015,3,62424000,151045000,213469000
Nordmazedonien (ab 1992),2015,4,67704000,136615000,204319000
Nordmazedonien (ab 1992),2015,5,67566000,147341000,214907000
Nordmazedonien (ab 1992),2015,6,75599000,176114000,251713000
Nordmazedonien (ab 1992),2015,7,69850000,162171000,232021000
Nordmazedonien (ab 1992),2015,8,64707000,154902000,219609000
Nordmazedonien (ab 1992),2015,9,76166000,160622000,236788000
Nordmazedonien (ab 1992),2015,10,85617000,141630000,227247000
Nordmazedonien (ab 1992),2015,11,82886000,186614000,269500000
Nordmazedonien (ab 1992),2015,12,80242000,162292000,242534000
Nordmazedonien (ab 1992),2016,1,67723000,139044000,206767000
Nordmazedonien (ab 1992),2016,2,78038000,188665000,266703000
Nordmazedonien (ab 1992),2016,3,88041000,194654000,282695000
Nordmazedonien (ab 1992),2016,4,87882000,164749000,252631000
Nordmazedonien (ab 1992),2016,5,79638000,169998000,249636000
Nordmazedonien (ab 1992),2016,6,81977000,163550000,245527000
Nordmazedonien (ab 1992),2016,7,67303000,155530000,222833000
Nordmazedonien (ab 1992),2016,8,72830000,184245000,257075000
Nordmazedonien (ab 1992),2016,9,82394000,184611000,267005000
Nordmazedonien (ab 1992),2016,10,72533000,174949000,247482000
Nordmazedonien (ab 1992),2016,11,82784000,187804000,270588000
Nordmazedonien (ab 1992),2016,12,73533000,171521000,245054000
Nordmazedonien (ab 1992),2017,1,68560000,169787000,238347000
Nordmazedonien (ab 1992),2017,2,78656000,199335000,277991000
Nordmazedonien (ab 1992),2017,3,88173000,214200000,302373000
Nordmazedonien (ab 1992),2017,4,76965000,173544000,250509000
Nordmazedonien (ab 1992),2017,5,95493000,218942000,314435000
Nordmazedonien (ab 1992),2017,6,87554000,204863000,292417000
Nordmazedonien (ab 1992),2017,7,81668000,194711000,276379000
Nordmazedonien (ab 1992),2017,8,81212000,187686000,268898000
Nordmazedonien (ab 1992),2017,9,92050000,208955000,301005000
Nordmazedonien (ab 1992),2017,10,96599000,232030000,328629000
Nordmazedonien (ab 1992),2017,11,97713000,252093000,349806000
Nordmazedonien (ab 1992),2017,12,95827000,218193000,314020000
Nordmazedonien (ab 1992),2018,1,86859000,232242000,319101000
Nordmazedonien (ab 1992),2018,2,88099000,231836000,319935000
Nordmazedonien (ab 1992),2018,3,104544000,219984000,324528000
Nordmazedonien (ab 1992),2018,4,95218000,205299000,300517000
Nordmazedonien (ab 1992),2018,5,101757000,241099000,342856000
Nordmazedonien (ab 1992),2018,6,113307000,249158000,362465000
Nordmazedonien (ab 1992),2018,7,98489000,262830000,361319000
Nordmazedonien (ab 1992),2018,8,97280000,226960000,324240000
Nordmazedonien (ab 1992),2018,9,95317000,243745000,339062000
Nordmazedonien (ab 1992),2018,10,119690000,289694000,409384000
Nordmazedonien (ab 1992),2018,11,114727000,273698000,388425000
Nordmazedonien (ab 1992),2018,12,92214000,221005000,313219000
Nordmazedonien (ab 1992),2019,1,106102000,286207000,392309000
Nordmazedonien (ab 1992),2019,2,97535000,246019000,343554000
Nordmazedonien (ab 1992),2019,3,105467000,292269000,397736000
Nordmazedonien (ab 1992),2019,4,107204000,275183000,382387000
Nordmazedonien (ab 1992),2019,5,113495000,270573000,384068000
Nordmazedonien (ab 1992),2019,6,102634000,257453000,360087000
Nordmazedonien (ab 1992),2019,7,99107000,288640000,387747000
Nordmazedonien (ab 1992),2019,8,102424000,237772000,340196000
Nordmazedonien (ab 1992),2019,9,105780000,268336000,374116000
Nordmazedonien (ab 1992),2019,10,117321000,265012000,382333000
Nordmazedonien (ab 1992),2019,11,106185000,269966000,376151000
Nordmazedonien (ab 1992),2019,12,95784000,248758000,344542000
Nordmazedonien (ab 1992),2020,1,97375000,248357000,345732000
Nordmazedonien (ab 1992),2020,2,95149000,247809000,342958000
Nordmazedonien (ab 1992),2020,3,90777000,232558000,323335000
Nordmazedonien (ab 1992),2020,4,33444000,42241000,75685000
Nordmazedonien (ab 1992),2020,5,50959000,116871000,167830000
Nordmazedonien (ab 1992),2020,6,75022000,229990000,305012000
Nordmazedonien (ab 1992),2020,7,89337000,260924000,350261000
Nordmazedonien (ab 1992),2020,8,83064000,254365000,337429000
Nordmazedonien (ab 1992),2020,9,99048000,288426000,387474000
Nordmazedonien (ab 1992),2020,10,107846000,296698000,404544000
Nordmazedonien (ab 1992),2020,11,99331000,297399000,396730000
Nordmazedonien (ab 1992),2020,12,109589000,274230000,383819000
Nordmazedonien (ab 1992),2021,1,92257000,265274000,357531000
Nordmazedonien (ab 1992),2021,2,106124000,294129000,400253000
Nordmazedonien (ab 1992),2021,3,125963000,310666000,436629000
Nordmazedonien (ab 1992),2021,4,118648000,316337000,434985000
Nordmazedonien (ab 1992),2021,5,102548000,265318000,367866000
Nordmazedonien (ab 1992),2021,6,104429000,461869000,566298000
Nordmazedonien (ab 1992),2021,7,93931000,245642000,339573000
Nordmazedonien (ab 1992),2021,8,95778000,303912000,399690000
Nordmazedonien (ab 1992),2021,9,101695000,232480000,334175000
Nordmazedonien (ab 1992),2021,10,91820000,242845000,334665000
Nordmazedonien (ab 1992),2021,11,106049000,268023000,374072000
Nordmazedonien (ab 1992),2021,12,105408000,271041000,376449000
Nordmazedonien (ab 1992),2022,1,90732000,289533000,380265000
Nordmazedonien (ab 1992),2022,2,112508000,325825000,438333000
Nordmazedonien (ab 1992),2022,3,127684000,309526000,437210000
Nordmazedonien (ab 1992),2022,4,102612000,252084000,354696000
Nordmazedonien (ab 1992),2022,5,116983000,361377000,478360000
Nordmazedonien (ab 1992),2022,6,113951000,357585000,471536000
Nordmazedonien (ab 1992),2022,7,100275000,305861000,406136000
Nordmazedonien (ab 1992),2022,8,105029000,311780000,416809000
Nordmazedonien (ab 1992),2022,9,113095000,368872000,481967000
Nordmazedonien (ab 1992),2022,10,108240000,351010000,459250000
Nordmazedonien (ab 1992),2022,11,113593000,358421000,472014000
Nordmazedonien (ab 1992),2022,12,111938000,301461000,413399000
Nordmazedonien (ab 1992),2023,1,100415000,289153000,389568000
Nordmazedonien (ab 1992),2023,2,114812000,346793000,461605000
Nordmazedonien (ab 1992),2023,3,124863000,379837000,504700000
Nordmazedonien (ab 1992),2023,4,90580000,289449000,380029000
Nordmazedonien (ab 1992),2023,5,112385000,375566000,487951000
Nordmazedonien (ab 1992),2023,6,124956000,321032000,445988000
Nordmazedonien (ab 1992),2023,7,104125000,317288000,421413000
Nordmazedonien (ab 1992),2023,8,116808000,251711000,368519000
Nordmazedonien (ab 1992),2023,9,112744000,322115000,434859000
Nordmazedonien (ab 1992),2023,10,120677000,320111000,440788000
Nordmazedonien (ab 1992),2023,11,120775000,312527000,433302000
Nordmazedonien (ab 1992),2023,12,116389000,253897000,370286000
Nordmazedonien (ab 1992),2024,1,106824000,258130000,364954000
Nordmazedonien (ab 1992),2024,2,131409000,306479000,437888000
Nordmazedonien (ab 1992),2024,3,147182000,281451000,428633000
Nordmazedonien (ab 1992),2024,4,138579000,347164000,485743000
Nordmazedonien (ab 1992),2024,5,118547000,249060000,367607000
Nordmazedonien (ab 1992),2024,6,124836000,266657000,391493000
Nordmazedonien (ab 1992),2024,7,114036000,413074000,527110000
Nordmazedonien (ab 1992),2024,8,104588000,255943000,360531000
Nordmazedonien (ab 1992),2024,9,107683000,268718000,376401000
Nordmazedonien (ab 1992),2024,10,122907000,280345000,403252000
Nordmazedonien (ab 1992),2024,11,103176000,242661000,345837000
Nordmazedonien (ab 1992),2024,12,94232000,211670000,305902000
Norfolkinseln (ab 2001),2008,1,21000,0,21000
Norfolkinseln (ab 2001),2008,2,7000,1000,8000
Norfolkinseln (ab 2001),2008,3,15000,1000,16000
Norfolkinseln (ab 2001),2008,4,0,0,0
Norfolkinseln (ab 2001),2008,5,37000,0,37000
Norfolkinseln (ab 2001),2008,6,72000,1000,73000
Norfolkinseln (ab 2001),2008,7,4000,1000,5000
Norfolkinseln (ab 2001),2008,8,7000,1000,8000
Norfolkinseln (ab 2001),2008,9,0,0,0
Norfolkinseln (ab 2001),2008,10,19000,1000,20000
Norfolkinseln (ab 2001),2008,11,6000,0,6000
Norfolkinseln (ab 2001),2008,12,15000,2000,17000
Norfolkinseln (ab 2001),2009,1,53000,2000,55000
Norfolkinseln (ab 2001),2009,2,67000,0,67000
Norfolkinseln (ab 2001),2009,3,13000,0,13000
Norfolkinseln (ab 2001),2009,4,3000,0,3000
Norfolkinseln (ab 2001),2009,5,19000,0,19000
Norfolkinseln (ab 2001),2009,6,38000,0,38000
Norfolkinseln (ab 2001),2009,7,0,0,0
Norfolkinseln (ab 2001),2009,8,0,0,0
Norfolkinseln (ab 2001),2009,9,2000,0,2000
Norfolkinseln (ab 2001),2009,10,18000,0,18000
Norfolkinseln (ab 2001),2009,11,0,0,0
Norfolkinseln (ab 2001),2009,12,8000,0,8000
Norfolkinseln (ab 2001),2010,1,0,0,0
Norfolkinseln (ab 2001),2010,2,7000,0,7000
Norfolkinseln (ab 2001),2010,3,3000,0,3000
Norfolkinseln (ab 2001),2010,4,52000,0,52000
Norfolkinseln (ab 2001),2010,5,0,0,0
Norfolkinseln (ab 2001),2010,6,3000,0,3000
Norfolkinseln (ab 2001),2010,7,4000,0,4000
Norfolkinseln (ab 2001),2010,8,2000,0,2000
Norfolkinseln (ab 2001),2010,9,0,0,0
Norfolkinseln (ab 2001),2010,10,2000,0,2000
Norfolkinseln (ab 2001),2010,11,16000,0,16000
Norfolkinseln (ab 2001),2010,12,33000,0,33000
Norfolkinseln (ab 2001),2011,1,3000,0,3000
Norfolkinseln (ab 2001),2011,2,0,0,0
Norfolkinseln (ab 2001),2011,3,0,0,0
Norfolkinseln (ab 2001),2011,4,7000,0,7000
Norfolkinseln (ab 2001),2011,5,53000,0,53000
Norfolkinseln (ab 2001),2011,6,0,0,0
Norfolkinseln (ab 2001),2011,7,0,0,0
Norfolkinseln (ab 2001),2011,8,12000,0,12000
Norfolkinseln (ab 2001),2011,9,0,0,0
Norfolkinseln (ab 2001),2011,10,27000,0,27000
Norfolkinseln (ab 2001),2011,11,3000,0,3000
Norfolkinseln (ab 2001),2011,12,0,0,0
Norfolkinseln (ab 2001),2012,1,0,0,0
Norfolkinseln (ab 2001),2012,2,4000,0,4000
Norfolkinseln (ab 2001),2012,3,1000,0,1000
Norfolkinseln (ab 2001),2012,4,3000,0,3000
Norfolkinseln (ab 2001),2012,5,30000,0,30000
Norfolkinseln (ab 2001),2012,6,0,0,0
Norfolkinseln (ab 2001),2012,7,3000,0,3000
Norfolkinseln (ab 2001),2012,8,5000,0,5000
Norfolkinseln (ab 2001),2012,9,2000,0,2000
Norfolkinseln (ab 2001),2012,10,22000,0,22000
Norfolkinseln (ab 2001),2012,11,5000,0,5000
Norfolkinseln (ab 2001),2012,12,5000,0,5000
Norfolkinseln (ab 2001),2013,1,0,0,0
Norfolkinseln (ab 2001),2013,2,0,0,0
Norfolkinseln (ab 2001),2013,3,0,0,0
Norfolkinseln (ab 2001),2013,4,65000,0,65000
Norfolkinseln (ab 2001),2013,5,0,0,0
Norfolkinseln (ab 2001),2013,6,0,0,0
Norfolkinseln (ab 2001),2013,7,0,0,0
Norfolkinseln (ab 2001),2013,8,0,0,0
Norfolkinseln (ab 2001),2013,9,0,0,0
Norfolkinseln (ab 2001),2013,10,31000,0,31000
Norfolkinseln (ab 2001),2013,11,8000,0,8000
Norfolkinseln (ab 2001),2013,12,0,0,0
Norfolkinseln (ab 2001),2014,1,0,0,0
Norfolkinseln (ab 2001),2014,2,5000,0,5000
Norfolkinseln (ab 2001),2014,3,0,0,0
Norfolkinseln (ab 2001),2014,4,48000,0,48000
Norfolkinseln (ab 2001),2014,5,5000,0,5000
Norfolkinseln (ab 2001),2014,6,0,0,0
Norfolkinseln (ab 2001),2014,7,10000,0,10000
Norfolkinseln (ab 2001),2014,8,0,0,0
Norfolkinseln (ab 2001),2014,9,0,0,0
Norfolkinseln (ab 2001),2014,10,41000,0,41000
Norfolkinseln (ab 2001),2014,11,0,0,0
Norfolkinseln (ab 2001),2014,12,0,0,0
Norfolkinseln (ab 2001),2015,1,1000,0,1000
Norfolkinseln (ab 2001),2015,2,0,0,0
Norfolkinseln (ab 2001),2015,3,3000,0,3000
Norfolkinseln (ab 2001),2015,4,72000,0,72000
Norfolkinseln (ab 2001),2015,5,0,0,0
Norfolkinseln (ab 2001),2015,6,0,0,0
Norfolkinseln (ab 2001),2015,7,1000,0,1000
Norfolkinseln (ab 2001),2015,8,0,0,0
Norfolkinseln (ab 2001),2015,9,0,0,0
Norfolkinseln (ab 2001),2015,10,24000,2000,26000
Norfolkinseln (ab 2001),2015,11,0,0,0
Norfolkinseln (ab 2001),2015,12,0,0,0
Norfolkinseln (ab 2001),2016,1,8000,0,8000
Norfolkinseln (ab 2001),2016,2,0,0,0
Norfolkinseln (ab 2001),2016,3,0,0,0
Norfolkinseln (ab 2001),2016,4,46000,0,46000
Norfolkinseln (ab 2001),2016,5,46000,0,46000
Norfolkinseln (ab 2001),2016,6,0,0,0
Norfolkinseln (ab 2001),2016,7,0,0,0
Norfolkinseln (ab 2001),2016,8,6000,0,6000
Norfolkinseln (ab 2001),2016,9,0,0,0
Norfolkinseln (ab 2001),2016,10,26000,0,26000
Norfolkinseln (ab 2001),2016,11,11000,0,11000
Norfolkinseln (ab 2001),2016,12,0,0,0
Norfolkinseln (ab 2001),2017,1,6000,0,6000
Norfolkinseln (ab 2001),2017,2,0,0,0
Norfolkinseln (ab 2001),2017,3,0,0,0
Norfolkinseln (ab 2001),2017,4,51000,0,51000
Norfolkinseln (ab 2001),2017,5,6000,0,6000
Norfolkinseln (ab 2001),2017,6,0,0,0
Norfolkinseln (ab 2001),2017,7,0,0,0
Norfolkinseln (ab 2001),2017,8,0,0,0
Norfolkinseln (ab 2001),2017,9,0,0,0
Norfolkinseln (ab 2001),2017,10,0,0,0
Norfolkinseln (ab 2001),2017,11,24000,0,24000
Norfolkinseln (ab 2001),2017,12,0,0,0
Norfolkinseln (ab 2001),2018,1,0,0,0
Norfolkinseln (ab 2001),2018,2,2000,0,2000
Norfolkinseln (ab 2001),2018,3,7000,0,7000
Norfolkinseln (ab 2001),2018,4,0,0,0
Norfolkinseln (ab 2001),2018,5,51000,0,51000
Norfolkinseln (ab 2001),2018,6,3000,0,3000
Norfolkinseln (ab 2001),2018,7,0,0,0
Norfolkinseln (ab 2001),2018,8,0,0,0
Norfolkinseln (ab 2001),2018,9,0,0,0
Norfolkinseln (ab 2001),2018,10,34000,0,34000
Norfolkinseln (ab 2001),2018,11,0,0,0
Norfolkinseln (ab 2001),2018,12,0,0,0
Norfolkinseln (ab 2001),2019,1,0,0,0
Norfolkinseln (ab 2001),2019,2,0,0,0
Norfolkinseln (ab 2001),2019,3,0,0,0
Norfolkinseln (ab 2001),2019,4,0,0,0
Norfolkinseln (ab 2001),2019,5,50000,0,50000
Norfolkinseln (ab 2001),2019,6,0,0,0
Norfolkinseln (ab 2001),2019,7,0,0,0
Norfolkinseln (ab 2001),2019,8,0,0,0
Norfolkinseln (ab 2001),2019,9,5000,0,5000
Norfolkinseln (ab 2001),2019,10,0,0,0
Norfolkinseln (ab 2001),2019,11,23000,0,23000
Norfolkinseln (ab 2001),2019,12,9000,0,9000
Norfolkinseln (ab 2001),2020,1,24000,0,24000
Norfolkinseln (ab 2001),2020,2,0,0,0
Norfolkinseln (ab 2001),2020,3,1000,0,1000
Norfolkinseln (ab 2001),2020,4,0,0,0
Norfolkinseln (ab 2001),2020,5,10000,0,10000
Norfolkinseln (ab 2001),2020,6,0,0,0
Norfolkinseln (ab 2001),2020,7,0,0,0
Norfolkinseln (ab 2001),2020,8,0,0,0
Norfolkinseln (ab 2001),2020,9,0,0,0
Norfolkinseln (ab 2001),2020,10,0,0,0
Norfolkinseln (ab 2001),2020,11,0,0,0
Norfolkinseln (ab 2001),2020,12,0,0,0
Norfolkinseln (ab 2001),2021,1,0,0,0
Norfolkinseln (ab 2001),2021,2,9000,0,9000
Norfolkinseln (ab 2001),2021,3,0,0,0
Norfolkinseln (ab 2001),2021,4,0,0,0
Norfolkinseln (ab 2001),2021,5,23000,0,23000
Norfolkinseln (ab 2001),2021,6,0,0,0
Norfolkinseln (ab 2001),2021,7,0,0,0
Norfolkinseln (ab 2001),2021,8,0,0,0
Norfolkinseln (ab 2001),2021,9,1000,0,1000
Norfolkinseln (ab 2001),2021,10,0,41000,41000
Norfolkinseln (ab 2001),2021,11,17000,0,17000
Norfolkinseln (ab 2001),2021,12,0,0,0
Norfolkinseln (ab 2001),2022,1,0,0,0
Norfolkinseln (ab 2001),2022,2,0,0,0
Norfolkinseln (ab 2001),2022,3,0,0,0
Norfolkinseln (ab 2001),2022,4,6000,0,6000
Norfolkinseln (ab 2001),2022,5,34000,0,34000
Norfolkinseln (ab 2001),2022,6,0,0,0
Norfolkinseln (ab 2001),2022,7,0,0,0
Norfolkinseln (ab 2001),2022,8,0,0,0
Norfolkinseln (ab 2001),2022,9,0,0,0
Norfolkinseln (ab 2001),2022,10,0,0,0
Norfolkinseln (ab 2001),2022,11,0,0,0
Norfolkinseln (ab 2001),2022,12,0,0,0
Norfolkinseln (ab 2001),2023,1,0,0,0
Norfolkinseln (ab 2001),2023,2,0,0,0
Norfolkinseln (ab 2001),2023,3,26000,0,26000
Norfolkinseln (ab 2001),2023,4,0,0,0
Norfolkinseln (ab 2001),2023,5,0,0,0
Norfolkinseln (ab 2001),2023,6,51000,0,51000
Norfolkinseln (ab 2001),2023,7,0,0,0
Norfolkinseln (ab 2001),2023,8,0,0,0
Norfolkinseln (ab 2001),2023,9,0,0,0
Norfolkinseln (ab 2001),2023,10,0,0,0
Norfolkinseln (ab 2001),2023,11,0,1000,1000
Norfolkinseln (ab 2001),2023,12,51000,0,51000
Norfolkinseln (ab 2001),2024,1,0,0,0
Norfolkinseln (ab 2001),2024,2,0,0,0
Norfolkinseln (ab 2001),2024,3,0,0,0
Norfolkinseln (ab 2001),2024,4,0,0,0
Norfolkinseln (ab 2001),2024,5,43000,0,43000
Norfolkinseln (ab 2001),2024,6,0,0,0
Norfolkinseln (ab 2001),2024,7,0,0,0
Norfolkinseln (ab 2001),2024,8,0,0,0
Norfolkinseln (ab 2001),2024,9,0,0,0
Norfolkinseln (ab 2001),2024,10,0,0,0
Norfolkinseln (ab 2001),2024,11,0,0,0
Norfolkinseln (ab 2001),2024,12,0,0,0
Norwegen,2008,1,631972000,1879667000,2511639000
Norwegen,2008,2,649437000,1865041000,2514478000
Norwegen,2008,3,623036000,1826566000,2449602000
Norwegen,2008,4,678564000,1851634000,2530198000
Norwegen,2008,5,643618000,1777525000,2421143000
Norwegen,2008,6,703328000,2005385000,2708713000
Norwegen,2008,7,787265000,2327931000,3115196000
Norwegen,2008,8,554825000,1730466000,2285291000
Norwegen,2008,9,666300000,1682402000,2348702000
Norwegen,2008,10,708875000,1494128000,2203003000
Norwegen,2008,11,539220000,2064027000,2603247000
Norwegen,2008,12,458128000,1818591000,2276719000
Norwegen,2009,1,450761000,1686775000,2137536000
Norwegen,2009,2,557216000,1628222000,2185438000
Norwegen,2009,3,520207000,1996831000,2517038000
Norwegen,2009,4,464949000,1523116000,1988065000
Norwegen,2009,5,466056000,1436551000,1902607000
Norwegen,2009,6,518497000,1530775000,2049272000
Norwegen,2009,7,505044000,1320920000,1825964000
Norwegen,2009,8,541446000,1472733000,2014179000
Norwegen,2009,9,549543000,1302702000,1852245000
Norwegen,2009,10,523053000,1191279000,1714332000
Norwegen,2009,11,652037000,757813000,1409850000
Norwegen,2009,12,478683000,1312994000,1791677000
Norwegen,2010,1,485240000,1388748000,1873988000
Norwegen,2010,2,514991000,1401380000,1916371000
Norwegen,2010,3,602408000,1529929000,2132337000
Norwegen,2010,4,786959000,1530761000,2317720000
Norwegen,2010,5,565104000,1312213000,1877317000
Norwegen,2010,6,642824000,1613204000,2256028000
Norwegen,2010,7,544977000,1249652000,1794629000
Norwegen,2010,8,549366000,1412170000,1961536000
Norwegen,2010,9,646145000,1172244000,1818389000
Norwegen,2010,10,628897000,1374088000,2002985000
Norwegen,2010,11,846059000,1634879000,2480938000
Norwegen,2010,12,552787000,1547684000,2100471000
Norwegen,2011,1,599427000,1869284000,2468711000
Norwegen,2011,2,574755000,1952052000,2526807000
Norwegen,2011,3,679391000,1622175000,2301566000
Norwegen,2011,4,578636000,1920818000,2499454000
Norwegen,2011,5,665603000,1736519000,2402122000
Norwegen,2011,6,608408000,1589077000,2197485000
Norwegen,2011,7,651315000,1511984000,2163299000
Norwegen,2011,8,648642000,1817575000,2466217000
Norwegen,2011,9,737313000,1714848000,2452161000
Norwegen,2011,10,720288000,1314820000,2035108000
Norwegen,2011,11,812834000,1661314000,2474148000
Norwegen,2011,12,579897000,1923565000,2503462000
Norwegen,2012,1,616030000,1598270000,2214300000
Norwegen,2012,2,676287000,1991319000,2667606000
Norwegen,2012,3,752875000,1999021000,2751896000
Norwegen,2012,4,709742000,1994230000,2703972000
Norwegen,2012,5,809734000,1845044000,2654778000
Norwegen,2012,6,736653000,1748034000,2484687000
Norwegen,2012,7,688130000,1535889000,2224019000
Norwegen,2012,8,729335000,1685614000,2414949000
Norwegen,2012,9,722004000,1841004000,2563008000
Norwegen,2012,10,804582000,2618058000,3422640000
Norwegen,2012,11,737203000,1543149000,2280352000
Norwegen,2012,12,533161000,1267887000,1801048000
Norwegen,2013,1,679345000,1652863000,2332208000
Norwegen,2013,2,665046000,1580525000,2245571000
Norwegen,2013,3,721699000,1346318000,2068017000
Norwegen,2013,4,776096000,1534038000,2310134000
Norwegen,2013,5,687658000,1451914000,2139572000
Norwegen,2013,6,694033000,1592402000,2286435000
Norwegen,2013,7,645438000,1431710000,2077148000
Norwegen,2013,8,678286000,1726477000,2404763000
Norwegen,2013,9,684126000,1283087000,1967213000
Norwegen,2013,10,762892000,1337839000,2100731000
Norwegen,2013,11,675687000,1835237000,2510924000
Norwegen,2013,12,531967000,1296092000,1828059000
Norwegen,2014,1,607905000,1464677000,2072582000
Norwegen,2014,2,635348000,1775166000,2410514000
Norwegen,2014,3,706320000,1481922000,2188242000
Norwegen,2014,4,641422000,1549114000,2190536000
Norwegen,2014,5,668675000,1604492000,2273167000
Norwegen,2014,6,922592000,1337483000,2260075000
Norwegen,2014,7,688938000,1341101000,2030039000
Norwegen,2014,8,627739000,1431391000,2059130000
Norwegen,2014,9,769906000,1382732000,2152638000
Norwegen,2014,10,772383000,1354080000,2126463000
Norwegen,2014,11,698986000,1541325000,2240311000
Norwegen,2014,12,724572000,1517355000,2241927000
Norwegen,2015,1,607985000,1566722000,2174707000
Norwegen,2015,2,626367000,1235342000,1861709000
Norwegen,2015,3,820438000,1381365000,2201803000
Norwegen,2015,4,703343000,1545451000,2248794000
Norwegen,2015,5,645454000,1155089000,1800543000
Norwegen,2015,6,802576000,1476296000,2278872000
Norwegen,2015,7,643271000,1349773000,1993044000
Norwegen,2015,8,582830000,1358814000,1941644000
Norwegen,2015,9,706541000,1329640000,2036181000
Norwegen,2015,10,717544000,1472984000,2190528000
Norwegen,2015,11,672612000,1231254000,1903866000
Norwegen,2015,12,555101000,1124698000,1679799000
Norwegen,2016,1,578188000,1166886000,1745074000
Norwegen,2016,2,695887000,1010551000,1706438000
Norwegen,2016,3,664721000,1018765000,1683486000
Norwegen,2016,4,736046000,931219000,1667265000
Norwegen,2016,5,813597000,889631000,1703228000
Norwegen,2016,6,836955000,1019526000,1856481000
Norwegen,2016,7,618181000,1011328000,1629509000
Norwegen,2016,8,703143000,1485474000,2188617000
Norwegen,2016,9,748875000,898054000,1646929000
Norwegen,2016,10,736369000,1165526000,1901895000
Norwegen,2016,11,751808000,1041333000,1793141000
Norwegen,2016,12,772941000,1056617000,1829558000
Norwegen,2017,1,662746000,956097000,1618843000
Norwegen,2017,2,683323000,846270000,1529593000
Norwegen,2017,3,860949000,1048019000,1908968000
Norwegen,2017,4,732502000,939017000,1671519000
Norwegen,2017,5,803083000,875977000,1679060000
Norwegen,2017,6,761862000,859312000,1621174000
Norwegen,2017,7,622199000,821120000,1443319000
Norwegen,2017,8,720231000,881615000,1601846000
Norwegen,2017,9,730946000,791805000,1522751000
Norwegen,2017,10,766023000,1045886000,1811909000
Norwegen,2017,11,778783000,910332000,1689115000
Norwegen,2017,12,638836000,1055049000,1693885000
Norwegen,2018,1,705256000,1068051000,1773307000
Norwegen,2018,2,712080000,1044345000,1756425000
Norwegen,2018,3,799672000,968667000,1768339000
Norwegen,2018,4,814193000,915214000,1729407000
Norwegen,2018,5,783595000,985215000,1768810000
Norwegen,2018,6,951262000,1128240000,2079502000
Norwegen,2018,7,709693000,1069737000,1779430000
Norwegen,2018,8,696805000,1042182000,1738987000
Norwegen,2018,9,710233000,934934000,1645167000
Norwegen,2018,10,777151000,1160179000,1937330000
Norwegen,2018,11,804486000,1187167000,1991653000
Norwegen,2018,12,622683000,919166000,1541849000
Norwegen,2019,1,748390000,1201057000,1949447000
Norwegen,2019,2,806206000,1109231000,1915437000
Norwegen,2019,3,857107000,1020585000,1877692000
Norwegen,2019,4,776088000,1066614000,1842702000
Norwegen,2019,5,901490000,1002464000,1903954000
Norwegen,2019,6,744177000,1028997000,1773174000
Norwegen,2019,7,703603000,1012129000,1715732000
Norwegen,2019,8,690168000,814529000,1504697000
Norwegen,2019,9,793156000,855132000,1648288000
Norwegen,2019,10,795027000,742103000,1537130000
Norwegen,2019,11,697411000,1003009000,1700420000
Norwegen,2019,12,623539000,1074377000,1697916000
Norwegen,2020,1,751140000,965126000,1716266000
Norwegen,2020,2,767799000,900099000,1667898000
Norwegen,2020,3,679980000,775101000,1455081000
Norwegen,2020,4,498034000,557123000,1055157000
Norwegen,2020,5,575320000,578206000,1153526000
Norwegen,2020,6,855202000,573498000,1428700000
Norwegen,2020,7,695102000,555793000,1250895000
Norwegen,2020,8,640519000,574746000,1215265000
Norwegen,2020,9,903052000,588929000,1491981000
Norwegen,2020,10,728701000,608419000,1337120000
Norwegen,2020,11,716575000,707646000,1424221000
Norwegen,2020,12,589718000,718702000,1308420000
Norwegen,2021,1,631137000,797802000,1428939000
Norwegen,2021,2,764228000,790822000,1555050000
Norwegen,2021,3,923811000,976620000,1900431000
Norwegen,2021,4,817723000,986919000,1804642000
Norwegen,2021,5,778060000,1057575000,1835635000
Norwegen,2021,6,778726000,1191200000,1969926000
Norwegen,2021,7,855575000,1089778000,1945353000
Norwegen,2021,8,671055000,1348260000,2019315000
Norwegen,2021,9,867107000,1685227000,2552334000
Norwegen,2021,10,801981000,2395363000,3197344000
Norwegen,2021,11,885193000,2896805000,3781998000
Norwegen,2021,12,786755000,4186953000,4973708000
Norwegen,2022,1,823799000,3924775000,4748574000
Norwegen,2022,2,883222000,3684825000,4568047000
Norwegen,2022,3,900827000,4598362000,5499189000
Norwegen,2022,4,903231000,4689206000,5592437000
Norwegen,2022,5,925476000,4114156000,5039632000
Norwegen,2022,6,952799000,4396370000,5349169000
Norwegen,2022,7,790468000,6909909000,7700377000
Norwegen,2022,8,889426000,9189622000,10079048000
Norwegen,2022,9,1110793000,7075774000,8186567000
Norwegen,2022,10,967051000,4542351000,5509402000
Norwegen,2022,11,1243486000,4776241000,6019727000
Norwegen,2022,12,801872000,5185716000,5987588000
Norwegen,2023,1,862843000,3957965000,4820808000
Norwegen,2023,2,806553000,3113338000,3919891000
Norwegen,2023,3,909132000,3010058000,3919190000
Norwegen,2023,4,718792000,2543057000,3261849000
Norwegen,2023,5,786187000,2548051000,3334238000
Norwegen,2023,6,790944000,1923998000,2714942000
Norwegen,2023,7,609333000,2330285000,2939618000
Norwegen,2023,8,693274000,2177861000,2871135000
Norwegen,2023,9,731843000,1506470000,2238313000
Norwegen,2023,10,731046000,2518405000,3249451000
Norwegen,2023,11,797485000,2488352000,3285837000
Norwegen,2023,12,676163000,2522624000,3198787000
Norwegen,2024,1,772480000,2310347000,3082827000
Norwegen,2024,2,796566000,2515548000,3312114000
Norwegen,2024,3,820149000,2094139000,2914288000
Norwegen,2024,4,838505000,2267366000,3105871000
Norwegen,2024,5,739832000,2172121000,2911953000
Norwegen,2024,6,792521000,2107117000,2899638000
Norwegen,2024,7,763633000,1959233000,2722866000
Norwegen,2024,8,868365000,2321609000,3189974000
Norwegen,2024,9,865650000,1735487000,2601137000
Norwegen,2024,10,935479000,2523941000,3459420000
Norwegen,2024,11,913227000,2582904000,3496131000
Norwegen,2024,12,692956000,2649732000,3342688000
Nördliche Marianen (ab 1994),2008,1,24000,0,24000
Nördliche Marianen (ab 1994),2008,2,37000,0,37000
Nördliche Marianen (ab 1994),2008,3,12000,21000,33000
Nördliche Marianen (ab 1994),2008,4,22000,1000,23000
Nördliche Marianen (ab 1994),2008,5,114000,21000,135000
Nördliche Marianen (ab 1994),2008,6,18000,15000,33000
Nördliche Marianen (ab 1994),2008,7,0,17000,17000
Nördliche Marianen (ab 1994),2008,8,3000,14000,17000
Nördliche Marianen (ab 1994),2008,9,62000,3000,65000
Nördliche Marianen (ab 1994),2008,10,40000,2000,42000
Nördliche Marianen (ab 1994),2008,11,0,0,0
Nördliche Marianen (ab 1994),2008,12,18000,0,18000
Nördliche Marianen (ab 1994),2009,1,35000,12000,47000
Nördliche Marianen (ab 1994),2009,2,15000,8000,23000
Nördliche Marianen (ab 1994),2009,3,17000,11000,28000
Nördliche Marianen (ab 1994),2009,4,0,0,0
Nördliche Marianen (ab 1994),2009,5,0,0,0
Nördliche Marianen (ab 1994),2009,6,21000,0,21000
Nördliche Marianen (ab 1994),2009,7,0,0,0
Nördliche Marianen (ab 1994),2009,8,0,0,0
Nördliche Marianen (ab 1994),2009,9,205000,0,205000
Nördliche Marianen (ab 1994),2009,10,0,0,0
Nördliche Marianen (ab 1994),2009,11,0,0,0
Nördliche Marianen (ab 1994),2009,12,0,0,0
Nördliche Marianen (ab 1994),2010,1,0,0,0
Nördliche Marianen (ab 1994),2010,2,0,0,0
Nördliche Marianen (ab 1994),2010,3,8000,0,8000
Nördliche Marianen (ab 1994),2010,4,0,0,0
Nördliche Marianen (ab 1994),2010,5,0,0,0
Nördliche Marianen (ab 1994),2010,6,4000,0,4000
Nördliche Marianen (ab 1994),2010,7,8000,0,8000
Nördliche Marianen (ab 1994),2010,8,6000,0,6000
Nördliche Marianen (ab 1994),2010,9,3000,0,3000
Nördliche Marianen (ab 1994),2010,10,5000,0,5000
Nördliche Marianen (ab 1994),2010,11,0,0,0
Nördliche Marianen (ab 1994),2010,12,0,0,0
Nördliche Marianen (ab 1994),2011,1,564000,0,564000
Nördliche Marianen (ab 1994),2011,2,155000,0,155000
Nördliche Marianen (ab 1994),2011,3,618000,0,618000
Nördliche Marianen (ab 1994),2011,4,0,0,0
Nördliche Marianen (ab 1994),2011,5,1185000,0,1185000
Nördliche Marianen (ab 1994),2011,6,0,0,0
Nördliche Marianen (ab 1994),2011,7,0,0,0
Nördliche Marianen (ab 1994),2011,8,1526000,0,1526000
Nördliche Marianen (ab 1994),2011,9,0,0,0
Nördliche Marianen (ab 1994),2011,10,61000,0,61000
Nördliche Marianen (ab 1994),2011,11,4000,0,4000
Nördliche Marianen (ab 1994),2011,12,0,0,0
Nördliche Marianen (ab 1994),2012,1,360000,0,360000
Nördliche Marianen (ab 1994),2012,2,0,0,0
Nördliche Marianen (ab 1994),2012,3,6000,0,6000
Nördliche Marianen (ab 1994),2012,4,183000,0,183000
Nördliche Marianen (ab 1994),2012,5,153000,0,153000
Nördliche Marianen (ab 1994),2012,6,0,0,0
Nördliche Marianen (ab 1994),2012,7,95000,0,95000
Nördliche Marianen (ab 1994),2012,8,20000,0,20000
Nördliche Marianen (ab 1994),2012,9,35000,0,35000
Nördliche Marianen (ab 1994),2012,10,6000,0,6000
Nördliche Marianen (ab 1994),2012,11,4000,0,4000
Nördliche Marianen (ab 1994),2012,12,15000,0,15000
Nördliche Marianen (ab 1994),2013,1,12000,0,12000
Nördliche Marianen (ab 1994),2013,2,5000,0,5000
Nördliche Marianen (ab 1994),2013,3,13000,0,13000
Nördliche Marianen (ab 1994),2013,4,439000,0,439000
Nördliche Marianen (ab 1994),2013,5,3000,0,3000
Nördliche Marianen (ab 1994),2013,6,0,0,0
Nördliche Marianen (ab 1994),2013,7,3000,0,3000
Nördliche Marianen (ab 1994),2013,8,62000,0,62000
Nördliche Marianen (ab 1994),2013,9,3000,0,3000
Nördliche Marianen (ab 1994),2013,10,383000,0,383000
Nördliche Marianen (ab 1994),2013,11,0,0,0
Nördliche Marianen (ab 1994),2013,12,25000,0,25000
Nördliche Marianen (ab 1994),2014,1,0,0,0
Nördliche Marianen (ab 1994),2014,2,38000,0,38000
Nördliche Marianen (ab 1994),2014,3,0,0,0
Nördliche Marianen (ab 1994),2014,4,6000,0,6000
Nördliche Marianen (ab 1994),2014,5,9000,0,9000
Nördliche Marianen (ab 1994),2014,6,0,0,0
Nördliche Marianen (ab 1994),2014,7,2000,0,2000
Nördliche Marianen (ab 1994),2014,8,38000,0,38000
Nördliche Marianen (ab 1994),2014,9,0,0,0
Nördliche Marianen (ab 1994),2014,10,10000,0,10000
Nördliche Marianen (ab 1994),2014,11,0,0,0
Nördliche Marianen (ab 1994),2014,12,0,0,0
Nördliche Marianen (ab 1994),2015,1,27000,0,27000
Nördliche Marianen (ab 1994),2015,2,0,0,0
Nördliche Marianen (ab 1994),2015,3,0,0,0
Nördliche Marianen (ab 1994),2015,4,11000,0,11000
Nördliche Marianen (ab 1994),2015,5,63000,0,63000
Nördliche Marianen (ab 1994),2015,6,58000,0,58000
Nördliche Marianen (ab 1994),2015,7,39000,37000,76000
Nördliche Marianen (ab 1994),2015,8,20000,0,20000
Nördliche Marianen (ab 1994),2015,9,42000,5000,47000
Nördliche Marianen (ab 1994),2015,10,7000,0,7000
Nördliche Marianen (ab 1994),2015,11,1000,0,1000
Nördliche Marianen (ab 1994),2015,12,3000,0,3000
Nördliche Marianen (ab 1994),2016,1,0,0,0
Nördliche Marianen (ab 1994),2016,2,5000,0,5000
Nördliche Marianen (ab 1994),2016,3,3000,0,3000
Nördliche Marianen (ab 1994),2016,4,212000,0,212000
Nördliche Marianen (ab 1994),2016,5,13000,0,13000
Nördliche Marianen (ab 1994),2016,6,36000,0,36000
Nördliche Marianen (ab 1994),2016,7,112000,0,112000
Nördliche Marianen (ab 1994),2016,8,136000,0,136000
Nördliche Marianen (ab 1994),2016,9,120000,0,120000
Nördliche Marianen (ab 1994),2016,10,1494000,0,1494000
Nördliche Marianen (ab 1994),2016,11,1888000,0,1888000
Nördliche Marianen (ab 1994),2016,12,147000,0,147000
Nördliche Marianen (ab 1994),2017,1,9000,0,9000
Nördliche Marianen (ab 1994),2017,2,98000,0,98000
Nördliche Marianen (ab 1994),2017,3,2000,0,2000
Nördliche Marianen (ab 1994),2017,4,0,0,0
Nördliche Marianen (ab 1994),2017,5,21000,0,21000
Nördliche Marianen (ab 1994),2017,6,5000,0,5000
Nördliche Marianen (ab 1994),2017,7,0,0,0
Nördliche Marianen (ab 1994),2017,8,79000,0,79000
Nördliche Marianen (ab 1994),2017,9,62000,0,62000
Nördliche Marianen (ab 1994),2017,10,0,0,0
Nördliche Marianen (ab 1994),2017,11,65000,0,65000
Nördliche Marianen (ab 1994),2017,12,249000,0,249000
Nördliche Marianen (ab 1994),2018,1,0,0,0
Nördliche Marianen (ab 1994),2018,2,66000,0,66000
Nördliche Marianen (ab 1994),2018,3,1000,0,1000
Nördliche Marianen (ab 1994),2018,4,102000,0,102000
Nördliche Marianen (ab 1994),2018,5,36000,0,36000
Nördliche Marianen (ab 1994),2018,6,0,0,0
Nördliche Marianen (ab 1994),2018,7,6000,0,6000
Nördliche Marianen (ab 1994),2018,8,59000,0,59000
Nördliche Marianen (ab 1994),2018,9,0,0,0
Nördliche Marianen (ab 1994),2018,10,7000,0,7000
Nördliche Marianen (ab 1994),2018,11,16000,0,16000
Nördliche Marianen (ab 1994),2018,12,98000,0,98000
Nördliche Marianen (ab 1994),2019,1,28000,0,28000
Nördliche Marianen (ab 1994),2019,2,18000,0,18000
Nördliche Marianen (ab 1994),2019,3,36000,46000,82000
Nördliche Marianen (ab 1994),2019,4,105000,0,105000
Nördliche Marianen (ab 1994),2019,5,3000,0,3000
Nördliche Marianen (ab 1994),2019,6,0,0,0
Nördliche Marianen (ab 1994),2019,7,104000,0,104000
Nördliche Marianen (ab 1994),2019,8,46000,0,46000
Nördliche Marianen (ab 1994),2019,9,11000,0,11000
Nördliche Marianen (ab 1994),2019,10,0,0,0
Nördliche Marianen (ab 1994),2019,11,0,0,0
Nördliche Marianen (ab 1994),2019,12,170000,0,170000
Nördliche Marianen (ab 1994),2020,1,3000,0,3000
Nördliche Marianen (ab 1994),2020,2,36000,0,36000
Nördliche Marianen (ab 1994),2020,3,1190000,0,1190000
Nördliche Marianen (ab 1994),2020,4,4000,0,4000
Nördliche Marianen (ab 1994),2020,5,1082000,0,1082000
Nördliche Marianen (ab 1994),2020,6,213000,0,213000
Nördliche Marianen (ab 1994),2020,7,278000,0,278000
Nördliche Marianen (ab 1994),2020,8,0,0,0
Nördliche Marianen (ab 1994),2020,9,585000,0,585000
Nördliche Marianen (ab 1994),2020,10,1000,0,1000
Nördliche Marianen (ab 1994),2020,11,1000,0,1000
Nördliche Marianen (ab 1994),2020,12,1000,54000,55000
Nördliche Marianen (ab 1994),2021,1,0,0,0
Nördliche Marianen (ab 1994),2021,2,3000,0,3000
Nördliche Marianen (ab 1994),2021,3,8000,14000,22000
Nördliche Marianen (ab 1994),2021,4,0,0,0
Nördliche Marianen (ab 1994),2021,5,265000,0,265000
Nördliche Marianen (ab 1994),2021,6,0,0,0
Nördliche Marianen (ab 1994),2021,7,201000,0,201000
Nördliche Marianen (ab 1994),2021,8,0,0,0
Nördliche Marianen (ab 1994),2021,9,56000,0,56000
Nördliche Marianen (ab 1994),2021,10,87000,8000,95000
Nördliche Marianen (ab 1994),2021,11,4000,13000,17000
Nördliche Marianen (ab 1994),2021,12,2000,0,2000
Nördliche Marianen (ab 1994),2022,1,371000,10000,381000
Nördliche Marianen (ab 1994),2022,2,1158000,36000,1194000
Nördliche Marianen (ab 1994),2022,3,1000,0,1000
Nördliche Marianen (ab 1994),2022,4,0,0,0
Nördliche Marianen (ab 1994),2022,5,131000,0,131000
Nördliche Marianen (ab 1994),2022,6,4000,0,4000
Nördliche Marianen (ab 1994),2022,7,37000,0,37000
Nördliche Marianen (ab 1994),2022,8,520000,0,520000
Nördliche Marianen (ab 1994),2022,9,0,0,0
Nördliche Marianen (ab 1994),2022,10,50000,0,50000
Nördliche Marianen (ab 1994),2022,11,54000,48000,102000
Nördliche Marianen (ab 1994),2022,12,120000,48000,168000
Nördliche Marianen (ab 1994),2023,1,0,0,0
Nördliche Marianen (ab 1994),2023,2,52000,0,52000
Nördliche Marianen (ab 1994),2023,3,36000,0,36000
Nördliche Marianen (ab 1994),2023,4,53000,43000,96000
Nördliche Marianen (ab 1994),2023,5,4000,0,4000
Nördliche Marianen (ab 1994),2023,6,0,0,0
Nördliche Marianen (ab 1994),2023,7,0,0,0
Nördliche Marianen (ab 1994),2023,8,0,0,0
Nördliche Marianen (ab 1994),2023,9,25000,0,25000
Nördliche Marianen (ab 1994),2023,10,0,0,0
Nördliche Marianen (ab 1994),2023,11,19000,0,19000
Nördliche Marianen (ab 1994),2023,12,18000,0,18000
Nördliche Marianen (ab 1994),2024,1,85000,0,85000
Nördliche Marianen (ab 1994),2024,2,0,0,0
Nördliche Marianen (ab 1994),2024,3,11000,0,11000
Nördliche Marianen (ab 1994),2024,4,91000,0,91000
Nördliche Marianen (ab 1994),2024,5,73000,0,73000
Nördliche Marianen (ab 1994),2024,6,64000,0,64000
Nördliche Marianen (ab 1994),2024,7,99000,0,99000
Nördliche Marianen (ab 1994),2024,8,0,1000,1000
Nördliche Marianen (ab 1994),2024,9,1000,0,1000
Nördliche Marianen (ab 1994),2024,10,1000,0,1000
Nördliche Marianen (ab 1994),2024,11,4000,0,4000
Nördliche Marianen (ab 1994),2024,12,19000,0,19000
Oman,2008,1,41189000,3837000,45026000
Oman,2008,2,52760000,1358000,54118000
Oman,2008,3,37515000,1064000,38579000
Oman,2008,4,336376000,831000,337207000
Oman,2008,5,46634000,1068000,47702000
Oman,2008,6,46399000,1171000,47570000
Oman,2008,7,45046000,966000,46012000
Oman,2008,8,30554000,543000,31097000
Oman,2008,9,55903000,987000,56890000
Oman,2008,10,65425000,429000,65854000
Oman,2008,11,70904000,333000,71237000
Oman,2008,12,50611000,559000,51170000
Oman,2009,1,31661000,653000,32314000
Oman,2009,2,36266000,710000,36976000
Oman,2009,3,44199000,603000,44802000
Oman,2009,4,31547000,796000,32343000
Oman,2009,5,57465000,1248000,58713000
Oman,2009,6,28652000,1029000,29681000
Oman,2009,7,29062000,2207000,31269000
Oman,2009,8,22302000,1377000,23679000
Oman,2009,9,41753000,2460000,44213000
Oman,2009,10,34163000,1539000,35702000
Oman,2009,11,44552000,1387000,45939000
Oman,2009,12,48775000,1725000,50500000
Oman,2010,1,37340000,1101000,38441000
Oman,2010,2,69616000,1336000,70952000
Oman,2010,3,40855000,1288000,42143000
Oman,2010,4,39991000,2043000,42034000
Oman,2010,5,37390000,1806000,39196000
Oman,2010,6,61082000,1020000,62102000
Oman,2010,7,41435000,1662000,43097000
Oman,2010,8,33722000,1375000,35097000
Oman,2010,9,45617000,1783000,47400000
Oman,2010,10,53731000,1705000,55436000
Oman,2010,11,46700000,1340000,48040000
Oman,2010,12,41384000,1885000,43269000
Oman,2011,1,28323000,5348000,33671000
Oman,2011,2,44106000,5462000,49568000
Oman,2011,3,54943000,2851000,57794000
Oman,2011,4,89585000,2438000,92023000
Oman,2011,5,86571000,4096000,90667000
Oman,2011,6,58376000,2111000,60487000
Oman,2011,7,55741000,2477000,58218000
Oman,2011,8,54003000,2430000,56433000
Oman,2011,9,49642000,3015000,52657000
Oman,2011,10,39815000,1622000,41437000
Oman,2011,11,72848000,2104000,74952000
Oman,2011,12,157136000,2915000,160051000
Oman,2012,1,38248000,5112000,43360000
Oman,2012,2,42003000,2692000,44695000
Oman,2012,3,41167000,3442000,44609000
Oman,2012,4,37219000,2826000,40045000
Oman,2012,5,86429000,7373000,93802000
Oman,2012,6,126335000,2914000,129249000
Oman,2012,7,70233000,3335000,73568000
Oman,2012,8,95665000,3425000,99090000
Oman,2012,9,57445000,3440000,60885000
Oman,2012,10,57021000,4621000,61642000
Oman,2012,11,63810000,5794000,69604000
Oman,2012,12,105623000,5981000,111604000
Oman,2013,1,116009000,3634000,119643000
Oman,2013,2,48225000,3723000,51948000
Oman,2013,3,55206000,3858000,59064000
Oman,2013,4,66790000,4901000,71691000
Oman,2013,5,55611000,4547000,60158000
Oman,2013,6,58129000,3519000,61648000
Oman,2013,7,48919000,4517000,53436000
Oman,2013,8,66431000,3724000,70155000
Oman,2013,9,64403000,4793000,69196000
Oman,2013,10,50036000,3897000,53933000
Oman,2013,11,60742000,4878000,65620000
Oman,2013,12,62769000,3138000,65907000
Oman,2014,1,53969000,4109000,58078000
Oman,2014,2,54493000,3069000,57562000
Oman,2014,3,54612000,8655000,63267000
Oman,2014,4,56225000,7671000,63896000
Oman,2014,5,59765000,4550000,64315000
Oman,2014,6,61971000,6016000,67987000
Oman,2014,7,64211000,9310000,73521000
Oman,2014,8,50184000,6007000,56191000
Oman,2014,9,60066000,4609000,64675000
Oman,2014,10,59754000,4754000,64508000
Oman,2014,11,64314000,4546000,68860000
Oman,2014,12,52117000,3646000,55763000
Oman,2015,1,73772000,4509000,78281000
Oman,2015,2,68631000,4472000,73103000
Oman,2015,3,66550000,4002000,70552000
Oman,2015,4,72006000,4631000,76637000
Oman,2015,5,72965000,3596000,76561000
Oman,2015,6,84563000,3858000,88421000
Oman,2015,7,91602000,3010000,94612000
Oman,2015,8,64943000,5427000,70370000
Oman,2015,9,79343000,4563000,83906000
Oman,2015,10,88329000,3579000,91908000
Oman,2015,11,89522000,3335000,92857000
Oman,2015,12,84946000,3081000,88027000
Oman,2016,1,56237000,4794000,61031000
Oman,2016,2,73334000,3182000,76516000
Oman,2016,3,64772000,2918000,67690000
Oman,2016,4,76058000,3444000,79502000
Oman,2016,5,85579000,2640000,88219000
Oman,2016,6,81109000,4532000,85641000
Oman,2016,7,61451000,3486000,64937000
Oman,2016,8,69519000,3421000,72940000
Oman,2016,9,70656000,2793000,73449000
Oman,2016,10,59290000,1979000,61269000
Oman,2016,11,73373000,2724000,76097000
Oman,2016,12,62700000,3514000,66214000
Oman,2017,1,54644000,3507000,58151000
Oman,2017,2,61157000,3378000,64535000
Oman,2017,3,83224000,2701000,85925000
Oman,2017,4,55266000,1895000,57161000
Oman,2017,5,64266000,3190000,67456000
Oman,2017,6,60459000,2107000,62566000
Oman,2017,7,80934000,12133000,93067000
Oman,2017,8,94012000,2049000,96061000
Oman,2017,9,112372000,1810000,114182000
Oman,2017,10,68097000,1874000,69971000
Oman,2017,11,105778000,2366000,108144000
Oman,2017,12,74464000,1771000,76235000
Oman,2018,1,70322000,3506000,73828000
Oman,2018,2,58187000,2095000,60282000
Oman,2018,3,66820000,1882000,68702000
Oman,2018,4,55706000,1780000,57486000
Oman,2018,5,75122000,3591000,78713000
Oman,2018,6,79866000,1744000,81610000
Oman,2018,7,69690000,5031000,74721000
Oman,2018,8,63594000,2007000,65601000
Oman,2018,9,65444000,2835000,68279000
Oman,2018,10,69877000,2576000,72453000
Oman,2018,11,63280000,6980000,70260000
Oman,2018,12,67929000,12544000,80473000
Oman,2019,1,49385000,11070000,60455000
Oman,2019,2,70770000,6962000,77732000
Oman,2019,3,54896000,1489000,56385000
Oman,2019,4,57868000,1617000,59485000
Oman,2019,5,126979000,3377000,130356000
Oman,2019,6,60242000,1490000,61732000
Oman,2019,7,59295000,1655000,60950000
Oman,2019,8,51570000,1828000,53398000
Oman,2019,9,75554000,2004000,77558000
Oman,2019,10,63842000,2216000,66058000
Oman,2019,11,60987000,4035000,65022000
Oman,2019,12,143852000,800000,144652000
Oman,2020,1,52771000,2320000,55091000
Oman,2020,2,66363000,1468000,67831000
Oman,2020,3,121870000,1220000,123090000
Oman,2020,4,48210000,5102000,53312000
Oman,2020,5,45382000,1359000,46741000
Oman,2020,6,62854000,2585000,65439000
Oman,2020,7,59750000,2210000,61960000
Oman,2020,8,40842000,3479000,44321000
Oman,2020,9,55341000,4011000,59352000
Oman,2020,10,72813000,4302000,77115000
Oman,2020,11,49258000,1793000,51051000
Oman,2020,12,61339000,4983000,66322000
Oman,2021,1,40283000,1291000,41574000
Oman,2021,2,42805000,2366000,45171000
Oman,2021,3,55899000,1489000,57388000
Oman,2021,4,46218000,1464000,47682000
Oman,2021,5,37609000,930000,38539000
Oman,2021,6,47170000,2019000,49189000
Oman,2021,7,40630000,3242000,43872000
Oman,2021,8,39086000,3175000,42261000
Oman,2021,9,120573000,9213000,129786000
Oman,2021,10,39134000,31635000,70769000
Oman,2021,11,50637000,66618000,117255000
Oman,2021,12,52112000,29162000,81274000
Oman,2022,1,48255000,3400000,51655000
Oman,2022,2,117177000,2577000,119754000
Oman,2022,3,62468000,12762000,75230000
Oman,2022,4,55115000,2436000,57551000
Oman,2022,5,53408000,3370000,56778000
Oman,2022,6,72714000,17620000,90334000
Oman,2022,7,71532000,2215000,73747000
Oman,2022,8,63921000,2150000,66071000
Oman,2022,9,64473000,2531000,67004000
Oman,2022,10,62140000,12981000,75121000
Oman,2022,11,59733000,11457000,71190000
Oman,2022,12,59897000,4320000,64217000
Oman,2023,1,49452000,2892000,52344000
Oman,2023,2,67044000,80814000,147858000
Oman,2023,3,78833000,6249000,85082000
Oman,2023,4,45237000,1663000,46900000
Oman,2023,5,65358000,8083000,73441000
Oman,2023,6,112577000,82703000,195280000
Oman,2023,7,68050000,2756000,70806000
Oman,2023,8,65145000,77144000,142289000
Oman,2023,9,62438000,139643000,202081000
Oman,2023,10,61624000,72675000,134299000
Oman,2023,11,55152000,36661000,91813000
Oman,2023,12,88905000,3042000,91947000
Oman,2024,1,54830000,20590000,75420000
Oman,2024,2,61625000,17935000,79560000
Oman,2024,3,69345000,2815000,72160000
Oman,2024,4,71985000,2590000,74575000
Oman,2024,5,53003000,53762000,106765000
Oman,2024,6,83930000,4923000,88853000
Oman,2024,7,77635000,3449000,81084000
Oman,2024,8,66268000,2176000,68444000
Oman,2024,9,80903000,25954000,106857000
Oman,2024,10,78019000,5742000,83761000
Oman,2024,11,68687000,3112000,71799000
Oman,2024,12,83803000,1640000,85443000
Pakistan,2008,1,57468000,62256000,119724000
Pakistan,2008,2,62174000,59978000,122152000
Pakistan,2008,3,66171000,61934000,128105000
Pakistan,2008,4,99357000,62868000,162225000
Pakistan,2008,5,74272000,51898000,126170000
Pakistan,2008,6,65763000,57486000,123249000
Pakistan,2008,7,104439000,60787000,165226000
Pakistan,2008,8,81522000,53331000,134853000
Pakistan,2008,9,63794000,61807000,125601000
Pakistan,2008,10,58277000,57529000,115806000
Pakistan,2008,11,45454000,51787000,97241000
Pakistan,2008,12,63056000,47942000,110998000
Pakistan,2009,1,43572000,59199000,102771000
Pakistan,2009,2,52053000,61812000,113865000
Pakistan,2009,3,74778000,67649000,142427000
Pakistan,2009,4,53735000,51923000,105658000
Pakistan,2009,5,64132000,45622000,109754000
Pakistan,2009,6,109686000,50189000,159875000
Pakistan,2009,7,59441000,61722000,121163000
Pakistan,2009,8,51137000,52586000,103723000
Pakistan,2009,9,59648000,58726000,118374000
Pakistan,2009,10,52828000,52459000,105287000
Pakistan,2009,11,53186000,50928000,104114000
Pakistan,2009,12,74650000,55520000,130170000
Pakistan,2010,1,50644000,64251000,114895000
Pakistan,2010,2,63149000,64369000,127518000
Pakistan,2010,3,82059000,79399000,161458000
Pakistan,2010,4,53998000,57994000,111992000
Pakistan,2010,5,51639000,61905000,113544000
Pakistan,2010,6,86239000,74013000,160252000
Pakistan,2010,7,69546000,79055000,148601000
Pakistan,2010,8,66943000,81622000,148565000
Pakistan,2010,9,59025000,75757000,134782000
Pakistan,2010,10,62115000,67836000,129951000
Pakistan,2010,11,42852000,75482000,118334000
Pakistan,2010,12,88768000,71819000,160587000
Pakistan,2011,1,43492000,92804000,136296000
Pakistan,2011,2,65324000,87181000,152505000
Pakistan,2011,3,63680000,104705000,168385000
Pakistan,2011,4,61662000,91221000,152883000
Pakistan,2011,5,73788000,104343000,178131000
Pakistan,2011,6,56272000,103988000,160260000
Pakistan,2011,7,53622000,105850000,159472000
Pakistan,2011,8,62985000,100143000,163128000
Pakistan,2011,9,59004000,97031000,156035000
Pakistan,2011,10,70361000,83853000,154214000
Pakistan,2011,11,60664000,83143000,143807000
Pakistan,2011,12,90916000,69904000,160820000
Pakistan,2012,1,73786000,87935000,161721000
Pakistan,2012,2,83030000,86631000,169661000
Pakistan,2012,3,78879000,88894000,167773000
Pakistan,2012,4,56200000,74700000,130900000
Pakistan,2012,5,87058000,72926000,159984000
Pakistan,2012,6,88086000,86147000,174233000
Pakistan,2012,7,64608000,104964000,169572000
Pakistan,2012,8,67704000,91828000,159532000
Pakistan,2012,9,65073000,69035000,134108000
Pakistan,2012,10,69080000,80579000,149659000
Pakistan,2012,11,63341000,71646000,134987000
Pakistan,2012,12,73806000,66953000,140759000
Pakistan,2013,1,60971000,97080000,158051000
Pakistan,2013,2,69372000,90597000,159969000
Pakistan,2013,3,73660000,91655000,165315000
Pakistan,2013,4,71062000,92864000,163926000
Pakistan,2013,5,66026000,81499000,147525000
Pakistan,2013,6,67275000,84557000,151832000
Pakistan,2013,7,65731000,91180000,156911000
Pakistan,2013,8,64296000,99614000,163910000
Pakistan,2013,9,80554000,84322000,164876000
Pakistan,2013,10,73801000,94173000,167974000
Pakistan,2013,11,67470000,80061000,147531000
Pakistan,2013,12,73038000,69004000,142042000
Pakistan,2014,1,68497000,120714000,189211000
Pakistan,2014,2,55415000,103253000,158668000
Pakistan,2014,3,73676000,102252000,175928000
Pakistan,2014,4,71603000,97510000,169113000
Pakistan,2014,5,64131000,86497000,150628000
Pakistan,2014,6,69476000,101411000,170887000
Pakistan,2014,7,70376000,114395000,184771000
Pakistan,2014,8,53528000,107987000,161515000
Pakistan,2014,9,73277000,124127000,197404000
Pakistan,2014,10,76992000,115760000,192752000
Pakistan,2014,11,63127000,95372000,158499000
Pakistan,2014,12,64274000,102159000,166433000
Pakistan,2015,1,75093000,134810000,209903000
Pakistan,2015,2,84586000,126924000,211510000
Pakistan,2015,3,81505000,125704000,207209000
Pakistan,2015,4,73068000,107776000,180844000
Pakistan,2015,5,66240000,101086000,167326000
Pakistan,2015,6,79550000,121385000,200935000
Pakistan,2015,7,94572000,132088000,226660000
Pakistan,2015,8,67291000,121877000,189168000
Pakistan,2015,9,72100000,119064000,191164000
Pakistan,2015,10,97029000,110511000,207540000
Pakistan,2015,11,119422000,105892000,225314000
Pakistan,2015,12,105275000,118932000,224207000
Pakistan,2016,1,57842000,140950000,198792000
Pakistan,2016,2,93363000,125019000,218382000
Pakistan,2016,3,78420000,131771000,210191000
Pakistan,2016,4,76579000,113969000,190548000
Pakistan,2016,5,92289000,115376000,207665000
Pakistan,2016,6,90379000,127820000,218199000
Pakistan,2016,7,82179000,120628000,202807000
Pakistan,2016,8,100068000,140960000,241028000
Pakistan,2016,9,152514000,127095000,279609000
Pakistan,2016,10,86500000,121048000,207548000
Pakistan,2016,11,108795000,123342000,232137000
Pakistan,2016,12,141570000,121729000,263299000
Pakistan,2017,1,79519000,147173000,226692000
Pakistan,2017,2,92672000,136954000,229626000
Pakistan,2017,3,113112000,158603000,271715000
Pakistan,2017,4,85925000,126073000,211998000
Pakistan,2017,5,106794000,141627000,248421000
Pakistan,2017,6,108242000,139713000,247955000
Pakistan,2017,7,95416000,140302000,235718000
Pakistan,2017,8,94014000,149933000,243947000
Pakistan,2017,9,90295000,136111000,226406000
Pakistan,2017,10,106544000,124861000,231405000
Pakistan,2017,11,106953000,145931000,252884000
Pakistan,2017,12,123293000,121076000,244369000
Pakistan,2018,1,132072000,163434000,295506000
Pakistan,2018,2,115950000,138025000,253975000
Pakistan,2018,3,138980000,134604000,273584000
Pakistan,2018,4,98911000,144072000,242983000
Pakistan,2018,5,105519000,143340000,248859000
Pakistan,2018,6,103757000,132438000,236195000
Pakistan,2018,7,98078000,151770000,249848000
Pakistan,2018,8,95624000,149587000,245211000
Pakistan,2018,9,103334000,140116000,243450000
Pakistan,2018,10,94006000,136303000,230309000
Pakistan,2018,11,119495000,146740000,266235000
Pakistan,2018,12,98993000,117650000,216643000
Pakistan,2019,1,86062000,176688000,262750000
Pakistan,2019,2,82604000,139351000,221955000
Pakistan,2019,3,120754000,143545000,264299000
Pakistan,2019,4,101319000,139582000,240901000
Pakistan,2019,5,86673000,153598000,240271000
Pakistan,2019,6,108721000,138554000,247275000
Pakistan,2019,7,88664000,145307000,233971000
Pakistan,2019,8,88722000,160626000,249348000
Pakistan,2019,9,85743000,149542000,235285000
Pakistan,2019,10,79553000,155386000,234939000
Pakistan,2019,11,97265000,158116000,255381000
Pakistan,2019,12,88720000,139781000,228501000
Pakistan,2020,1,82076000,198586000,280662000
Pakistan,2020,2,81529000,140420000,221949000
Pakistan,2020,3,80807000,204584000,285391000
Pakistan,2020,4,90773000,129479000,220252000
Pakistan,2020,5,56432000,94378000,150810000
Pakistan,2020,6,69821000,114334000,184155000
Pakistan,2020,7,86171000,156571000,242742000
Pakistan,2020,8,85043000,169282000,254325000
Pakistan,2020,9,72527000,166851000,239378000
Pakistan,2020,10,126823000,185511000,312334000
Pakistan,2020,11,132985000,154106000,287091000
Pakistan,2020,12,90457000,143435000,233892000
Pakistan,2021,1,75496000,175756000,251252000
Pakistan,2021,2,102087000,157172000,259259000
Pakistan,2021,3,110104000,174611000,284715000
Pakistan,2021,4,92404000,192363000,284767000
Pakistan,2021,5,100909000,146820000,247729000
Pakistan,2021,6,88734000,165186000,253920000
Pakistan,2021,7,92481000,189939000,282420000
Pakistan,2021,8,89851000,179096000,268947000
Pakistan,2021,9,92845000,195234000,288079000
Pakistan,2021,10,188416000,201458000,389874000
Pakistan,2021,11,201001000,199829000,400830000
Pakistan,2021,12,100457000,191096000,291553000
Pakistan,2022,1,89061000,213586000,302647000
Pakistan,2022,2,131782000,206491000,338273000
Pakistan,2022,3,108597000,237586000,346183000
Pakistan,2022,4,77047000,230042000,307089000
Pakistan,2022,5,113559000,231704000,345263000
Pakistan,2022,6,100653000,240388000,341041000
Pakistan,2022,7,92450000,205368000,297818000
Pakistan,2022,8,99790000,317051000,416841000
Pakistan,2022,9,86780000,272003000,358783000
Pakistan,2022,10,85493000,250825000,336318000
Pakistan,2022,11,111755000,289763000,401518000
Pakistan,2022,12,104697000,213694000,318391000
Pakistan,2023,1,65504000,262100000,327604000
Pakistan,2023,2,72176000,201315000,273491000
Pakistan,2023,3,88504000,206234000,294738000
Pakistan,2023,4,79808000,168530000,248338000
Pakistan,2023,5,76705000,174057000,250762000
Pakistan,2023,6,90144000,193463000,283607000
Pakistan,2023,7,72923000,190920000,263843000
Pakistan,2023,8,87836000,220712000,308548000
Pakistan,2023,9,88899000,186849000,275748000
Pakistan,2023,10,79316000,183884000,263200000
Pakistan,2023,11,91675000,213254000,304929000
Pakistan,2023,12,78104000,159672000,237776000
Pakistan,2024,1,63699000,198905000,262604000
Pakistan,2024,2,61548000,170176000,231724000
Pakistan,2024,3,63077000,219037000,282114000
Pakistan,2024,4,80611000,210847000,291458000
Pakistan,2024,5,65983000,209561000,275544000
Pakistan,2024,6,66363000,185959000,252322000
Pakistan,2024,7,80684000,222453000,303137000
Pakistan,2024,8,68846000,224753000,293599000
Pakistan,2024,9,65167000,190466000,255633000
Pakistan,2024,10,71417000,227045000,298462000
Pakistan,2024,11,76279000,234109000,310388000
Pakistan,2024,12,83577000,216905000,300482000
Palau (ab 1995),2008,1,19000,8000,27000
Palau (ab 1995),2008,2,5000,0,5000
Palau (ab 1995),2008,3,4000,6000,10000
Palau (ab 1995),2008,4,4000,0,4000
Palau (ab 1995),2008,5,9000,0,9000
Palau (ab 1995),2008,6,6000,2000,8000
Palau (ab 1995),2008,7,2000,0,2000
Palau (ab 1995),2008,8,6000,0,6000
Palau (ab 1995),2008,9,0,1000,1000
Palau (ab 1995),2008,10,0,1000,1000
Palau (ab 1995),2008,11,1000,0,1000
Palau (ab 1995),2008,12,109000,2000,111000
Palau (ab 1995),2009,1,14000,0,14000
Palau (ab 1995),2009,2,20000,0,20000
Palau (ab 1995),2009,3,116000,0,116000
Palau (ab 1995),2009,4,25000,0,25000
Palau (ab 1995),2009,5,34000,0,34000
Palau (ab 1995),2009,6,61000,0,61000
Palau (ab 1995),2009,7,2000,0,2000
Palau (ab 1995),2009,8,0,0,0
Palau (ab 1995),2009,9,0,0,0
Palau (ab 1995),2009,10,0,0,0
Palau (ab 1995),2009,11,0,0,0
Palau (ab 1995),2009,12,11000,0,11000
Palau (ab 1995),2010,1,0,0,0
Palau (ab 1995),2010,2,12000,0,12000
Palau (ab 1995),2010,3,27000,0,27000
Palau (ab 1995),2010,4,0,1000,1000
Palau (ab 1995),2010,5,34000,0,34000
Palau (ab 1995),2010,6,0,9000,9000
Palau (ab 1995),2010,7,2000,0,2000
Palau (ab 1995),2010,8,0,0,0
Palau (ab 1995),2010,9,0,3000,3000
Palau (ab 1995),2010,10,2000,8000,10000
Palau (ab 1995),2010,11,125000,0,125000
Palau (ab 1995),2010,12,0,5000,5000
Palau (ab 1995),2011,1,13000,0,13000
Palau (ab 1995),2011,2,120000,0,120000
Palau (ab 1995),2011,3,0,15000,15000
Palau (ab 1995),2011,4,0,19000,19000
Palau (ab 1995),2011,5,0,22000,22000
Palau (ab 1995),2011,6,0,2000,2000
Palau (ab 1995),2011,7,0,0,0
Palau (ab 1995),2011,8,2000,0,2000
Palau (ab 1995),2011,9,119000,2000,121000
Palau (ab 1995),2011,10,0,0,0
Palau (ab 1995),2011,11,0,5000,5000
Palau (ab 1995),2011,12,0,11000,11000
Palau (ab 1995),2012,1,0,1000,1000
Palau (ab 1995),2012,2,0,15000,15000
Palau (ab 1995),2012,3,0,4000,4000
Palau (ab 1995),2012,4,0,0,0
Palau (ab 1995),2012,5,0,14000,14000
Palau (ab 1995),2012,6,0,28000,28000
Palau (ab 1995),2012,7,1000,14000,15000
Palau (ab 1995),2012,8,0,9000,9000
Palau (ab 1995),2012,9,0,11000,11000
Palau (ab 1995),2012,10,0,0,0
Palau (ab 1995),2012,11,32000,8000,40000
Palau (ab 1995),2012,12,3000,0,3000
Palau (ab 1995),2013,1,0,17000,17000
Palau (ab 1995),2013,2,0,3000,3000
Palau (ab 1995),2013,3,0,0,0
Palau (ab 1995),2013,4,26000,15000,41000
Palau (ab 1995),2013,5,0,7000,7000
Palau (ab 1995),2013,6,9000,6000,15000
Palau (ab 1995),2013,7,3000,18000,21000
Palau (ab 1995),2013,8,0,0,0
Palau (ab 1995),2013,9,2000,12000,14000
Palau (ab 1995),2013,10,0,6000,6000
Palau (ab 1995),2013,11,0,19000,19000
Palau (ab 1995),2013,12,0,14000,14000
Palau (ab 1995),2014,1,0,2000,2000
Palau (ab 1995),2014,2,21000,10000,31000
Palau (ab 1995),2014,3,0,5000,5000
Palau (ab 1995),2014,4,0,12000,12000
Palau (ab 1995),2014,5,12000,0,12000
Palau (ab 1995),2014,6,0,0,0
Palau (ab 1995),2014,7,0,0,0
Palau (ab 1995),2014,8,0,0,0
Palau (ab 1995),2014,9,0,0,0
Palau (ab 1995),2014,10,0,13000,13000
Palau (ab 1995),2014,11,0,5000,5000
Palau (ab 1995),2014,12,0,7000,7000
Palau (ab 1995),2015,1,0,0,0
Palau (ab 1995),2015,2,0,6000,6000
Palau (ab 1995),2015,3,0,0,0
Palau (ab 1995),2015,4,0,7000,7000
Palau (ab 1995),2015,5,0,8000,8000
Palau (ab 1995),2015,6,2000,0,2000
Palau (ab 1995),2015,7,19000,0,19000
Palau (ab 1995),2015,8,10000,0,10000
Palau (ab 1995),2015,9,0,7000,7000
Palau (ab 1995),2015,10,219000,2000,221000
Palau (ab 1995),2015,11,3000,0,3000
Palau (ab 1995),2015,12,3000,10000,13000
Palau (ab 1995),2016,1,4000,0,4000
Palau (ab 1995),2016,2,3000,0,3000
Palau (ab 1995),2016,3,9000,4000,13000
Palau (ab 1995),2016,4,0,11000,11000
Palau (ab 1995),2016,5,9000,0,9000
Palau (ab 1995),2016,6,0,4000,4000
Palau (ab 1995),2016,7,0,5000,5000
Palau (ab 1995),2016,8,0,0,0
Palau (ab 1995),2016,9,0,0,0
Palau (ab 1995),2016,10,2000,18000,20000
Palau (ab 1995),2016,11,4000,0,4000
Palau (ab 1995),2016,12,0,0,0
Palau (ab 1995),2017,1,0,0,0
Palau (ab 1995),2017,2,0,4000,4000
Palau (ab 1995),2017,3,3000,9000,12000
Palau (ab 1995),2017,4,0,4000,4000
Palau (ab 1995),2017,5,0,0,0
Palau (ab 1995),2017,6,18000,6000,24000
Palau (ab 1995),2017,7,0,0,0
Palau (ab 1995),2017,8,0,0,0
Palau (ab 1995),2017,9,0,5000,5000
Palau (ab 1995),2017,10,1000,40000,41000
Palau (ab 1995),2017,11,4000,3000,7000
Palau (ab 1995),2017,12,0,0,0
Palau (ab 1995),2018,1,10000,0,10000
Palau (ab 1995),2018,2,15000,3000,18000
Palau (ab 1995),2018,3,5000,0,5000
Palau (ab 1995),2018,4,0,4000,4000
Palau (ab 1995),2018,5,0,3000,3000
Palau (ab 1995),2018,6,34000,0,34000
Palau (ab 1995),2018,7,45000,0,45000
Palau (ab 1995),2018,8,13000,3000,16000
Palau (ab 1995),2018,9,0,7000,7000
Palau (ab 1995),2018,10,92000,0,92000
Palau (ab 1995),2018,11,2000,14000,16000
Palau (ab 1995),2018,12,1000,1000,2000
Palau (ab 1995),2019,1,0,0,0
Palau (ab 1995),2019,2,0,0,0
Palau (ab 1995),2019,3,16000,0,16000
Palau (ab 1995),2019,4,0,4000,4000
Palau (ab 1995),2019,5,4000,0,4000
Palau (ab 1995),2019,6,0,0,0
Palau (ab 1995),2019,7,0,3000,3000
Palau (ab 1995),2019,8,0,0,0
Palau (ab 1995),2019,9,0,0,0
Palau (ab 1995),2019,10,0,26000,26000
Palau (ab 1995),2019,11,0,2000,2000
Palau (ab 1995),2019,12,0,0,0
Palau (ab 1995),2020,1,1000,0,1000
Palau (ab 1995),2020,2,0,1000,1000
Palau (ab 1995),2020,3,8000,1000,9000
Palau (ab 1995),2020,4,0,0,0
Palau (ab 1995),2020,5,0,0,0
Palau (ab 1995),2020,6,13000,1000,14000
Palau (ab 1995),2020,7,0,0,0
Palau (ab 1995),2020,8,77000,0,77000
Palau (ab 1995),2020,9,0,11000,11000
Palau (ab 1995),2020,10,0,0,0
Palau (ab 1995),2020,11,8000,0,8000
Palau (ab 1995),2020,12,0,6000,6000
Palau (ab 1995),2021,1,3000,0,3000
Palau (ab 1995),2021,2,76000,0,76000
Palau (ab 1995),2021,3,8000,0,8000
Palau (ab 1995),2021,4,2000,0,2000
Palau (ab 1995),2021,5,248000,0,248000
Palau (ab 1995),2021,6,12000,0,12000
Palau (ab 1995),2021,7,39000,0,39000
Palau (ab 1995),2021,8,0,0,0
Palau (ab 1995),2021,9,0,0,0
Palau (ab 1995),2021,10,6000,0,6000
Palau (ab 1995),2021,11,0,9000,9000
Palau (ab 1995),2021,12,15000,0,15000
Palau (ab 1995),2022,1,22000,0,22000
Palau (ab 1995),2022,2,4000,0,4000
Palau (ab 1995),2022,3,0,0,0
Palau (ab 1995),2022,4,27000,0,27000
Palau (ab 1995),2022,5,0,0,0
Palau (ab 1995),2022,6,110000,0,110000
Palau (ab 1995),2022,7,0,0,0
Palau (ab 1995),2022,8,0,0,0
Palau (ab 1995),2022,9,0,0,0
Palau (ab 1995),2022,10,0,0,0
Palau (ab 1995),2022,11,31000,0,31000
Palau (ab 1995),2022,12,7000,0,7000
Palau (ab 1995),2023,1,0,0,0
Palau (ab 1995),2023,2,13000,0,13000
Palau (ab 1995),2023,3,9000,0,9000
Palau (ab 1995),2023,4,10000,0,10000
Palau (ab 1995),2023,5,0,0,0
Palau (ab 1995),2023,6,1000,0,1000
Palau (ab 1995),2023,7,0,0,0
Palau (ab 1995),2023,8,0,0,0
Palau (ab 1995),2023,9,23000,0,23000
Palau (ab 1995),2023,10,14000,0,14000
Palau (ab 1995),2023,11,0,0,0
Palau (ab 1995),2023,12,0,0,0
Palau (ab 1995),2024,1,0,0,0
Palau (ab 1995),2024,2,8000,0,8000
Palau (ab 1995),2024,3,3000,0,3000
Palau (ab 1995),2024,4,0,0,0
Palau (ab 1995),2024,5,0,0,0
Palau (ab 1995),2024,6,7000,0,7000
Palau (ab 1995),2024,7,2000,0,2000
Palau (ab 1995),2024,8,0,0,0
Palau (ab 1995),2024,9,0,0,0
Palau (ab 1995),2024,10,12000,0,12000
Palau (ab 1995),2024,11,18000,0,18000
Palau (ab 1995),2024,12,38000,0,38000
Panama,2008,1,15028000,102634000,117662000
Panama,2008,2,17410000,10653000,28063000
Panama,2008,3,14985000,9902000,24887000
Panama,2008,4,25405000,9766000,35171000
Panama,2008,5,11221000,10203000,21424000
Panama,2008,6,56219000,10223000,66442000
Panama,2008,7,18319000,9562000,27881000
Panama,2008,8,47730000,17707000,65437000
Panama,2008,9,17086000,6808000,23894000
Panama,2008,10,12934000,38718000,51652000
Panama,2008,11,15989000,16000000,31989000
Panama,2008,12,30228000,9990000,40218000
Panama,2009,1,13339000,5434000,18773000
Panama,2009,2,50313000,6334000,56647000
Panama,2009,3,14290000,7248000,21538000
Panama,2009,4,12164000,9853000,22017000
Panama,2009,5,10085000,8244000,18329000
Panama,2009,6,27220000,5370000,32590000
Panama,2009,7,36683000,4019000,40702000
Panama,2009,8,10283000,4154000,14437000
Panama,2009,9,13789000,5264000,19053000
Panama,2009,10,26365000,4217000,30582000
Panama,2009,11,15492000,4504000,19996000
Panama,2009,12,14278000,4140000,18418000
Panama,2010,1,12350000,3743000,16093000
Panama,2010,2,16540000,3453000,19993000
Panama,2010,3,23421000,19982000,43403000
Panama,2010,4,12102000,7620000,19722000
Panama,2010,5,14826000,6337000,21163000
Panama,2010,6,21140000,5938000,27078000
Panama,2010,7,27045000,4469000,31514000
Panama,2010,8,50693000,4598000,55291000
Panama,2010,9,77407000,4617000,82024000
Panama,2010,10,20587000,4360000,24947000
Panama,2010,11,21924000,5566000,27490000
Panama,2010,12,18648000,3748000,22396000
Panama,2011,1,19278000,4608000,23886000
Panama,2011,2,19525000,4385000,23910000
Panama,2011,3,21624000,5488000,27112000
Panama,2011,4,20630000,7827000,28457000
Panama,2011,5,20011000,6856000,26867000
Panama,2011,6,19369000,5203000,24572000
Panama,2011,7,26391000,4194000,30585000
Panama,2011,8,24960000,3722000,28682000
Panama,2011,9,24594000,3143000,27737000
Panama,2011,10,34612000,2257000,36869000
Panama,2011,11,30764000,2416000,33180000
Panama,2011,12,36354000,21692000,58046000
Panama,2012,1,25931000,2117000,28048000
Panama,2012,2,21532000,1641000,23173000
Panama,2012,3,26564000,3671000,30235000
Panama,2012,4,19124000,2935000,22059000
Panama,2012,5,24240000,3044000,27284000
Panama,2012,6,28290000,3015000,31305000
Panama,2012,7,29334000,1554000,30888000
Panama,2012,8,29024000,1746000,30770000
Panama,2012,9,27851000,7383000,35234000
Panama,2012,10,27837000,1799000,29636000
Panama,2012,11,26819000,4288000,31107000
Panama,2012,12,20859000,4456000,25315000
Panama,2013,1,41578000,1774000,43352000
Panama,2013,2,29940000,4362000,34302000
Panama,2013,3,44747000,4351000,49098000
Panama,2013,4,28323000,7419000,35742000
Panama,2013,5,32734000,8685000,41419000
Panama,2013,6,30203000,5929000,36132000
Panama,2013,7,31887000,3488000,35375000
Panama,2013,8,37950000,3534000,41484000
Panama,2013,9,31731000,3907000,35638000
Panama,2013,10,35840000,3390000,39230000
Panama,2013,11,47457000,3769000,51226000
Panama,2013,12,26867000,3505000,30372000
Panama,2014,1,32466000,4243000,36709000
Panama,2014,2,38973000,2917000,41890000
Panama,2014,3,30283000,5689000,35972000
Panama,2014,4,30996000,6457000,37453000
Panama,2014,5,23910000,7286000,31196000
Panama,2014,6,31083000,4365000,35448000
Panama,2014,7,52634000,4000000,56634000
Panama,2014,8,34278000,2995000,37273000
Panama,2014,9,55834000,4703000,60537000
Panama,2014,10,33970000,3705000,37675000
Panama,2014,11,26968000,3562000,30530000
Panama,2014,12,26533000,3644000,30177000
Panama,2015,1,28901000,5380000,34281000
Panama,2015,2,32992000,2035000,35027000
Panama,2015,3,45949000,5578000,51527000
Panama,2015,4,53606000,5967000,59573000
Panama,2015,5,27249000,4022000,31271000
Panama,2015,6,32330000,6426000,38756000
Panama,2015,7,31832000,3987000,35819000
Panama,2015,8,26337000,4148000,30485000
Panama,2015,9,38109000,5266000,43375000
Panama,2015,10,29852000,3500000,33352000
Panama,2015,11,30864000,19362000,50226000
Panama,2015,12,25982000,5268000,31250000
Panama,2016,1,33369000,5168000,38537000
Panama,2016,2,46466000,3520000,49986000
Panama,2016,3,35634000,2472000,38106000
Panama,2016,4,44010000,4441000,48451000
Panama,2016,5,21775000,3498000,25273000
Panama,2016,6,26321000,3133000,29454000
Panama,2016,7,29027000,3135000,32162000
Panama,2016,8,27820000,5551000,33371000
Panama,2016,9,26450000,2109000,28559000
Panama,2016,10,24454000,1913000,26367000
Panama,2016,11,26124000,1327000,27451000
Panama,2016,12,41094000,3610000,44704000
Panama,2017,1,35012000,2621000,37633000
Panama,2017,2,22690000,1777000,24467000
Panama,2017,3,29361000,2732000,32093000
Panama,2017,4,22681000,2259000,24940000
Panama,2017,5,70528000,4787000,75315000
Panama,2017,6,25992000,3861000,29853000
Panama,2017,7,31473000,5580000,37053000
Panama,2017,8,31515000,3292000,34807000
Panama,2017,9,32256000,3980000,36236000
Panama,2017,10,30538000,3049000,33587000
Panama,2017,11,27236000,5110000,32346000
Panama,2017,12,33998000,4301000,38299000
Panama,2018,1,25984000,4031000,30015000
Panama,2018,2,33586000,3634000,37220000
Panama,2018,3,32417000,3292000,35709000
Panama,2018,4,26133000,5532000,31665000
Panama,2018,5,28474000,2639000,31113000
Panama,2018,6,30250000,4297000,34547000
Panama,2018,7,35779000,3149000,38928000
Panama,2018,8,28811000,1551000,30362000
Panama,2018,9,27909000,1176000,29085000
Panama,2018,10,32802000,2018000,34820000
Panama,2018,11,30493000,1316000,31809000
Panama,2018,12,74768000,1775000,76543000
Panama,2019,1,79793000,5117000,84910000
Panama,2019,2,100170000,2572000,102742000
Panama,2019,3,41390000,5602000,46992000
Panama,2019,4,79881000,5037000,84918000
Panama,2019,5,31180000,5454000,36634000
Panama,2019,6,29614000,4594000,34208000
Panama,2019,7,37593000,8972000,46565000
Panama,2019,8,30469000,30315000,60784000
Panama,2019,9,28750000,2386000,31136000
Panama,2019,10,38108000,6203000,44311000
Panama,2019,11,46371000,16048000,62419000
Panama,2019,12,31948000,16073000,48021000
Panama,2020,1,48945000,16918000,65863000
Panama,2020,2,34196000,4027000,38223000
Panama,2020,3,38994000,5465000,44459000
Panama,2020,4,20507000,26199000,46706000
Panama,2020,5,32261000,4942000,37203000
Panama,2020,6,29072000,3968000,33040000
Panama,2020,7,26655000,28281000,54936000
Panama,2020,8,20158000,5535000,25693000
Panama,2020,9,24503000,4473000,28976000
Panama,2020,10,29010000,4439000,33449000
Panama,2020,11,29246000,4408000,33654000
Panama,2020,12,23289000,1996000,25285000
Panama,2021,1,25585000,20900000,46485000
Panama,2021,2,25780000,31990000,57770000
Panama,2021,3,34927000,47522000,82449000
Panama,2021,4,27198000,3889000,31087000
Panama,2021,5,36709000,3292000,40001000
Panama,2021,6,29238000,38132000,67370000
Panama,2021,7,41868000,4976000,46844000
Panama,2021,8,28685000,3415000,32100000
Panama,2021,9,32189000,3554000,35743000
Panama,2021,10,23402000,45752000,69154000
Panama,2021,11,29036000,36711000,65747000
Panama,2021,12,38546000,12795000,51341000
Panama,2022,1,28743000,19283000,48026000
Panama,2022,2,45588000,3403000,48991000
Panama,2022,3,41486000,7077000,48563000
Panama,2022,4,33337000,68810000,102147000
Panama,2022,5,41079000,4343000,45422000
Panama,2022,6,35911000,60823000,96734000
Panama,2022,7,33991000,16742000,50733000
Panama,2022,8,37638000,2943000,40581000
Panama,2022,9,27805000,35891000,63696000
Panama,2022,10,44877000,21445000,66322000
Panama,2022,11,39461000,3352000,42813000
Panama,2022,12,39542000,2759000,42301000
Panama,2023,1,45490000,49575000,95065000
Panama,2023,2,40834000,5446000,46280000
Panama,2023,3,53082000,6593000,59675000
Panama,2023,4,33895000,5275000,39170000
Panama,2023,5,40460000,45157000,85617000
Panama,2023,6,45448000,48177000,93625000
Panama,2023,7,34121000,5649000,39770000
Panama,2023,8,77935000,3879000,81814000
Panama,2023,9,64806000,4947000,69753000
Panama,2023,10,44087000,46341000,90428000
Panama,2023,11,54698000,6356000,61054000
Panama,2023,12,37550000,2719000,40269000
Panama,2024,1,37110000,5941000,43051000
Panama,2024,2,34811000,5790000,40601000
Panama,2024,3,44625000,5042000,49667000
Panama,2024,4,39120000,6133000,45253000
Panama,2024,5,51447000,7835000,59282000
Panama,2024,6,34165000,5797000,39962000
Panama,2024,7,41613000,7529000,49142000
Panama,2024,8,48929000,3534000,52463000
Panama,2024,9,44405000,20135000,64540000
Panama,2024,10,38244000,6155000,44399000
Panama,2024,11,51165000,7215000,58380000
Panama,2024,12,33080000,7102000,40182000
Papua-Neuguinea,2008,1,312000,26111000,26423000
Papua-Neuguinea,2008,2,919000,7674000,8593000
Papua-Neuguinea,2008,3,694000,2891000,3585000
Papua-Neuguinea,2008,4,619000,11357000,11976000
Papua-Neuguinea,2008,5,1234000,47405000,48639000
Papua-Neuguinea,2008,6,559000,11743000,12302000
Papua-Neuguinea,2008,7,749000,9503000,10252000
Papua-Neuguinea,2008,8,339000,15104000,15443000
Papua-Neuguinea,2008,9,5995000,19110000,25105000
Papua-Neuguinea,2008,10,444000,15296000,15740000
Papua-Neuguinea,2008,11,132000,36735000,36867000
Papua-Neuguinea,2008,12,357000,39674000,40031000
Papua-Neuguinea,2009,1,726000,13274000,14000000
Papua-Neuguinea,2009,2,6136000,7752000,13888000
Papua-Neuguinea,2009,3,663000,7463000,8126000
Papua-Neuguinea,2009,4,1833000,9463000,11296000
Papua-Neuguinea,2009,5,2677000,7797000,10474000
Papua-Neuguinea,2009,6,9101000,4506000,13607000
Papua-Neuguinea,2009,7,457000,12248000,12705000
Papua-Neuguinea,2009,8,5630000,11685000,17315000
Papua-Neuguinea,2009,9,421000,12340000,12761000
Papua-Neuguinea,2009,10,1795000,10494000,12289000
Papua-Neuguinea,2009,11,489000,38446000,38935000
Papua-Neuguinea,2009,12,2100000,18009000,20109000
Papua-Neuguinea,2010,1,273000,11878000,12151000
Papua-Neuguinea,2010,2,369000,12336000,12705000
Papua-Neuguinea,2010,3,6692000,10788000,17480000
Papua-Neuguinea,2010,4,1161000,52087000,53248000
Papua-Neuguinea,2010,5,529000,9823000,10352000
Papua-Neuguinea,2010,6,5493000,14088000,19581000
Papua-Neuguinea,2010,7,455000,17506000,17961000
Papua-Neuguinea,2010,8,534000,18594000,19128000
Papua-Neuguinea,2010,9,574000,28373000,28947000
Papua-Neuguinea,2010,10,1412000,17473000,18885000
Papua-Neuguinea,2010,11,390000,21363000,21753000
Papua-Neuguinea,2010,12,1613000,18326000,19939000
Papua-Neuguinea,2011,1,180000,20885000,21065000
Papua-Neuguinea,2011,2,713000,21282000,21995000
Papua-Neuguinea,2011,3,7219000,19549000,26768000
Papua-Neuguinea,2011,4,7406000,66256000,73662000
Papua-Neuguinea,2011,5,757000,21485000,22242000
Papua-Neuguinea,2011,6,1447000,13547000,14994000
Papua-Neuguinea,2011,7,4750000,32139000,36889000
Papua-Neuguinea,2011,8,1869000,28462000,30331000
Papua-Neuguinea,2011,9,3187000,26771000,29958000
Papua-Neuguinea,2011,10,2867000,41154000,44021000
Papua-Neuguinea,2011,11,1020000,23874000,24894000
Papua-Neuguinea,2011,12,2312000,24523000,26835000
Papua-Neuguinea,2012,1,811000,32741000,33552000
Papua-Neuguinea,2012,2,2173000,25247000,27420000
Papua-Neuguinea,2012,3,1907000,64554000,66461000
Papua-Neuguinea,2012,4,453000,42793000,43246000
Papua-Neuguinea,2012,5,8067000,24630000,32697000
Papua-Neuguinea,2012,6,1289000,32196000,33485000
Papua-Neuguinea,2012,7,12001000,36752000,48753000
Papua-Neuguinea,2012,8,25611000,26684000,52295000
Papua-Neuguinea,2012,9,1758000,68467000,70225000
Papua-Neuguinea,2012,10,5571000,19326000,24897000
Papua-Neuguinea,2012,11,6219000,26379000,32598000
Papua-Neuguinea,2012,12,2811000,21478000,24289000
Papua-Neuguinea,2013,1,5090000,10870000,15960000
Papua-Neuguinea,2013,2,1963000,12416000,14379000
Papua-Neuguinea,2013,3,1123000,5138000,6261000
Papua-Neuguinea,2013,4,1997000,17679000,19676000
Papua-Neuguinea,2013,5,671000,64367000,65038000
Papua-Neuguinea,2013,6,1198000,23271000,24469000
Papua-Neuguinea,2013,7,1784000,18143000,19927000
Papua-Neuguinea,2013,8,1053000,23689000,24742000
Papua-Neuguinea,2013,9,3762000,18417000,22179000
Papua-Neuguinea,2013,10,1984000,17763000,19747000
Papua-Neuguinea,2013,11,1763000,17069000,18832000
Papua-Neuguinea,2013,12,3823000,18400000,22223000
Papua-Neuguinea,2014,1,2339000,14665000,17004000
Papua-Neuguinea,2014,2,1849000,31811000,33660000
Papua-Neuguinea,2014,3,1852000,15797000,17649000
Papua-Neuguinea,2014,4,4580000,13491000,18071000
Papua-Neuguinea,2014,5,2413000,15974000,18387000
Papua-Neuguinea,2014,6,2147000,23368000,25515000
Papua-Neuguinea,2014,7,2523000,20811000,23334000
Papua-Neuguinea,2014,8,1887000,54609000,56496000
Papua-Neuguinea,2014,9,1393000,28808000,30201000
Papua-Neuguinea,2014,10,1830000,18617000,20447000
Papua-Neuguinea,2014,11,1657000,46321000,47978000
Papua-Neuguinea,2014,12,4715000,10069000,14784000
Papua-Neuguinea,2015,1,2478000,16904000,19382000
Papua-Neuguinea,2015,2,2421000,25521000,27942000
Papua-Neuguinea,2015,3,6487000,16780000,23267000
Papua-Neuguinea,2015,4,1886000,17219000,19105000
Papua-Neuguinea,2015,5,2260000,20325000,22585000
Papua-Neuguinea,2015,6,3775000,22443000,26218000
Papua-Neuguinea,2015,7,2259000,29068000,31327000
Papua-Neuguinea,2015,8,1482000,29647000,31129000
Papua-Neuguinea,2015,9,3545000,56711000,60256000
Papua-Neuguinea,2015,10,2983000,17020000,20003000
Papua-Neuguinea,2015,11,843000,23776000,24619000
Papua-Neuguinea,2015,12,1594000,9244000,10838000
Papua-Neuguinea,2016,1,1935000,20514000,22449000
Papua-Neuguinea,2016,2,1622000,14529000,16151000
Papua-Neuguinea,2016,3,2423000,6226000,8649000
Papua-Neuguinea,2016,4,1567000,11512000,13079000
Papua-Neuguinea,2016,5,805000,12815000,13620000
Papua-Neuguinea,2016,6,1662000,13328000,14990000
Papua-Neuguinea,2016,7,5522000,10001000,15523000
Papua-Neuguinea,2016,8,2265000,20361000,22626000
Papua-Neuguinea,2016,9,2353000,13157000,15510000
Papua-Neuguinea,2016,10,1917000,19677000,21594000
Papua-Neuguinea,2016,11,1654000,16789000,18443000
Papua-Neuguinea,2016,12,3138000,11122000,14260000
Papua-Neuguinea,2017,1,2192000,11013000,13205000
Papua-Neuguinea,2017,2,3438000,18266000,21704000
Papua-Neuguinea,2017,3,2288000,11865000,14153000
Papua-Neuguinea,2017,4,2959000,19240000,22199000
Papua-Neuguinea,2017,5,3310000,18765000,22075000
Papua-Neuguinea,2017,6,1661000,8934000,10595000
Papua-Neuguinea,2017,7,1212000,16520000,17732000
Papua-Neuguinea,2017,8,1206000,16018000,17224000
Papua-Neuguinea,2017,9,1311000,40550000,41861000
Papua-Neuguinea,2017,10,2795000,11316000,14111000
Papua-Neuguinea,2017,11,1383000,14327000,15710000
Papua-Neuguinea,2017,12,1710000,9608000,11318000
Papua-Neuguinea,2018,1,802000,12675000,13477000
Papua-Neuguinea,2018,2,1183000,5623000,6806000
Papua-Neuguinea,2018,3,5629000,6493000,12122000
Papua-Neuguinea,2018,4,1264000,4675000,5939000
Papua-Neuguinea,2018,5,1215000,7262000,8477000
Papua-Neuguinea,2018,6,1582000,7138000,8720000
Papua-Neuguinea,2018,7,2062000,9475000,11537000
Papua-Neuguinea,2018,8,3119000,48449000,51568000
Papua-Neuguinea,2018,9,1025000,14017000,15042000
Papua-Neuguinea,2018,10,1091000,13070000,14161000
Papua-Neuguinea,2018,11,2022000,75807000,77829000
Papua-Neuguinea,2018,12,1488000,7617000,9105000
Papua-Neuguinea,2019,1,1460000,41197000,42657000
Papua-Neuguinea,2019,2,819000,5025000,5844000
Papua-Neuguinea,2019,3,909000,7366000,8275000
Papua-Neuguinea,2019,4,1583000,26632000,28215000
Papua-Neuguinea,2019,5,1928000,8152000,10080000
Papua-Neuguinea,2019,6,843000,6920000,7763000
Papua-Neuguinea,2019,7,3325000,10909000,14234000
Papua-Neuguinea,2019,8,6018000,8328000,14346000
Papua-Neuguinea,2019,9,4490000,11390000,15880000
Papua-Neuguinea,2019,10,4079000,16796000,20875000
Papua-Neuguinea,2019,11,2364000,11004000,13368000
Papua-Neuguinea,2019,12,2314000,9590000,11904000
Papua-Neuguinea,2020,1,1016000,18440000,19456000
Papua-Neuguinea,2020,2,2304000,18631000,20935000
Papua-Neuguinea,2020,3,1016000,9110000,10126000
Papua-Neuguinea,2020,4,622000,6366000,6988000
Papua-Neuguinea,2020,5,1029000,23215000,24244000
Papua-Neuguinea,2020,6,3402000,4771000,8173000
Papua-Neuguinea,2020,7,2100000,12141000,14241000
Papua-Neuguinea,2020,8,767000,9048000,9815000
Papua-Neuguinea,2020,9,709000,11680000,12389000
Papua-Neuguinea,2020,10,1361000,10400000,11761000
Papua-Neuguinea,2020,11,923000,17799000,18722000
Papua-Neuguinea,2020,12,1282000,5972000,7254000
Papua-Neuguinea,2021,1,183000,12003000,12186000
Papua-Neuguinea,2021,2,660000,15339000,15999000
Papua-Neuguinea,2021,3,2230000,3904000,6134000
Papua-Neuguinea,2021,4,381000,5160000,5541000
Papua-Neuguinea,2021,5,403000,74995000,75398000
Papua-Neuguinea,2021,6,438000,22330000,22768000
Papua-Neuguinea,2021,7,3427000,3897000,7324000
Papua-Neuguinea,2021,8,805000,6980000,7785000
Papua-Neuguinea,2021,9,414000,9201000,9615000
Papua-Neuguinea,2021,10,835000,24500000,25335000
Papua-Neuguinea,2021,11,1449000,16217000,17666000
Papua-Neuguinea,2021,12,730000,10441000,11171000
Papua-Neuguinea,2022,1,492000,38153000,38645000
Papua-Neuguinea,2022,2,309000,18882000,19191000
Papua-Neuguinea,2022,3,1223000,26918000,28141000
Papua-Neuguinea,2022,4,1165000,6658000,7823000
Papua-Neuguinea,2022,5,150000,7112000,7262000
Papua-Neuguinea,2022,6,470000,12376000,12846000
Papua-Neuguinea,2022,7,713000,12443000,13156000
Papua-Neuguinea,2022,8,838000,16003000,16841000
Papua-Neuguinea,2022,9,703000,13368000,14071000
Papua-Neuguinea,2022,10,683000,31320000,32003000
Papua-Neuguinea,2022,11,553000,23753000,24306000
Papua-Neuguinea,2022,12,325000,24608000,24933000
Papua-Neuguinea,2023,1,6072000,21203000,27275000
Papua-Neuguinea,2023,2,488000,74427000,74915000
Papua-Neuguinea,2023,3,1505000,26035000,27540000
Papua-Neuguinea,2023,4,403000,11315000,11718000
Papua-Neuguinea,2023,5,627000,23005000,23632000
Papua-Neuguinea,2023,6,317000,13585000,13902000
Papua-Neuguinea,2023,7,614000,7223000,7837000
Papua-Neuguinea,2023,8,333000,20838000,21171000
Papua-Neuguinea,2023,9,1015000,12479000,13494000
Papua-Neuguinea,2023,10,2342000,11523000,13865000
Papua-Neuguinea,2023,11,266000,8753000,9019000
Papua-Neuguinea,2023,12,1877000,14050000,15927000
Papua-Neuguinea,2024,1,497000,26987000,27484000
Papua-Neuguinea,2024,2,4866000,31193000,36059000
Papua-Neuguinea,2024,3,959000,8979000,9938000
Papua-Neuguinea,2024,4,617000,25330000,25947000
Papua-Neuguinea,2024,5,3373000,8749000,12122000
Papua-Neuguinea,2024,6,1666000,25830000,27496000
Papua-Neuguinea,2024,7,2621000,5807000,8428000
Papua-Neuguinea,2024,8,503000,19522000,20025000
Papua-Neuguinea,2024,9,850000,19596000,20446000
Papua-Neuguinea,2024,10,740000,29946000,30686000
Papua-Neuguinea,2024,11,982000,18139000,19121000
Papua-Neuguinea,2024,12,421000,20579000,21000000
Paraguay,2008,1,4039000,2165000,6204000
Paraguay,2008,2,7269000,2663000,9932000
Paraguay,2008,3,5629000,2968000,8597000
Paraguay,2008,4,4764000,3438000,8202000
Paraguay,2008,5,5930000,3178000,9108000
Paraguay,2008,6,6522000,3962000,10484000
Paraguay,2008,7,10380000,27006000,37386000
Paraguay,2008,8,7534000,2540000,10074000
Paraguay,2008,9,6390000,16210000,22600000
Paraguay,2008,10,9621000,6601000,16222000
Paraguay,2008,11,8237000,1764000,10001000
Paraguay,2008,12,6618000,2952000,9570000
Paraguay,2009,1,4929000,2099000,7028000
Paraguay,2009,2,6250000,3657000,9907000
Paraguay,2009,3,4493000,5034000,9527000
Paraguay,2009,4,4988000,5168000,10156000
Paraguay,2009,5,6321000,2501000,8822000
Paraguay,2009,6,5868000,3045000,8913000
Paraguay,2009,7,8695000,4019000,12714000
Paraguay,2009,8,7043000,2370000,9413000
Paraguay,2009,9,6701000,1556000,8257000
Paraguay,2009,10,7653000,11173000,18826000
Paraguay,2009,11,8775000,1518000,10293000
Paraguay,2009,12,7436000,2070000,9506000
Paraguay,2010,1,7082000,2785000,9867000
Paraguay,2010,2,6963000,3160000,10123000
Paraguay,2010,3,9220000,5341000,14561000
Paraguay,2010,4,5110000,4555000,9665000
Paraguay,2010,5,9829000,16958000,26787000
Paraguay,2010,6,8480000,7302000,15782000
Paraguay,2010,7,11665000,29284000,40949000
Paraguay,2010,8,7396000,23412000,30808000
Paraguay,2010,9,11262000,16994000,28256000
Paraguay,2010,10,8611000,58627000,67238000
Paraguay,2010,11,7008000,3264000,10272000
Paraguay,2010,12,9056000,2821000,11877000
Paraguay,2011,1,11745000,2702000,14447000
Paraguay,2011,2,8216000,4402000,12618000
Paraguay,2011,3,10772000,4620000,15392000
Paraguay,2011,4,7334000,6313000,13647000
Paraguay,2011,5,8199000,37903000,46102000
Paraguay,2011,6,9088000,17629000,26717000
Paraguay,2011,7,12365000,13957000,26322000
Paraguay,2011,8,10108000,27672000,37780000
Paraguay,2011,9,8865000,28252000,37117000
Paraguay,2011,10,9658000,59638000,69296000
Paraguay,2011,11,12243000,18237000,30480000
Paraguay,2011,12,7705000,2957000,10662000
Paraguay,2012,1,10045000,45997000,56042000
Paraguay,2012,2,10925000,19213000,30138000
Paraguay,2012,3,9039000,4336000,13375000
Paraguay,2012,4,6531000,44011000,50542000
Paraguay,2012,5,7924000,13448000,21372000
Paraguay,2012,6,11181000,34945000,46126000
Paraguay,2012,7,11579000,28999000,40578000
Paraguay,2012,8,13993000,38571000,52564000
Paraguay,2012,9,10521000,22756000,33277000
Paraguay,2012,10,12888000,37962000,50850000
Paraguay,2012,11,10606000,2702000,13308000
Paraguay,2012,12,9164000,1666000,10830000
Paraguay,2013,1,6966000,2292000,9258000
Paraguay,2013,2,10296000,2988000,13284000
Paraguay,2013,3,11577000,3346000,14923000
Paraguay,2013,4,11362000,41095000,52457000
Paraguay,2013,5,11052000,28140000,39192000
Paraguay,2013,6,9646000,16946000,26592000
Paraguay,2013,7,11918000,34893000,46811000
Paraguay,2013,8,10134000,32804000,42938000
Paraguay,2013,9,11326000,65498000,76824000
Paraguay,2013,10,10277000,2092000,12369000
Paraguay,2013,11,9988000,1863000,11851000
Paraguay,2013,12,7766000,3761000,11527000
Paraguay,2014,1,10504000,3128000,13632000
Paraguay,2014,2,8728000,2670000,11398000
Paraguay,2014,3,10772000,25684000,36456000
Paraguay,2014,4,7843000,43581000,51424000
Paraguay,2014,5,7760000,23008000,30768000
Paraguay,2014,6,8548000,5097000,13645000
Paraguay,2014,7,12651000,29611000,42262000
Paraguay,2014,8,10057000,3065000,13122000
Paraguay,2014,9,13271000,2765000,16036000
Paraguay,2014,10,12461000,3022000,15483000
Paraguay,2014,11,10268000,2998000,13266000
Paraguay,2014,12,12121000,3525000,15646000
Paraguay,2015,1,11617000,4117000,15734000
Paraguay,2015,2,10149000,4175000,14324000
Paraguay,2015,3,12280000,38467000,50747000
Paraguay,2015,4,14601000,41489000,56090000
Paraguay,2015,5,12947000,23167000,36114000
Paraguay,2015,6,12403000,3337000,15740000
Paraguay,2015,7,12444000,11932000,24376000
Paraguay,2015,8,11188000,4033000,15221000
Paraguay,2015,9,13083000,6604000,19687000
Paraguay,2015,10,11786000,3698000,15484000
Paraguay,2015,11,11091000,5190000,16281000
Paraguay,2015,12,10542000,5263000,15805000
Paraguay,2016,1,10822000,6890000,17712000
Paraguay,2016,2,10802000,2920000,13722000
Paraguay,2016,3,8411000,9703000,18114000
Paraguay,2016,4,10005000,3604000,13609000
Paraguay,2016,5,9187000,3743000,12930000
Paraguay,2016,6,12377000,20657000,33034000
Paraguay,2016,7,11327000,2598000,13925000
Paraguay,2016,8,10798000,4228000,15026000
Paraguay,2016,9,12605000,3511000,16116000
Paraguay,2016,10,12774000,25284000,38058000
Paraguay,2016,11,13449000,4739000,18188000
Paraguay,2016,12,16098000,4389000,20487000
Paraguay,2017,1,12972000,5092000,18064000
Paraguay,2017,2,12264000,4242000,16506000
Paraguay,2017,3,14055000,5245000,19300000
Paraguay,2017,4,9931000,15673000,25604000
Paraguay,2017,5,20662000,4166000,24828000
Paraguay,2017,6,13483000,14924000,28407000
Paraguay,2017,7,13914000,21934000,35848000
Paraguay,2017,8,16229000,3943000,20172000
Paraguay,2017,9,17061000,5982000,23043000
Paraguay,2017,10,11215000,5190000,16405000
Paraguay,2017,11,17351000,8146000,25497000
Paraguay,2017,12,12241000,4863000,17104000
Paraguay,2018,1,16036000,6001000,22037000
Paraguay,2018,2,15326000,4725000,20051000
Paraguay,2018,3,19318000,4749000,24067000
Paraguay,2018,4,11206000,3587000,14793000
Paraguay,2018,5,11114000,4098000,15212000
Paraguay,2018,6,17221000,3921000,21142000
Paraguay,2018,7,16548000,3767000,20315000
Paraguay,2018,8,14463000,3728000,18191000
Paraguay,2018,9,13353000,4056000,17409000
Paraguay,2018,10,14035000,6279000,20314000
Paraguay,2018,11,15207000,6131000,21338000
Paraguay,2018,12,12661000,5235000,17896000
Paraguay,2019,1,14819000,4865000,19684000
Paraguay,2019,2,10451000,4422000,14873000
Paraguay,2019,3,16228000,3731000,19959000
Paraguay,2019,4,14950000,3392000,18342000
Paraguay,2019,5,13336000,3820000,17156000
Paraguay,2019,6,9943000,4240000,14183000
Paraguay,2019,7,15051000,3872000,18923000
Paraguay,2019,8,17321000,3966000,21287000
Paraguay,2019,9,17459000,3420000,20879000
Paraguay,2019,10,13062000,3951000,17013000
Paraguay,2019,11,15032000,4415000,19447000
Paraguay,2019,12,14126000,3264000,17390000
Paraguay,2020,1,10749000,3107000,13856000
Paraguay,2020,2,12907000,3007000,15914000
Paraguay,2020,3,15860000,4071000,19931000
Paraguay,2020,4,8226000,2786000,11012000
Paraguay,2020,5,7538000,2952000,10490000
Paraguay,2020,6,11357000,2924000,14281000
Paraguay,2020,7,14729000,3366000,18095000
Paraguay,2020,8,12278000,3310000,15588000
Paraguay,2020,9,11441000,3800000,15241000
Paraguay,2020,10,14774000,3835000,18609000
Paraguay,2020,11,12011000,3439000,15450000
Paraguay,2020,12,12809000,3155000,15964000
Paraguay,2021,1,11499000,3245000,14744000
Paraguay,2021,2,12244000,3089000,15333000
Paraguay,2021,3,16187000,3878000,20065000
Paraguay,2021,4,13091000,4205000,17296000
Paraguay,2021,5,20593000,4017000,24610000
Paraguay,2021,6,16382000,4055000,20437000
Paraguay,2021,7,15016000,5088000,20104000
Paraguay,2021,8,19046000,5170000,24216000
Paraguay,2021,9,13798000,6302000,20100000
Paraguay,2021,10,17129000,3722000,20851000
Paraguay,2021,11,15736000,7058000,22794000
Paraguay,2021,12,14760000,5065000,19825000
Paraguay,2022,1,20857000,4373000,25230000
Paraguay,2022,2,13184000,4042000,17226000
Paraguay,2022,3,23267000,4979000,28246000
Paraguay,2022,4,12548000,5423000,17971000
Paraguay,2022,5,13011000,5842000,18853000
Paraguay,2022,6,14387000,4637000,19024000
Paraguay,2022,7,16603000,4899000,21502000
Paraguay,2022,8,16834000,6038000,22872000
Paraguay,2022,9,17815000,6549000,24364000
Paraguay,2022,10,23037000,4706000,27743000
Paraguay,2022,11,18357000,6998000,25355000
Paraguay,2022,12,16772000,4366000,21138000
Paraguay,2023,1,14414000,5427000,19841000
Paraguay,2023,2,14326000,3549000,17875000
Paraguay,2023,3,16855000,4875000,21730000
Paraguay,2023,4,13807000,2537000,16344000
Paraguay,2023,5,18991000,4613000,23604000
Paraguay,2023,6,21299000,4327000,25626000
Paraguay,2023,7,13495000,8073000,21568000
Paraguay,2023,8,16859000,3448000,20307000
Paraguay,2023,9,18155000,5373000,23528000
Paraguay,2023,10,17804000,6293000,24097000
Paraguay,2023,11,19784000,6233000,26017000
Paraguay,2023,12,17869000,4677000,22546000
Paraguay,2024,1,17070000,4493000,21563000
Paraguay,2024,2,20196000,4352000,24548000
Paraguay,2024,3,19005000,3769000,22774000
Paraguay,2024,4,21948000,4363000,26311000
Paraguay,2024,5,18094000,4594000,22688000
Paraguay,2024,6,19005000,4830000,23835000
Paraguay,2024,7,21855000,5333000,27188000
Paraguay,2024,8,25764000,4580000,30344000
Paraguay,2024,9,24602000,3768000,28370000
Paraguay,2024,10,19417000,4568000,23985000
Paraguay,2024,11,21682000,4797000,26479000
Paraguay,2024,12,19151000,5453000,24604000
Peru,2008,1,36851000,88401000,125252000
Peru,2008,2,34465000,35397000,69862000
Peru,2008,3,40913000,75206000,116119000
Peru,2008,4,46630000,69167000,115797000
Peru,2008,5,32447000,74068000,106515000
Peru,2008,6,48806000,58010000,106816000
Peru,2008,7,46054000,59753000,105807000
Peru,2008,8,41611000,69996000,111607000
Peru,2008,9,45861000,143449000,189310000
Peru,2008,10,53606000,94281000,147887000
Peru,2008,11,39998000,62187000,102185000
Peru,2008,12,52980000,57399000,110379000
Peru,2009,1,37435000,98447000,135882000
Peru,2009,2,29040000,44000000,73040000
Peru,2009,3,44032000,47528000,91560000
Peru,2009,4,32522000,52856000,85378000
Peru,2009,5,28176000,40593000,68769000
Peru,2009,6,42566000,53422000,95988000
Peru,2009,7,43920000,63950000,107870000
Peru,2009,8,29326000,74356000,103682000
Peru,2009,9,33189000,113427000,146616000
Peru,2009,10,32038000,103131000,135169000
Peru,2009,11,38697000,80296000,118993000
Peru,2009,12,40335000,91830000,132165000
Peru,2010,1,36847000,91842000,128689000
Peru,2010,2,47898000,67690000,115588000
Peru,2010,3,59100000,71791000,130891000
Peru,2010,4,52685000,106806000,159491000
Peru,2010,5,46892000,77498000,124390000
Peru,2010,6,51613000,90406000,142019000
Peru,2010,7,53341000,106952000,160293000
Peru,2010,8,56959000,122380000,179339000
Peru,2010,9,54569000,159458000,214027000
Peru,2010,10,57657000,102466000,160123000
Peru,2010,11,49320000,137023000,186343000
Peru,2010,12,50356000,171313000,221669000
Peru,2011,1,65945000,151410000,217355000
Peru,2011,2,59684000,49009000,108693000
Peru,2011,3,66209000,115403000,181612000
Peru,2011,4,60476000,34404000,94880000
Peru,2011,5,60647000,118056000,178703000
Peru,2011,6,57586000,119118000,176704000
Peru,2011,7,71716000,153189000,224905000
Peru,2011,8,66071000,146813000,212884000
Peru,2011,9,59251000,137745000,196996000
Peru,2011,10,52389000,188218000,240607000
Peru,2011,11,66063000,94346000,160409000
Peru,2011,12,78113000,111723000,189836000
Peru,2012,1,63722000,155025000,218747000
Peru,2012,2,113857000,176736000,290593000
Peru,2012,3,76370000,92900000,169270000
Peru,2012,4,77824000,116996000,194820000
Peru,2012,5,73872000,74117000,147989000
Peru,2012,6,79617000,112428000,192045000
Peru,2012,7,83475000,79962000,163437000
Peru,2012,8,69180000,140723000,209903000
Peru,2012,9,70520000,101068000,171588000
Peru,2012,10,78138000,167952000,246090000
Peru,2012,11,77949000,181689000,259638000
Peru,2012,12,83627000,77942000,161569000
Peru,2013,1,70985000,135664000,206649000
Peru,2013,2,77853000,72740000,150593000
Peru,2013,3,69979000,63465000,133444000
Peru,2013,4,73348000,74878000,148226000
Peru,2013,5,74072000,49485000,123557000
Peru,2013,6,71176000,72582000,143758000
Peru,2013,7,76344000,119002000,195346000
Peru,2013,8,75201000,69691000,144892000
Peru,2013,9,72585000,91922000,164507000
Peru,2013,10,111525000,118167000,229692000
Peru,2013,11,91435000,63038000,154473000
Peru,2013,12,92488000,73124000,165612000
Peru,2014,1,88179000,66431000,154610000
Peru,2014,2,64422000,91164000,155586000
Peru,2014,3,89634000,81508000,171142000
Peru,2014,4,84985000,67014000,151999000
Peru,2014,5,66208000,83951000,150159000
Peru,2014,6,81115000,52161000,133276000
Peru,2014,7,90102000,74596000,164698000
Peru,2014,8,66647000,83650000,150297000
Peru,2014,9,76970000,147320000,224290000
Peru,2014,10,70351000,151581000,221932000
Peru,2014,11,64039000,137673000,201712000
Peru,2014,12,68859000,95670000,164529000
Peru,2015,1,59855000,72395000,132250000
Peru,2015,2,81694000,58330000,140024000
Peru,2015,3,74140000,88421000,162561000
Peru,2015,4,74096000,105328000,179424000
Peru,2015,5,66224000,88008000,154232000
Peru,2015,6,80372000,138863000,219235000
Peru,2015,7,72429000,49597000,122026000
Peru,2015,8,66477000,63019000,129496000
Peru,2015,9,68609000,126104000,194713000
Peru,2015,10,65160000,114951000,180111000
Peru,2015,11,66960000,82290000,149250000
Peru,2015,12,58092000,139421000,197513000
Peru,2016,1,60510000,84950000,145460000
Peru,2016,2,70162000,78084000,148246000
Peru,2016,3,80218000,49243000,129461000
Peru,2016,4,75549000,81103000,156652000
Peru,2016,5,53165000,83199000,136364000
Peru,2016,6,70969000,122857000,193826000
Peru,2016,7,68659000,86399000,155058000
Peru,2016,8,84659000,84960000,169619000
Peru,2016,9,81242000,108298000,189540000
Peru,2016,10,72849000,87034000,159883000
Peru,2016,11,78982000,104481000,183463000
Peru,2016,12,65046000,90270000,155316000
Peru,2017,1,67184000,189821000,257005000
Peru,2017,2,73348000,58960000,132308000
Peru,2017,3,74942000,91064000,166006000
Peru,2017,4,69206000,79847000,149053000
Peru,2017,5,69187000,86991000,156178000
Peru,2017,6,67420000,93679000,161099000
Peru,2017,7,83911000,116496000,200407000
Peru,2017,8,83931000,76189000,160120000
Peru,2017,9,65789000,82790000,148579000
Peru,2017,10,67282000,122933000,190215000
Peru,2017,11,78881000,137215000,216096000
Peru,2017,12,70759000,79557000,150316000
Peru,2018,1,65975000,71763000,137738000
Peru,2018,2,70623000,147298000,217921000
Peru,2018,3,77628000,65470000,143098000
Peru,2018,4,64514000,98294000,162808000
Peru,2018,5,64698000,93530000,158228000
Peru,2018,6,69546000,111143000,180689000
Peru,2018,7,75901000,168222000,244123000
Peru,2018,8,81648000,77303000,158951000
Peru,2018,9,72569000,123811000,196380000
Peru,2018,10,80247000,118659000,198906000
Peru,2018,11,66046000,105670000,171716000
Peru,2018,12,51428000,84255000,135683000
Peru,2019,1,65808000,165925000,231733000
Peru,2019,2,75316000,72446000,147762000
Peru,2019,3,72216000,118391000,190607000
Peru,2019,4,75857000,120725000,196582000
Peru,2019,5,95084000,105560000,200644000
Peru,2019,6,81169000,109188000,190357000
Peru,2019,7,97654000,71396000,169050000
Peru,2019,8,77277000,120721000,197998000
Peru,2019,9,69771000,87828000,157599000
Peru,2019,10,67800000,97137000,164937000
Peru,2019,11,78170000,84617000,162787000
Peru,2019,12,74681000,117920000,192601000
Peru,2020,1,62253000,149714000,211967000
Peru,2020,2,81726000,84803000,166529000
Peru,2020,3,67812000,103838000,171650000
Peru,2020,4,62106000,145098000,207204000
Peru,2020,5,36166000,63477000,99643000
Peru,2020,6,48517000,84541000,133058000
Peru,2020,7,74804000,59366000,134170000
Peru,2020,8,49764000,104171000,153935000
Peru,2020,9,68352000,91897000,160249000
Peru,2020,10,57955000,140285000,198240000
Peru,2020,11,73182000,143076000,216258000
Peru,2020,12,73508000,84437000,157945000
Peru,2021,1,66121000,88388000,154509000
Peru,2021,2,66780000,100983000,167763000
Peru,2021,3,93747000,107015000,200762000
Peru,2021,4,76222000,117740000,193962000
Peru,2021,5,84599000,88244000,172843000
Peru,2021,6,74937000,75858000,150795000
Peru,2021,7,80202000,62788000,142990000
Peru,2021,8,56682000,126248000,182930000
Peru,2021,9,63678000,146501000,210179000
Peru,2021,10,65536000,62542000,128078000
Peru,2021,11,72176000,132496000,204672000
Peru,2021,12,77276000,258402000,335678000
Peru,2022,1,59290000,170802000,230092000
Peru,2022,2,79750000,123738000,203488000
Peru,2022,3,91412000,218410000,309822000
Peru,2022,4,111012000,85211000,196223000
Peru,2022,5,138827000,77004000,215831000
Peru,2022,6,109350000,93766000,203116000
Peru,2022,7,76979000,58284000,135263000
Peru,2022,8,92497000,129873000,222370000
Peru,2022,9,95736000,120388000,216124000
Peru,2022,10,160782000,197917000,358699000
Peru,2022,11,102950000,144847000,247797000
Peru,2022,12,71808000,154729000,226537000
Peru,2023,1,115333000,92784000,208117000
Peru,2023,2,112392000,86302000,198694000
Peru,2023,3,111061000,157618000,268679000
Peru,2023,4,61411000,86463000,147874000
Peru,2023,5,73451000,113642000,187093000
Peru,2023,6,94340000,147886000,242226000
Peru,2023,7,86259000,96341000,182600000
Peru,2023,8,69903000,74525000,144428000
Peru,2023,9,76992000,88581000,165573000
Peru,2023,10,94819000,123803000,218622000
Peru,2023,11,89602000,100235000,189837000
Peru,2023,12,100669000,215209000,315878000
Peru,2024,1,64843000,128357000,193200000
Peru,2024,2,77227000,87740000,164967000
Peru,2024,3,82310000,114553000,196863000
Peru,2024,4,84178000,120434000,204612000
Peru,2024,5,82098000,54742000,136840000
Peru,2024,6,84130000,67364000,151494000
Peru,2024,7,87638000,142211000,229849000
Peru,2024,8,74116000,101223000,175339000
Peru,2024,9,78934000,117611000,196545000
Peru,2024,10,79792000,128280000,208072000
Peru,2024,11,97016000,170945000,267961000
Peru,2024,12,79930000,193060000,272990000
Philippinen,2008,1,92934000,154025000,246959000
Philippinen,2008,2,84782000,139730000,224512000
Philippinen,2008,3,74542000,146707000,221249000
Philippinen,2008,4,70427000,168592000,239019000
Philippinen,2008,5,68186000,127397000,195583000
Philippinen,2008,6,91916000,126617000,218533000
Philippinen,2008,7,73910000,142325000,216235000
Philippinen,2008,8,74689000,124526000,199215000
Philippinen,2008,9,83116000,156844000,239960000
Philippinen,2008,10,74073000,157079000,231152000
Philippinen,2008,11,61231000,123719000,184950000
Philippinen,2008,12,73539000,170659000,244198000
Philippinen,2009,1,74448000,112267000,186715000
Philippinen,2009,2,60585000,88670000,149255000
Philippinen,2009,3,64637000,104066000,168703000
Philippinen,2009,4,60704000,96568000,157272000
Philippinen,2009,5,60516000,94701000,155217000
Philippinen,2009,6,54139000,121586000,175725000
Philippinen,2009,7,75413000,115784000,191197000
Philippinen,2009,8,59344000,114133000,173477000
Philippinen,2009,9,60033000,178641000,238674000
Philippinen,2009,10,65693000,150474000,216167000
Philippinen,2009,11,76438000,147534000,223972000
Philippinen,2009,12,75329000,168996000,244325000
Philippinen,2010,1,62477000,178202000,240679000
Philippinen,2010,2,78848000,192013000,270861000
Philippinen,2010,3,91231000,198861000,290092000
Philippinen,2010,4,77295000,302325000,379620000
Philippinen,2010,5,88467000,170655000,259122000
Philippinen,2010,6,80401000,200633000,281034000
Philippinen,2010,7,83359000,158093000,241452000
Philippinen,2010,8,77618000,168741000,246359000
Philippinen,2010,9,85145000,206308000,291453000
Philippinen,2010,10,114263000,175720000,289983000
Philippinen,2010,11,156938000,160116000,317054000
Philippinen,2010,12,113068000,156529000,269597000
Philippinen,2011,1,110977000,167101000,278078000
Philippinen,2011,2,73270000,157288000,230558000
Philippinen,2011,3,92307000,186447000,278754000
Philippinen,2011,4,91620000,152008000,243628000
Philippinen,2011,5,85311000,183117000,268428000
Philippinen,2011,6,85168000,157950000,243118000
Philippinen,2011,7,84592000,144610000,229202000
Philippinen,2011,8,88393000,164660000,253053000
Philippinen,2011,9,131019000,190316000,321335000
Philippinen,2011,10,157217000,178655000,335872000
Philippinen,2011,11,115191000,168844000,284035000
Philippinen,2011,12,131243000,155509000,286752000
Philippinen,2012,1,161870000,165335000,327205000
Philippinen,2012,2,84032000,201714000,285746000
Philippinen,2012,3,133799000,277175000,410974000
Philippinen,2012,4,117469000,248266000,365735000
Philippinen,2012,5,137946000,174068000,312014000
Philippinen,2012,6,159017000,194081000,353098000
Philippinen,2012,7,105954000,166821000,272775000
Philippinen,2012,8,103148000,173290000,276438000
Philippinen,2012,9,138250000,178909000,317159000
Philippinen,2012,10,161920000,191440000,353360000
Philippinen,2012,11,108651000,173469000,282120000
Philippinen,2012,12,122933000,144876000,267809000
Philippinen,2013,1,110115000,174323000,284438000
Philippinen,2013,2,101049000,178133000,279182000
Philippinen,2013,3,148960000,182669000,331629000
Philippinen,2013,4,110526000,201256000,311782000
Philippinen,2013,5,109013000,187522000,296535000
Philippinen,2013,6,109071000,186405000,295476000
Philippinen,2013,7,127170000,198630000,325800000
Philippinen,2013,8,218430000,198782000,417212000
Philippinen,2013,9,164875000,220726000,385601000
Philippinen,2013,10,219804000,217576000,437380000
Philippinen,2013,11,163765000,203325000,367090000
Philippinen,2013,12,144010000,202880000,346890000
Philippinen,2014,1,118513000,221858000,340371000
Philippinen,2014,2,125427000,210071000,335498000
Philippinen,2014,3,125544000,239142000,364686000
Philippinen,2014,4,160778000,202855000,363633000
Philippinen,2014,5,127312000,215839000,343151000
Philippinen,2014,6,145248000,223751000,368999000
Philippinen,2014,7,191680000,226073000,417753000
Philippinen,2014,8,143760000,230722000,374482000
Philippinen,2014,9,250036000,246987000,497023000
Philippinen,2014,10,277672000,249760000,527432000
Philippinen,2014,11,228417000,236386000,464803000
Philippinen,2014,12,138657000,228001000,366658000
Philippinen,2015,1,196244000,241510000,437754000
Philippinen,2015,2,139170000,235141000,374311000
Philippinen,2015,3,289170000,288988000,578158000
Philippinen,2015,4,281756000,254785000,536541000
Philippinen,2015,5,198394000,248320000,446714000
Philippinen,2015,6,158066000,261215000,419281000
Philippinen,2015,7,163995000,252468000,416463000
Philippinen,2015,8,144010000,238324000,382334000
Philippinen,2015,9,136904000,270504000,407408000
Philippinen,2015,10,140614000,240652000,381266000
Philippinen,2015,11,143938000,248339000,392277000
Philippinen,2015,12,154425000,228975000,383400000
Philippinen,2016,1,137700000,240004000,377704000
Philippinen,2016,2,153190000,229925000,383115000
Philippinen,2016,3,208758000,233416000,442174000
Philippinen,2016,4,153212000,237592000,390804000
Philippinen,2016,5,135777000,232367000,368144000
Philippinen,2016,6,217080000,238248000,455328000
Philippinen,2016,7,131601000,235358000,366959000
Philippinen,2016,8,206283000,233893000,440176000
Philippinen,2016,9,152097000,254998000,407095000
Philippinen,2016,10,190768000,239235000,430003000
Philippinen,2016,11,217172000,248981000,466153000
Philippinen,2016,12,146114000,225210000,371324000
Philippinen,2017,1,164132000,277820000,441952000
Philippinen,2017,2,161847000,284962000,446809000
Philippinen,2017,3,185352000,315265000,500617000
Philippinen,2017,4,162683000,271967000,434650000
Philippinen,2017,5,206499000,311510000,518009000
Philippinen,2017,6,166895000,310966000,477861000
Philippinen,2017,7,177100000,309439000,486539000
Philippinen,2017,8,178334000,321294000,499628000
Philippinen,2017,9,164808000,316574000,481382000
Philippinen,2017,10,176142000,305153000,481295000
Philippinen,2017,11,148764000,291452000,440216000
Philippinen,2017,12,146151000,283275000,429426000
Philippinen,2018,1,139093000,307034000,446127000
Philippinen,2018,2,132490000,265396000,397886000
Philippinen,2018,3,203807000,307988000,511795000
Philippinen,2018,4,236534000,334178000,570712000
Philippinen,2018,5,261717000,292584000,554301000
Philippinen,2018,6,269546000,319563000,589109000
Philippinen,2018,7,157830000,313560000,471390000
Philippinen,2018,8,228206000,311933000,540139000
Philippinen,2018,9,213549000,317263000,530812000
Philippinen,2018,10,166034000,332979000,499013000
Philippinen,2018,11,304361000,305259000,609620000
Philippinen,2018,12,263180000,267362000,530542000
Philippinen,2019,1,240493000,326257000,566750000
Philippinen,2019,2,193992000,276585000,470577000
Philippinen,2019,3,181958000,569699000,751657000
Philippinen,2019,4,144614000,302395000,447009000
Philippinen,2019,5,226188000,316450000,542638000
Philippinen,2019,6,148956000,310955000,459911000
Philippinen,2019,7,259917000,317644000,577561000
Philippinen,2019,8,165672000,313026000,478698000
Philippinen,2019,9,210237000,321792000,532029000
Philippinen,2019,10,261255000,345675000,606930000
Philippinen,2019,11,302376000,308657000,611033000
Philippinen,2019,12,159479000,287986000,447465000
Philippinen,2020,1,213493000,330892000,544385000
Philippinen,2020,2,243895000,287956000,531851000
Philippinen,2020,3,141404000,309388000,450792000
Philippinen,2020,4,150031000,222919000,372950000
Philippinen,2020,5,109694000,191074000,300768000
Philippinen,2020,6,183896000,207101000,390997000
Philippinen,2020,7,161469000,259487000,420956000
Philippinen,2020,8,119113000,305379000,424492000
Philippinen,2020,9,140173000,306996000,447169000
Philippinen,2020,10,130748000,307496000,438244000
Philippinen,2020,11,188515000,339025000,527540000
Philippinen,2020,12,141957000,286139000,428096000
Philippinen,2021,1,117778000,274740000,392518000
Philippinen,2021,2,121591000,245288000,366879000
Philippinen,2021,3,215481000,321855000,537336000
Philippinen,2021,4,122901000,342548000,465449000
Philippinen,2021,5,191655000,312913000,504568000
Philippinen,2021,6,129172000,329117000,458289000
Philippinen,2021,7,140072000,344786000,484858000
Philippinen,2021,8,128413000,369690000,498103000
Philippinen,2021,9,159700000,345089000,504789000
Philippinen,2021,10,160304000,316548000,476852000
Philippinen,2021,11,170095000,377661000,547756000
Philippinen,2021,12,194047000,385748000,579795000
Philippinen,2022,1,132202000,340607000,472809000
Philippinen,2022,2,153770000,340086000,493856000
Philippinen,2022,3,225199000,453984000,679183000
Philippinen,2022,4,122648000,418882000,541530000
Philippinen,2022,5,151004000,425875000,576879000
Philippinen,2022,6,132410000,459098000,591508000
Philippinen,2022,7,216219000,470769000,686988000
Philippinen,2022,8,162797000,466922000,629719000
Philippinen,2022,9,146097000,465787000,611884000
Philippinen,2022,10,146317000,439925000,586242000
Philippinen,2022,11,168185000,637224000,805409000
Philippinen,2022,12,226937000,420806000,647743000
Philippinen,2023,1,159670000,549101000,708771000
Philippinen,2023,2,164744000,395557000,560301000
Philippinen,2023,3,172268000,441782000,614050000
Philippinen,2023,4,142985000,385007000,527992000
Philippinen,2023,5,137621000,408718000,546339000
Philippinen,2023,6,159389000,393948000,553337000
Philippinen,2023,7,228221000,368366000,596587000
Philippinen,2023,8,159114000,407239000,566353000
Philippinen,2023,9,148548000,434816000,583364000
Philippinen,2023,10,151204000,397640000,548844000
Philippinen,2023,11,154140000,386691000,540831000
Philippinen,2023,12,140898000,319024000,459922000
Philippinen,2024,1,141266000,342130000,483396000
Philippinen,2024,2,155123000,347522000,502645000
Philippinen,2024,3,219052000,354972000,574024000
Philippinen,2024,4,151490000,425757000,577247000
Philippinen,2024,5,144949000,385871000,530820000
Philippinen,2024,6,227146000,363318000,590464000
Philippinen,2024,7,166854000,360086000,526940000
Philippinen,2024,8,148551000,387698000,536249000
Philippinen,2024,9,205620000,430240000,635860000
Philippinen,2024,10,137853000,474210000,612063000
Philippinen,2024,11,134915000,420792000,555707000
Philippinen,2024,12,117286000,439802000,557088000
Pitcairn,2008,1,20000,1000,21000
Pitcairn,2008,2,34000,0,34000
Pitcairn,2008,3,2000,1000,3000
Pitcairn,2008,4,29000,23000,52000
Pitcairn,2008,5,0,0,0
Pitcairn,2008,6,1000,1000,2000
Pitcairn,2008,7,25000,0,25000
Pitcairn,2008,8,0,4000,4000
Pitcairn,2008,9,5000,1000,6000
Pitcairn,2008,10,0,2000,2000
Pitcairn,2008,11,0,0,0
Pitcairn,2008,12,10000,0,10000
Pitcairn,2009,1,33000,4000,37000
Pitcairn,2009,2,4000,3000,7000
Pitcairn,2009,3,273000,1000,274000
Pitcairn,2009,4,0,0,0
Pitcairn,2009,5,127000,0,127000
Pitcairn,2009,6,5000,0,5000
Pitcairn,2009,7,0,0,0
Pitcairn,2009,8,0,0,0
Pitcairn,2009,9,8000,0,8000
Pitcairn,2009,10,2000,0,2000
Pitcairn,2009,11,0,0,0
Pitcairn,2009,12,0,0,0
Pitcairn,2010,1,0,0,0
Pitcairn,2010,2,0,0,0
Pitcairn,2010,3,0,0,0
Pitcairn,2010,4,0,2000,2000
Pitcairn,2010,5,0,0,0
Pitcairn,2010,6,0,0,0
Pitcairn,2010,7,0,0,0
Pitcairn,2010,8,3000,0,3000
Pitcairn,2010,9,0,1000,1000
Pitcairn,2010,10,0,0,0
Pitcairn,2010,11,0,0,0
Pitcairn,2010,12,0,0,0
Pitcairn,2011,1,0,0,0
Pitcairn,2011,2,0,1000,1000
Pitcairn,2011,3,0,0,0
Pitcairn,2011,4,0,0,0
Pitcairn,2011,5,0,0,0
Pitcairn,2011,6,0,0,0
Pitcairn,2011,7,28000,0,28000
Pitcairn,2011,8,0,0,0
Pitcairn,2011,9,0,0,0
Pitcairn,2011,10,0,0,0
Pitcairn,2011,11,0,0,0
Pitcairn,2011,12,0,0,0
Pitcairn,2012,1,0,0,0
Pitcairn,2012,2,0,0,0
Pitcairn,2012,3,0,0,0
Pitcairn,2012,4,0,0,0
Pitcairn,2012,5,0,0,0
Pitcairn,2012,6,0,0,0
Pitcairn,2012,7,0,0,0
Pitcairn,2012,8,0,0,0
Pitcairn,2012,9,5000,0,5000
Pitcairn,2012,10,0,0,0
Pitcairn,2012,11,0,0,0
Pitcairn,2012,12,4000,7000,11000
Pitcairn,2013,1,0,0,0
Pitcairn,2013,2,0,0,0
Pitcairn,2013,3,0,0,0
Pitcairn,2013,4,40000,0,40000
Pitcairn,2013,5,13000,0,13000
Pitcairn,2013,6,0,0,0
Pitcairn,2013,7,1000,7000,8000
Pitcairn,2013,8,6000,0,6000
Pitcairn,2013,9,0,0,0
Pitcairn,2013,10,0,0,0
Pitcairn,2013,11,13000,0,13000
Pitcairn,2013,12,0,0,0
Pitcairn,2014,1,1000,0,1000
Pitcairn,2014,2,0,0,0
Pitcairn,2014,3,0,1000,1000
Pitcairn,2014,4,52000,1000,53000
Pitcairn,2014,5,0,2000,2000
Pitcairn,2014,6,5000,0,5000
Pitcairn,2014,7,8000,0,8000
Pitcairn,2014,8,0,0,0
Pitcairn,2014,9,14000,0,14000
Pitcairn,2014,10,0,0,0
Pitcairn,2014,11,0,0,0
Pitcairn,2014,12,2000,0,2000
Pitcairn,2015,1,0,0,0
Pitcairn,2015,2,0,0,0
Pitcairn,2015,3,25000,0,25000
Pitcairn,2015,4,16000,0,16000
Pitcairn,2015,5,0,0,0
Pitcairn,2015,6,0,0,0
Pitcairn,2015,7,0,0,0
Pitcairn,2015,8,4000,0,4000
Pitcairn,2015,9,0,0,0
Pitcairn,2015,10,0,2000,2000
Pitcairn,2015,11,0,0,0
Pitcairn,2015,12,7000,0,7000
Pitcairn,2016,1,0,0,0
Pitcairn,2016,2,0,0,0
Pitcairn,2016,3,0,0,0
Pitcairn,2016,4,0,0,0
Pitcairn,2016,5,4000,0,4000
Pitcairn,2016,6,28000,0,28000
Pitcairn,2016,7,0,0,0
Pitcairn,2016,8,1000,0,1000
Pitcairn,2016,9,0,0,0
Pitcairn,2016,10,0,0,0
Pitcairn,2016,11,0,0,0
Pitcairn,2016,12,0,0,0
Pitcairn,2017,1,2000,0,2000
Pitcairn,2017,2,3000,0,3000
Pitcairn,2017,3,0,0,0
Pitcairn,2017,4,0,0,0
Pitcairn,2017,5,2000,0,2000
Pitcairn,2017,6,0,0,0
Pitcairn,2017,7,0,0,0
Pitcairn,2017,8,0,0,0
Pitcairn,2017,9,1000,0,1000
Pitcairn,2017,10,0,0,0
Pitcairn,2017,11,0,0,0
Pitcairn,2017,12,0,0,0
Pitcairn,2018,1,0,0,0
Pitcairn,2018,2,0,0,0
Pitcairn,2018,3,0,0,0
Pitcairn,2018,4,0,4000,4000
Pitcairn,2018,5,0,0,0
Pitcairn,2018,6,0,3000,3000
Pitcairn,2018,7,0,0,0
Pitcairn,2018,8,0,0,0
Pitcairn,2018,9,0,5000,5000
Pitcairn,2018,10,0,0,0
Pitcairn,2018,11,0,0,0
Pitcairn,2018,12,0,6000,6000
Pitcairn,2019,1,0,0,0
Pitcairn,2019,2,0,0,0
Pitcairn,2019,3,0,212000,212000
Pitcairn,2019,4,0,0,0
Pitcairn,2019,5,16000,0,16000
Pitcairn,2019,6,0,2000,2000
Pitcairn,2019,7,0,0,0
Pitcairn,2019,8,0,0,0
Pitcairn,2019,9,0,5000,5000
Pitcairn,2019,10,0,0,0
Pitcairn,2019,11,0,0,0
Pitcairn,2019,12,0,9000,9000
Pitcairn,2020,1,0,0,0
Pitcairn,2020,2,0,1000,1000
Pitcairn,2020,3,0,2000,2000
Pitcairn,2020,4,0,0,0
Pitcairn,2020,5,0,0,0
Pitcairn,2020,6,0,0,0
Pitcairn,2020,7,0,0,0
Pitcairn,2020,8,0,0,0
Pitcairn,2020,9,0,1000,1000
Pitcairn,2020,10,0,0,0
Pitcairn,2020,11,0,0,0
Pitcairn,2020,12,0,0,0
Pitcairn,2021,1,2000,0,2000
Pitcairn,2021,2,0,0,0
Pitcairn,2021,3,0,0,0
Pitcairn,2021,4,0,0,0
Pitcairn,2021,5,0,0,0
Pitcairn,2021,6,0,0,0
Pitcairn,2021,7,0,0,0
Pitcairn,2021,8,0,9000,9000
Pitcairn,2021,9,0,0,0
Pitcairn,2021,10,0,0,0
Pitcairn,2021,11,0,24000,24000
Pitcairn,2021,12,0,27000,27000
Pitcairn,2022,1,0,12000,12000
Pitcairn,2022,2,0,6000,6000
Pitcairn,2022,3,0,0,0
Pitcairn,2022,4,0,0,0
Pitcairn,2022,5,0,0,0
Pitcairn,2022,6,0,0,0
Pitcairn,2022,7,0,0,0
Pitcairn,2022,8,0,0,0
Pitcairn,2022,9,2000,0,2000
Pitcairn,2022,10,0,0,0
Pitcairn,2022,11,0,0,0
Pitcairn,2022,12,0,0,0
Pitcairn,2023,1,0,0,0
Pitcairn,2023,2,0,0,0
Pitcairn,2023,3,0,0,0
Pitcairn,2023,4,0,0,0
Pitcairn,2023,5,0,0,0
Pitcairn,2023,6,0,0,0
Pitcairn,2023,7,0,0,0
Pitcairn,2023,8,0,0,0
Pitcairn,2023,9,0,0,0
Pitcairn,2023,10,0,0,0
Pitcairn,2023,11,0,0,0
Pitcairn,2023,12,0,0,0
Pitcairn,2024,1,0,0,0
Pitcairn,2024,2,0,0,0
Pitcairn,2024,3,0,0,0
Pitcairn,2024,4,0,0,0
Pitcairn,2024,5,0,0,0
Pitcairn,2024,6,0,0,0
Pitcairn,2024,7,0,0,0
Pitcairn,2024,8,0,0,0
Pitcairn,2024,9,0,0,0
Pitcairn,2024,10,0,0,0
Pitcairn,2024,11,0,0,0
Pitcairn,2024,12,0,0,0
Plurinationaler Staat Bolivien,2008,1,4834000,13582000,18416000
Plurinationaler Staat Bolivien,2008,2,4324000,4037000,8361000
Plurinationaler Staat Bolivien,2008,3,4131000,2274000,6405000
Plurinationaler Staat Bolivien,2008,4,4496000,2349000,6845000
Plurinationaler Staat Bolivien,2008,5,3168000,1741000,4909000
Plurinationaler Staat Bolivien,2008,6,4096000,3843000,7939000
Plurinationaler Staat Bolivien,2008,7,3746000,21645000,25391000
Plurinationaler Staat Bolivien,2008,8,3850000,2769000,6619000
Plurinationaler Staat Bolivien,2008,9,4116000,11168000,15284000
Plurinationaler Staat Bolivien,2008,10,6904000,4272000,11176000
Plurinationaler Staat Bolivien,2008,11,5095000,2941000,8036000
Plurinationaler Staat Bolivien,2008,12,5144000,4393000,9537000
Plurinationaler Staat Bolivien,2009,1,3374000,5817000,9191000
Plurinationaler Staat Bolivien,2009,2,3291000,6907000,10198000
Plurinationaler Staat Bolivien,2009,3,5496000,2565000,8061000
Plurinationaler Staat Bolivien,2009,4,3722000,6898000,10620000
Plurinationaler Staat Bolivien,2009,5,2665000,7044000,9709000
Plurinationaler Staat Bolivien,2009,6,3491000,5758000,9249000
Plurinationaler Staat Bolivien,2009,7,6087000,11057000,17144000
Plurinationaler Staat Bolivien,2009,8,4282000,9281000,13563000
Plurinationaler Staat Bolivien,2009,9,4258000,3116000,7374000
Plurinationaler Staat Bolivien,2009,10,9217000,4281000,13498000
Plurinationaler Staat Bolivien,2009,11,5738000,16162000,21900000
Plurinationaler Staat Bolivien,2009,12,5525000,2116000,7641000
Plurinationaler Staat Bolivien,2010,1,4490000,1544000,6034000
Plurinationaler Staat Bolivien,2010,2,3769000,11529000,15298000
Plurinationaler Staat Bolivien,2010,3,7619000,3122000,10741000
Plurinationaler Staat Bolivien,2010,4,6330000,2167000,8497000
Plurinationaler Staat Bolivien,2010,5,5813000,17606000,23419000
Plurinationaler Staat Bolivien,2010,6,6794000,4087000,10881000
Plurinationaler Staat Bolivien,2010,7,7006000,3759000,10765000
Plurinationaler Staat Bolivien,2010,8,5869000,2818000,8687000
Plurinationaler Staat Bolivien,2010,9,6778000,17182000,23960000
Plurinationaler Staat Bolivien,2010,10,5693000,3674000,9367000
Plurinationaler Staat Bolivien,2010,11,6510000,4527000,11037000
Plurinationaler Staat Bolivien,2010,12,13673000,3818000,17491000
Plurinationaler Staat Bolivien,2011,1,8211000,2297000,10508000
Plurinationaler Staat Bolivien,2011,2,7336000,17278000,24614000
Plurinationaler Staat Bolivien,2011,3,5670000,3441000,9111000
Plurinationaler Staat Bolivien,2011,4,4761000,1786000,6547000
Plurinationaler Staat Bolivien,2011,5,6556000,13839000,20395000
Plurinationaler Staat Bolivien,2011,6,5142000,4384000,9526000
Plurinationaler Staat Bolivien,2011,7,6454000,2974000,9428000
Plurinationaler Staat Bolivien,2011,8,7663000,5645000,13308000
Plurinationaler Staat Bolivien,2011,9,6846000,21215000,28061000
Plurinationaler Staat Bolivien,2011,10,10089000,5176000,15265000
Plurinationaler Staat Bolivien,2011,11,10904000,17365000,28269000
Plurinationaler Staat Bolivien,2011,12,8794000,3409000,12203000
Plurinationaler Staat Bolivien,2012,1,5390000,10992000,16382000
Plurinationaler Staat Bolivien,2012,2,6333000,2613000,8946000
Plurinationaler Staat Bolivien,2012,3,6262000,2929000,9191000
Plurinationaler Staat Bolivien,2012,4,6286000,1795000,8081000
Plurinationaler Staat Bolivien,2012,5,6831000,24124000,30955000
Plurinationaler Staat Bolivien,2012,6,7864000,3393000,11257000
Plurinationaler Staat Bolivien,2012,7,11500000,3692000,15192000
Plurinationaler Staat Bolivien,2012,8,9907000,9095000,19002000
Plurinationaler Staat Bolivien,2012,9,11700000,4995000,16695000
Plurinationaler Staat Bolivien,2012,10,13045000,13015000,26060000
Plurinationaler Staat Bolivien,2012,11,10298000,4576000,14874000
Plurinationaler Staat Bolivien,2012,12,12513000,2938000,15451000
Plurinationaler Staat Bolivien,2013,1,10711000,19939000,30650000
Plurinationaler Staat Bolivien,2013,2,8146000,3139000,11285000
Plurinationaler Staat Bolivien,2013,3,9794000,2621000,12415000
Plurinationaler Staat Bolivien,2013,4,8554000,16921000,25475000
Plurinationaler Staat Bolivien,2013,5,7910000,3118000,11028000
Plurinationaler Staat Bolivien,2013,6,11971000,14533000,26504000
Plurinationaler Staat Bolivien,2013,7,11497000,4201000,15698000
Plurinationaler Staat Bolivien,2013,8,15308000,17466000,32774000
Plurinationaler Staat Bolivien,2013,9,8345000,3811000,12156000
Plurinationaler Staat Bolivien,2013,10,9835000,7107000,16942000
Plurinationaler Staat Bolivien,2013,11,10216000,5456000,15672000
Plurinationaler Staat Bolivien,2013,12,8393000,4305000,12698000
Plurinationaler Staat Bolivien,2014,1,10138000,16528000,26666000
Plurinationaler Staat Bolivien,2014,2,10302000,5564000,15866000
Plurinationaler Staat Bolivien,2014,3,11349000,4090000,15439000
Plurinationaler Staat Bolivien,2014,4,9407000,15612000,25019000
Plurinationaler Staat Bolivien,2014,5,9091000,5917000,15008000
Plurinationaler Staat Bolivien,2014,6,15068000,17681000,32749000
Plurinationaler Staat Bolivien,2014,7,10405000,7277000,17682000
Plurinationaler Staat Bolivien,2014,8,9607000,5697000,15304000
Plurinationaler Staat Bolivien,2014,9,10675000,8073000,18748000
Plurinationaler Staat Bolivien,2014,10,14158000,7990000,22148000
Plurinationaler Staat Bolivien,2014,11,9576000,6258000,15834000
Plurinationaler Staat Bolivien,2014,12,9981000,6653000,16634000
Plurinationaler Staat Bolivien,2015,1,14555000,6847000,21402000
Plurinationaler Staat Bolivien,2015,2,11713000,5249000,16962000
Plurinationaler Staat Bolivien,2015,3,12374000,17710000,30084000
Plurinationaler Staat Bolivien,2015,4,11131000,3897000,15028000
Plurinationaler Staat Bolivien,2015,5,14156000,5125000,19281000
Plurinationaler Staat Bolivien,2015,6,12218000,7046000,19264000
Plurinationaler Staat Bolivien,2015,7,12389000,6318000,18707000
Plurinationaler Staat Bolivien,2015,8,23842000,22124000,45966000
Plurinationaler Staat Bolivien,2015,9,12782000,7338000,20120000
Plurinationaler Staat Bolivien,2015,10,10433000,8068000,18501000
Plurinationaler Staat Bolivien,2015,11,11745000,7526000,19271000
Plurinationaler Staat Bolivien,2015,12,10582000,21034000,31616000
Plurinationaler Staat Bolivien,2016,1,8734000,8276000,17010000
Plurinationaler Staat Bolivien,2016,2,9641000,16501000,26142000
Plurinationaler Staat Bolivien,2016,3,8402000,4530000,12932000
Plurinationaler Staat Bolivien,2016,4,13766000,3588000,17354000
Plurinationaler Staat Bolivien,2016,5,8023000,21330000,29353000
Plurinationaler Staat Bolivien,2016,6,12044000,23270000,35314000
Plurinationaler Staat Bolivien,2016,7,9557000,8660000,18217000
Plurinationaler Staat Bolivien,2016,8,11432000,7492000,18924000
Plurinationaler Staat Bolivien,2016,9,12539000,7365000,19904000
Plurinationaler Staat Bolivien,2016,10,14275000,23385000,37660000
Plurinationaler Staat Bolivien,2016,11,14729000,9807000,24536000
Plurinationaler Staat Bolivien,2016,12,17174000,7572000,24746000
Plurinationaler Staat Bolivien,2017,1,9163000,6746000,15909000
Plurinationaler Staat Bolivien,2017,2,16198000,21282000,37480000
Plurinationaler Staat Bolivien,2017,3,14498000,6871000,21369000
Plurinationaler Staat Bolivien,2017,4,12566000,21948000,34514000
Plurinationaler Staat Bolivien,2017,5,13093000,19003000,32096000
Plurinationaler Staat Bolivien,2017,6,16311000,11315000,27626000
Plurinationaler Staat Bolivien,2017,7,17771000,25048000,42819000
Plurinationaler Staat Bolivien,2017,8,12444000,7375000,19819000
Plurinationaler Staat Bolivien,2017,9,12994000,10836000,23830000
Plurinationaler Staat Bolivien,2017,10,14682000,17163000,31845000
Plurinationaler Staat Bolivien,2017,11,14272000,8637000,22909000
Plurinationaler Staat Bolivien,2017,12,12616000,4017000,16633000
Plurinationaler Staat Bolivien,2018,1,11505000,5581000,17086000
Plurinationaler Staat Bolivien,2018,2,11692000,3006000,14698000
Plurinationaler Staat Bolivien,2018,3,10228000,27034000,37262000
Plurinationaler Staat Bolivien,2018,4,10334000,16984000,27318000
Plurinationaler Staat Bolivien,2018,5,10399000,10256000,20655000
Plurinationaler Staat Bolivien,2018,6,12682000,12113000,24795000
Plurinationaler Staat Bolivien,2018,7,11053000,5957000,17010000
Plurinationaler Staat Bolivien,2018,8,12403000,17704000,30107000
Plurinationaler Staat Bolivien,2018,9,13507000,19410000,32917000
Plurinationaler Staat Bolivien,2018,10,9250000,18629000,27879000
Plurinationaler Staat Bolivien,2018,11,16528000,7591000,24119000
Plurinationaler Staat Bolivien,2018,12,14305000,11341000,25646000
Plurinationaler Staat Bolivien,2019,1,6985000,20139000,27124000
Plurinationaler Staat Bolivien,2019,2,9264000,7623000,16887000
Plurinationaler Staat Bolivien,2019,3,11172000,9283000,20455000
Plurinationaler Staat Bolivien,2019,4,8623000,18737000,27360000
Plurinationaler Staat Bolivien,2019,5,10011000,22122000,32133000
Plurinationaler Staat Bolivien,2019,6,9847000,8744000,18591000
Plurinationaler Staat Bolivien,2019,7,13945000,9093000,23038000
Plurinationaler Staat Bolivien,2019,8,12082000,21075000,33157000
Plurinationaler Staat Bolivien,2019,9,12681000,10294000,22975000
Plurinationaler Staat Bolivien,2019,10,10728000,23917000,34645000
Plurinationaler Staat Bolivien,2019,11,9157000,9151000,18308000
Plurinationaler Staat Bolivien,2019,12,12070000,8572000,20642000
Plurinationaler Staat Bolivien,2020,1,10213000,11895000,22108000
Plurinationaler Staat Bolivien,2020,2,8246000,22599000,30845000
Plurinationaler Staat Bolivien,2020,3,10169000,10755000,20924000
Plurinationaler Staat Bolivien,2020,4,15783000,8274000,24057000
Plurinationaler Staat Bolivien,2020,5,5872000,7959000,13831000
Plurinationaler Staat Bolivien,2020,6,7258000,8981000,16239000
Plurinationaler Staat Bolivien,2020,7,8954000,9362000,18316000
Plurinationaler Staat Bolivien,2020,8,5647000,25789000,31436000
Plurinationaler Staat Bolivien,2020,9,7512000,7211000,14723000
Plurinationaler Staat Bolivien,2020,10,8365000,17710000,26075000
Plurinationaler Staat Bolivien,2020,11,8413000,8757000,17170000
Plurinationaler Staat Bolivien,2020,12,7881000,15316000,23197000
Plurinationaler Staat Bolivien,2021,1,6492000,11255000,17747000
Plurinationaler Staat Bolivien,2021,2,8132000,28120000,36252000
Plurinationaler Staat Bolivien,2021,3,9735000,9674000,19409000
Plurinationaler Staat Bolivien,2021,4,12758000,10534000,23292000
Plurinationaler Staat Bolivien,2021,5,8431000,7982000,16413000
Plurinationaler Staat Bolivien,2021,6,9716000,27114000,36830000
Plurinationaler Staat Bolivien,2021,7,11755000,12027000,23782000
Plurinationaler Staat Bolivien,2021,8,9769000,28126000,37895000
Plurinationaler Staat Bolivien,2021,9,12366000,11909000,24275000
Plurinationaler Staat Bolivien,2021,10,8942000,11174000,20116000
Plurinationaler Staat Bolivien,2021,11,11431000,7746000,19177000
Plurinationaler Staat Bolivien,2021,12,9951000,5038000,14989000
Plurinationaler Staat Bolivien,2022,1,9146000,11531000,20677000
Plurinationaler Staat Bolivien,2022,2,8223000,7309000,15532000
Plurinationaler Staat Bolivien,2022,3,13103000,9744000,22847000
Plurinationaler Staat Bolivien,2022,4,32371000,4616000,36987000
Plurinationaler Staat Bolivien,2022,5,9474000,6933000,16407000
Plurinationaler Staat Bolivien,2022,6,12424000,13353000,25777000
Plurinationaler Staat Bolivien,2022,7,12996000,10102000,23098000
Plurinationaler Staat Bolivien,2022,8,10919000,9586000,20505000
Plurinationaler Staat Bolivien,2022,9,11872000,27124000,38996000
Plurinationaler Staat Bolivien,2022,10,10191000,11542000,21733000
Plurinationaler Staat Bolivien,2022,11,12285000,9654000,21939000
Plurinationaler Staat Bolivien,2022,12,16347000,14553000,30900000
Plurinationaler Staat Bolivien,2023,1,7740000,8635000,16375000
Plurinationaler Staat Bolivien,2023,2,10348000,9085000,19433000
Plurinationaler Staat Bolivien,2023,3,14600000,26135000,40735000
Plurinationaler Staat Bolivien,2023,4,7557000,11321000,18878000
Plurinationaler Staat Bolivien,2023,5,9893000,7228000,17121000
Plurinationaler Staat Bolivien,2023,6,11521000,5699000,17220000
Plurinationaler Staat Bolivien,2023,7,12714000,5551000,18265000
Plurinationaler Staat Bolivien,2023,8,11034000,5264000,16298000
Plurinationaler Staat Bolivien,2023,9,10493000,8944000,19437000
Plurinationaler Staat Bolivien,2023,10,19274000,38262000,57536000
Plurinationaler Staat Bolivien,2023,11,13130000,9010000,22140000
Plurinationaler Staat Bolivien,2023,12,11500000,6430000,17930000
Plurinationaler Staat Bolivien,2024,1,5652000,10143000,15795000
Plurinationaler Staat Bolivien,2024,2,6026000,6112000,12138000
Plurinationaler Staat Bolivien,2024,3,7736000,12455000,20191000
Plurinationaler Staat Bolivien,2024,4,8611000,28034000,36645000
Plurinationaler Staat Bolivien,2024,5,6708000,13317000,20025000
Plurinationaler Staat Bolivien,2024,6,8719000,11785000,20504000
Plurinationaler Staat Bolivien,2024,7,8660000,19301000,27961000
Plurinationaler Staat Bolivien,2024,8,5706000,18751000,24457000
Plurinationaler Staat Bolivien,2024,9,6621000,26153000,32774000
Plurinationaler Staat Bolivien,2024,10,6117000,20463000,26580000
Plurinationaler Staat Bolivien,2024,11,7297000,16138000,23435000
Plurinationaler Staat Bolivien,2024,12,5798000,10751000,16549000
Polargebiete (bis 2000),2008,1,0,0,0
Polargebiete (bis 2000),2008,2,0,0,0
Polargebiete (bis 2000),2008,3,0,0,0
Polargebiete (bis 2000),2008,4,0,0,0
Polargebiete (bis 2000),2008,5,0,0,0
Polargebiete (bis 2000),2008,6,0,0,0
Polargebiete (bis 2000),2008,7,0,0,0
Polargebiete (bis 2000),2008,8,0,0,0
Polargebiete (bis 2000),2008,9,0,0,0
Polargebiete (bis 2000),2008,10,0,0,0
Polargebiete (bis 2000),2008,11,0,0,0
Polargebiete (bis 2000),2008,12,0,0,0
Polargebiete (bis 2000),2009,1,0,0,0
Polargebiete (bis 2000),2009,2,0,0,0
Polargebiete (bis 2000),2009,3,0,0,0
Polargebiete (bis 2000),2009,4,0,0,0
Polargebiete (bis 2000),2009,5,0,0,0
Polargebiete (bis 2000),2009,6,0,0,0
Polargebiete (bis 2000),2009,7,0,0,0
Polargebiete (bis 2000),2009,8,0,0,0
Polargebiete (bis 2000),2009,9,0,0,0
Polargebiete (bis 2000),2009,10,0,0,0
Polargebiete (bis 2000),2009,11,0,0,0
Polargebiete (bis 2000),2009,12,0,0,0
Polargebiete (bis 2000),2010,1,0,0,0
Polargebiete (bis 2000),2010,2,0,0,0
Polargebiete (bis 2000),2010,3,0,0,0
Polargebiete (bis 2000),2010,4,0,0,0
Polargebiete (bis 2000),2010,5,0,0,0
Polargebiete (bis 2000),2010,6,0,0,0
Polargebiete (bis 2000),2010,7,0,0,0
Polargebiete (bis 2000),2010,8,0,0,0
Polargebiete (bis 2000),2010,9,0,0,0
Polargebiete (bis 2000),2010,10,0,0,0
Polargebiete (bis 2000),2010,11,0,0,0
Polargebiete (bis 2000),2010,12,0,0,0
Polargebiete (bis 2000),2011,1,0,0,0
Polargebiete (bis 2000),2011,2,0,0,0
Polargebiete (bis 2000),2011,3,0,0,0
Polargebiete (bis 2000),2011,4,0,0,0
Polargebiete (bis 2000),2011,5,0,0,0
Polargebiete (bis 2000),2011,6,0,0,0
Polargebiete (bis 2000),2011,7,0,0,0
Polargebiete (bis 2000),2011,8,0,0,0
Polargebiete (bis 2000),2011,9,0,0,0
Polargebiete (bis 2000),2011,10,0,0,0
Polargebiete (bis 2000),2011,11,0,0,0
Polargebiete (bis 2000),2011,12,0,0,0
Polargebiete (bis 2000),2012,1,0,0,0
Polargebiete (bis 2000),2012,2,0,0,0
Polargebiete (bis 2000),2012,3,0,0,0
Polargebiete (bis 2000),2012,4,0,0,0
Polargebiete (bis 2000),2012,5,0,0,0
Polargebiete (bis 2000),2012,6,0,0,0
Polargebiete (bis 2000),2012,7,0,0,0
Polargebiete (bis 2000),2012,8,0,0,0
Polargebiete (bis 2000),2012,9,0,0,0
Polargebiete (bis 2000),2012,10,0,0,0
Polargebiete (bis 2000),2012,11,0,0,0
Polargebiete (bis 2000),2012,12,0,0,0
Polargebiete (bis 2000),2013,1,0,0,0
Polargebiete (bis 2000),2013,2,0,0,0
Polargebiete (bis 2000),2013,3,0,0,0
Polargebiete (bis 2000),2013,4,0,0,0
Polargebiete (bis 2000),2013,5,0,0,0
Polargebiete (bis 2000),2013,6,0,0,0
Polargebiete (bis 2000),2013,7,0,0,0
Polargebiete (bis 2000),2013,8,0,0,0
Polargebiete (bis 2000),2013,9,0,0,0
Polargebiete (bis 2000),2013,10,0,0,0
Polargebiete (bis 2000),2013,11,0,0,0
Polargebiete (bis 2000),2013,12,0,0,0
Polargebiete (bis 2000),2014,1,0,0,0
Polargebiete (bis 2000),2014,2,0,0,0
Polargebiete (bis 2000),2014,3,0,0,0
Polargebiete (bis 2000),2014,4,0,0,0
Polargebiete (bis 2000),2014,5,0,0,0
Polargebiete (bis 2000),2014,6,0,0,0
Polargebiete (bis 2000),2014,7,0,0,0
Polargebiete (bis 2000),2014,8,0,0,0
Polargebiete (bis 2000),2014,9,0,0,0
Polargebiete (bis 2000),2014,10,0,0,0
Polargebiete (bis 2000),2014,11,0,0,0
Polargebiete (bis 2000),2014,12,0,0,0
Polargebiete (bis 2000),2015,1,0,0,0
Polargebiete (bis 2000),2015,2,0,0,0
Polargebiete (bis 2000),2015,3,0,0,0
Polargebiete (bis 2000),2015,4,0,0,0
Polargebiete (bis 2000),2015,5,0,0,0
Polargebiete (bis 2000),2015,6,0,0,0
Polargebiete (bis 2000),2015,7,0,0,0
Polargebiete (bis 2000),2015,8,0,0,0
Polargebiete (bis 2000),2015,9,0,0,0
Polargebiete (bis 2000),2015,10,0,0,0
Polargebiete (bis 2000),2015,11,0,0,0
Polargebiete (bis 2000),2015,12,0,0,0
Polargebiete (bis 2000),2016,1,0,0,0
Polargebiete (bis 2000),2016,2,0,0,0
Polargebiete (bis 2000),2016,3,0,0,0
Polargebiete (bis 2000),2016,4,0,0,0
Polargebiete (bis 2000),2016,5,0,0,0
Polargebiete (bis 2000),2016,6,0,0,0
Polargebiete (bis 2000),2016,7,0,0,0
Polargebiete (bis 2000),2016,8,0,0,0
Polargebiete (bis 2000),2016,9,0,0,0
Polargebiete (bis 2000),2016,10,0,0,0
Polargebiete (bis 2000),2016,11,0,0,0
Polargebiete (bis 2000),2016,12,0,0,0
Polargebiete (bis 2000),2017,1,0,0,0
Polargebiete (bis 2000),2017,2,0,0,0
Polargebiete (bis 2000),2017,3,0,0,0
Polargebiete (bis 2000),2017,4,0,0,0
Polargebiete (bis 2000),2017,5,0,0,0
Polargebiete (bis 2000),2017,6,0,0,0
Polargebiete (bis 2000),2017,7,0,0,0
Polargebiete (bis 2000),2017,8,0,0,0
Polargebiete (bis 2000),2017,9,0,0,0
Polargebiete (bis 2000),2017,10,0,0,0
Polargebiete (bis 2000),2017,11,0,0,0
Polargebiete (bis 2000),2017,12,0,0,0
Polargebiete (bis 2000),2018,1,0,0,0
Polargebiete (bis 2000),2018,2,0,0,0
Polargebiete (bis 2000),2018,3,0,0,0
Polargebiete (bis 2000),2018,4,0,0,0
Polargebiete (bis 2000),2018,5,0,0,0
Polargebiete (bis 2000),2018,6,0,0,0
Polargebiete (bis 2000),2018,7,0,0,0
Polargebiete (bis 2000),2018,8,0,0,0
Polargebiete (bis 2000),2018,9,0,0,0
Polargebiete (bis 2000),2018,10,0,0,0
Polargebiete (bis 2000),2018,11,0,0,0
Polargebiete (bis 2000),2018,12,0,0,0
Polargebiete (bis 2000),2019,1,0,0,0
Polargebiete (bis 2000),2019,2,0,0,0
Polargebiete (bis 2000),2019,3,0,0,0
Polargebiete (bis 2000),2019,4,0,0,0
Polargebiete (bis 2000),2019,5,0,0,0
Polargebiete (bis 2000),2019,6,0,0,0
Polargebiete (bis 2000),2019,7,0,0,0
Polargebiete (bis 2000),2019,8,0,0,0
Polargebiete (bis 2000),2019,9,0,0,0
Polargebiete (bis 2000),2019,10,0,0,0
Polargebiete (bis 2000),2019,11,0,0,0
Polargebiete (bis 2000),2019,12,0,0,0
Polargebiete (bis 2000),2020,1,0,0,0
Polargebiete (bis 2000),2020,2,0,0,0
Polargebiete (bis 2000),2020,3,0,0,0
Polargebiete (bis 2000),2020,4,0,0,0
Polargebiete (bis 2000),2020,5,0,0,0
Polargebiete (bis 2000),2020,6,0,0,0
Polargebiete (bis 2000),2020,7,0,0,0
Polargebiete (bis 2000),2020,8,0,0,0
Polargebiete (bis 2000),2020,9,0,0,0
Polargebiete (bis 2000),2020,10,0,0,0
Polargebiete (bis 2000),2020,11,0,0,0
Polargebiete (bis 2000),2020,12,0,0,0
Polargebiete (bis 2000),2021,1,0,0,0
Polargebiete (bis 2000),2021,2,0,0,0
Polargebiete (bis 2000),2021,3,0,0,0
Polargebiete (bis 2000),2021,4,0,0,0
Polargebiete (bis 2000),2021,5,0,0,0
Polargebiete (bis 2000),2021,6,0,0,0
Polargebiete (bis 2000),2021,7,0,0,0
Polargebiete (bis 2000),2021,8,0,0,0
Polargebiete (bis 2000),2021,9,0,0,0
Polargebiete (bis 2000),2021,10,0,0,0
Polargebiete (bis 2000),2021,11,0,0,0
Polargebiete (bis 2000),2021,12,0,0,0
Polargebiete (bis 2000),2022,1,0,0,0
Polargebiete (bis 2000),2022,2,0,0,0
Polargebiete (bis 2000),2022,3,0,0,0
Polargebiete (bis 2000),2022,4,0,0,0
Polargebiete (bis 2000),2022,5,0,0,0
Polargebiete (bis 2000),2022,6,0,0,0
Polargebiete (bis 2000),2022,7,0,0,0
Polargebiete (bis 2000),2022,8,0,0,0
Polargebiete (bis 2000),2022,9,0,0,0
Polargebiete (bis 2000),2022,10,0,0,0
Polargebiete (bis 2000),2022,11,0,0,0
Polargebiete (bis 2000),2022,12,0,0,0
Polargebiete (bis 2000),2023,1,0,0,0
Polargebiete (bis 2000),2023,2,0,0,0
Polargebiete (bis 2000),2023,3,0,0,0
Polargebiete (bis 2000),2023,4,0,0,0
Polargebiete (bis 2000),2023,5,0,0,0
Polargebiete (bis 2000),2023,6,0,0,0
Polargebiete (bis 2000),2023,7,0,0,0
Polargebiete (bis 2000),2023,8,0,0,0
Polargebiete (bis 2000),2023,9,0,0,0
Polargebiete (bis 2000),2023,10,0,0,0
Polargebiete (bis 2000),2023,11,0,0,0
Polargebiete (bis 2000),2023,12,0,0,0
Polargebiete (bis 2000),2024,1,0,0,0
Polargebiete (bis 2000),2024,2,0,0,0
Polargebiete (bis 2000),2024,3,0,0,0
Polargebiete (bis 2000),2024,4,0,0,0
Polargebiete (bis 2000),2024,5,0,0,0
Polargebiete (bis 2000),2024,6,0,0,0
Polargebiete (bis 2000),2024,7,0,0,0
Polargebiete (bis 2000),2024,8,0,0,0
Polargebiete (bis 2000),2024,9,0,0,0
Polargebiete (bis 2000),2024,10,0,0,0
Polargebiete (bis 2000),2024,11,0,0,0
Polargebiete (bis 2000),2024,12,0,0,0
Polen,2008,1,3344249000,2108013000,5452262000
Polen,2008,2,3332194000,2106438000,5438632000
Polen,2008,3,3469134000,2158395000,5627529000
Polen,2008,4,3664881000,2261860000,5926741000
Polen,2008,5,3390330000,2131764000,5522094000
Polen,2008,6,3516262000,2277495000,5793757000
Polen,2008,7,3536930000,2233668000,5770598000
Polen,2008,8,3390053000,2116445000,5506498000
Polen,2008,9,3720999000,2325449000,6046448000
Polen,2008,10,3752466000,2471939000,6224405000
Polen,2008,11,3100599000,2012994000,5113593000
Polen,2008,12,2532252000,1670359000,4202611000
Polen,2009,1,2471451000,1726129000,4197580000
Polen,2009,2,2435332000,1705488000,4140820000
Polen,2009,3,2699891000,1956798000,4656689000
Polen,2009,4,2549478000,1831499000,4380977000
Polen,2009,5,2455114000,1718487000,4173601000
Polen,2009,6,2413047000,1755578000,4168625000
Polen,2009,7,2586904000,1695438000,4282342000
Polen,2009,8,2487217000,1859131000,4346348000
Polen,2009,9,2963093000,2017309000,4980402000
Polen,2009,10,2928443000,2093060000,5021503000
Polen,2009,11,2713993000,1907354000,4621347000
Polen,2009,12,2417824000,1894668000,4312492000
Polen,2010,1,2482953000,1900233000,4383186000
Polen,2010,2,2621121000,2018450000,4639571000
Polen,2010,3,3311824000,2416632000,5728456000
Polen,2010,4,2936042000,2042601000,4978643000
Polen,2010,5,3053853000,2363714000,5417567000
Polen,2010,6,3378097000,2413348000,5791445000
Polen,2010,7,3085354000,2147421000,5232775000
Polen,2010,8,3212292000,2252992000,5465284000
Polen,2010,9,3460182000,2562010000,6022192000
Polen,2010,10,3649889000,2629031000,6278920000
Polen,2010,11,3399041000,2441284000,5840325000
Polen,2010,12,3074890000,2449231000,5524121000
Polen,2011,1,3293660000,2366724000,5660384000
Polen,2011,2,3458014000,2618209000,6076223000
Polen,2011,3,4002346000,2838109000,6840455000
Polen,2011,4,3594182000,2642561000,6236743000
Polen,2011,5,3812184000,2710477000,6522661000
Polen,2011,6,3679805000,2745779000,6425584000
Polen,2011,7,3538529000,2587386000,6125915000
Polen,2011,8,3638322000,2659854000,6298176000
Polen,2011,9,3929807000,2938709000,6868516000
Polen,2011,10,3736399000,2831815000,6568214000
Polen,2011,11,3671913000,2758633000,6430546000
Polen,2011,12,3147530000,2607100000,5754630000
Polen,2012,1,3380282000,2518393000,5898675000
Polen,2012,2,3469323000,2729750000,6199073000
Polen,2012,3,3646959000,2922071000,6569030000
Polen,2012,4,3371074000,2535771000,5906845000
Polen,2012,5,3600637000,2816804000,6417441000
Polen,2012,6,3420054000,2817863000,6237917000
Polen,2012,7,3471421000,2706424000,6177845000
Polen,2012,8,3549411000,2703591000,6253002000
Polen,2012,9,3464548000,2743817000,6208365000
Polen,2012,10,3965156000,3290220000,7255376000
Polen,2012,11,3537798000,2778048000,6315846000
Polen,2012,12,2946537000,2464520000,5411057000
Polen,2013,1,3414842000,2779031000,6193873000
Polen,2013,2,3253784000,2791662000,6045446000
Polen,2013,3,3606997000,2951584000,6558581000
Polen,2013,4,3481693000,2990549000,6472242000
Polen,2013,5,3434909000,2926869000,6361778000
Polen,2013,6,3635514000,3017896000,6653410000
Polen,2013,7,3515381000,2932874000,6448255000
Polen,2013,8,3525361000,2940533000,6465894000
Polen,2013,9,3782309000,3234484000,7016793000
Polen,2013,10,4116464000,3484246000,7600710000
Polen,2013,11,3654132000,3150275000,6804407000
Polen,2013,12,3051235000,2813021000,5864256000
Polen,2014,1,3676613000,3032331000,6708944000
Polen,2014,2,3695146000,3226853000,6921999000
Polen,2014,3,3940718000,3286568000,7227286000
Polen,2014,4,3828742000,3322230000,7150972000
Polen,2014,5,3736946000,3152807000,6889753000
Polen,2014,6,3980303000,3170331000,7150634000
Polen,2014,7,4221177000,3327069000,7548246000
Polen,2014,8,3653516000,2921570000,6575086000
Polen,2014,9,4380064000,3500966000,7881030000
Polen,2014,10,4543187000,3815501000,8358688000
Polen,2014,11,4208330000,3514249000,7722579000
Polen,2014,12,3826834000,3377626000,7204460000
Polen,2015,1,3858236000,3300564000,7158800000
Polen,2015,2,4131042000,3682489000,7813531000
Polen,2015,3,4561913000,3824594000,8386507000
Polen,2015,4,4241460000,3541669000,7783129000
Polen,2015,5,4219521000,3640387000,7859908000
Polen,2015,6,4446547000,3690885000,8137432000
Polen,2015,7,4560165000,3798471000,8358636000
Polen,2015,8,3953324000,3370732000,7324056000
Polen,2015,9,4718421000,4084826000,8803247000
Polen,2015,10,4799143000,4018962000,8818105000
Polen,2015,11,4635343000,4084796000,8720139000
Polen,2015,12,4037685000,3669989000,7707674000
Polen,2016,1,4129231000,3473156000,7602387000
Polen,2016,2,4386475000,3902574000,8289049000
Polen,2016,3,4838003000,3965198000,8803201000
Polen,2016,4,4631028000,3920651000,8551679000
Polen,2016,5,4406987000,3674567000,8081554000
Polen,2016,6,4693328000,3885773000,8579101000
Polen,2016,7,4405436000,3712846000,8118282000
Polen,2016,8,4428504000,3765029000,8193533000
Polen,2016,9,4874983000,4183879000,9058862000
Polen,2016,10,4686682000,3987492000,8674174000
Polen,2016,11,4876056000,4143031000,9019087000
Polen,2016,12,4225020000,3879278000,8104298000
Polen,2017,1,4460787000,3965548000,8426335000
Polen,2017,2,4649460000,3964847000,8614307000
Polen,2017,3,5134362000,4357276000,9491638000
Polen,2017,4,4727365000,4093056000,8820421000
Polen,2017,5,4889959000,4136085000,9026044000
Polen,2017,6,4965031000,4055683000,9020714000
Polen,2017,7,4683285000,4069703000,8752988000
Polen,2017,8,4956362000,4094345000,9050707000
Polen,2017,9,5215284000,4373024000,9588308000
Polen,2017,10,5316259000,4488768000,9805027000
Polen,2017,11,5409816000,4759698000,10169514000
Polen,2017,12,4595818000,4175357000,8771175000
Polen,2018,1,5179527000,4378629000,9558156000
Polen,2018,2,4936810000,4359484000,9296294000
Polen,2018,3,5267421000,4582489000,9849910000
Polen,2018,4,5102824000,4520480000,9623304000
Polen,2018,5,5051418000,4296399000,9347817000
Polen,2018,6,5410703000,4673112000,10083815000
Polen,2018,7,5296065000,4629797000,9925862000
Polen,2018,8,5398526000,4541555000,9940081000
Polen,2018,9,5422310000,4658241000,10080551000
Polen,2018,10,6044777000,5093401000,11138178000
Polen,2018,11,5694508000,5083225000,10777733000
Polen,2018,12,4553016000,4274621000,8827637000
Polen,2019,1,5225132000,4650042000,9875174000
Polen,2019,2,5128763000,4748836000,9877599000
Polen,2019,3,5624387000,5073653000,10698040000
Polen,2019,4,5255897000,4688092000,9943989000
Polen,2019,5,5606637000,4712244000,10318881000
Polen,2019,6,5432868000,4680183000,10113051000
Polen,2019,7,5442499000,4712225000,10154724000
Polen,2019,8,5411764000,4391922000,9803686000
Polen,2019,9,5822729000,5060905000,10883634000
Polen,2019,10,6088027000,5271399000,11359426000
Polen,2019,11,6023877000,5225887000,11249764000
Polen,2019,12,4774466000,4400097000,9174563000
Polen,2020,1,5726267000,4865272000,10591539000
Polen,2020,2,5706196000,4878013000,10584209000
Polen,2020,3,5711966000,4819422000,10531388000
Polen,2020,4,3942932000,3586393000,7529325000
Polen,2020,5,4131371000,4007494000,8138865000
Polen,2020,6,4936095000,4595086000,9531181000
Polen,2020,7,5366041000,4869546000,10235587000
Polen,2020,8,5421002000,4685718000,10106720000
Polen,2020,9,5952377000,5344658000,11297035000
Polen,2020,10,6357173000,5574751000,11931924000
Polen,2020,11,6270569000,5960513000,12231082000
Polen,2020,12,5485678000,5294235000,10779913000
Polen,2021,1,5722941000,5095178000,10818119000
Polen,2021,2,6191709000,5468167000,11659876000
Polen,2021,3,7104130000,6197541000,13301671000
Polen,2021,4,6287249000,5425066000,11712315000
Polen,2021,5,6383259000,5614516000,11997775000
Polen,2021,6,6663180000,5811546000,12474726000
Polen,2021,7,6393835000,5474077000,11867912000
Polen,2021,8,6162596000,5362547000,11525143000
Polen,2021,9,6693545000,5884125000,12577670000
Polen,2021,10,7071207000,6149916000,13221123000
Polen,2021,11,7083305000,6488302000,13571607000
Polen,2021,12,6821410000,6077099000,12898509000
Polen,2022,1,6973340000,5600254000,12573594000
Polen,2022,2,7318637000,6081652000,13400289000
Polen,2022,3,8361768000,6847930000,15209698000
Polen,2022,4,7129842000,6138787000,13268629000
Polen,2022,5,7958532000,6644660000,14603192000
Polen,2022,6,8047581000,6492603000,14540184000
Polen,2022,7,7489722000,6280862000,13770584000
Polen,2022,8,7804934000,6409307000,14214241000
Polen,2022,9,8511611000,7136851000,15648462000
Polen,2022,10,7961754000,7012222000,14973976000
Polen,2022,11,8195619000,7406626000,15602245000
Polen,2022,12,6874427000,6332945000,13207372000
Polen,2023,1,7475261000,6530335000,14005596000
Polen,2023,2,7424467000,6983965000,14408432000
Polen,2023,3,8494864000,7768742000,16263606000
Polen,2023,4,6905658000,6325361000,13231019000
Polen,2023,5,7446768000,7084051000,14530819000
Polen,2023,6,7933862000,7006860000,14940722000
Polen,2023,7,7244095000,6437347000,13681442000
Polen,2023,8,7531065000,6351830000,13882895000
Polen,2023,9,7680230000,6583887000,14264117000
Polen,2023,10,7859358000,6805809000,14665167000
Polen,2023,11,8259952000,7259562000,15519514000
Polen,2023,12,6389293000,5696868000,12086161000
Polen,2024,1,8018674000,6574851000,14593525000
Polen,2024,2,7981641000,6517366000,14499007000
Polen,2024,3,8163602000,6715254000,14878856000
Polen,2024,4,7906579000,7005171000,14911750000
Polen,2024,5,7729310000,6151049000,13880359000
Polen,2024,6,7585563000,6208295000,13793858000
Polen,2024,7,7628197000,6394501000,14022698000
Polen,2024,8,7658075000,6117946000,13776021000
Polen,2024,9,7881411000,6769229000,14650640000
Polen,2024,10,8288786000,7112458000,15401244000
Polen,2024,11,8179211000,6718945000,14898156000
Polen,2024,12,6931832000,5823678000,12755510000
Portugal,2008,1,683520000,368127000,1051647000
Portugal,2008,2,685889000,364008000,1049897000
Portugal,2008,3,621145000,401493000,1022638000
Portugal,2008,4,815013000,359291000,1174304000
Portugal,2008,5,655100000,338068000,993168000
Portugal,2008,6,679748000,321402000,1001150000
Portugal,2008,7,710741000,371239000,1081980000
Portugal,2008,8,611202000,298740000,909942000
Portugal,2008,9,735822000,340580000,1076402000
Portugal,2008,10,704438000,350202000,1054640000
Portugal,2008,11,692982000,311117000,1004099000
Portugal,2008,12,537371000,238253000,775624000
Portugal,2009,1,525393000,254599000,779992000
Portugal,2009,2,505246000,269682000,774928000
Portugal,2009,3,562067000,317482000,879549000
Portugal,2009,4,511370000,304135000,815505000
Portugal,2009,5,492781000,272342000,765123000
Portugal,2009,6,482546000,292953000,775499000
Portugal,2009,7,497935000,305670000,803605000
Portugal,2009,8,437404000,248466000,685870000
Portugal,2009,9,582642000,292787000,875429000
Portugal,2009,10,567385000,315752000,883137000
Portugal,2009,11,545087000,298134000,843221000
Portugal,2009,12,485328000,291189000,776517000
Portugal,2010,1,500552000,296703000,797255000
Portugal,2010,2,528693000,282359000,811052000
Portugal,2010,3,647185000,387056000,1034241000
Portugal,2010,4,525119000,327746000,852865000
Portugal,2010,5,577439000,355779000,933218000
Portugal,2010,6,1072253000,334950000,1407203000
Portugal,2010,7,672341000,361650000,1033991000
Portugal,2010,8,484160000,310082000,794242000
Portugal,2010,9,623214000,334493000,957707000
Portugal,2010,10,613087000,364096000,977183000
Portugal,2010,11,642252000,359350000,1001602000
Portugal,2010,12,882223000,307554000,1189777000
Portugal,2011,1,606815000,362771000,969586000
Portugal,2011,2,631414000,370885000,1002299000
Portugal,2011,3,699446000,431816000,1131262000
Portugal,2011,4,602073000,380529000,982602000
Portugal,2011,5,664079000,428357000,1092436000
Portugal,2011,6,583244000,395162000,978406000
Portugal,2011,7,552290000,404946000,957236000
Portugal,2011,8,514858000,352546000,867404000
Portugal,2011,9,582318000,397567000,979885000
Portugal,2011,10,564640000,409918000,974558000
Portugal,2011,11,580010000,415530000,995540000
Portugal,2011,12,444510000,356754000,801264000
Portugal,2012,1,545521000,384604000,930125000
Portugal,2012,2,529724000,402016000,931740000
Portugal,2012,3,594818000,458295000,1053113000
Portugal,2012,4,486513000,364867000,851380000
Portugal,2012,5,541288000,417861000,959149000
Portugal,2012,6,518311000,420499000,938810000
Portugal,2012,7,480647000,455416000,936063000
Portugal,2012,8,468106000,377567000,845673000
Portugal,2012,9,491204000,392987000,884191000
Portugal,2012,10,563495000,440658000,1004153000
Portugal,2012,11,545248000,425727000,970975000
Portugal,2012,12,389043000,334880000,723923000
Portugal,2013,1,532030000,397466000,929496000
Portugal,2013,2,485038000,414935000,899973000
Portugal,2013,3,553253000,421948000,975201000
Portugal,2013,4,518936000,420129000,939065000
Portugal,2013,5,546669000,425462000,972131000
Portugal,2013,6,593148000,445964000,1039112000
Portugal,2013,7,533449000,453620000,987069000
Portugal,2013,8,432022000,387993000,820015000
Portugal,2013,9,536818000,419743000,956561000
Portugal,2013,10,571000000,479156000,1050156000
Portugal,2013,11,579054000,478211000,1057265000
Portugal,2013,12,482750000,362374000,845124000
Portugal,2014,1,591590000,402301000,993891000
Portugal,2014,2,586597000,435187000,1021784000
Portugal,2014,3,591001000,469171000,1060172000
Portugal,2014,4,595692000,411506000,1007198000
Portugal,2014,5,601823000,440176000,1041999000
Portugal,2014,6,609264000,475838000,1085102000
Portugal,2014,7,597614000,500436000,1098050000
Portugal,2014,8,482862000,339037000,821899000
Portugal,2014,9,606886000,440190000,1047076000
Portugal,2014,10,668430000,495419000,1163849000
Portugal,2014,11,633585000,427668000,1061253000
Portugal,2014,12,528234000,368705000,896939000
Portugal,2015,1,610777000,405105000,1015882000
Portugal,2015,2,615682000,455351000,1071033000
Portugal,2015,3,661680000,474061000,1135741000
Portugal,2015,4,663603000,485920000,1149523000
Portugal,2015,5,665350000,450549000,1115899000
Portugal,2015,6,677547000,459240000,1136787000
Portugal,2015,7,659755000,538800000,1198555000
Portugal,2015,8,486807000,393083000,879890000
Portugal,2015,9,649558000,513308000,1162866000
Portugal,2015,10,676389000,492154000,1168543000
Portugal,2015,11,657482000,479683000,1137165000
Portugal,2015,12,507591000,377934000,885525000
Portugal,2016,1,569155000,419520000,988675000
Portugal,2016,2,674377000,479949000,1154326000
Portugal,2016,3,692592000,467351000,1159943000
Portugal,2016,4,677241000,487928000,1165169000
Portugal,2016,5,694536000,454409000,1148945000
Portugal,2016,6,705350000,541749000,1247099000
Portugal,2016,7,639151000,497293000,1136444000
Portugal,2016,8,556891000,452912000,1009803000
Portugal,2016,9,711640000,501254000,1212894000
Portugal,2016,10,678314000,478434000,1156748000
Portugal,2016,11,726075000,504875000,1230950000
Portugal,2016,12,625229000,416081000,1041310000
Portugal,2017,1,698652000,476138000,1174790000
Portugal,2017,2,709531000,478788000,1188319000
Portugal,2017,3,785447000,544618000,1330065000
Portugal,2017,4,729180000,508972000,1238152000
Portugal,2017,5,771447000,526330000,1297777000
Portugal,2017,6,737612000,508695000,1246307000
Portugal,2017,7,734388000,522156000,1256544000
Portugal,2017,8,689998000,496269000,1186267000
Portugal,2017,9,749205000,554844000,1304049000
Portugal,2017,10,774343000,565757000,1340100000
Portugal,2017,11,838483000,614930000,1453413000
Portugal,2017,12,749282000,444895000,1194177000
Portugal,2018,1,831892000,535824000,1367716000
Portugal,2018,2,783063000,530236000,1313299000
Portugal,2018,3,902159000,559829000,1461988000
Portugal,2018,4,812265000,570150000,1382415000
Portugal,2018,5,829759000,554891000,1384650000
Portugal,2018,6,910442000,559075000,1469517000
Portugal,2018,7,826034000,660301000,1486335000
Portugal,2018,8,746098000,480719000,1226817000
Portugal,2018,9,799112000,594397000,1393509000
Portugal,2018,10,877159000,639821000,1516980000
Portugal,2018,11,915713000,624109000,1539822000
Portugal,2018,12,803651000,463112000,1266763000
Portugal,2019,1,955235000,610710000,1565945000
Portugal,2019,2,847375000,642227000,1489602000
Portugal,2019,3,907536000,632644000,1540180000
Portugal,2019,4,997688000,607229000,1604917000
Portugal,2019,5,888306000,657889000,1546195000
Portugal,2019,6,896287000,644455000,1540742000
Portugal,2019,7,844929000,634102000,1479031000
Portugal,2019,8,693701000,510276000,1203977000
Portugal,2019,9,916474000,672022000,1588496000
Portugal,2019,10,914238000,639948000,1554186000
Portugal,2019,11,1086097000,625343000,1711440000
Portugal,2019,12,722026000,520714000,1242740000
Portugal,2020,1,958721000,590248000,1548969000
Portugal,2020,2,846908000,605537000,1452445000
Portugal,2020,3,785352000,558078000,1343430000
Portugal,2020,4,416059000,328321000,744380000
Portugal,2020,5,543723000,442972000,986695000
Portugal,2020,6,640388000,544848000,1185236000
Portugal,2020,7,832776000,559698000,1392474000
Portugal,2020,8,641218000,507987000,1149205000
Portugal,2020,9,845553000,616729000,1462282000
Portugal,2020,10,930533000,641348000,1571881000
Portugal,2020,11,833403000,574674000,1408077000
Portugal,2020,12,622030000,475672000,1097702000
Portugal,2021,1,813652000,516105000,1329757000
Portugal,2021,2,804791000,523277000,1328068000
Portugal,2021,3,974337000,621630000,1595967000
Portugal,2021,4,839710000,575212000,1414922000
Portugal,2021,5,807539000,599753000,1407292000
Portugal,2021,6,838635000,597630000,1436265000
Portugal,2021,7,918324000,668541000,1586865000
Portugal,2021,8,667262000,459348000,1126610000
Portugal,2021,9,804945000,620883000,1425828000
Portugal,2021,10,897980000,622834000,1520814000
Portugal,2021,11,908409000,703563000,1611972000
Portugal,2021,12,781550000,582200000,1363750000
Portugal,2022,1,884548000,592991000,1477539000
Portugal,2022,2,898170000,639192000,1537362000
Portugal,2022,3,1037093000,760122000,1797215000
Portugal,2022,4,935223000,690303000,1625526000
Portugal,2022,5,985413000,772887000,1758300000
Portugal,2022,6,938647000,789419000,1728066000
Portugal,2022,7,939908000,646600000,1586508000
Portugal,2022,8,813572000,716816000,1530388000
Portugal,2022,9,1069318000,734559000,1803877000
Portugal,2022,10,983169000,710047000,1693216000
Portugal,2022,11,1120689000,750872000,1871561000
Portugal,2022,12,977730000,598685000,1576415000
Portugal,2023,1,1010409000,627112000,1637521000
Portugal,2023,2,1072280000,659159000,1731439000
Portugal,2023,3,1160151000,798002000,1958153000
Portugal,2023,4,945716000,631116000,1576832000
Portugal,2023,5,1049136000,719222000,1768358000
Portugal,2023,6,1089813000,729780000,1819593000
Portugal,2023,7,907316000,732066000,1639382000
Portugal,2023,8,976532000,581142000,1557674000
Portugal,2023,9,996672000,629091000,1625763000
Portugal,2023,10,1002231000,666591000,1668822000
Portugal,2023,11,1063879000,701377000,1765256000
Portugal,2023,12,814620000,509594000,1324214000
Portugal,2024,1,1066990000,716601000,1783591000
Portugal,2024,2,1085533000,741868000,1827401000
Portugal,2024,3,1076646000,785308000,1861954000
Portugal,2024,4,1053230000,816409000,1869639000
Portugal,2024,5,1002121000,749271000,1751392000
Portugal,2024,6,966958000,727570000,1694528000
Portugal,2024,7,967853000,755566000,1723419000
Portugal,2024,8,914316000,658852000,1573168000
Portugal,2024,9,1083612000,746279000,1829891000
Portugal,2024,10,1030496000,806914000,1837410000
Portugal,2024,11,1002661000,848754000,1851415000
Portugal,2024,12,857131000,625494000,1482625000
Republik Korea,2008,1,812786000,738508000,1551294000
Republik Korea,2008,2,763326000,740366000,1503692000
Republik Korea,2008,3,764328000,1123390000,1887718000
Republik Korea,2008,4,793814000,621972000,1415786000
Republik Korea,2008,5,646769000,861309000,1508078000
Republik Korea,2008,6,740375000,614868000,1355243000
Republik Korea,2008,7,974851000,601335000,1576186000
Republik Korea,2008,8,643208000,834637000,1477845000
Republik Korea,2008,9,756839000,603852000,1360691000
Republik Korea,2008,10,713918000,638737000,1352655000
Republik Korea,2008,11,621232000,731632000,1352864000
Republik Korea,2008,12,580929000,1069425000,1650354000
Republik Korea,2009,1,531992000,561477000,1093469000
Republik Korea,2009,2,528780000,768870000,1297650000
Republik Korea,2009,3,565981000,588688000,1154669000
Republik Korea,2009,4,573419000,707452000,1280871000
Republik Korea,2009,5,538067000,488747000,1026814000
Republik Korea,2009,6,718261000,572420000,1290681000
Republik Korea,2009,7,827771000,714692000,1542463000
Republik Korea,2009,8,627299000,687614000,1314913000
Republik Korea,2009,9,708305000,993123000,1701428000
Republik Korea,2009,10,703114000,632414000,1335528000
Republik Korea,2009,11,782550000,611428000,1393978000
Republik Korea,2009,12,867609000,474884000,1342493000
Republik Korea,2010,1,651576000,836678000,1488254000
Republik Korea,2010,2,710457000,600200000,1310657000
Republik Korea,2010,3,880181000,1140271000,2020452000
Republik Korea,2010,4,780189000,967082000,1747271000
Republik Korea,2010,5,782236000,1012477000,1794713000
Republik Korea,2010,6,889710000,1215548000,2105258000
Republik Korea,2010,7,1038614000,1102443000,2141057000
Republik Korea,2010,8,869120000,970334000,1839454000
Republik Korea,2010,9,870582000,814091000,1684673000
Republik Korea,2010,10,889914000,705992000,1595906000
Republik Korea,2010,11,943426000,1307092000,2250518000
Republik Korea,2010,12,952995000,598359000,1551354000
Republik Korea,2011,1,805358000,1040873000,1846231000
Republik Korea,2011,2,969636000,981877000,1951513000
Republik Korea,2011,3,1047223000,665650000,1712873000
Republik Korea,2011,4,966699000,826796000,1793495000
Republik Korea,2011,5,1066885000,868815000,1935700000
Republik Korea,2011,6,870656000,648126000,1518782000
Republik Korea,2011,7,957629000,1047470000,2005099000
Republik Korea,2011,8,981238000,641264000,1622502000
Republik Korea,2011,9,1016129000,789534000,1805663000
Republik Korea,2011,10,913790000,640820000,1554610000
Republik Korea,2011,11,1053852000,830886000,1884738000
Republik Korea,2011,12,1049119000,640565000,1689684000
Republik Korea,2012,1,914828000,799868000,1714696000
Republik Korea,2012,2,1158697000,959674000,2118371000
Republik Korea,2012,3,1231508000,638467000,1869975000
Republik Korea,2012,4,992139000,653259000,1645398000
Republik Korea,2012,5,1016583000,759361000,1775944000
Republik Korea,2012,6,1124719000,672243000,1796962000
Republik Korea,2012,7,1162984000,568359000,1731343000
Republik Korea,2012,8,1139681000,799726000,1939407000
Republik Korea,2012,9,1120185000,603968000,1724153000
Republik Korea,2012,10,1193059000,818381000,2011440000
Republik Korea,2012,11,1254740000,730093000,1984833000
Republik Korea,2012,12,1089899000,453655000,1543554000
Republik Korea,2013,1,1066144000,967174000,2033318000
Republik Korea,2013,2,1084364000,448396000,1532760000
Republik Korea,2013,3,1267004000,631895000,1898899000
Republik Korea,2013,4,1225430000,766306000,1991736000
Republik Korea,2013,5,1174228000,737142000,1911370000
Republik Korea,2013,6,1204866000,651649000,1856515000
Republik Korea,2013,7,1330932000,740579000,2071511000
Republik Korea,2013,8,1113095000,633440000,1746535000
Republik Korea,2013,9,1317393000,669880000,1987273000
Republik Korea,2013,10,1153338000,598219000,1751557000
Republik Korea,2013,11,1220172000,649119000,1869291000
Republik Korea,2013,12,1290305000,554504000,1844809000
Republik Korea,2014,1,1161634000,654767000,1816401000
Republik Korea,2014,2,1147144000,567266000,1714410000
Republik Korea,2014,3,1222808000,820245000,2043053000
Republik Korea,2014,4,1235981000,683329000,1919310000
Republik Korea,2014,5,1173432000,806208000,1979640000
Republik Korea,2014,6,1290886000,562385000,1853271000
Republik Korea,2014,7,1452111000,637277000,2089388000
Republik Korea,2014,8,1141512000,602853000,1744365000
Republik Korea,2014,9,1390496000,783272000,2173768000
Republik Korea,2014,10,1588277000,695045000,2283322000
Republik Korea,2014,11,1309482000,589601000,1899083000
Republik Korea,2014,12,1501853000,611083000,2112936000
Republik Korea,2015,1,1235209000,619246000,1854455000
Republik Korea,2015,2,1425824000,520946000,1946770000
Republik Korea,2015,3,1617061000,689773000,2306834000
Republik Korea,2015,4,1421664000,601556000,2023220000
Republik Korea,2015,5,1320840000,611710000,1932550000
Republik Korea,2015,6,1583997000,664347000,2248344000
Republik Korea,2015,7,1642783000,634257000,2277040000
Republik Korea,2015,8,1325453000,673635000,1999088000
Republik Korea,2015,9,1560968000,732852000,2293820000
Republik Korea,2015,10,1699373000,760338000,2459711000
Republik Korea,2015,11,1537414000,643734000,2181148000
Republik Korea,2015,12,1504697000,530788000,2035485000
Republik Korea,2016,1,1151801000,613328000,1765129000
Republik Korea,2016,2,1315289000,608084000,1923373000
Republik Korea,2016,3,1455830000,608531000,2064361000
Republik Korea,2016,4,1505621000,611343000,2116964000
Republik Korea,2016,5,1361513000,669913000,2031426000
Republik Korea,2016,6,1569057000,625283000,2194340000
Republik Korea,2016,7,1362948000,635387000,1998335000
Republik Korea,2016,8,1454473000,636372000,2090845000
Republik Korea,2016,9,1347251000,577674000,1924925000
Republik Korea,2016,10,1580090000,632335000,2212425000
Republik Korea,2016,11,1386133000,750750000,2136883000
Republik Korea,2016,12,1741659000,782083000,2523742000
Republik Korea,2017,1,1261730000,832627000,2094357000
Republik Korea,2017,2,1326648000,887151000,2213799000
Republik Korea,2017,3,1584980000,861122000,2446102000
Republik Korea,2017,4,1411302000,1229181000,2640483000
Republik Korea,2017,5,1567065000,922611000,2489676000
Republik Korea,2017,6,1451886000,1005503000,2457389000
Republik Korea,2017,7,1456756000,944981000,2401737000
Republik Korea,2017,8,1473042000,946541000,2419583000
Republik Korea,2017,9,1401294000,1037675000,2438969000
Republik Korea,2017,10,1510608000,1191966000,2702574000
Republik Korea,2017,11,1619846000,740655000,2360501000
Republik Korea,2017,12,1396050000,761422000,2157472000
Republik Korea,2018,1,1520788000,883072000,2403860000
Republik Korea,2018,2,1387080000,766054000,2153134000
Republik Korea,2018,3,1543657000,812774000,2356431000
Republik Korea,2018,4,1560818000,1021340000,2582158000
Republik Korea,2018,5,1379424000,1024565000,2403989000
Republik Korea,2018,6,1420405000,1108298000,2528703000
Republik Korea,2018,7,1374863000,1040439000,2415302000
Republik Korea,2018,8,1515240000,1132227000,2647467000
Republik Korea,2018,9,1414650000,1012819000,2427469000
Republik Korea,2018,10,1496736000,1220788000,2717524000
Republik Korea,2018,11,1462917000,1009804000,2472721000
Republik Korea,2018,12,1183049000,1123527000,2306576000
Republik Korea,2019,1,1387586000,958361000,2345947000
Republik Korea,2019,2,1343704000,1000572000,2344276000
Republik Korea,2019,3,1386116000,1029398000,2415514000
Republik Korea,2019,4,1466048000,1148671000,2614719000
Republik Korea,2019,5,1736448000,976488000,2712936000
Republik Korea,2019,6,1299495000,1013097000,2312592000
Republik Korea,2019,7,1546244000,961430000,2507674000
Republik Korea,2019,8,1227463000,937595000,2165058000
Republik Korea,2019,9,1510494000,1201394000,2711888000
Republik Korea,2019,10,1423794000,1019332000,2443126000
Republik Korea,2019,11,1503576000,1237741000,2741317000
Republik Korea,2019,12,1421903000,812241000,2234144000
Republik Korea,2020,1,1561605000,1171316000,2732921000
Republik Korea,2020,2,1834000000,1027573000,2861573000
Republik Korea,2020,3,1820642000,1150620000,2971262000
Republik Korea,2020,4,1105529000,940537000,2046066000
Republik Korea,2020,5,1187746000,834643000,2022389000
Republik Korea,2020,6,1521773000,856752000,2378525000
Republik Korea,2020,7,1660695000,836461000,2497156000
Republik Korea,2020,8,1223002000,781174000,2004176000
Republik Korea,2020,9,1433345000,830548000,2263893000
Republik Korea,2020,10,1493628000,854341000,2347969000
Republik Korea,2020,11,1452924000,1043431000,2496355000
Republik Korea,2020,12,1479445000,980907000,2460352000
Republik Korea,2021,1,1421091000,1069044000,2490135000
Republik Korea,2021,2,1518088000,906076000,2424164000
Republik Korea,2021,3,1739477000,1220714000,2960191000
Republik Korea,2021,4,1595023000,1100696000,2695719000
Republik Korea,2021,5,1484095000,1136054000,2620149000
Republik Korea,2021,6,1514677000,1153793000,2668470000
Republik Korea,2021,7,1553459000,915536000,2468995000
Republik Korea,2021,8,1251890000,1033151000,2285041000
Republik Korea,2021,9,1468543000,920602000,2389145000
Republik Korea,2021,10,1761484000,1100722000,2862206000
Republik Korea,2021,11,1687789000,1074804000,2762593000
Republik Korea,2021,12,1737177000,997929000,2735106000
Republik Korea,2022,1,1537887000,1109962000,2647849000
Republik Korea,2022,2,1816469000,940601000,2757070000
Republik Korea,2022,3,1645133000,1127443000,2772576000
Republik Korea,2022,4,1540235000,1059180000,2599415000
Republik Korea,2022,5,1853028000,1143332000,2996360000
Republik Korea,2022,6,1907339000,1047480000,2954819000
Republik Korea,2022,7,1652030000,1120048000,2772078000
Republik Korea,2022,8,1778536000,1102476000,2881012000
Republik Korea,2022,9,2042352000,1165095000,3207447000
Republik Korea,2022,10,1892135000,1075479000,2967614000
Republik Korea,2022,11,1895585000,1469369000,3364954000
Republik Korea,2022,12,1966195000,997534000,2963729000
Republik Korea,2023,1,1591538000,1009820000,2601358000
Republik Korea,2023,2,1959358000,903910000,2863268000
Republik Korea,2023,3,1942905000,1286419000,3229324000
Republik Korea,2023,4,1692541000,1108193000,2800734000
Republik Korea,2023,5,1584393000,1186902000,2771295000
Republik Korea,2023,6,1588840000,1322168000,2911008000
Republik Korea,2023,7,1582095000,1149679000,2731774000
Republik Korea,2023,8,1456733000,1196416000,2653149000
Republik Korea,2023,9,1767598000,1445229000,3212827000
Republik Korea,2023,10,1642186000,1120649000,2762835000
Republik Korea,2023,11,1782317000,1193342000,2975659000
Republik Korea,2023,12,1832457000,938840000,2771297000
Republik Korea,2024,1,1523996000,932448000,2456444000
Republik Korea,2024,2,1753146000,1139856000,2893002000
Republik Korea,2024,3,1744902000,1229658000,2974560000
Republik Korea,2024,4,1766943000,1163895000,2930838000
Republik Korea,2024,5,1525677000,1131832000,2657509000
Republik Korea,2024,6,1731779000,1241076000,2972855000
Republik Korea,2024,7,1814157000,1058494000,2872651000
Republik Korea,2024,8,1598177000,924201000,2522378000
Republik Korea,2024,9,1479086000,1807770000,3286856000
Republik Korea,2024,10,1635409000,891423000,2526832000
Republik Korea,2024,11,1561771000,1054452000,2616223000
Republik Korea,2024,12,1429473000,788779000,2218252000
Republik Moldau (ab 05/1992),2008,1,24207000,8781000,32988000
Republik Moldau (ab 05/1992),2008,2,23575000,12444000,36019000
Republik Moldau (ab 05/1992),2008,3,25159000,12992000,38151000
Republik Moldau (ab 05/1992),2008,4,23903000,10002000,33905000
Republik Moldau (ab 05/1992),2008,5,24996000,6048000,31044000
Republik Moldau (ab 05/1992),2008,6,26947000,9005000,35952000
Republik Moldau (ab 05/1992),2008,7,29941000,9768000,39709000
Republik Moldau (ab 05/1992),2008,8,23203000,11583000,34786000
Republik Moldau (ab 05/1992),2008,9,25994000,8589000,34583000
Republik Moldau (ab 05/1992),2008,10,34341000,8804000,43145000
Republik Moldau (ab 05/1992),2008,11,29699000,6905000,36604000
Republik Moldau (ab 05/1992),2008,12,22619000,6523000,29142000
Republik Moldau (ab 05/1992),2009,1,14653000,5165000,19818000
Republik Moldau (ab 05/1992),2009,2,15018000,8782000,23800000
Republik Moldau (ab 05/1992),2009,3,18396000,11192000,29588000
Republik Moldau (ab 05/1992),2009,4,14101000,7792000,21893000
Republik Moldau (ab 05/1992),2009,5,15676000,4631000,20307000
Republik Moldau (ab 05/1992),2009,6,19746000,6314000,26060000
Republik Moldau (ab 05/1992),2009,7,20623000,7470000,28093000
Republik Moldau (ab 05/1992),2009,8,16006000,5633000,21639000
Republik Moldau (ab 05/1992),2009,9,19245000,4844000,24089000
Republik Moldau (ab 05/1992),2009,10,21291000,5908000,27199000
Republik Moldau (ab 05/1992),2009,11,20711000,5226000,25937000
Republik Moldau (ab 05/1992),2009,12,21588000,6284000,27872000
Republik Moldau (ab 05/1992),2010,1,10925000,5499000,16424000
Republik Moldau (ab 05/1992),2010,2,14657000,6488000,21145000
Republik Moldau (ab 05/1992),2010,3,24056000,7212000,31268000
Republik Moldau (ab 05/1992),2010,4,20177000,7166000,27343000
Republik Moldau (ab 05/1992),2010,5,20966000,6451000,27417000
Republik Moldau (ab 05/1992),2010,6,24125000,8348000,32473000
Republik Moldau (ab 05/1992),2010,7,23736000,6849000,30585000
Republik Moldau (ab 05/1992),2010,8,23212000,7450000,30662000
Republik Moldau (ab 05/1992),2010,9,23621000,7778000,31399000
Republik Moldau (ab 05/1992),2010,10,26903000,7308000,34211000
Republik Moldau (ab 05/1992),2010,11,26469000,9892000,36361000
Republik Moldau (ab 05/1992),2010,12,24223000,9702000,33925000
Republik Moldau (ab 05/1992),2011,1,16276000,7971000,24247000
Republik Moldau (ab 05/1992),2011,2,26070000,8686000,34756000
Republik Moldau (ab 05/1992),2011,3,30323000,10313000,40636000
Republik Moldau (ab 05/1992),2011,4,25626000,9077000,34703000
Republik Moldau (ab 05/1992),2011,5,25464000,7932000,33396000
Republik Moldau (ab 05/1992),2011,6,27150000,10175000,37325000
Republik Moldau (ab 05/1992),2011,7,23638000,9005000,32643000
Republik Moldau (ab 05/1992),2011,8,37417000,9911000,47328000
Republik Moldau (ab 05/1992),2011,9,32497000,8944000,41441000
Republik Moldau (ab 05/1992),2011,10,30987000,8047000,39034000
Republik Moldau (ab 05/1992),2011,11,34976000,12758000,47734000
Republik Moldau (ab 05/1992),2011,12,33927000,8684000,42611000
Republik Moldau (ab 05/1992),2012,1,20614000,7647000,28261000
Republik Moldau (ab 05/1992),2012,2,26265000,9403000,35668000
Republik Moldau (ab 05/1992),2012,3,35482000,8230000,43712000
Republik Moldau (ab 05/1992),2012,4,29172000,7303000,36475000
Republik Moldau (ab 05/1992),2012,5,32443000,7156000,39599000
Republik Moldau (ab 05/1992),2012,6,31117000,8624000,39741000
Republik Moldau (ab 05/1992),2012,7,28029000,8239000,36268000
Republik Moldau (ab 05/1992),2012,8,33064000,7987000,41051000
Republik Moldau (ab 05/1992),2012,9,31423000,6391000,37814000
Republik Moldau (ab 05/1992),2012,10,37129000,8729000,45858000
Republik Moldau (ab 05/1992),2012,11,33529000,8421000,41950000
Republik Moldau (ab 05/1992),2012,12,28904000,7251000,36155000
Republik Moldau (ab 05/1992),2013,1,20479000,8371000,28850000
Republik Moldau (ab 05/1992),2013,2,28437000,8458000,36895000
Republik Moldau (ab 05/1992),2013,3,39810000,9257000,49067000
Republik Moldau (ab 05/1992),2013,4,38401000,11776000,50177000
Republik Moldau (ab 05/1992),2013,5,28106000,9507000,37613000
Republik Moldau (ab 05/1992),2013,6,29796000,9732000,39528000
Republik Moldau (ab 05/1992),2013,7,31181000,10050000,41231000
Republik Moldau (ab 05/1992),2013,8,29269000,10003000,39272000
Republik Moldau (ab 05/1992),2013,9,30212000,10590000,40802000
Republik Moldau (ab 05/1992),2013,10,29922000,11526000,41448000
Republik Moldau (ab 05/1992),2013,11,29588000,12236000,41824000
Republik Moldau (ab 05/1992),2013,12,28231000,12596000,40827000
Republik Moldau (ab 05/1992),2014,1,20288000,11134000,31422000
Republik Moldau (ab 05/1992),2014,2,21768000,11793000,33561000
Republik Moldau (ab 05/1992),2014,3,31389000,11580000,42969000
Republik Moldau (ab 05/1992),2014,4,29389000,10107000,39496000
Republik Moldau (ab 05/1992),2014,5,27307000,8539000,35846000
Republik Moldau (ab 05/1992),2014,6,25671000,12536000,38207000
Republik Moldau (ab 05/1992),2014,7,29026000,13640000,42666000
Republik Moldau (ab 05/1992),2014,8,25053000,11063000,36116000
Republik Moldau (ab 05/1992),2014,9,26899000,11920000,38819000
Republik Moldau (ab 05/1992),2014,10,30164000,13032000,43196000
Republik Moldau (ab 05/1992),2014,11,27530000,11940000,39470000
Republik Moldau (ab 05/1992),2014,12,29196000,12173000,41369000
Republik Moldau (ab 05/1992),2015,1,19104000,11927000,31031000
Republik Moldau (ab 05/1992),2015,2,19229000,13935000,33164000
Republik Moldau (ab 05/1992),2015,3,31572000,13691000,45263000
Republik Moldau (ab 05/1992),2015,4,24381000,13757000,38138000
Republik Moldau (ab 05/1992),2015,5,21859000,10347000,32206000
Republik Moldau (ab 05/1992),2015,6,26721000,14808000,41529000
Republik Moldau (ab 05/1992),2015,7,23509000,16626000,40135000
Republik Moldau (ab 05/1992),2015,8,21193000,11047000,32240000
Republik Moldau (ab 05/1992),2015,9,23440000,12804000,36244000
Republik Moldau (ab 05/1992),2015,10,23639000,13927000,37566000
Republik Moldau (ab 05/1992),2015,11,26031000,15079000,41110000
Republik Moldau (ab 05/1992),2015,12,19592000,13039000,32631000
Republik Moldau (ab 05/1992),2016,1,15309000,11565000,26874000
Republik Moldau (ab 05/1992),2016,2,19257000,13913000,33170000
Republik Moldau (ab 05/1992),2016,3,29260000,14904000,44164000
Republik Moldau (ab 05/1992),2016,4,28463000,14723000,43186000
Republik Moldau (ab 05/1992),2016,5,19967000,11625000,31592000
Republik Moldau (ab 05/1992),2016,6,23234000,13142000,36376000
Republik Moldau (ab 05/1992),2016,7,24308000,13064000,37372000
Republik Moldau (ab 05/1992),2016,8,25148000,11803000,36951000
Republik Moldau (ab 05/1992),2016,9,23044000,16721000,39765000
Republik Moldau (ab 05/1992),2016,10,24015000,13967000,37982000
Republik Moldau (ab 05/1992),2016,11,27658000,15995000,43653000
Republik Moldau (ab 05/1992),2016,12,21741000,13058000,34799000
Republik Moldau (ab 05/1992),2017,1,19985000,15119000,35104000
Republik Moldau (ab 05/1992),2017,2,25345000,14711000,40056000
Republik Moldau (ab 05/1992),2017,3,39742000,15995000,55737000
Republik Moldau (ab 05/1992),2017,4,25104000,11532000,36636000
Republik Moldau (ab 05/1992),2017,5,30727000,14886000,45613000
Republik Moldau (ab 05/1992),2017,6,29210000,16882000,46092000
Republik Moldau (ab 05/1992),2017,7,32141000,15101000,47242000
Republik Moldau (ab 05/1992),2017,8,36194000,19882000,56076000
Republik Moldau (ab 05/1992),2017,9,29779000,16473000,46252000
Republik Moldau (ab 05/1992),2017,10,33695000,19294000,52989000
Republik Moldau (ab 05/1992),2017,11,31582000,28850000,60432000
Republik Moldau (ab 05/1992),2017,12,27145000,18202000,45347000
Republik Moldau (ab 05/1992),2018,1,24758000,21034000,45792000
Republik Moldau (ab 05/1992),2018,2,33815000,21042000,54857000
Republik Moldau (ab 05/1992),2018,3,42396000,18576000,60972000
Republik Moldau (ab 05/1992),2018,4,31921000,17790000,49711000
Republik Moldau (ab 05/1992),2018,5,33663000,19502000,53165000
Republik Moldau (ab 05/1992),2018,6,35152000,20174000,55326000
Republik Moldau (ab 05/1992),2018,7,33456000,19857000,53313000
Republik Moldau (ab 05/1992),2018,8,34453000,19317000,53770000
Republik Moldau (ab 05/1992),2018,9,31660000,19273000,50933000
Republik Moldau (ab 05/1992),2018,10,36302000,21814000,58116000
Republik Moldau (ab 05/1992),2018,11,37403000,22118000,59521000
Republik Moldau (ab 05/1992),2018,12,27729000,23360000,51089000
Republik Moldau (ab 05/1992),2019,1,27078000,22687000,49765000
Republik Moldau (ab 05/1992),2019,2,34095000,22773000,56868000
Republik Moldau (ab 05/1992),2019,3,42583000,22066000,64649000
Republik Moldau (ab 05/1992),2019,4,34906000,23344000,58250000
Republik Moldau (ab 05/1992),2019,5,35066000,18787000,53853000
Republik Moldau (ab 05/1992),2019,6,34608000,20948000,55556000
Republik Moldau (ab 05/1992),2019,7,37414000,20527000,57941000
Republik Moldau (ab 05/1992),2019,8,33964000,19140000,53104000
Republik Moldau (ab 05/1992),2019,9,35900000,22167000,58067000
Republik Moldau (ab 05/1992),2019,10,37140000,22802000,59942000
Republik Moldau (ab 05/1992),2019,11,35555000,26763000,62318000
Republik Moldau (ab 05/1992),2019,12,33022000,18129000,51151000
Republik Moldau (ab 05/1992),2020,1,30732000,24201000,54933000
Republik Moldau (ab 05/1992),2020,2,40393000,23210000,63603000
Republik Moldau (ab 05/1992),2020,3,37444000,23631000,61075000
Republik Moldau (ab 05/1992),2020,4,17931000,12756000,30687000
Republik Moldau (ab 05/1992),2020,5,18340000,12351000,30691000
Republik Moldau (ab 05/1992),2020,6,28324000,18515000,46839000
Republik Moldau (ab 05/1992),2020,7,31765000,23805000,55570000
Republik Moldau (ab 05/1992),2020,8,29939000,29269000,59208000
Republik Moldau (ab 05/1992),2020,9,31346000,27417000,58763000
Republik Moldau (ab 05/1992),2020,10,34091000,28284000,62375000
Republik Moldau (ab 05/1992),2020,11,36103000,28637000,64740000
Republik Moldau (ab 05/1992),2020,12,28111000,18857000,46968000
Republik Moldau (ab 05/1992),2021,1,25737000,21447000,47184000
Republik Moldau (ab 05/1992),2021,2,36308000,23618000,59926000
Republik Moldau (ab 05/1992),2021,3,46601000,29742000,76343000
Republik Moldau (ab 05/1992),2021,4,37025000,22224000,59249000
Republik Moldau (ab 05/1992),2021,5,37731000,22803000,60534000
Republik Moldau (ab 05/1992),2021,6,34635000,20241000,54876000
Republik Moldau (ab 05/1992),2021,7,35866000,23352000,59218000
Republik Moldau (ab 05/1992),2021,8,37219000,14975000,52194000
Republik Moldau (ab 05/1992),2021,9,40499000,19711000,60210000
Republik Moldau (ab 05/1992),2021,10,36548000,24671000,61219000
Republik Moldau (ab 05/1992),2021,11,40348000,27071000,67419000
Republik Moldau (ab 05/1992),2021,12,37057000,16437000,53494000
Republik Moldau (ab 05/1992),2022,1,32125000,19861000,51986000
Republik Moldau (ab 05/1992),2022,2,42381000,21895000,64276000
Republik Moldau (ab 05/1992),2022,3,49712000,28798000,78510000
Republik Moldau (ab 05/1992),2022,4,40568000,27232000,67800000
Republik Moldau (ab 05/1992),2022,5,43974000,26188000,70162000
Republik Moldau (ab 05/1992),2022,6,44884000,24906000,69790000
Republik Moldau (ab 05/1992),2022,7,47815000,20874000,68689000
Republik Moldau (ab 05/1992),2022,8,49706000,23882000,73588000
Republik Moldau (ab 05/1992),2022,9,48495000,22570000,71065000
Republik Moldau (ab 05/1992),2022,10,42546000,24272000,66818000
Republik Moldau (ab 05/1992),2022,11,51928000,32246000,84174000
Republik Moldau (ab 05/1992),2022,12,42722000,22438000,65160000
Republik Moldau (ab 05/1992),2023,1,38166000,23508000,61674000
Republik Moldau (ab 05/1992),2023,2,48876000,24742000,73618000
Republik Moldau (ab 05/1992),2023,3,52850000,24846000,77696000
Republik Moldau (ab 05/1992),2023,4,43225000,18105000,61330000
Republik Moldau (ab 05/1992),2023,5,46876000,22838000,69714000
Republik Moldau (ab 05/1992),2023,6,44233000,24592000,68825000
Republik Moldau (ab 05/1992),2023,7,41387000,23917000,65304000
Republik Moldau (ab 05/1992),2023,8,46775000,28614000,75389000
Republik Moldau (ab 05/1992),2023,9,44178000,33787000,77965000
Republik Moldau (ab 05/1992),2023,10,50334000,43268000,93602000
Republik Moldau (ab 05/1992),2023,11,48415000,25876000,74291000
Republik Moldau (ab 05/1992),2023,12,42139000,31889000,74028000
Republik Moldau (ab 05/1992),2024,1,39879000,26205000,66084000
Republik Moldau (ab 05/1992),2024,2,53265000,27279000,80544000
Republik Moldau (ab 05/1992),2024,3,50894000,25693000,76587000
Republik Moldau (ab 05/1992),2024,4,56914000,23890000,80804000
Republik Moldau (ab 05/1992),2024,5,45200000,18500000,63700000
Republik Moldau (ab 05/1992),2024,6,51547000,17516000,69063000
Republik Moldau (ab 05/1992),2024,7,52832000,16905000,69737000
Republik Moldau (ab 05/1992),2024,8,47987000,16762000,64749000
Republik Moldau (ab 05/1992),2024,9,48768000,19452000,68220000
Republik Moldau (ab 05/1992),2024,10,52909000,19983000,72892000
Republik Moldau (ab 05/1992),2024,11,54251000,18388000,72639000
Republik Moldau (ab 05/1992),2024,12,46873000,15523000,62396000
Reunion (bis 1996),2008,1,0,0,0
Reunion (bis 1996),2008,2,0,0,0
Reunion (bis 1996),2008,3,0,0,0
Reunion (bis 1996),2008,4,0,0,0
Reunion (bis 1996),2008,5,0,0,0
Reunion (bis 1996),2008,6,0,0,0
Reunion (bis 1996),2008,7,0,0,0
Reunion (bis 1996),2008,8,0,0,0
Reunion (bis 1996),2008,9,0,0,0
Reunion (bis 1996),2008,10,0,0,0
Reunion (bis 1996),2008,11,0,0,0
Reunion (bis 1996),2008,12,0,0,0
Reunion (bis 1996),2009,1,0,0,0
Reunion (bis 1996),2009,2,0,0,0
Reunion (bis 1996),2009,3,0,0,0
Reunion (bis 1996),2009,4,0,0,0
Reunion (bis 1996),2009,5,0,0,0
Reunion (bis 1996),2009,6,0,0,0
Reunion (bis 1996),2009,7,0,0,0
Reunion (bis 1996),2009,8,0,0,0
Reunion (bis 1996),2009,9,0,0,0
Reunion (bis 1996),2009,10,0,0,0
Reunion (bis 1996),2009,11,0,0,0
Reunion (bis 1996),2009,12,0,0,0
Reunion (bis 1996),2010,1,0,0,0
Reunion (bis 1996),2010,2,0,0,0
Reunion (bis 1996),2010,3,0,0,0
Reunion (bis 1996),2010,4,0,0,0
Reunion (bis 1996),2010,5,0,0,0
Reunion (bis 1996),2010,6,0,0,0
Reunion (bis 1996),2010,7,0,0,0
Reunion (bis 1996),2010,8,0,0,0
Reunion (bis 1996),2010,9,0,0,0
Reunion (bis 1996),2010,10,0,0,0
Reunion (bis 1996),2010,11,0,0,0
Reunion (bis 1996),2010,12,0,0,0
Reunion (bis 1996),2011,1,0,0,0
Reunion (bis 1996),2011,2,0,0,0
Reunion (bis 1996),2011,3,0,0,0
Reunion (bis 1996),2011,4,0,0,0
Reunion (bis 1996),2011,5,0,0,0
Reunion (bis 1996),2011,6,0,0,0
Reunion (bis 1996),2011,7,0,0,0
Reunion (bis 1996),2011,8,0,0,0
Reunion (bis 1996),2011,9,0,0,0
Reunion (bis 1996),2011,10,0,0,0
Reunion (bis 1996),2011,11,0,0,0
Reunion (bis 1996),2011,12,0,0,0
Reunion (bis 1996),2012,1,0,0,0
Reunion (bis 1996),2012,2,0,0,0
Reunion (bis 1996),2012,3,0,0,0
Reunion (bis 1996),2012,4,0,0,0
Reunion (bis 1996),2012,5,0,0,0
Reunion (bis 1996),2012,6,0,0,0
Reunion (bis 1996),2012,7,0,0,0
Reunion (bis 1996),2012,8,0,0,0
Reunion (bis 1996),2012,9,0,0,0
Reunion (bis 1996),2012,10,0,0,0
Reunion (bis 1996),2012,11,0,0,0
Reunion (bis 1996),2012,12,0,0,0
Reunion (bis 1996),2013,1,0,0,0
Reunion (bis 1996),2013,2,0,0,0
Reunion (bis 1996),2013,3,0,0,0
Reunion (bis 1996),2013,4,0,0,0
Reunion (bis 1996),2013,5,0,0,0
Reunion (bis 1996),2013,6,0,0,0
Reunion (bis 1996),2013,7,0,0,0
Reunion (bis 1996),2013,8,0,0,0
Reunion (bis 1996),2013,9,0,0,0
Reunion (bis 1996),2013,10,0,0,0
Reunion (bis 1996),2013,11,0,0,0
Reunion (bis 1996),2013,12,0,0,0
Reunion (bis 1996),2014,1,0,0,0
Reunion (bis 1996),2014,2,0,0,0
Reunion (bis 1996),2014,3,0,0,0
Reunion (bis 1996),2014,4,0,0,0
Reunion (bis 1996),2014,5,0,0,0
Reunion (bis 1996),2014,6,0,0,0
Reunion (bis 1996),2014,7,0,0,0
Reunion (bis 1996),2014,8,0,0,0
Reunion (bis 1996),2014,9,0,0,0
Reunion (bis 1996),2014,10,0,0,0
Reunion (bis 1996),2014,11,0,0,0
Reunion (bis 1996),2014,12,0,0,0
Reunion (bis 1996),2015,1,0,0,0
Reunion (bis 1996),2015,2,0,0,0
Reunion (bis 1996),2015,3,0,0,0
Reunion (bis 1996),2015,4,0,0,0
Reunion (bis 1996),2015,5,0,0,0
Reunion (bis 1996),2015,6,0,0,0
Reunion (bis 1996),2015,7,0,0,0
Reunion (bis 1996),2015,8,0,0,0
Reunion (bis 1996),2015,9,0,0,0
Reunion (bis 1996),2015,10,0,0,0
Reunion (bis 1996),2015,11,0,0,0
Reunion (bis 1996),2015,12,0,0,0
Reunion (bis 1996),2016,1,0,0,0
Reunion (bis 1996),2016,2,0,0,0
Reunion (bis 1996),2016,3,0,0,0
Reunion (bis 1996),2016,4,0,0,0
Reunion (bis 1996),2016,5,0,0,0
Reunion (bis 1996),2016,6,0,0,0
Reunion (bis 1996),2016,7,0,0,0
Reunion (bis 1996),2016,8,0,0,0
Reunion (bis 1996),2016,9,0,0,0
Reunion (bis 1996),2016,10,0,0,0
Reunion (bis 1996),2016,11,0,0,0
Reunion (bis 1996),2016,12,0,0,0
Reunion (bis 1996),2017,1,0,0,0
Reunion (bis 1996),2017,2,0,0,0
Reunion (bis 1996),2017,3,0,0,0
Reunion (bis 1996),2017,4,0,0,0
Reunion (bis 1996),2017,5,0,0,0
Reunion (bis 1996),2017,6,0,0,0
Reunion (bis 1996),2017,7,0,0,0
Reunion (bis 1996),2017,8,0,0,0
Reunion (bis 1996),2017,9,0,0,0
Reunion (bis 1996),2017,10,0,0,0
Reunion (bis 1996),2017,11,0,0,0
Reunion (bis 1996),2017,12,0,0,0
Reunion (bis 1996),2018,1,0,0,0
Reunion (bis 1996),2018,2,0,0,0
Reunion (bis 1996),2018,3,0,0,0
Reunion (bis 1996),2018,4,0,0,0
Reunion (bis 1996),2018,5,0,0,0
Reunion (bis 1996),2018,6,0,0,0
Reunion (bis 1996),2018,7,0,0,0
Reunion (bis 1996),2018,8,0,0,0
Reunion (bis 1996),2018,9,0,0,0
Reunion (bis 1996),2018,10,0,0,0
Reunion (bis 1996),2018,11,0,0,0
Reunion (bis 1996),2018,12,0,0,0
Reunion (bis 1996),2019,1,0,0,0
Reunion (bis 1996),2019,2,0,0,0
Reunion (bis 1996),2019,3,0,0,0
Reunion (bis 1996),2019,4,0,0,0
Reunion (bis 1996),2019,5,0,0,0
Reunion (bis 1996),2019,6,0,0,0
Reunion (bis 1996),2019,7,0,0,0
Reunion (bis 1996),2019,8,0,0,0
Reunion (bis 1996),2019,9,0,0,0
Reunion (bis 1996),2019,10,0,0,0
Reunion (bis 1996),2019,11,0,0,0
Reunion (bis 1996),2019,12,0,0,0
Reunion (bis 1996),2020,1,0,0,0
Reunion (bis 1996),2020,2,0,0,0
Reunion (bis 1996),2020,3,0,0,0
Reunion (bis 1996),2020,4,0,0,0
Reunion (bis 1996),2020,5,0,0,0
Reunion (bis 1996),2020,6,0,0,0
Reunion (bis 1996),2020,7,0,0,0
Reunion (bis 1996),2020,8,0,0,0
Reunion (bis 1996),2020,9,0,0,0
Reunion (bis 1996),2020,10,0,0,0
Reunion (bis 1996),2020,11,0,0,0
Reunion (bis 1996),2020,12,0,0,0
Reunion (bis 1996),2021,1,0,0,0
Reunion (bis 1996),2021,2,0,0,0
Reunion (bis 1996),2021,3,0,0,0
Reunion (bis 1996),2021,4,0,0,0
Reunion (bis 1996),2021,5,0,0,0
Reunion (bis 1996),2021,6,0,0,0
Reunion (bis 1996),2021,7,0,0,0
Reunion (bis 1996),2021,8,0,0,0
Reunion (bis 1996),2021,9,0,0,0
Reunion (bis 1996),2021,10,0,0,0
Reunion (bis 1996),2021,11,0,0,0
Reunion (bis 1996),2021,12,0,0,0
Reunion (bis 1996),2022,1,0,0,0
Reunion (bis 1996),2022,2,0,0,0
Reunion (bis 1996),2022,3,0,0,0
Reunion (bis 1996),2022,4,0,0,0
Reunion (bis 1996),2022,5,0,0,0
Reunion (bis 1996),2022,6,0,0,0
Reunion (bis 1996),2022,7,0,0,0
Reunion (bis 1996),2022,8,0,0,0
Reunion (bis 1996),2022,9,0,0,0
Reunion (bis 1996),2022,10,0,0,0
Reunion (bis 1996),2022,11,0,0,0
Reunion (bis 1996),2022,12,0,0,0
Reunion (bis 1996),2023,1,0,0,0
Reunion (bis 1996),2023,2,0,0,0
Reunion (bis 1996),2023,3,0,0,0
Reunion (bis 1996),2023,4,0,0,0
Reunion (bis 1996),2023,5,0,0,0
Reunion (bis 1996),2023,6,0,0,0
Reunion (bis 1996),2023,7,0,0,0
Reunion (bis 1996),2023,8,0,0,0
Reunion (bis 1996),2023,9,0,0,0
Reunion (bis 1996),2023,10,0,0,0
Reunion (bis 1996),2023,11,0,0,0
Reunion (bis 1996),2023,12,0,0,0
Reunion (bis 1996),2024,1,0,0,0
Reunion (bis 1996),2024,2,0,0,0
Reunion (bis 1996),2024,3,0,0,0
Reunion (bis 1996),2024,4,0,0,0
Reunion (bis 1996),2024,5,0,0,0
Reunion (bis 1996),2024,6,0,0,0
Reunion (bis 1996),2024,7,0,0,0
Reunion (bis 1996),2024,8,0,0,0
Reunion (bis 1996),2024,9,0,0,0
Reunion (bis 1996),2024,10,0,0,0
Reunion (bis 1996),2024,11,0,0,0
Reunion (bis 1996),2024,12,0,0,0
Ruanda,2008,1,5497000,1182000,6679000
Ruanda,2008,2,1993000,1638000,3631000
Ruanda,2008,3,915000,906000,1821000
Ruanda,2008,4,2853000,351000,3204000
Ruanda,2008,5,1971000,643000,2614000
Ruanda,2008,6,2083000,419000,2502000
Ruanda,2008,7,1626000,303000,1929000
Ruanda,2008,8,1593000,488000,2081000
Ruanda,2008,9,2170000,1875000,4045000
Ruanda,2008,10,2173000,2968000,5141000
Ruanda,2008,11,2216000,872000,3088000
Ruanda,2008,12,7217000,5341000,12558000
Ruanda,2009,1,1670000,1954000,3624000
Ruanda,2009,2,2371000,1285000,3656000
Ruanda,2009,3,1675000,1554000,3229000
Ruanda,2009,4,2122000,60000,2182000
Ruanda,2009,5,1802000,4000,1806000
Ruanda,2009,6,2033000,170000,2203000
Ruanda,2009,7,1743000,206000,1949000
Ruanda,2009,8,1762000,563000,2325000
Ruanda,2009,9,735000,2057000,2792000
Ruanda,2009,10,977000,998000,1975000
Ruanda,2009,11,875000,1617000,2492000
Ruanda,2009,12,12626000,1372000,13998000
Ruanda,2010,1,839000,629000,1468000
Ruanda,2010,2,1542000,853000,2395000
Ruanda,2010,3,2152000,91000,2243000
Ruanda,2010,4,1017000,558000,1575000
Ruanda,2010,5,4197000,682000,4879000
Ruanda,2010,6,1340000,1292000,2632000
Ruanda,2010,7,1288000,635000,1923000
Ruanda,2010,8,2735000,1174000,3909000
Ruanda,2010,9,1832000,2568000,4400000
Ruanda,2010,10,1922000,1223000,3145000
Ruanda,2010,11,1470000,1682000,3152000
Ruanda,2010,12,2229000,878000,3107000
Ruanda,2011,1,430000,1968000,2398000
Ruanda,2011,2,977000,2661000,3638000
Ruanda,2011,3,1064000,3082000,4146000
Ruanda,2011,4,1022000,678000,1700000
Ruanda,2011,5,1340000,797000,2137000
Ruanda,2011,6,2444000,125000,2569000
Ruanda,2011,7,3745000,213000,3958000
Ruanda,2011,8,1070000,193000,1263000
Ruanda,2011,9,1495000,1509000,3004000
Ruanda,2011,10,3043000,1042000,4085000
Ruanda,2011,11,4496000,634000,5130000
Ruanda,2011,12,2515000,601000,3116000
Ruanda,2012,1,3346000,1224000,4570000
Ruanda,2012,2,2200000,622000,2822000
Ruanda,2012,3,1928000,786000,2714000
Ruanda,2012,4,3033000,689000,3722000
Ruanda,2012,5,3336000,225000,3561000
Ruanda,2012,6,2622000,421000,3043000
Ruanda,2012,7,1748000,481000,2229000
Ruanda,2012,8,2826000,1011000,3837000
Ruanda,2012,9,2185000,630000,2815000
Ruanda,2012,10,1499000,1276000,2775000
Ruanda,2012,11,2819000,1018000,3837000
Ruanda,2012,12,6160000,767000,6927000
Ruanda,2013,1,3778000,672000,4450000
Ruanda,2013,2,2594000,901000,3495000
Ruanda,2013,3,3520000,789000,4309000
Ruanda,2013,4,2306000,936000,3242000
Ruanda,2013,5,1838000,349000,2187000
Ruanda,2013,6,2341000,380000,2721000
Ruanda,2013,7,2881000,567000,3448000
Ruanda,2013,8,2434000,598000,3032000
Ruanda,2013,9,3367000,570000,3937000
Ruanda,2013,10,3212000,780000,3992000
Ruanda,2013,11,2374000,717000,3091000
Ruanda,2013,12,1591000,890000,2481000
Ruanda,2014,1,1085000,342000,1427000
Ruanda,2014,2,1113000,418000,1531000
Ruanda,2014,3,2415000,381000,2796000
Ruanda,2014,4,1727000,242000,1969000
Ruanda,2014,5,4152000,148000,4300000
Ruanda,2014,6,3881000,2938000,6819000
Ruanda,2014,7,2286000,270000,2556000
Ruanda,2014,8,2027000,3135000,5162000
Ruanda,2014,9,3575000,4178000,7753000
Ruanda,2014,10,1709000,1129000,2838000
Ruanda,2014,11,1881000,4417000,6298000
Ruanda,2014,12,2753000,4776000,7529000
Ruanda,2015,1,1865000,6761000,8626000
Ruanda,2015,2,1866000,246000,2112000
Ruanda,2015,3,1443000,3526000,4969000
Ruanda,2015,4,2884000,657000,3541000
Ruanda,2015,5,2469000,2082000,4551000
Ruanda,2015,6,2381000,701000,3082000
Ruanda,2015,7,2947000,1669000,4616000
Ruanda,2015,8,2718000,904000,3622000
Ruanda,2015,9,3607000,995000,4602000
Ruanda,2015,10,2520000,2583000,5103000
Ruanda,2015,11,6218000,1767000,7985000
Ruanda,2015,12,5342000,1060000,6402000
Ruanda,2016,1,1882000,1225000,3107000
Ruanda,2016,2,3334000,2073000,5407000
Ruanda,2016,3,3135000,847000,3982000
Ruanda,2016,4,4953000,1352000,6305000
Ruanda,2016,5,2842000,430000,3272000
Ruanda,2016,6,5289000,412000,5701000
Ruanda,2016,7,3400000,429000,3829000
Ruanda,2016,8,2798000,2401000,5199000
Ruanda,2016,9,3848000,816000,4664000
Ruanda,2016,10,1733000,875000,2608000
Ruanda,2016,11,2923000,957000,3880000
Ruanda,2016,12,3183000,1355000,4538000
Ruanda,2017,1,2206000,774000,2980000
Ruanda,2017,2,4852000,1136000,5988000
Ruanda,2017,3,2683000,628000,3311000
Ruanda,2017,4,2476000,171000,2647000
Ruanda,2017,5,4563000,861000,5424000
Ruanda,2017,6,4471000,787000,5258000
Ruanda,2017,7,3000000,1398000,4398000
Ruanda,2017,8,2837000,2866000,5703000
Ruanda,2017,9,2208000,561000,2769000
Ruanda,2017,10,4048000,1486000,5534000
Ruanda,2017,11,4157000,534000,4691000
Ruanda,2017,12,2459000,307000,2766000
Ruanda,2018,1,4969000,1109000,6078000
Ruanda,2018,2,4577000,2483000,7060000
Ruanda,2018,3,2652000,1632000,4284000
Ruanda,2018,4,1704000,3086000,4790000
Ruanda,2018,5,3066000,4570000,7636000
Ruanda,2018,6,8185000,480000,8665000
Ruanda,2018,7,2887000,1168000,4055000
Ruanda,2018,8,2739000,565000,3304000
Ruanda,2018,9,2313000,544000,2857000
Ruanda,2018,10,3513000,1306000,4819000
Ruanda,2018,11,3905000,991000,4896000
Ruanda,2018,12,3557000,533000,4090000
Ruanda,2019,1,3383000,1554000,4937000
Ruanda,2019,2,5745000,1571000,7316000
Ruanda,2019,3,3913000,466000,4379000
Ruanda,2019,4,6575000,919000,7494000
Ruanda,2019,5,7705000,661000,8366000
Ruanda,2019,6,5772000,353000,6125000
Ruanda,2019,7,5305000,503000,5808000
Ruanda,2019,8,4521000,1275000,5796000
Ruanda,2019,9,3868000,354000,4222000
Ruanda,2019,10,3358000,1330000,4688000
Ruanda,2019,11,2556000,964000,3520000
Ruanda,2019,12,4110000,344000,4454000
Ruanda,2020,1,3877000,1541000,5418000
Ruanda,2020,2,5112000,902000,6014000
Ruanda,2020,3,6469000,511000,6980000
Ruanda,2020,4,3808000,590000,4398000
Ruanda,2020,5,2633000,1453000,4086000
Ruanda,2020,6,7475000,890000,8365000
Ruanda,2020,7,11277000,761000,12038000
Ruanda,2020,8,4073000,743000,4816000
Ruanda,2020,9,5271000,1809000,7080000
Ruanda,2020,10,8577000,1627000,10204000
Ruanda,2020,11,2234000,962000,3196000
Ruanda,2020,12,8731000,3073000,11804000
Ruanda,2021,1,2755000,979000,3734000
Ruanda,2021,2,5106000,1140000,6246000
Ruanda,2021,3,3035000,1043000,4078000
Ruanda,2021,4,8227000,1474000,9701000
Ruanda,2021,5,6332000,504000,6836000
Ruanda,2021,6,3551000,416000,3967000
Ruanda,2021,7,8947000,1014000,9961000
Ruanda,2021,8,15399000,1856000,17255000
Ruanda,2021,9,2513000,1174000,3687000
Ruanda,2021,10,3286000,1559000,4845000
Ruanda,2021,11,3387000,4000000,7387000
Ruanda,2021,12,13347000,3103000,16450000
Ruanda,2022,1,2182000,6373000,8555000
Ruanda,2022,2,2121000,1721000,3842000
Ruanda,2022,3,2383000,2392000,4775000
Ruanda,2022,4,12744000,2143000,14887000
Ruanda,2022,5,3291000,3444000,6735000
Ruanda,2022,6,6459000,782000,7241000
Ruanda,2022,7,3574000,1175000,4749000
Ruanda,2022,8,4900000,1169000,6069000
Ruanda,2022,9,3206000,1525000,4731000
Ruanda,2022,10,3546000,3302000,6848000
Ruanda,2022,11,3566000,2549000,6115000
Ruanda,2022,12,4320000,1651000,5971000
Ruanda,2023,1,3324000,1311000,4635000
Ruanda,2023,2,4486000,2768000,7254000
Ruanda,2023,3,3648000,2908000,6556000
Ruanda,2023,4,4107000,832000,4939000
Ruanda,2023,5,6188000,1619000,7807000
Ruanda,2023,6,7511000,413000,7924000
Ruanda,2023,7,6301000,700000,7001000
Ruanda,2023,8,3563000,1258000,4821000
Ruanda,2023,9,3130000,322000,3452000
Ruanda,2023,10,3514000,2553000,6067000
Ruanda,2023,11,3610000,1207000,4817000
Ruanda,2023,12,4182000,1548000,5730000
Ruanda,2024,1,2843000,670000,3513000
Ruanda,2024,2,6006000,1903000,7909000
Ruanda,2024,3,5369000,675000,6044000
Ruanda,2024,4,3963000,1378000,5341000
Ruanda,2024,5,6719000,2049000,8768000
Ruanda,2024,6,7479000,3275000,10754000
Ruanda,2024,7,2673000,492000,3165000
Ruanda,2024,8,5584000,1110000,6694000
Ruanda,2024,9,8113000,2228000,10341000
Ruanda,2024,10,6138000,4380000,10518000
Ruanda,2024,11,3818000,4246000,8064000
Ruanda,2024,12,4220000,1423000,5643000
Rumänien,2008,1,705465000,367621000,1073086000
Rumänien,2008,2,759682000,386418000,1146100000
Rumänien,2008,3,733718000,446074000,1179792000
Rumänien,2008,4,816971000,403917000,1220888000
Rumänien,2008,5,767807000,419619000,1187426000
Rumänien,2008,6,805081000,380929000,1186010000
Rumänien,2008,7,767640000,440913000,1208553000
Rumänien,2008,8,719212000,393959000,1113171000
Rumänien,2008,9,842147000,404906000,1247053000
Rumänien,2008,10,783784000,375364000,1159148000
Rumänien,2008,11,776031000,446408000,1222439000
Rumänien,2008,12,500375000,416393000,916768000
Rumänien,2009,1,483483000,343609000,827092000
Rumänien,2009,2,505261000,383389000,888650000
Rumänien,2009,3,515930000,481685000,997615000
Rumänien,2009,4,476471000,559803000,1036274000
Rumänien,2009,5,472981000,365704000,838685000
Rumänien,2009,6,505363000,479383000,984746000
Rumänien,2009,7,548508000,505634000,1054142000
Rumänien,2009,8,492345000,457145000,949490000
Rumänien,2009,9,632939000,553970000,1186909000
Rumänien,2009,10,586284000,540424000,1126708000
Rumänien,2009,11,585928000,529392000,1115320000
Rumänien,2009,12,594550000,465307000,1059857000
Rumänien,2010,1,472870000,379145000,852015000
Rumänien,2010,2,545046000,453706000,998752000
Rumänien,2010,3,642104000,575154000,1217258000
Rumänien,2010,4,559384000,435166000,994550000
Rumänien,2010,5,573072000,534487000,1107559000
Rumänien,2010,6,668261000,628267000,1296528000
Rumänien,2010,7,646138000,587016000,1233154000
Rumänien,2010,8,568765000,504835000,1073600000
Rumänien,2010,9,660406000,584158000,1244564000
Rumänien,2010,10,661064000,623326000,1284390000
Rumänien,2010,11,695392000,620287000,1315679000
Rumänien,2010,12,599525000,538020000,1137545000
Rumänien,2011,1,595296000,574624000,1169920000
Rumänien,2011,2,637244000,590963000,1228207000
Rumänien,2011,3,792321000,704049000,1496370000
Rumänien,2011,4,695096000,677838000,1372934000
Rumänien,2011,5,752425000,688714000,1441139000
Rumänien,2011,6,758536000,652735000,1411271000
Rumänien,2011,7,696636000,731340000,1427976000
Rumänien,2011,8,750186000,691868000,1442054000
Rumänien,2011,9,812150000,725813000,1537963000
Rumänien,2011,10,789678000,835123000,1624801000
Rumänien,2011,11,831375000,862445000,1693820000
Rumänien,2011,12,689765000,626782000,1316547000
Rumänien,2012,1,698753000,649221000,1347974000
Rumänien,2012,2,704747000,855459000,1560206000
Rumänien,2012,3,757179000,804158000,1561337000
Rumänien,2012,4,701699000,656722000,1358421000
Rumänien,2012,5,771197000,724763000,1495960000
Rumänien,2012,6,916272000,721487000,1637759000
Rumänien,2012,7,751465000,669155000,1420620000
Rumänien,2012,8,743643000,683807000,1427450000
Rumänien,2012,9,817389000,717522000,1534911000
Rumänien,2012,10,888160000,805813000,1693973000
Rumänien,2012,11,774328000,744559000,1518887000
Rumänien,2012,12,634962000,585874000,1220836000
Rumänien,2013,1,729255000,685896000,1415151000
Rumänien,2013,2,708792000,769165000,1477957000
Rumänien,2013,3,789820000,781534000,1571354000
Rumänien,2013,4,817351000,807948000,1625299000
Rumänien,2013,5,814725000,706120000,1520845000
Rumänien,2013,6,832062000,765876000,1597938000
Rumänien,2013,7,845202000,755993000,1601195000
Rumänien,2013,8,788832000,730285000,1519117000
Rumänien,2013,9,851989000,806491000,1658480000
Rumänien,2013,10,930216000,890184000,1820400000
Rumänien,2013,11,847234000,826139000,1673373000
Rumänien,2013,12,681147000,645215000,1326362000
Rumänien,2014,1,815885000,759934000,1575819000
Rumänien,2014,2,831856000,872316000,1704172000
Rumänien,2014,3,908718000,875103000,1783821000
Rumänien,2014,4,851819000,827664000,1679483000
Rumänien,2014,5,881836000,855982000,1737818000
Rumänien,2014,6,933758000,869800000,1803558000
Rumänien,2014,7,973569000,959104000,1932673000
Rumänien,2014,8,819876000,722211000,1542087000
Rumänien,2014,9,976065000,911408000,1887473000
Rumänien,2014,10,1039779000,942179000,1981958000
Rumänien,2014,11,951093000,873390000,1824483000
Rumänien,2014,12,775029000,747748000,1522777000
Rumänien,2015,1,897645000,793517000,1691162000
Rumänien,2015,2,936170000,880049000,1816219000
Rumänien,2015,3,1005533000,945115000,1950648000
Rumänien,2015,4,964146000,870207000,1834353000
Rumänien,2015,5,987178000,846932000,1834110000
Rumänien,2015,6,1047305000,930253000,1977558000
Rumänien,2015,7,1076481000,932810000,2009291000
Rumänien,2015,8,943107000,812267000,1755374000
Rumänien,2015,9,1118784000,1013205000,2131989000
Rumänien,2015,10,1188967000,987822000,2176789000
Rumänien,2015,11,1122348000,990783000,2113131000
Rumänien,2015,12,933368000,729882000,1663250000
Rumänien,2016,1,979922000,831786000,1811708000
Rumänien,2016,2,1083660000,1009920000,2093580000
Rumänien,2016,3,1195427000,1041290000,2236717000
Rumänien,2016,4,1142714000,1010693000,2153407000
Rumänien,2016,5,1096815000,962110000,2058925000
Rumänien,2016,6,1174846000,1096253000,2271099000
Rumänien,2016,7,1087573000,1051354000,2138927000
Rumänien,2016,8,1137552000,1030346000,2167898000
Rumänien,2016,9,1219212000,1202861000,2422073000
Rumänien,2016,10,1169970000,1111116000,2281086000
Rumänien,2016,11,1243586000,1192645000,2436231000
Rumänien,2016,12,1024314000,968907000,1993221000
Rumänien,2017,1,1042963000,1118221000,2161184000
Rumänien,2017,2,1195344000,1220903000,2416247000
Rumänien,2017,3,1337612000,1368333000,2705945000
Rumänien,2017,4,1224543000,1119410000,2343953000
Rumänien,2017,5,1266524000,1277546000,2544070000
Rumänien,2017,6,1297962000,1192278000,2490240000
Rumänien,2017,7,1231127000,1255764000,2486891000
Rumänien,2017,8,1283625000,1234106000,2517731000
Rumänien,2017,9,1330665000,1356486000,2687151000
Rumänien,2017,10,1334049000,1320432000,2654481000
Rumänien,2017,11,1378838000,1410859000,2789697000
Rumänien,2017,12,1203033000,1060505000,2263538000
Rumänien,2018,1,1261974000,1274278000,2536252000
Rumänien,2018,2,1309494000,1292929000,2602423000
Rumänien,2018,3,1425416000,1420205000,2845621000
Rumänien,2018,4,1315097000,1333147000,2648244000
Rumänien,2018,5,1354488000,1311557000,2666045000
Rumänien,2018,6,1406467000,1382415000,2788882000
Rumänien,2018,7,1379010000,1357074000,2736084000
Rumänien,2018,8,1381048000,1329546000,2710594000
Rumänien,2018,9,1356539000,1352499000,2709038000
Rumänien,2018,10,1522327000,1493735000,3016062000
Rumänien,2018,11,1435265000,1376882000,2812147000
Rumänien,2018,12,1109462000,1066790000,2176252000
Rumänien,2019,1,1389141000,1229240000,2618381000
Rumänien,2019,2,1370516000,1380929000,2751445000
Rumänien,2019,3,1442727000,1427765000,2870492000
Rumänien,2019,4,1327418000,1352533000,2679951000
Rumänien,2019,5,1435841000,1359175000,2795016000
Rumänien,2019,6,1396351000,1337330000,2733681000
Rumänien,2019,7,1439723000,1339753000,2779476000
Rumänien,2019,8,1344918000,1217582000,2562500000
Rumänien,2019,9,1470499000,1377540000,2848039000
Rumänien,2019,10,1553356000,1341770000,2895126000
Rumänien,2019,11,1492873000,1341918000,2834791000
Rumänien,2019,12,1177015000,1091178000,2268193000
Rumänien,2020,1,1459330000,1275850000,2735180000
Rumänien,2020,2,1504138000,1340832000,2844970000
Rumänien,2020,3,1401809000,1201400000,2603209000
Rumänien,2020,4,843578000,638522000,1482100000
Rumänien,2020,5,907682000,868059000,1775741000
Rumänien,2020,6,1181116000,1073667000,2254783000
Rumänien,2020,7,1334921000,1203030000,2537951000
Rumänien,2020,8,1313443000,1058376000,2371819000
Rumänien,2020,9,1551739000,1279643000,2831382000
Rumänien,2020,10,1577581000,1260234000,2837815000
Rumänien,2020,11,1507404000,1338582000,2845986000
Rumänien,2020,12,1270235000,1062226000,2332461000
Rumänien,2021,1,1398809000,1099518000,2498327000
Rumänien,2021,2,1478706000,1267310000,2746016000
Rumänien,2021,3,1684096000,1420195000,3104291000
Rumänien,2021,4,1519641000,1256787000,2776428000
Rumänien,2021,5,1470912000,1106783000,2577695000
Rumänien,2021,6,1534585000,1231862000,2766447000
Rumänien,2021,7,1564651000,1195794000,2760445000
Rumänien,2021,8,1491626000,1001275000,2492901000
Rumänien,2021,9,1574357000,1215181000,2789538000
Rumänien,2021,10,1552582000,1279174000,2831756000
Rumänien,2021,11,1624385000,1448845000,3073230000
Rumänien,2021,12,1421806000,1144454000,2566260000
Rumänien,2022,1,1626051000,1264583000,2890634000
Rumänien,2022,2,1630287000,1411488000,3041775000
Rumänien,2022,3,1857287000,1553575000,3410862000
Rumänien,2022,4,1558541000,1347207000,2905748000
Rumänien,2022,5,1801243000,1558698000,3359941000
Rumänien,2022,6,1753481000,1471762000,3225243000
Rumänien,2022,7,1685753000,1442947000,3128700000
Rumänien,2022,8,1710567000,1353662000,3064229000
Rumänien,2022,9,1936292000,1657874000,3594166000
Rumänien,2022,10,1810933000,1574488000,3385421000
Rumänien,2022,11,1947455000,1756409000,3703864000
Rumänien,2022,12,1502972000,1242718000,2745690000
Rumänien,2023,1,1838113000,1411067000,3249180000
Rumänien,2023,2,1787698000,1591952000,3379650000
Rumänien,2023,3,2080003000,1797952000,3877955000
Rumänien,2023,4,1617792000,1467240000,3085032000
Rumänien,2023,5,1853792000,1768546000,3622338000
Rumänien,2023,6,1882998000,1690166000,3573164000
Rumänien,2023,7,1812379000,1586655000,3399034000
Rumänien,2023,8,1817759000,1533948000,3351707000
Rumänien,2023,9,1923347000,1722323000,3645670000
Rumänien,2023,10,1940665000,1684386000,3625051000
Rumänien,2023,11,1975768000,1744583000,3720351000
Rumänien,2023,12,1531334000,1285050000,2816384000
Rumänien,2024,1,1910701000,1558867000,3469568000
Rumänien,2024,2,1889631000,1843239000,3732870000
Rumänien,2024,3,2026865000,1942219000,3969084000
Rumänien,2024,4,2013868000,1838953000,3852821000
Rumänien,2024,5,1867950000,1474720000,3342670000
Rumänien,2024,6,1806067000,1631964000,3438031000
Rumänien,2024,7,1860613000,1654450000,3515063000
Rumänien,2024,8,1788692000,1465382000,3254074000
Rumänien,2024,9,1929805000,1721208000,3651013000
Rumänien,2024,10,1968156000,1739271000,3707427000
Rumänien,2024,11,1824046000,1586710000,3410756000
Rumänien,2024,12,1533285000,1296217000,2829502000
Russische Föderation (ab 05/1992),2008,1,2361336000,2787856000,5149192000
Russische Föderation (ab 05/1992),2008,2,2578435000,3015916000,5594351000
Russische Föderation (ab 05/1992),2008,3,2573918000,2884999000,5458917000
Russische Föderation (ab 05/1992),2008,4,2917858000,3226549000,6144407000
Russische Föderation (ab 05/1992),2008,5,2485829000,2960970000,5446799000
Russische Föderation (ab 05/1992),2008,6,2848592000,2744668000,5593260000
Russische Föderation (ab 05/1992),2008,7,2855302000,3689104000,6544406000
Russische Föderation (ab 05/1992),2008,8,2854520000,3102962000,5957482000
Russische Föderation (ab 05/1992),2008,9,2908336000,3981893000,6890229000
Russische Föderation (ab 05/1992),2008,10,3040881000,3086157000,6127038000
Russische Föderation (ab 05/1992),2008,11,2556504000,3150571000,5707075000
Russische Föderation (ab 05/1992),2008,12,2330852000,2455142000,4785994000
Russische Föderation (ab 05/1992),2009,1,1586578000,2070947000,3657525000
Russische Föderation (ab 05/1992),2009,2,1738949000,1798511000,3537460000
Russische Föderation (ab 05/1992),2009,3,1852570000,2031344000,3883914000
Russische Föderation (ab 05/1992),2009,4,1504846000,1843130000,3347976000
Russische Föderation (ab 05/1992),2009,5,1418322000,1858295000,3276617000
Russische Föderation (ab 05/1992),2009,6,1613814000,1814000000,3427814000
Russische Föderation (ab 05/1992),2009,7,1878384000,1980141000,3858525000
Russische Föderation (ab 05/1992),2009,8,1617497000,1764659000,3382156000
Russische Föderation (ab 05/1992),2009,9,1725257000,2818861000,4544118000
Russische Föderation (ab 05/1992),2009,10,1844985000,2459868000,4304853000
Russische Föderation (ab 05/1992),2009,11,2079864000,2397054000,4476918000
Russische Föderation (ab 05/1992),2009,12,1759837000,2351019000,4110856000
Russische Föderation (ab 05/1992),2010,1,1303946000,1976260000,3280206000
Russische Föderation (ab 05/1992),2010,2,1626311000,2121836000,3748147000
Russische Föderation (ab 05/1992),2010,3,2214998000,2861996000,5076994000
Russische Föderation (ab 05/1992),2010,4,2004157000,2604138000,4608295000
Russische Föderation (ab 05/1992),2010,5,2000301000,3160552000,5160853000
Russische Föderation (ab 05/1992),2010,6,2295759000,2706838000,5002597000
Russische Föderation (ab 05/1992),2010,7,2369448000,2894433000,5263881000
Russische Föderation (ab 05/1992),2010,8,2436767000,2634479000,5071246000
Russische Föderation (ab 05/1992),2010,9,2570690000,2181131000,4751821000
Russische Föderation (ab 05/1992),2010,10,2654492000,2978958000,5633450000
Russische Föderation (ab 05/1992),2010,11,2681142000,2644597000,5325739000
Russische Föderation (ab 05/1992),2010,12,2196291000,3074935000,5271226000
Russische Föderation (ab 05/1992),2011,1,1924190000,2858840000,4783030000
Russische Föderation (ab 05/1992),2011,2,2419302000,2962764000,5382066000
Russische Föderation (ab 05/1992),2011,3,3029397000,3682644000,6712041000
Russische Föderation (ab 05/1992),2011,4,2714885000,3238832000,5953717000
Russische Föderation (ab 05/1992),2011,5,2997533000,3548919000,6546452000
Russische Föderation (ab 05/1992),2011,6,2796831000,2272710000,5069541000
Russische Föderation (ab 05/1992),2011,7,2837960000,4442939000,7280899000
Russische Föderation (ab 05/1992),2011,8,3280600000,2833094000,6113694000
Russische Föderation (ab 05/1992),2011,9,3327273000,3354433000,6681706000
Russische Föderation (ab 05/1992),2011,10,3031627000,3703097000,6734724000
Russische Föderation (ab 05/1992),2011,11,3270123000,3793761000,7063884000
Russische Föderation (ab 05/1992),2011,12,2829025000,4194167000,7023192000
Russische Föderation (ab 05/1992),2012,1,2434842000,3575468000,6010310000
Russische Föderation (ab 05/1992),2012,2,2887940000,3185314000,6073254000
Russische Föderation (ab 05/1992),2012,3,3320207000,4259959000,7580166000
Russische Föderation (ab 05/1992),2012,4,3055102000,3735835000,6790937000
Russische Föderation (ab 05/1992),2012,5,3196196000,3551427000,6747623000
Russische Föderation (ab 05/1992),2012,6,3275690000,3403677000,6679367000
Russische Föderation (ab 05/1992),2012,7,3519936000,3392954000,6912890000
Russische Föderation (ab 05/1992),2012,8,3466897000,2921971000,6388868000
Russische Föderation (ab 05/1992),2012,9,3195205000,3740326000,6935531000
Russische Föderation (ab 05/1992),2012,10,3461027000,4331512000,7792539000
Russische Föderation (ab 05/1992),2012,11,3695232000,3009162000,6704394000
Russische Föderation (ab 05/1992),2012,12,2595036000,3657449000,6252485000
Russische Föderation (ab 05/1992),2013,1,2597284000,3499058000,6096342000
Russische Föderation (ab 05/1992),2013,2,2954572000,3536513000,6491085000
Russische Föderation (ab 05/1992),2013,3,3108069000,3677162000,6785231000
Russische Föderation (ab 05/1992),2013,4,3185921000,3262921000,6448842000
Russische Föderation (ab 05/1992),2013,5,3111633000,3177461000,6289094000
Russische Föderation (ab 05/1992),2013,6,2945951000,3362779000,6308730000
Russische Föderation (ab 05/1992),2013,7,3237601000,3394965000,6632566000
Russische Föderation (ab 05/1992),2013,8,3034761000,3848183000,6882944000
Russische Föderation (ab 05/1992),2013,9,3036384000,3417982000,6454366000
Russische Föderation (ab 05/1992),2013,10,3184020000,3276531000,6460551000
Russische Föderation (ab 05/1992),2013,11,3040317000,3433834000,6474151000
Russische Föderation (ab 05/1992),2013,12,2365089000,3347058000,5712147000
Russische Föderation (ab 05/1992),2014,1,2217461000,3811338000,6028799000
Russische Föderation (ab 05/1992),2014,2,2422421000,3428489000,5850910000
Russische Föderation (ab 05/1992),2014,3,2909174000,3253784000,6162958000
Russische Föderation (ab 05/1992),2014,4,2654698000,3380302000,6035000000
Russische Föderation (ab 05/1992),2014,5,2595890000,3191472000,5787362000
Russische Föderation (ab 05/1992),2014,6,2319272000,3099391000,5418663000
Russische Föderation (ab 05/1992),2014,7,2791948000,2649172000,5441120000
Russische Föderation (ab 05/1992),2014,8,2237987000,3110795000,5348782000
Russische Föderation (ab 05/1992),2014,9,2525568000,3186706000,5712274000
Russische Föderation (ab 05/1992),2014,10,2469219000,3199575000,5668794000
Russische Föderation (ab 05/1992),2014,11,2313865000,3230026000,5543891000
Russische Föderation (ab 05/1992),2014,12,1765931000,2780652000,4546583000
Russische Föderation (ab 05/1992),2015,1,1430752000,2344358000,3775110000
Russische Föderation (ab 05/1992),2015,2,1596844000,2177197000,3774041000
Russische Föderation (ab 05/1992),2015,3,1895133000,2727667000,4622800000
Russische Föderation (ab 05/1992),2015,4,1767475000,2760822000,4528297000
Russische Föderation (ab 05/1992),2015,5,1682284000,2789925000,4472209000
Russische Föderation (ab 05/1992),2015,6,2015820000,2672663000,4688483000
Russische Föderation (ab 05/1992),2015,7,2118014000,2674484000,4792498000
Russische Föderation (ab 05/1992),2015,8,1760991000,2344207000,4105198000
Russische Föderation (ab 05/1992),2015,9,1939352000,2307074000,4246426000
Russische Föderation (ab 05/1992),2015,10,1953831000,2526435000,4480266000
Russische Föderation (ab 05/1992),2015,11,1924285000,2499151000,4423436000
Russische Föderation (ab 05/1992),2015,12,1562588000,2261672000,3824260000
Russische Föderation (ab 05/1992),2016,1,1253173000,2051173000,3304346000
Russische Föderation (ab 05/1992),2016,2,1644481000,1961193000,3605674000
Russische Föderation (ab 05/1992),2016,3,1813642000,2230404000,4044046000
Russische Föderation (ab 05/1992),2016,4,1779227000,2006245000,3785472000
Russische Föderation (ab 05/1992),2016,5,1655864000,2032238000,3688102000
Russische Föderation (ab 05/1992),2016,6,1857976000,2049846000,3907822000
Russische Föderation (ab 05/1992),2016,7,1841973000,2157587000,3999560000
Russische Föderation (ab 05/1992),2016,8,2069843000,2221211000,4291054000
Russische Föderation (ab 05/1992),2016,9,2077604000,2258947000,4336551000
Russische Föderation (ab 05/1992),2016,10,1856206000,2382319000,4238525000
Russische Föderation (ab 05/1992),2016,11,2084650000,2574609000,4659259000
Russische Föderation (ab 05/1992),2016,12,1573312000,2544474000,4117786000
Russische Föderation (ab 05/1992),2017,1,2132758000,2781987000,4914745000
Russische Föderation (ab 05/1992),2017,2,1826616000,2903558000,4730174000
Russische Föderation (ab 05/1992),2017,3,2299424000,2898972000,5198396000
Russische Föderation (ab 05/1992),2017,4,2045430000,2622492000,4667922000
Russische Föderation (ab 05/1992),2017,5,2201357000,2728905000,4930262000
Russische Föderation (ab 05/1992),2017,6,2184069000,2333315000,4517384000
Russische Föderation (ab 05/1992),2017,7,2112949000,2177505000,4290454000
Russische Föderation (ab 05/1992),2017,8,2276461000,2254432000,4530893000
Russische Föderation (ab 05/1992),2017,9,2404925000,2551538000,4956463000
Russische Föderation (ab 05/1992),2017,10,2165629000,2582634000,4748263000
Russische Föderation (ab 05/1992),2017,11,2379108000,2716166000,5095274000
Russische Föderation (ab 05/1992),2017,12,1721910000,2822773000,4544683000
Russische Föderation (ab 05/1992),2018,1,1846923000,2892941000,4739864000
Russische Föderation (ab 05/1992),2018,2,2146306000,2939415000,5085721000
Russische Föderation (ab 05/1992),2018,3,2262405000,2848906000,5111311000
Russische Föderation (ab 05/1992),2018,4,2138119000,2900001000,5038120000
Russische Föderation (ab 05/1992),2018,5,2108646000,2957183000,5065829000
Russische Föderation (ab 05/1992),2018,6,2375549000,2957559000,5333108000
Russische Föderation (ab 05/1992),2018,7,2250169000,3109656000,5359825000
Russische Föderation (ab 05/1992),2018,8,2217156000,2845986000,5063142000
Russische Föderation (ab 05/1992),2018,9,2099172000,3009683000,5108855000
Russische Föderation (ab 05/1992),2018,10,2287557000,3437632000,5725189000
Russische Föderation (ab 05/1992),2018,11,2425179000,3337351000,5762530000
Russische Föderation (ab 05/1992),2018,12,1718644000,2748265000,4466909000
Russische Föderation (ab 05/1992),2019,1,1833777000,3220570000,5054347000
Russische Föderation (ab 05/1992),2019,2,2073640000,2907836000,4981476000
Russische Föderation (ab 05/1992),2019,3,2241963000,2835231000,5077194000
Russische Föderation (ab 05/1992),2019,4,2347690000,2568963000,4916653000
Russische Föderation (ab 05/1992),2019,5,2434240000,2534413000,4968653000
Russische Föderation (ab 05/1992),2019,6,2064481000,2234219000,4298700000
Russische Föderation (ab 05/1992),2019,7,2465505000,2377985000,4843490000
Russische Föderation (ab 05/1992),2019,8,2251127000,2342361000,4593488000
Russische Föderation (ab 05/1992),2019,9,2217456000,2275770000,4493226000
Russische Föderation (ab 05/1992),2019,10,2628230000,2471977000,5100207000
Russische Föderation (ab 05/1992),2019,11,2282400000,2745380000,5027780000
Russische Föderation (ab 05/1992),2019,12,1716060000,2738252000,4454312000
Russische Föderation (ab 05/1992),2020,1,1870396000,2554381000,4424777000
Russische Föderation (ab 05/1992),2020,2,2023924000,2367053000,4390977000
Russische Föderation (ab 05/1992),2020,3,2230595000,2201893000,4432488000
Russische Föderation (ab 05/1992),2020,4,1650866000,1386699000,3037565000
Russische Föderation (ab 05/1992),2020,5,1481813000,1142294000,2624107000
Russische Föderation (ab 05/1992),2020,6,1932918000,1318478000,3251396000
Russische Föderation (ab 05/1992),2020,7,2011136000,1453823000,3464959000
Russische Föderation (ab 05/1992),2020,8,1822692000,1381572000,3204264000
Russische Föderation (ab 05/1992),2020,9,2158599000,1996709000,4155308000
Russische Föderation (ab 05/1992),2020,10,2107042000,1946601000,4053643000
Russische Föderation (ab 05/1992),2020,11,2065577000,2024917000,4090494000
Russische Föderation (ab 05/1992),2020,12,1735463000,1695200000,3430663000
Russische Föderation (ab 05/1992),2021,1,1643966000,2515200000,4159166000
Russische Föderation (ab 05/1992),2021,2,1961300000,2274071000,4235371000
Russische Föderation (ab 05/1992),2021,3,2471669000,2538898000,5010567000
Russische Föderation (ab 05/1992),2021,4,2302760000,2608077000,4910837000
Russische Föderation (ab 05/1992),2021,5,2287643000,2495996000,4783639000
Russische Föderation (ab 05/1992),2021,6,2077079000,2522878000,4599957000
Russische Föderation (ab 05/1992),2021,7,2361215000,2603652000,4964867000
Russische Föderation (ab 05/1992),2021,8,2130193000,2862067000,4992260000
Russische Föderation (ab 05/1992),2021,9,2308616000,2870639000,5179255000
Russische Föderation (ab 05/1992),2021,10,2431121000,2903966000,5335087000
Russische Föderation (ab 05/1992),2021,11,2596353000,3579609000,6175962000
Russische Föderation (ab 05/1992),2021,12,2059992000,3340855000,5400847000
Russische Föderation (ab 05/1992),2022,1,2131989000,4098691000,6230680000
Russische Föderation (ab 05/1992),2022,2,2087403000,3756773000,5844176000
Russische Föderation (ab 05/1992),2022,3,997803000,4739520000,5737323000
Russische Föderation (ab 05/1992),2022,4,781618000,3835206000,4616824000
Russische Föderation (ab 05/1992),2022,5,1100793000,3589533000,4690326000
Russische Föderation (ab 05/1992),2022,6,1171080000,3530636000,4701716000
Russische Föderation (ab 05/1992),2022,7,1012172000,2959500000,3971672000
Russische Föderation (ab 05/1992),2022,8,1147800000,2902442000,4050242000
Russische Föderation (ab 05/1992),2022,9,1096167000,1869431000,2965598000
Russische Föderation (ab 05/1992),2022,10,982759000,1832367000,2815126000
Russische Föderation (ab 05/1992),2022,11,1219345000,1579789000,2799134000
Russische Föderation (ab 05/1992),2022,12,816445000,1669485000,2485930000
Russische Föderation (ab 05/1992),2023,1,894371000,978305000,1872676000
Russische Föderation (ab 05/1992),2023,2,832795000,323951000,1156746000
Russische Föderation (ab 05/1992),2023,3,1048186000,327123000,1375309000
Russische Föderation (ab 05/1992),2023,4,725067000,298763000,1023830000
Russische Föderation (ab 05/1992),2023,5,705460000,252336000,957796000
Russische Föderation (ab 05/1992),2023,6,743179000,278997000,1022176000
Russische Föderation (ab 05/1992),2023,7,696371000,227044000,923415000
Russische Föderation (ab 05/1992),2023,8,739094000,170872000,909966000
Russische Föderation (ab 05/1992),2023,9,615070000,180698000,795768000
Russische Föderation (ab 05/1992),2023,10,610963000,195670000,806633000
Russische Föderation (ab 05/1992),2023,11,753263000,170129000,923392000
Russische Föderation (ab 05/1992),2023,12,533669000,194011000,727680000
Russische Föderation (ab 05/1992),2024,1,615350000,169363000,784713000
Russische Föderation (ab 05/1992),2024,2,676841000,204383000,881224000
Russische Föderation (ab 05/1992),2024,3,601009000,180174000,781183000
Russische Föderation (ab 05/1992),2024,4,726331000,171223000,897554000
Russische Föderation (ab 05/1992),2024,5,553075000,167130000,720205000
Russische Föderation (ab 05/1992),2024,6,555671000,170478000,726149000
Russische Föderation (ab 05/1992),2024,7,726299000,143258000,869557000
Russische Föderation (ab 05/1992),2024,8,629211000,98920000,728131000
Russische Föderation (ab 05/1992),2024,9,647808000,121754000,769562000
Russische Föderation (ab 05/1992),2024,10,628739000,151401000,780140000
Russische Föderation (ab 05/1992),2024,11,782127000,113007000,895134000
Russische Föderation (ab 05/1992),2024,12,427723000,124753000,552476000
Salomonen,2008,1,191000,10000,201000
Salomonen,2008,2,239000,2000,241000
Salomonen,2008,3,47000,38000,85000
Salomonen,2008,4,51000,0,51000
Salomonen,2008,5,135000,31000,166000
Salomonen,2008,6,1200000,6000,1206000
Salomonen,2008,7,572000,9000,581000
Salomonen,2008,8,31000,0,31000
Salomonen,2008,9,66000,49000,115000
Salomonen,2008,10,71000,0,71000
Salomonen,2008,11,15000,0,15000
Salomonen,2008,12,34000,0,34000
Salomonen,2009,1,26000,3000,29000
Salomonen,2009,2,115000,33000,148000
Salomonen,2009,3,334000,0,334000
Salomonen,2009,4,76000,13000,89000
Salomonen,2009,5,135000,1000,136000
Salomonen,2009,6,79000,0,79000
Salomonen,2009,7,33000,9000,42000
Salomonen,2009,8,68000,52000,120000
Salomonen,2009,9,4000,8000,12000
Salomonen,2009,10,5000,108000,113000
Salomonen,2009,11,15000,61000,76000
Salomonen,2009,12,36000,39000,75000
Salomonen,2010,1,7000,1000,8000
Salomonen,2010,2,21000,1000,22000
Salomonen,2010,3,0,48000,48000
Salomonen,2010,4,1000,0,1000
Salomonen,2010,5,1000,0,1000
Salomonen,2010,6,17000,8000,25000
Salomonen,2010,7,49000,0,49000
Salomonen,2010,8,2000,1544000,1546000
Salomonen,2010,9,5000,578000,583000
Salomonen,2010,10,6000,0,6000
Salomonen,2010,11,14000,896000,910000
Salomonen,2010,12,5000,2000,7000
Salomonen,2011,1,6000,0,6000
Salomonen,2011,2,0,0,0
Salomonen,2011,3,0,0,0
Salomonen,2011,4,5000,406000,411000
Salomonen,2011,5,0,718000,718000
Salomonen,2011,6,40000,4169000,4209000
Salomonen,2011,7,0,0,0
Salomonen,2011,8,0,0,0
Salomonen,2011,9,0,0,0
Salomonen,2011,10,0,0,0
Salomonen,2011,11,44000,0,44000
Salomonen,2011,12,0,0,0
Salomonen,2012,1,83000,0,83000
Salomonen,2012,2,162000,2587000,2749000
Salomonen,2012,3,1000,68000,69000
Salomonen,2012,4,0,754000,754000
Salomonen,2012,5,7000,19000,26000
Salomonen,2012,6,30000,0,30000
Salomonen,2012,7,12000,4000,16000
Salomonen,2012,8,7000,929000,936000
Salomonen,2012,9,4000,0,4000
Salomonen,2012,10,7000,0,7000
Salomonen,2012,11,19000,0,19000
Salomonen,2012,12,0,1000,1000
Salomonen,2013,1,10000,0,10000
Salomonen,2013,2,22000,3609000,3631000
Salomonen,2013,3,10000,0,10000
Salomonen,2013,4,24000,0,24000
Salomonen,2013,5,56000,0,56000
Salomonen,2013,6,7000,3161000,3168000
Salomonen,2013,7,31000,1183000,1214000
Salomonen,2013,8,1000,1318000,1319000
Salomonen,2013,9,15000,0,15000
Salomonen,2013,10,3000,2137000,2140000
Salomonen,2013,11,620000,962000,1582000
Salomonen,2013,12,1000,1732000,1733000
Salomonen,2014,1,0,26000,26000
Salomonen,2014,2,9000,0,9000
Salomonen,2014,3,35000,0,35000
Salomonen,2014,4,116000,1312000,1428000
Salomonen,2014,5,27000,19000,46000
Salomonen,2014,6,154000,27000,181000
Salomonen,2014,7,2000,0,2000
Salomonen,2014,8,20000,9000,29000
Salomonen,2014,9,13000,0,13000
Salomonen,2014,10,32000,47000,79000
Salomonen,2014,11,5000,43000,48000
Salomonen,2014,12,5000,0,5000
Salomonen,2015,1,62000,16000,78000
Salomonen,2015,2,92000,10000,102000
Salomonen,2015,3,73000,0,73000
Salomonen,2015,4,6000,3000,9000
Salomonen,2015,5,6000,0,6000
Salomonen,2015,6,1000,0,1000
Salomonen,2015,7,34000,330000,364000
Salomonen,2015,8,43000,0,43000
Salomonen,2015,9,14000,0,14000
Salomonen,2015,10,75000,0,75000
Salomonen,2015,11,6000,0,6000
Salomonen,2015,12,198000,0,198000
Salomonen,2016,1,12000,0,12000
Salomonen,2016,2,33000,0,33000
Salomonen,2016,3,348000,1000,349000
Salomonen,2016,4,22000,2122000,2144000
Salomonen,2016,5,25000,0,25000
Salomonen,2016,6,29000,95000,124000
Salomonen,2016,7,24000,0,24000
Salomonen,2016,8,22000,0,22000
Salomonen,2016,9,23000,0,23000
Salomonen,2016,10,66000,0,66000
Salomonen,2016,11,127000,0,127000
Salomonen,2016,12,23000,0,23000
Salomonen,2017,1,53000,0,53000
Salomonen,2017,2,0,3022000,3022000
Salomonen,2017,3,66000,100000,166000
Salomonen,2017,4,21000,445000,466000
Salomonen,2017,5,97000,2917000,3014000
Salomonen,2017,6,5000,0,5000
Salomonen,2017,7,44000,1000,45000
Salomonen,2017,8,64000,0,64000
Salomonen,2017,9,53000,0,53000
Salomonen,2017,10,2000,4000,6000
Salomonen,2017,11,35000,0,35000
Salomonen,2017,12,0,5000,5000
Salomonen,2018,1,23000,0,23000
Salomonen,2018,2,66000,14000,80000
Salomonen,2018,3,7000,0,7000
Salomonen,2018,4,3000,3000,6000
Salomonen,2018,5,5000,0,5000
Salomonen,2018,6,9000,0,9000
Salomonen,2018,7,81000,18000,99000
Salomonen,2018,8,25000,3000,28000
Salomonen,2018,9,6000,3000,9000
Salomonen,2018,10,24000,3000,27000
Salomonen,2018,11,3000,24000,27000
Salomonen,2018,12,6000,6000,12000
Salomonen,2019,1,3000,1000,4000
Salomonen,2019,2,13000,5000,18000
Salomonen,2019,3,22000,3000,25000
Salomonen,2019,4,105000,1000,106000
Salomonen,2019,5,2000,10000,12000
Salomonen,2019,6,36000,0,36000
Salomonen,2019,7,23000,0,23000
Salomonen,2019,8,50000,20000,70000
Salomonen,2019,9,29000,1000,30000
Salomonen,2019,10,3000,0,3000
Salomonen,2019,11,56000,0,56000
Salomonen,2019,12,30000,4000,34000
Salomonen,2020,1,13000,1000,14000
Salomonen,2020,2,24000,1000,25000
Salomonen,2020,3,49000,10000,59000
Salomonen,2020,4,6000,0,6000
Salomonen,2020,5,27000,0,27000
Salomonen,2020,6,15000,0,15000
Salomonen,2020,7,13000,0,13000
Salomonen,2020,8,4000,46000,50000
Salomonen,2020,9,4000,2000,6000
Salomonen,2020,10,10000,0,10000
Salomonen,2020,11,22000,4000,26000
Salomonen,2020,12,24000,2000,26000
Salomonen,2021,1,0,0,0
Salomonen,2021,2,13000,0,13000
Salomonen,2021,3,180000,21000,201000
Salomonen,2021,4,10000,437000,447000
Salomonen,2021,5,42000,47000,89000
Salomonen,2021,6,78000,144000,222000
Salomonen,2021,7,8000,302000,310000
Salomonen,2021,8,14000,68000,82000
Salomonen,2021,9,285000,12000,297000
Salomonen,2021,10,43000,38000,81000
Salomonen,2021,11,0,213000,213000
Salomonen,2021,12,28000,75000,103000
Salomonen,2022,1,9000,151000,160000
Salomonen,2022,2,0,184000,184000
Salomonen,2022,3,23000,140000,163000
Salomonen,2022,4,1046000,137000,1183000
Salomonen,2022,5,1000,110000,111000
Salomonen,2022,6,769000,210000,979000
Salomonen,2022,7,1000,71000,72000
Salomonen,2022,8,82000,21000,103000
Salomonen,2022,9,27000,70000,97000
Salomonen,2022,10,121000,102000,223000
Salomonen,2022,11,95000,68000,163000
Salomonen,2022,12,0,35000,35000
Salomonen,2023,1,3000,5000,8000
Salomonen,2023,2,15000,67000,82000
Salomonen,2023,3,84000,397000,481000
Salomonen,2023,4,2000,223000,225000
Salomonen,2023,5,0,33000,33000
Salomonen,2023,6,14000,139000,153000
Salomonen,2023,7,0,291000,291000
Salomonen,2023,8,46000,93000,139000
Salomonen,2023,9,1000,380000,381000
Salomonen,2023,10,2000,136000,138000
Salomonen,2023,11,10000,136000,146000
Salomonen,2023,12,4000,63000,67000
Salomonen,2024,1,0,75000,75000
Salomonen,2024,2,80000,110000,190000
Salomonen,2024,3,23000,202000,225000
Salomonen,2024,4,1000,125000,126000
Salomonen,2024,5,13000,135000,148000
Salomonen,2024,6,13000,592000,605000
Salomonen,2024,7,7000,227000,234000
Salomonen,2024,8,13000,110000,123000
Salomonen,2024,9,9000,86000,95000
Salomonen,2024,10,44000,175000,219000
Salomonen,2024,11,68000,125000,193000
Salomonen,2024,12,32000,119000,151000
Sambia,2008,1,1832000,1278000,3110000
Sambia,2008,2,4111000,1295000,5406000
Sambia,2008,3,4859000,1006000,5865000
Sambia,2008,4,3540000,1280000,4820000
Sambia,2008,5,4040000,1379000,5419000
Sambia,2008,6,3498000,1336000,4834000
Sambia,2008,7,4538000,1827000,6365000
Sambia,2008,8,3804000,1566000,5370000
Sambia,2008,9,7634000,1468000,9102000
Sambia,2008,10,3057000,1887000,4944000
Sambia,2008,11,3720000,1391000,5111000
Sambia,2008,12,2131000,2629000,4760000
Sambia,2009,1,5565000,1216000,6781000
Sambia,2009,2,1377000,739000,2116000
Sambia,2009,3,1663000,2753000,4416000
Sambia,2009,4,3034000,2711000,5745000
Sambia,2009,5,1247000,1437000,2684000
Sambia,2009,6,1536000,1414000,2950000
Sambia,2009,7,2908000,2341000,5249000
Sambia,2009,8,2441000,881000,3322000
Sambia,2009,9,2767000,2129000,4896000
Sambia,2009,10,2978000,743000,3721000
Sambia,2009,11,3875000,3105000,6980000
Sambia,2009,12,5105000,1054000,6159000
Sambia,2010,1,1587000,1083000,2670000
Sambia,2010,2,2103000,709000,2812000
Sambia,2010,3,2170000,896000,3066000
Sambia,2010,4,2157000,1635000,3792000
Sambia,2010,5,1540000,4837000,6377000
Sambia,2010,6,2069000,1070000,3139000
Sambia,2010,7,2401000,3959000,6360000
Sambia,2010,8,6952000,482000,7434000
Sambia,2010,9,2065000,879000,2944000
Sambia,2010,10,2759000,2209000,4968000
Sambia,2010,11,2573000,1241000,3814000
Sambia,2010,12,2147000,1500000,3647000
Sambia,2011,1,1898000,1439000,3337000
Sambia,2011,2,1308000,1108000,2416000
Sambia,2011,3,2554000,1603000,4157000
Sambia,2011,4,1879000,1624000,3503000
Sambia,2011,5,1905000,2794000,4699000
Sambia,2011,6,2284000,2294000,4578000
Sambia,2011,7,4034000,6843000,10877000
Sambia,2011,8,5051000,13500000,18551000
Sambia,2011,9,4934000,841000,5775000
Sambia,2011,10,9828000,1430000,11258000
Sambia,2011,11,5775000,1923000,7698000
Sambia,2011,12,4125000,1573000,5698000
Sambia,2012,1,5191000,1463000,6654000
Sambia,2012,2,2097000,1796000,3893000
Sambia,2012,3,7645000,1146000,8791000
Sambia,2012,4,7592000,1989000,9581000
Sambia,2012,5,7929000,3274000,11203000
Sambia,2012,6,13102000,2145000,15247000
Sambia,2012,7,5953000,3414000,9367000
Sambia,2012,8,5341000,6411000,11752000
Sambia,2012,9,4500000,3118000,7618000
Sambia,2012,10,3670000,4226000,7896000
Sambia,2012,11,19451000,3980000,23431000
Sambia,2012,12,6557000,1310000,7867000
Sambia,2013,1,7312000,6434000,13746000
Sambia,2013,2,22298000,1744000,24042000
Sambia,2013,3,19820000,2111000,21931000
Sambia,2013,4,14482000,1894000,16376000
Sambia,2013,5,7318000,1724000,9042000
Sambia,2013,6,17751000,2269000,20020000
Sambia,2013,7,12264000,5184000,17448000
Sambia,2013,8,19739000,1254000,20993000
Sambia,2013,9,15451000,1994000,17445000
Sambia,2013,10,5469000,2322000,7791000
Sambia,2013,11,5990000,2316000,8306000
Sambia,2013,12,5372000,2791000,8163000
Sambia,2014,1,9656000,697000,10353000
Sambia,2014,2,12142000,1792000,13934000
Sambia,2014,3,11576000,1740000,13316000
Sambia,2014,4,4701000,688000,5389000
Sambia,2014,5,9715000,2081000,11796000
Sambia,2014,6,5153000,6536000,11689000
Sambia,2014,7,4248000,2440000,6688000
Sambia,2014,8,5759000,1408000,7167000
Sambia,2014,9,4918000,3257000,8175000
Sambia,2014,10,3574000,1327000,4901000
Sambia,2014,11,3611000,1809000,5420000
Sambia,2014,12,3642000,794000,4436000
Sambia,2015,1,1922000,1300000,3222000
Sambia,2015,2,6325000,2045000,8370000
Sambia,2015,3,3205000,935000,4140000
Sambia,2015,4,7597000,515000,8112000
Sambia,2015,5,10103000,3602000,13705000
Sambia,2015,6,4458000,1733000,6191000
Sambia,2015,7,4106000,1876000,5982000
Sambia,2015,8,4033000,3561000,7594000
Sambia,2015,9,3809000,1428000,5237000
Sambia,2015,10,1945000,1879000,3824000
Sambia,2015,11,2239000,5740000,7979000
Sambia,2015,12,8151000,1050000,9201000
Sambia,2016,1,5480000,578000,6058000
Sambia,2016,2,4726000,1238000,5964000
Sambia,2016,3,5940000,1278000,7218000
Sambia,2016,4,4191000,505000,4696000
Sambia,2016,5,3577000,1334000,4911000
Sambia,2016,6,5272000,5923000,11195000
Sambia,2016,7,4120000,5587000,9707000
Sambia,2016,8,4617000,5905000,10522000
Sambia,2016,9,3974000,1429000,5403000
Sambia,2016,10,3446000,2909000,6355000
Sambia,2016,11,3347000,7634000,10981000
Sambia,2016,12,6319000,1488000,7807000
Sambia,2017,1,3302000,4573000,7875000
Sambia,2017,2,2858000,5596000,8454000
Sambia,2017,3,4029000,4775000,8804000
Sambia,2017,4,6109000,1746000,7855000
Sambia,2017,5,12892000,3122000,16014000
Sambia,2017,6,6324000,4917000,11241000
Sambia,2017,7,4176000,3281000,7457000
Sambia,2017,8,2767000,2461000,5228000
Sambia,2017,9,3533000,10642000,14175000
Sambia,2017,10,2493000,6567000,9060000
Sambia,2017,11,6013000,4943000,10956000
Sambia,2017,12,2958000,1378000,4336000
Sambia,2018,1,3650000,2411000,6061000
Sambia,2018,2,4494000,4673000,9167000
Sambia,2018,3,3416000,7104000,10520000
Sambia,2018,4,5550000,6346000,11896000
Sambia,2018,5,4554000,5686000,10240000
Sambia,2018,6,5336000,4399000,9735000
Sambia,2018,7,9503000,3454000,12957000
Sambia,2018,8,4747000,3592000,8339000
Sambia,2018,9,4481000,6406000,10887000
Sambia,2018,10,9642000,8543000,18185000
Sambia,2018,11,6815000,2712000,9527000
Sambia,2018,12,3603000,5947000,9550000
Sambia,2019,1,3131000,15633000,18764000
Sambia,2019,2,4712000,7926000,12638000
Sambia,2019,3,5970000,6541000,12511000
Sambia,2019,4,7191000,14737000,21928000
Sambia,2019,5,8828000,2793000,11621000
Sambia,2019,6,2865000,2227000,5092000
Sambia,2019,7,6534000,12079000,18613000
Sambia,2019,8,3540000,1610000,5150000
Sambia,2019,9,8374000,7843000,16217000
Sambia,2019,10,6308000,2449000,8757000
Sambia,2019,11,2852000,1928000,4780000
Sambia,2019,12,3612000,1923000,5535000
Sambia,2020,1,2022000,7367000,9389000
Sambia,2020,2,3308000,4499000,7807000
Sambia,2020,3,2424000,3438000,5862000
Sambia,2020,4,3253000,9095000,12348000
Sambia,2020,5,4059000,2639000,6698000
Sambia,2020,6,2346000,21127000,23473000
Sambia,2020,7,5276000,2891000,8167000
Sambia,2020,8,2631000,2045000,4676000
Sambia,2020,9,2976000,4292000,7268000
Sambia,2020,10,3954000,12625000,16579000
Sambia,2020,11,6902000,1967000,8869000
Sambia,2020,12,2169000,1641000,3810000
Sambia,2021,1,3322000,1366000,4688000
Sambia,2021,2,2817000,1799000,4616000
Sambia,2021,3,3266000,2797000,6063000
Sambia,2021,4,4658000,15351000,20009000
Sambia,2021,5,5191000,2410000,7601000
Sambia,2021,6,3314000,1995000,5309000
Sambia,2021,7,3584000,5796000,9380000
Sambia,2021,8,3895000,5194000,9089000
Sambia,2021,9,3144000,4080000,7224000
Sambia,2021,10,2925000,12329000,15254000
Sambia,2021,11,4369000,10522000,14891000
Sambia,2021,12,2981000,11213000,14194000
Sambia,2022,1,2719000,2373000,5092000
Sambia,2022,2,3114000,5199000,8313000
Sambia,2022,3,3393000,4212000,7605000
Sambia,2022,4,6134000,9083000,15217000
Sambia,2022,5,6112000,3792000,9904000
Sambia,2022,6,3280000,4957000,8237000
Sambia,2022,7,5103000,3349000,8452000
Sambia,2022,8,7271000,3459000,10730000
Sambia,2022,9,4880000,3155000,8035000
Sambia,2022,10,2517000,11556000,14073000
Sambia,2022,11,2667000,3519000,6186000
Sambia,2022,12,3028000,2844000,5872000
Sambia,2023,1,2368000,7063000,9431000
Sambia,2023,2,4657000,2538000,7195000
Sambia,2023,3,4240000,4914000,9154000
Sambia,2023,4,4952000,5628000,10580000
Sambia,2023,5,5997000,2985000,8982000
Sambia,2023,6,2955000,5383000,8338000
Sambia,2023,7,3228000,4344000,7572000
Sambia,2023,8,5383000,4514000,9897000
Sambia,2023,9,3470000,3128000,6598000
Sambia,2023,10,4126000,7334000,11460000
Sambia,2023,11,11980000,6668000,18648000
Sambia,2023,12,8948000,1926000,10874000
Sambia,2024,1,5301000,2968000,8269000
Sambia,2024,2,19677000,1043000,20720000
Sambia,2024,3,5323000,1311000,6634000
Sambia,2024,4,18221000,3858000,22079000
Sambia,2024,5,4977000,4230000,9207000
Sambia,2024,6,4120000,2477000,6597000
Sambia,2024,7,10180000,4600000,14780000
Sambia,2024,8,4266000,2957000,7223000
Sambia,2024,9,11160000,2831000,13991000
Sambia,2024,10,7706000,4354000,12060000
Sambia,2024,11,2597000,2088000,4685000
Sambia,2024,12,3712000,1740000,5452000
Samoa,2008,1,89000,14000,103000
Samoa,2008,2,0,0,0
Samoa,2008,3,310000,17000,327000
Samoa,2008,4,32000,0,32000
Samoa,2008,5,70000,0,70000
Samoa,2008,6,0,0,0
Samoa,2008,7,207000,3000,210000
Samoa,2008,8,124000,0,124000
Samoa,2008,9,7000,1000,8000
Samoa,2008,10,40000,0,40000
Samoa,2008,11,27000,4000,31000
Samoa,2008,12,20000,0,20000
Samoa,2009,1,259000,1000,260000
Samoa,2009,2,20000,0,20000
Samoa,2009,3,30000,0,30000
Samoa,2009,4,9000,0,9000
Samoa,2009,5,50000,1000,51000
Samoa,2009,6,2000,5000,7000
Samoa,2009,7,47000,0,47000
Samoa,2009,8,19000,0,19000
Samoa,2009,9,3000,0,3000
Samoa,2009,10,22000,0,22000
Samoa,2009,11,7000,0,7000
Samoa,2009,12,12000,0,12000
Samoa,2010,1,16000,0,16000
Samoa,2010,2,10000,0,10000
Samoa,2010,3,63000,0,63000
Samoa,2010,4,102000,0,102000
Samoa,2010,5,4000,0,4000
Samoa,2010,6,26000,0,26000
Samoa,2010,7,13000,0,13000
Samoa,2010,8,33000,0,33000
Samoa,2010,9,7000,0,7000
Samoa,2010,10,116000,40000,156000
Samoa,2010,11,6000,74000,80000
Samoa,2010,12,13000,0,13000
Samoa,2011,1,39000,0,39000
Samoa,2011,2,29000,0,29000
Samoa,2011,3,77000,20000,97000
Samoa,2011,4,36000,0,36000
Samoa,2011,5,22000,0,22000
Samoa,2011,6,21000,0,21000
Samoa,2011,7,26000,7000,33000
Samoa,2011,8,5000,0,5000
Samoa,2011,9,7000,402000,409000
Samoa,2011,10,10000,0,10000
Samoa,2011,11,1000,0,1000
Samoa,2011,12,34000,46000,80000
Samoa,2012,1,26000,0,26000
Samoa,2012,2,5000,0,5000
Samoa,2012,3,2000,45000,47000
Samoa,2012,4,0,1000,1000
Samoa,2012,5,14000,0,14000
Samoa,2012,6,5000,29000,34000
Samoa,2012,7,36000,0,36000
Samoa,2012,8,9000,29000,38000
Samoa,2012,9,26000,0,26000
Samoa,2012,10,10000,0,10000
Samoa,2012,11,90000,0,90000
Samoa,2012,12,0,0,0
Samoa,2013,1,18000,0,18000
Samoa,2013,2,5000,29000,34000
Samoa,2013,3,2000,29000,31000
Samoa,2013,4,2000,0,2000
Samoa,2013,5,5000,0,5000
Samoa,2013,6,0,29000,29000
Samoa,2013,7,36000,0,36000
Samoa,2013,8,25000,29000,54000
Samoa,2013,9,508000,0,508000
Samoa,2013,10,16000,29000,45000
Samoa,2013,11,15000,0,15000
Samoa,2013,12,34000,0,34000
Samoa,2014,1,128000,29000,157000
Samoa,2014,2,5000,0,5000
Samoa,2014,3,23000,29000,52000
Samoa,2014,4,0,0,0
Samoa,2014,5,233000,0,233000
Samoa,2014,6,29000,29000,58000
Samoa,2014,7,325000,0,325000
Samoa,2014,8,23000,0,23000
Samoa,2014,9,18000,29000,47000
Samoa,2014,10,0,0,0
Samoa,2014,11,248000,0,248000
Samoa,2014,12,87000,58000,145000
Samoa,2015,1,13000,0,13000
Samoa,2015,2,36000,29000,65000
Samoa,2015,3,92000,0,92000
Samoa,2015,4,3000,54000,57000
Samoa,2015,5,12000,0,12000
Samoa,2015,6,19000,58000,77000
Samoa,2015,7,15000,0,15000
Samoa,2015,8,124000,0,124000
Samoa,2015,9,16000,29000,45000
Samoa,2015,10,398000,29000,427000
Samoa,2015,11,1000,0,1000
Samoa,2015,12,151000,1000,152000
Samoa,2016,1,5000,0,5000
Samoa,2016,2,37000,0,37000
Samoa,2016,3,0,0,0
Samoa,2016,4,937000,31000,968000
Samoa,2016,5,25000,0,25000
Samoa,2016,6,55000,98000,153000
Samoa,2016,7,51000,55000,106000
Samoa,2016,8,2000,63000,65000
Samoa,2016,9,20000,0,20000
Samoa,2016,10,12000,31000,43000
Samoa,2016,11,13000,78000,91000
Samoa,2016,12,18000,22000,40000
Samoa,2017,1,47000,31000,78000
Samoa,2017,2,15000,0,15000
Samoa,2017,3,10000,0,10000
Samoa,2017,4,13000,31000,44000
Samoa,2017,5,98000,0,98000
Samoa,2017,6,15000,0,15000
Samoa,2017,7,11000,0,11000
Samoa,2017,8,165000,51000,216000
Samoa,2017,9,51000,0,51000
Samoa,2017,10,14000,31000,45000
Samoa,2017,11,31000,0,31000
Samoa,2017,12,87000,0,87000
Samoa,2018,1,875000,31000,906000
Samoa,2018,2,429000,0,429000
Samoa,2018,3,31000,31000,62000
Samoa,2018,4,4000,0,4000
Samoa,2018,5,5000,61000,66000
Samoa,2018,6,425000,0,425000
Samoa,2018,7,1000,31000,32000
Samoa,2018,8,0,6000,6000
Samoa,2018,9,5000,0,5000
Samoa,2018,10,4000,50000,54000
Samoa,2018,11,7000,82000,89000
Samoa,2018,12,12000,34000,46000
Samoa,2019,1,397000,34000,431000
Samoa,2019,2,584000,0,584000
Samoa,2019,3,62000,33000,95000
Samoa,2019,4,7000,48000,55000
Samoa,2019,5,0,33000,33000
Samoa,2019,6,0,33000,33000
Samoa,2019,7,49000,0,49000
Samoa,2019,8,0,33000,33000
Samoa,2019,9,33000,0,33000
Samoa,2019,10,1516000,37000,1553000
Samoa,2019,11,20000,49000,69000
Samoa,2019,12,190000,0,190000
Samoa,2020,1,0,0,0
Samoa,2020,2,2000,33000,35000
Samoa,2020,3,2000,18000,20000
Samoa,2020,4,0,48000,48000
Samoa,2020,5,44000,9000,53000
Samoa,2020,6,174000,35000,209000
Samoa,2020,7,0,81000,81000
Samoa,2020,8,8000,0,8000
Samoa,2020,9,8000,0,8000
Samoa,2020,10,0,33000,33000
Samoa,2020,11,1000,0,1000
Samoa,2020,12,0,0,0
Samoa,2021,1,335000,0,335000
Samoa,2021,2,0,33000,33000
Samoa,2021,3,175000,0,175000
Samoa,2021,4,113000,17000,130000
Samoa,2021,5,3000,0,3000
Samoa,2021,6,27000,1000,28000
Samoa,2021,7,1743000,1000,1744000
Samoa,2021,8,165000,33000,198000
Samoa,2021,9,24000,0,24000
Samoa,2021,10,0,1000,1000
Samoa,2021,11,66000,48000,114000
Samoa,2021,12,0,3000,3000
Samoa,2022,1,0,18000,18000
Samoa,2022,2,22000,49000,71000
Samoa,2022,3,495000,0,495000
Samoa,2022,4,285000,8000,293000
Samoa,2022,5,0,34000,34000
Samoa,2022,6,13000,42000,55000
Samoa,2022,7,0,0,0
Samoa,2022,8,74000,121000,195000
Samoa,2022,9,0,0,0
Samoa,2022,10,23000,49000,72000
Samoa,2022,11,1000,0,1000
Samoa,2022,12,1000,0,1000
Samoa,2023,1,70000,45000,115000
Samoa,2023,2,13000,0,13000
Samoa,2023,3,92000,45000,137000
Samoa,2023,4,37000,0,37000
Samoa,2023,5,2000,64000,66000
Samoa,2023,6,245000,0,245000
Samoa,2023,7,7000,45000,52000
Samoa,2023,8,16000,0,16000
Samoa,2023,9,3000,0,3000
Samoa,2023,10,3000,0,3000
Samoa,2023,11,1000,0,1000
Samoa,2023,12,25000,40000,65000
Samoa,2024,1,863000,35000,898000
Samoa,2024,2,10000,0,10000
Samoa,2024,3,143000,0,143000
Samoa,2024,4,3000,0,3000
Samoa,2024,5,0,16000,16000
Samoa,2024,6,64000,0,64000
Samoa,2024,7,6000,97000,103000
Samoa,2024,8,109000,3000,112000
Samoa,2024,9,19000,45000,64000
Samoa,2024,10,0,0,0
Samoa,2024,11,0,24000,24000
Samoa,2024,12,79000,45000,124000
San Marino (ab 1994),2008,1,3377000,657000,4034000
San Marino (ab 1994),2008,2,3726000,639000,4365000
San Marino (ab 1994),2008,3,3564000,1013000,4577000
San Marino (ab 1994),2008,4,3861000,647000,4508000
San Marino (ab 1994),2008,5,2710000,803000,3513000
San Marino (ab 1994),2008,6,4426000,1091000,5517000
San Marino (ab 1994),2008,7,3294000,946000,4240000
San Marino (ab 1994),2008,8,2331000,818000,3149000
San Marino (ab 1994),2008,9,4546000,789000,5335000
San Marino (ab 1994),2008,10,4774000,531000,5305000
San Marino (ab 1994),2008,11,3001000,590000,3591000
San Marino (ab 1994),2008,12,2569000,497000,3066000
San Marino (ab 1994),2009,1,3207000,441000,3648000
San Marino (ab 1994),2009,2,3413000,586000,3999000
San Marino (ab 1994),2009,3,3498000,732000,4230000
San Marino (ab 1994),2009,4,3050000,577000,3627000
San Marino (ab 1994),2009,5,1689000,832000,2521000
San Marino (ab 1994),2009,6,2801000,526000,3327000
San Marino (ab 1994),2009,7,2630000,744000,3374000
San Marino (ab 1994),2009,8,2074000,305000,2379000
San Marino (ab 1994),2009,9,1397000,392000,1789000
San Marino (ab 1994),2009,10,1972000,697000,2669000
San Marino (ab 1994),2009,11,4759000,941000,5700000
San Marino (ab 1994),2009,12,2571000,815000,3386000
San Marino (ab 1994),2010,1,3338000,311000,3649000
San Marino (ab 1994),2010,2,3959000,416000,4375000
San Marino (ab 1994),2010,3,3393000,1279000,4672000
San Marino (ab 1994),2010,4,2149000,389000,2538000
San Marino (ab 1994),2010,5,2014000,559000,2573000
San Marino (ab 1994),2010,6,2453000,797000,3250000
San Marino (ab 1994),2010,7,2601000,564000,3165000
San Marino (ab 1994),2010,8,1399000,538000,1937000
San Marino (ab 1994),2010,9,3479000,706000,4185000
San Marino (ab 1994),2010,10,2776000,464000,3240000
San Marino (ab 1994),2010,11,3988000,355000,4343000
San Marino (ab 1994),2010,12,3667000,496000,4163000
San Marino (ab 1994),2011,1,3404000,616000,4020000
San Marino (ab 1994),2011,2,3269000,530000,3799000
San Marino (ab 1994),2011,3,3057000,618000,3675000
San Marino (ab 1994),2011,4,3450000,538000,3988000
San Marino (ab 1994),2011,5,2821000,618000,3439000
San Marino (ab 1994),2011,6,2844000,666000,3510000
San Marino (ab 1994),2011,7,2981000,588000,3569000
San Marino (ab 1994),2011,8,1837000,359000,2196000
San Marino (ab 1994),2011,9,2351000,428000,2779000
San Marino (ab 1994),2011,10,2745000,778000,3523000
San Marino (ab 1994),2011,11,2203000,603000,2806000
San Marino (ab 1994),2011,12,2172000,790000,2962000
San Marino (ab 1994),2012,1,2273000,498000,2771000
San Marino (ab 1994),2012,2,2299000,440000,2739000
San Marino (ab 1994),2012,3,2639000,645000,3284000
San Marino (ab 1994),2012,4,4277000,814000,5091000
San Marino (ab 1994),2012,5,2372000,457000,2829000
San Marino (ab 1994),2012,6,2602000,836000,3438000
San Marino (ab 1994),2012,7,3613000,543000,4156000
San Marino (ab 1994),2012,8,1837000,455000,2292000
San Marino (ab 1994),2012,9,2460000,676000,3136000
San Marino (ab 1994),2012,10,2882000,691000,3573000
San Marino (ab 1994),2012,11,2094000,836000,2930000
San Marino (ab 1994),2012,12,2168000,672000,2840000
San Marino (ab 1994),2013,1,2940000,481000,3421000
San Marino (ab 1994),2013,2,2316000,801000,3117000
San Marino (ab 1994),2013,3,1994000,640000,2634000
San Marino (ab 1994),2013,4,2205000,624000,2829000
San Marino (ab 1994),2013,5,2089000,531000,2620000
San Marino (ab 1994),2013,6,2018000,787000,2805000
San Marino (ab 1994),2013,7,2631000,1000000,3631000
San Marino (ab 1994),2013,8,1254000,434000,1688000
San Marino (ab 1994),2013,9,2121000,696000,2817000
San Marino (ab 1994),2013,10,2480000,630000,3110000
San Marino (ab 1994),2013,11,2482000,592000,3074000
San Marino (ab 1994),2013,12,1692000,814000,2506000
San Marino (ab 1994),2014,1,3050000,947000,3997000
San Marino (ab 1994),2014,2,3346000,732000,4078000
San Marino (ab 1994),2014,3,5641000,709000,6350000
San Marino (ab 1994),2014,4,2652000,566000,3218000
San Marino (ab 1994),2014,5,3006000,840000,3846000
San Marino (ab 1994),2014,6,2233000,669000,2902000
San Marino (ab 1994),2014,7,3368000,861000,4229000
San Marino (ab 1994),2014,8,1315000,607000,1922000
San Marino (ab 1994),2014,9,2440000,684000,3124000
San Marino (ab 1994),2014,10,2688000,1173000,3861000
San Marino (ab 1994),2014,11,2940000,857000,3797000
San Marino (ab 1994),2014,12,1820000,704000,2524000
San Marino (ab 1994),2015,1,2427000,609000,3036000
San Marino (ab 1994),2015,2,3433000,997000,4430000
San Marino (ab 1994),2015,3,4559000,987000,5546000
San Marino (ab 1994),2015,4,3416000,983000,4399000
San Marino (ab 1994),2015,5,3449000,847000,4296000
San Marino (ab 1994),2015,6,8357000,997000,9354000
San Marino (ab 1994),2015,7,3528000,770000,4298000
San Marino (ab 1994),2015,8,1690000,517000,2207000
San Marino (ab 1994),2015,9,3093000,649000,3742000
San Marino (ab 1994),2015,10,3603000,668000,4271000
San Marino (ab 1994),2015,11,2702000,654000,3356000
San Marino (ab 1994),2015,12,1924000,662000,2586000
San Marino (ab 1994),2016,1,2581000,946000,3527000
San Marino (ab 1994),2016,2,3620000,694000,4314000
San Marino (ab 1994),2016,3,3590000,847000,4437000
San Marino (ab 1994),2016,4,3479000,773000,4252000
San Marino (ab 1994),2016,5,3250000,655000,3905000
San Marino (ab 1994),2016,6,3515000,800000,4315000
San Marino (ab 1994),2016,7,3170000,803000,3973000
San Marino (ab 1994),2016,8,1694000,455000,2149000
San Marino (ab 1994),2016,9,2621000,855000,3476000
San Marino (ab 1994),2016,10,4562000,706000,5268000
San Marino (ab 1994),2016,11,4179000,877000,5056000
San Marino (ab 1994),2016,12,3381000,875000,4256000
San Marino (ab 1994),2017,1,4117000,780000,4897000
San Marino (ab 1994),2017,2,4188000,927000,5115000
San Marino (ab 1994),2017,3,4687000,1229000,5916000
San Marino (ab 1994),2017,4,3875000,901000,4776000
San Marino (ab 1994),2017,5,3892000,900000,4792000
San Marino (ab 1994),2017,6,4064000,666000,4730000
San Marino (ab 1994),2017,7,3858000,1032000,4890000
San Marino (ab 1994),2017,8,1964000,1027000,2991000
San Marino (ab 1994),2017,9,3420000,1149000,4569000
San Marino (ab 1994),2017,10,3466000,973000,4439000
San Marino (ab 1994),2017,11,3387000,833000,4220000
San Marino (ab 1994),2017,12,3231000,900000,4131000
San Marino (ab 1994),2018,1,3832000,678000,4510000
San Marino (ab 1994),2018,2,4397000,764000,5161000
San Marino (ab 1994),2018,3,4404000,831000,5235000
San Marino (ab 1994),2018,4,4562000,987000,5549000
San Marino (ab 1994),2018,5,3798000,991000,4789000
San Marino (ab 1994),2018,6,3785000,1659000,5444000
San Marino (ab 1994),2018,7,4340000,1116000,5456000
San Marino (ab 1994),2018,8,3516000,524000,4040000
San Marino (ab 1994),2018,9,3562000,962000,4524000
San Marino (ab 1994),2018,10,9975000,971000,10946000
San Marino (ab 1994),2018,11,4014000,1021000,5035000
San Marino (ab 1994),2018,12,1751000,1027000,2778000
San Marino (ab 1994),2019,1,4694000,989000,5683000
San Marino (ab 1994),2019,2,10173000,1123000,11296000
San Marino (ab 1994),2019,3,8147000,918000,9065000
San Marino (ab 1994),2019,4,5861000,732000,6593000
San Marino (ab 1994),2019,5,3715000,886000,4601000
San Marino (ab 1994),2019,6,3035000,780000,3815000
San Marino (ab 1994),2019,7,3357000,1227000,4584000
San Marino (ab 1994),2019,8,2139000,675000,2814000
San Marino (ab 1994),2019,9,3852000,1095000,4947000
San Marino (ab 1994),2019,10,4217000,706000,4923000
San Marino (ab 1994),2019,11,6180000,937000,7117000
San Marino (ab 1994),2019,12,2291000,1038000,3329000
San Marino (ab 1994),2020,1,4178000,792000,4970000
San Marino (ab 1994),2020,2,4245000,996000,5241000
San Marino (ab 1994),2020,3,2953000,1074000,4027000
San Marino (ab 1994),2020,4,2118000,474000,2592000
San Marino (ab 1994),2020,5,2951000,718000,3669000
San Marino (ab 1994),2020,6,3336000,1178000,4514000
San Marino (ab 1994),2020,7,3634000,771000,4405000
San Marino (ab 1994),2020,8,2129000,794000,2923000
San Marino (ab 1994),2020,9,4657000,705000,5362000
San Marino (ab 1994),2020,10,5661000,926000,6587000
San Marino (ab 1994),2020,11,4989000,834000,5823000
San Marino (ab 1994),2020,12,3888000,911000,4799000
San Marino (ab 1994),2021,1,3492000,915000,4407000
San Marino (ab 1994),2021,2,4240000,857000,5097000
San Marino (ab 1994),2021,3,7590000,1018000,8608000
San Marino (ab 1994),2021,4,4943000,1125000,6068000
San Marino (ab 1994),2021,5,4338000,935000,5273000
San Marino (ab 1994),2021,6,5669000,987000,6656000
San Marino (ab 1994),2021,7,5922000,643000,6565000
San Marino (ab 1994),2021,8,3606000,577000,4183000
San Marino (ab 1994),2021,9,5662000,1181000,6843000
San Marino (ab 1994),2021,10,7871000,793000,8664000
San Marino (ab 1994),2021,11,7127000,1140000,8267000
San Marino (ab 1994),2021,12,7686000,1196000,8882000
San Marino (ab 1994),2022,1,6925000,670000,7595000
San Marino (ab 1994),2022,2,7249000,908000,8157000
San Marino (ab 1994),2022,3,8105000,3442000,11547000
San Marino (ab 1994),2022,4,6582000,3108000,9690000
San Marino (ab 1994),2022,5,7902000,1600000,9502000
San Marino (ab 1994),2022,6,7789000,1018000,8807000
San Marino (ab 1994),2022,7,6355000,1131000,7486000
San Marino (ab 1994),2022,8,4588000,841000,5429000
San Marino (ab 1994),2022,9,7594000,968000,8562000
San Marino (ab 1994),2022,10,6683000,1672000,8355000
San Marino (ab 1994),2022,11,7001000,990000,7991000
San Marino (ab 1994),2022,12,5232000,1369000,6601000
San Marino (ab 1994),2023,1,7003000,552000,7555000
San Marino (ab 1994),2023,2,8603000,772000,9375000
San Marino (ab 1994),2023,3,8607000,1188000,9795000
San Marino (ab 1994),2023,4,6900000,800000,7700000
San Marino (ab 1994),2023,5,7550000,1258000,8808000
San Marino (ab 1994),2023,6,7317000,1438000,8755000
San Marino (ab 1994),2023,7,8492000,1162000,9654000
San Marino (ab 1994),2023,8,5719000,1207000,6926000
San Marino (ab 1994),2023,9,7925000,1254000,9179000
San Marino (ab 1994),2023,10,6960000,12904000,19864000
San Marino (ab 1994),2023,11,7695000,790000,8485000
San Marino (ab 1994),2023,12,5397000,1020000,6417000
San Marino (ab 1994),2024,1,9074000,938000,10012000
San Marino (ab 1994),2024,2,9450000,1437000,10887000
San Marino (ab 1994),2024,3,8554000,1575000,10129000
San Marino (ab 1994),2024,4,7064000,1646000,8710000
San Marino (ab 1994),2024,5,6585000,1844000,8429000
San Marino (ab 1994),2024,6,7348000,1590000,8938000
San Marino (ab 1994),2024,7,25178000,1386000,26564000
San Marino (ab 1994),2024,8,5014000,899000,5913000
San Marino (ab 1994),2024,9,6398000,1483000,7881000
San Marino (ab 1994),2024,10,7023000,960000,7983000
San Marino (ab 1994),2024,11,7228000,1258000,8486000
San Marino (ab 1994),2024,12,4590000,854000,5444000
Sao Tome und Principe,2008,1,11000,0,11000
Sao Tome und Principe,2008,2,4000,0,4000
Sao Tome und Principe,2008,3,18000,1000,19000
Sao Tome und Principe,2008,4,46000,21000,67000
Sao Tome und Principe,2008,5,14000,0,14000
Sao Tome und Principe,2008,6,44000,0,44000
Sao Tome und Principe,2008,7,2000,0,2000
Sao Tome und Principe,2008,8,218000,3000,221000
Sao Tome und Principe,2008,9,74000,0,74000
Sao Tome und Principe,2008,10,0,0,0
Sao Tome und Principe,2008,11,37000,129000,166000
Sao Tome und Principe,2008,12,169000,8000,177000
Sao Tome und Principe,2009,1,17000,1000,18000
Sao Tome und Principe,2009,2,22000,0,22000
Sao Tome und Principe,2009,3,83000,109000,192000
Sao Tome und Principe,2009,4,24000,14000,38000
Sao Tome und Principe,2009,5,17000,4000,21000
Sao Tome und Principe,2009,6,23000,19000,42000
Sao Tome und Principe,2009,7,82000,7000,89000
Sao Tome und Principe,2009,8,3000,21000,24000
Sao Tome und Principe,2009,9,86000,4000,90000
Sao Tome und Principe,2009,10,57000,0,57000
Sao Tome und Principe,2009,11,64000,0,64000
Sao Tome und Principe,2009,12,38000,2000,40000
Sao Tome und Principe,2010,1,20000,0,20000
Sao Tome und Principe,2010,2,16000,14000,30000
Sao Tome und Principe,2010,3,83000,0,83000
Sao Tome und Principe,2010,4,42000,0,42000
Sao Tome und Principe,2010,5,17000,0,17000
Sao Tome und Principe,2010,6,32000,0,32000
Sao Tome und Principe,2010,7,48000,2000,50000
Sao Tome und Principe,2010,8,38000,0,38000
Sao Tome und Principe,2010,9,56000,0,56000
Sao Tome und Principe,2010,10,20000,0,20000
Sao Tome und Principe,2010,11,16000,18000,34000
Sao Tome und Principe,2010,12,26000,0,26000
Sao Tome und Principe,2011,1,12000,0,12000
Sao Tome und Principe,2011,2,20000,2000,22000
Sao Tome und Principe,2011,3,17000,13000,30000
Sao Tome und Principe,2011,4,17000,0,17000
Sao Tome und Principe,2011,5,34000,100000,134000
Sao Tome und Principe,2011,6,47000,12000,59000
Sao Tome und Principe,2011,7,9000,0,9000
Sao Tome und Principe,2011,8,26000,0,26000
Sao Tome und Principe,2011,9,59000,0,59000
Sao Tome und Principe,2011,10,14000,0,14000
Sao Tome und Principe,2011,11,70000,7000,77000
Sao Tome und Principe,2011,12,50000,0,50000
Sao Tome und Principe,2012,1,4000,0,4000
Sao Tome und Principe,2012,2,47000,0,47000
Sao Tome und Principe,2012,3,2000,3000,5000
Sao Tome und Principe,2012,4,16000,0,16000
Sao Tome und Principe,2012,5,51000,0,51000
Sao Tome und Principe,2012,6,43000,0,43000
Sao Tome und Principe,2012,7,109000,57000,166000
Sao Tome und Principe,2012,8,14000,0,14000
Sao Tome und Principe,2012,9,33000,0,33000
Sao Tome und Principe,2012,10,68000,87000,155000
Sao Tome und Principe,2012,11,139000,18000,157000
Sao Tome und Principe,2012,12,51000,1000,52000
Sao Tome und Principe,2013,1,134000,33000,167000
Sao Tome und Principe,2013,2,443000,3000,446000
Sao Tome und Principe,2013,3,10000,89000,99000
Sao Tome und Principe,2013,4,46000,121000,167000
Sao Tome und Principe,2013,5,49000,41000,90000
Sao Tome und Principe,2013,6,78000,125000,203000
Sao Tome und Principe,2013,7,37000,72000,109000
Sao Tome und Principe,2013,8,20000,18000,38000
Sao Tome und Principe,2013,9,157000,33000,190000
Sao Tome und Principe,2013,10,185000,12000,197000
Sao Tome und Principe,2013,11,178000,9000,187000
Sao Tome und Principe,2013,12,49000,6000,55000
Sao Tome und Principe,2014,1,0,0,0
Sao Tome und Principe,2014,2,37000,197000,234000
Sao Tome und Principe,2014,3,20000,104000,124000
Sao Tome und Principe,2014,4,54000,0,54000
Sao Tome und Principe,2014,5,37000,0,37000
Sao Tome und Principe,2014,6,47000,0,47000
Sao Tome und Principe,2014,7,76000,44000,120000
Sao Tome und Principe,2014,8,65000,223000,288000
Sao Tome und Principe,2014,9,58000,0,58000
Sao Tome und Principe,2014,10,65000,0,65000
Sao Tome und Principe,2014,11,140000,109000,249000
Sao Tome und Principe,2014,12,128000,0,128000
Sao Tome und Principe,2015,1,39000,0,39000
Sao Tome und Principe,2015,2,37000,0,37000
Sao Tome und Principe,2015,3,40000,0,40000
Sao Tome und Principe,2015,4,17000,0,17000
Sao Tome und Principe,2015,5,89000,0,89000
Sao Tome und Principe,2015,6,20000,4000,24000
Sao Tome und Principe,2015,7,33000,0,33000
Sao Tome und Principe,2015,8,42000,0,42000
Sao Tome und Principe,2015,9,56000,0,56000
Sao Tome und Principe,2015,10,80000,0,80000
Sao Tome und Principe,2015,11,42000,0,42000
Sao Tome und Principe,2015,12,22000,0,22000
Sao Tome und Principe,2016,1,34000,0,34000
Sao Tome und Principe,2016,2,39000,0,39000
Sao Tome und Principe,2016,3,62000,0,62000
Sao Tome und Principe,2016,4,60000,0,60000
Sao Tome und Principe,2016,5,95000,0,95000
Sao Tome und Principe,2016,6,82000,0,82000
Sao Tome und Principe,2016,7,33000,0,33000
Sao Tome und Principe,2016,8,14000,0,14000
Sao Tome und Principe,2016,9,34000,0,34000
Sao Tome und Principe,2016,10,62000,0,62000
Sao Tome und Principe,2016,11,41000,0,41000
Sao Tome und Principe,2016,12,43000,0,43000
Sao Tome und Principe,2017,1,0,260000,260000
Sao Tome und Principe,2017,2,0,0,0
Sao Tome und Principe,2017,3,24000,0,24000
Sao Tome und Principe,2017,4,46000,225000,271000
Sao Tome und Principe,2017,5,6000,0,6000
Sao Tome und Principe,2017,6,28000,0,28000
Sao Tome und Principe,2017,7,61000,3000,64000
Sao Tome und Principe,2017,8,36000,270000,306000
Sao Tome und Principe,2017,9,28000,0,28000
Sao Tome und Principe,2017,10,22000,0,22000
Sao Tome und Principe,2017,11,0,0,0
Sao Tome und Principe,2017,12,6000,2000,8000
Sao Tome und Principe,2018,1,10000,0,10000
Sao Tome und Principe,2018,2,69000,0,69000
Sao Tome und Principe,2018,3,27000,376000,403000
Sao Tome und Principe,2018,4,17000,0,17000
Sao Tome und Principe,2018,5,27000,0,27000
Sao Tome und Principe,2018,6,10000,0,10000
Sao Tome und Principe,2018,7,22000,0,22000
Sao Tome und Principe,2018,8,20000,0,20000
Sao Tome und Principe,2018,9,17000,0,17000
Sao Tome und Principe,2018,10,32000,0,32000
Sao Tome und Principe,2018,11,14000,0,14000
Sao Tome und Principe,2018,12,25000,17000,42000
Sao Tome und Principe,2019,1,18000,0,18000
Sao Tome und Principe,2019,2,36000,15000,51000
Sao Tome und Principe,2019,3,790000,0,790000
Sao Tome und Principe,2019,4,0,0,0
Sao Tome und Principe,2019,5,37000,0,37000
Sao Tome und Principe,2019,6,54000,0,54000
Sao Tome und Principe,2019,7,14000,0,14000
Sao Tome und Principe,2019,8,19000,45000,64000
Sao Tome und Principe,2019,9,78000,0,78000
Sao Tome und Principe,2019,10,19000,0,19000
Sao Tome und Principe,2019,11,37000,0,37000
Sao Tome und Principe,2019,12,35000,0,35000
Sao Tome und Principe,2020,1,133000,1000,134000
Sao Tome und Principe,2020,2,26000,0,26000
Sao Tome und Principe,2020,3,15000,125000,140000
Sao Tome und Principe,2020,4,43000,0,43000
Sao Tome und Principe,2020,5,36000,8000,44000
Sao Tome und Principe,2020,6,28000,0,28000
Sao Tome und Principe,2020,7,22000,0,22000
Sao Tome und Principe,2020,8,39000,191000,230000
Sao Tome und Principe,2020,9,42000,0,42000
Sao Tome und Principe,2020,10,17000,4000,21000
Sao Tome und Principe,2020,11,158000,9000,167000
Sao Tome und Principe,2020,12,14000,163000,177000
Sao Tome und Principe,2021,1,51000,0,51000
Sao Tome und Principe,2021,2,130000,0,130000
Sao Tome und Principe,2021,3,0,9000,9000
Sao Tome und Principe,2021,4,43000,0,43000
Sao Tome und Principe,2021,5,7000,0,7000
Sao Tome und Principe,2021,6,30000,0,30000
Sao Tome und Principe,2021,7,80000,0,80000
Sao Tome und Principe,2021,8,28000,0,28000
Sao Tome und Principe,2021,9,35000,0,35000
Sao Tome und Principe,2021,10,57000,124000,181000
Sao Tome und Principe,2021,11,40000,22000,62000
Sao Tome und Principe,2021,12,48000,15000,63000
Sao Tome und Principe,2022,1,33000,6000,39000
Sao Tome und Principe,2022,2,26000,16000,42000
Sao Tome und Principe,2022,3,28000,0,28000
Sao Tome und Principe,2022,4,32000,0,32000
Sao Tome und Principe,2022,5,34000,0,34000
Sao Tome und Principe,2022,6,9000,0,9000
Sao Tome und Principe,2022,7,59000,7000,66000
Sao Tome und Principe,2022,8,89000,612000,701000
Sao Tome und Principe,2022,9,113000,103000,216000
Sao Tome und Principe,2022,10,38000,114000,152000
Sao Tome und Principe,2022,11,51000,0,51000
Sao Tome und Principe,2022,12,16000,342000,358000
Sao Tome und Principe,2023,1,16000,350000,366000
Sao Tome und Principe,2023,2,29000,300000,329000
Sao Tome und Principe,2023,3,198000,484000,682000
Sao Tome und Principe,2023,4,25000,485000,510000
Sao Tome und Principe,2023,5,75000,492000,567000
Sao Tome und Principe,2023,6,62000,0,62000
Sao Tome und Principe,2023,7,54000,448000,502000
Sao Tome und Principe,2023,8,140000,0,140000
Sao Tome und Principe,2023,9,322000,511000,833000
Sao Tome und Principe,2023,10,48000,519000,567000
Sao Tome und Principe,2023,11,41000,515000,556000
Sao Tome und Principe,2023,12,2000,198000,200000
Sao Tome und Principe,2024,1,34000,370000,404000
Sao Tome und Principe,2024,2,59000,383000,442000
Sao Tome und Principe,2024,3,36000,343000,379000
Sao Tome und Principe,2024,4,9000,0,9000
Sao Tome und Principe,2024,5,170000,466000,636000
Sao Tome und Principe,2024,6,113000,0,113000
Sao Tome und Principe,2024,7,52000,0,52000
Sao Tome und Principe,2024,8,16000,376000,392000
Sao Tome und Principe,2024,9,158000,0,158000
Sao Tome und Principe,2024,10,89000,439000,528000
Sao Tome und Principe,2024,11,17000,0,17000
Sao Tome und Principe,2024,12,32000,286000,318000
Saudi-Arabien,2008,1,437319000,90029000,527348000
Saudi-Arabien,2008,2,447672000,105040000,552712000
Saudi-Arabien,2008,3,406476000,83593000,490069000
Saudi-Arabien,2008,4,425036000,139869000,564905000
Saudi-Arabien,2008,5,358865000,148370000,507235000
Saudi-Arabien,2008,6,431076000,126095000,557171000
Saudi-Arabien,2008,7,450962000,153390000,604352000
Saudi-Arabien,2008,8,407832000,168721000,576553000
Saudi-Arabien,2008,9,405842000,111088000,516930000
Saudi-Arabien,2008,10,489285000,126390000,615675000
Saudi-Arabien,2008,11,462896000,135579000,598475000
Saudi-Arabien,2008,12,458375000,126264000,584639000
Saudi-Arabien,2009,1,362565000,77047000,439612000
Saudi-Arabien,2009,2,411744000,64500000,476244000
Saudi-Arabien,2009,3,432402000,57654000,490056000
Saudi-Arabien,2009,4,414740000,51689000,466429000
Saudi-Arabien,2009,5,375332000,81063000,456395000
Saudi-Arabien,2009,6,386603000,53694000,440297000
Saudi-Arabien,2009,7,510769000,49283000,560052000
Saudi-Arabien,2009,8,345255000,49558000,394813000
Saudi-Arabien,2009,9,361629000,37455000,399084000
Saudi-Arabien,2009,10,365028000,26892000,391920000
Saudi-Arabien,2009,11,445538000,47041000,492579000
Saudi-Arabien,2009,12,482968000,46388000,529356000
Saudi-Arabien,2010,1,286403000,41591000,327994000
Saudi-Arabien,2010,2,401697000,41930000,443627000
Saudi-Arabien,2010,3,499182000,40400000,539582000
Saudi-Arabien,2010,4,465697000,19178000,484875000
Saudi-Arabien,2010,5,445892000,59960000,505852000
Saudi-Arabien,2010,6,565474000,54855000,620329000
Saudi-Arabien,2010,7,524188000,86989000,611177000
Saudi-Arabien,2010,8,508963000,40556000,549519000
Saudi-Arabien,2010,9,543338000,64989000,608327000
Saudi-Arabien,2010,10,518282000,51516000,569798000
Saudi-Arabien,2010,11,523882000,60304000,584186000
Saudi-Arabien,2010,12,537541000,80435000,617976000
Saudi-Arabien,2011,1,493584000,66287000,559871000
Saudi-Arabien,2011,2,506047000,46579000,552626000
Saudi-Arabien,2011,3,570914000,72225000,643139000
Saudi-Arabien,2011,4,542516000,34615000,577131000
Saudi-Arabien,2011,5,538779000,43756000,582535000
Saudi-Arabien,2011,6,465299000,63688000,528987000
Saudi-Arabien,2011,7,512056000,46568000,558624000
Saudi-Arabien,2011,8,536214000,106827000,643041000
Saudi-Arabien,2011,9,602971000,140698000,743669000
Saudi-Arabien,2011,10,562956000,93793000,656749000
Saudi-Arabien,2011,11,670586000,101683000,772269000
Saudi-Arabien,2011,12,863720000,90303000,954023000
Saudi-Arabien,2012,1,596193000,182412000,778605000
Saudi-Arabien,2012,2,689611000,63841000,753452000
Saudi-Arabien,2012,3,768596000,151749000,920345000
Saudi-Arabien,2012,4,619541000,80143000,699684000
Saudi-Arabien,2012,5,765435000,186642000,952077000
Saudi-Arabien,2012,6,769167000,172403000,941570000
Saudi-Arabien,2012,7,639768000,138106000,777874000
Saudi-Arabien,2012,8,689951000,180327000,870278000
Saudi-Arabien,2012,9,687852000,120120000,807972000
Saudi-Arabien,2012,10,697401000,171705000,869106000
Saudi-Arabien,2012,11,718995000,100411000,819406000
Saudi-Arabien,2012,12,585152000,177993000,763145000
Saudi-Arabien,2013,1,654703000,61166000,715869000
Saudi-Arabien,2013,2,787623000,111961000,899584000
Saudi-Arabien,2013,3,919505000,109552000,1029057000
Saudi-Arabien,2013,4,864809000,77546000,942355000
Saudi-Arabien,2013,5,730999000,139053000,870052000
Saudi-Arabien,2013,6,715992000,131886000,847878000
Saudi-Arabien,2013,7,757776000,239295000,997071000
Saudi-Arabien,2013,8,749525000,190113000,939638000
Saudi-Arabien,2013,9,777737000,97657000,875394000
Saudi-Arabien,2013,10,776658000,204980000,981638000
Saudi-Arabien,2013,11,734685000,176303000,910988000
Saudi-Arabien,2013,12,756205000,133905000,890110000
Saudi-Arabien,2014,1,716986000,77757000,794743000
Saudi-Arabien,2014,2,742878000,75002000,817880000
Saudi-Arabien,2014,3,758986000,87083000,846069000
Saudi-Arabien,2014,4,833237000,89906000,923143000
Saudi-Arabien,2014,5,838770000,165648000,1004418000
Saudi-Arabien,2014,6,659276000,55910000,715186000
Saudi-Arabien,2014,7,752444000,94657000,847101000
Saudi-Arabien,2014,8,659971000,116320000,776291000
Saudi-Arabien,2014,9,708370000,83907000,792277000
Saudi-Arabien,2014,10,700198000,79377000,779575000
Saudi-Arabien,2014,11,726396000,91339000,817735000
Saudi-Arabien,2014,12,782273000,88140000,870413000
Saudi-Arabien,2015,1,589501000,61008000,650509000
Saudi-Arabien,2015,2,830204000,71397000,901601000
Saudi-Arabien,2015,3,914608000,103879000,1018487000
Saudi-Arabien,2015,4,915765000,33145000,948910000
Saudi-Arabien,2015,5,816052000,116315000,932367000
Saudi-Arabien,2015,6,870257000,70757000,941014000
Saudi-Arabien,2015,7,879305000,99405000,978710000
Saudi-Arabien,2015,8,749671000,53076000,802747000
Saudi-Arabien,2015,9,851071000,41087000,892158000
Saudi-Arabien,2015,10,831004000,83588000,914592000
Saudi-Arabien,2015,11,866141000,87343000,953484000
Saudi-Arabien,2015,12,812636000,53835000,866471000
Saudi-Arabien,2016,1,586707000,28072000,614779000
Saudi-Arabien,2016,2,658724000,30049000,688773000
Saudi-Arabien,2016,3,718468000,32356000,750824000
Saudi-Arabien,2016,4,701634000,34772000,736406000
Saudi-Arabien,2016,5,558948000,28466000,587414000
Saudi-Arabien,2016,6,596755000,35141000,631896000
Saudi-Arabien,2016,7,528661000,67600000,596261000
Saudi-Arabien,2016,8,541794000,55491000,597285000
Saudi-Arabien,2016,9,548320000,124185000,672505000
Saudi-Arabien,2016,10,525120000,81263000,606383000
Saudi-Arabien,2016,11,600707000,57457000,658164000
Saudi-Arabien,2016,12,698886000,48882000,747768000
Saudi-Arabien,2017,1,587072000,33310000,620382000
Saudi-Arabien,2017,2,616521000,33120000,649641000
Saudi-Arabien,2017,3,657215000,31427000,688642000
Saudi-Arabien,2017,4,537524000,77822000,615346000
Saudi-Arabien,2017,5,494378000,95770000,590148000
Saudi-Arabien,2017,6,475316000,76813000,552129000
Saudi-Arabien,2017,7,489287000,54164000,543451000
Saudi-Arabien,2017,8,548642000,75854000,624496000
Saudi-Arabien,2017,9,527635000,70793000,598428000
Saudi-Arabien,2017,10,467539000,53989000,521528000
Saudi-Arabien,2017,11,569537000,125432000,694969000
Saudi-Arabien,2017,12,571936000,75346000,647282000
Saudi-Arabien,2018,1,460150000,64449000,524599000
Saudi-Arabien,2018,2,578023000,96289000,674312000
Saudi-Arabien,2018,3,575553000,56811000,632364000
Saudi-Arabien,2018,4,537118000,63303000,600421000
Saudi-Arabien,2018,5,525956000,135131000,661087000
Saudi-Arabien,2018,6,532062000,63612000,595674000
Saudi-Arabien,2018,7,501259000,112497000,613756000
Saudi-Arabien,2018,8,550306000,144101000,694407000
Saudi-Arabien,2018,9,455504000,108241000,563745000
Saudi-Arabien,2018,10,472264000,122977000,595241000
Saudi-Arabien,2018,11,521213000,107038000,628251000
Saudi-Arabien,2018,12,548749000,105814000,654563000
Saudi-Arabien,2019,1,363005000,71270000,434275000
Saudi-Arabien,2019,2,401395000,37921000,439316000
Saudi-Arabien,2019,3,458364000,92405000,550769000
Saudi-Arabien,2019,4,439101000,92460000,531561000
Saudi-Arabien,2019,5,442120000,81112000,523232000
Saudi-Arabien,2019,6,441563000,126582000,568145000
Saudi-Arabien,2019,7,523543000,163072000,686615000
Saudi-Arabien,2019,8,479209000,64628000,543837000
Saudi-Arabien,2019,9,551255000,134079000,685334000
Saudi-Arabien,2019,10,598515000,177902000,776417000
Saudi-Arabien,2019,11,668921000,82883000,751804000
Saudi-Arabien,2019,12,547486000,46426000,593912000
Saudi-Arabien,2020,1,492499000,47183000,539682000
Saudi-Arabien,2020,2,650893000,50794000,701687000
Saudi-Arabien,2020,3,556347000,76375000,632722000
Saudi-Arabien,2020,4,389610000,101500000,491110000
Saudi-Arabien,2020,5,482616000,50779000,533395000
Saudi-Arabien,2020,6,507905000,140636000,648541000
Saudi-Arabien,2020,7,564386000,64486000,628872000
Saudi-Arabien,2020,8,396777000,60971000,457748000
Saudi-Arabien,2020,9,454174000,69902000,524076000
Saudi-Arabien,2020,10,413652000,98613000,512265000
Saudi-Arabien,2020,11,432173000,55002000,487175000
Saudi-Arabien,2020,12,501846000,104118000,605964000
Saudi-Arabien,2021,1,340639000,49210000,389849000
Saudi-Arabien,2021,2,443785000,32447000,476232000
Saudi-Arabien,2021,3,591313000,44550000,635863000
Saudi-Arabien,2021,4,413663000,103656000,517319000
Saudi-Arabien,2021,5,423402000,145865000,569267000
Saudi-Arabien,2021,6,548768000,87368000,636136000
Saudi-Arabien,2021,7,403762000,111096000,514858000
Saudi-Arabien,2021,8,466709000,157133000,623842000
Saudi-Arabien,2021,9,470487000,97147000,567634000
Saudi-Arabien,2021,10,413538000,152992000,566530000
Saudi-Arabien,2021,11,483180000,59210000,542390000
Saudi-Arabien,2021,12,564888000,67635000,632523000
Saudi-Arabien,2022,1,401037000,64014000,465051000
Saudi-Arabien,2022,2,385302000,107312000,492614000
Saudi-Arabien,2022,3,541392000,128529000,669921000
Saudi-Arabien,2022,4,419174000,211378000,630552000
Saudi-Arabien,2022,5,495905000,191890000,687795000
Saudi-Arabien,2022,6,521381000,145008000,666389000
Saudi-Arabien,2022,7,554868000,326757000,881625000
Saudi-Arabien,2022,8,734075000,212780000,946855000
Saudi-Arabien,2022,9,677780000,391013000,1068793000
Saudi-Arabien,2022,10,675661000,318348000,994009000
Saudi-Arabien,2022,11,653518000,378977000,1032495000
Saudi-Arabien,2022,12,648280000,301889000,950169000
Saudi-Arabien,2023,1,545361000,414104000,959465000
Saudi-Arabien,2023,2,618171000,282985000,901156000
Saudi-Arabien,2023,3,916553000,90711000,1007264000
Saudi-Arabien,2023,4,599409000,126295000,725704000
Saudi-Arabien,2023,5,554983000,166928000,721911000
Saudi-Arabien,2023,6,620940000,281612000,902552000
Saudi-Arabien,2023,7,702171000,299953000,1002124000
Saudi-Arabien,2023,8,692036000,253939000,945975000
Saudi-Arabien,2023,9,750581000,324202000,1074783000
Saudi-Arabien,2023,10,677506000,93936000,771442000
Saudi-Arabien,2023,11,721008000,59793000,780801000
Saudi-Arabien,2023,12,710213000,79312000,789525000
Saudi-Arabien,2024,1,619348000,88242000,707590000
Saudi-Arabien,2024,2,645847000,70279000,716126000
Saudi-Arabien,2024,3,636061000,156530000,792591000
Saudi-Arabien,2024,4,723246000,198325000,921571000
Saudi-Arabien,2024,5,634719000,308235000,942954000
Saudi-Arabien,2024,6,709834000,165233000,875067000
Saudi-Arabien,2024,7,800754000,273464000,1074218000
Saudi-Arabien,2024,8,685429000,228866000,914295000
Saudi-Arabien,2024,9,747307000,74470000,821777000
Saudi-Arabien,2024,10,776673000,54897000,831570000
Saudi-Arabien,2024,11,856928000,40168000,897096000
Saudi-Arabien,2024,12,872911000,61951000,934862000
Schiffs- und Luftfahrzeugbedarf,2008,1,123358000,1000,123359000
Schiffs- und Luftfahrzeugbedarf,2008,2,22459000,0,22459000
Schiffs- und Luftfahrzeugbedarf,2008,3,112934000,0,112934000
Schiffs- und Luftfahrzeugbedarf,2008,4,14499000,0,14499000
Schiffs- und Luftfahrzeugbedarf,2008,5,20520000,0,20520000
Schiffs- und Luftfahrzeugbedarf,2008,6,24002000,0,24002000
Schiffs- und Luftfahrzeugbedarf,2008,7,210657000,0,210657000
Schiffs- und Luftfahrzeugbedarf,2008,8,103748000,0,103748000
Schiffs- und Luftfahrzeugbedarf,2008,9,100364000,0,100364000
Schiffs- und Luftfahrzeugbedarf,2008,10,32890000,0,32890000
Schiffs- und Luftfahrzeugbedarf,2008,11,114880000,0,114880000
Schiffs- und Luftfahrzeugbedarf,2008,12,63458000,0,63458000
Schiffs- und Luftfahrzeugbedarf,2009,1,13077000,4000,13081000
Schiffs- und Luftfahrzeugbedarf,2009,2,61802000,0,61802000
Schiffs- und Luftfahrzeugbedarf,2009,3,24256000,0,24256000
Schiffs- und Luftfahrzeugbedarf,2009,4,21728000,18000,21746000
Schiffs- und Luftfahrzeugbedarf,2009,5,11423000,0,11423000
Schiffs- und Luftfahrzeugbedarf,2009,6,24992000,0,24992000
Schiffs- und Luftfahrzeugbedarf,2009,7,24088000,3000,24091000
Schiffs- und Luftfahrzeugbedarf,2009,8,16029000,0,16029000
Schiffs- und Luftfahrzeugbedarf,2009,9,15536000,0,15536000
Schiffs- und Luftfahrzeugbedarf,2009,10,20930000,0,20930000
Schiffs- und Luftfahrzeugbedarf,2009,11,16329000,0,16329000
Schiffs- und Luftfahrzeugbedarf,2009,12,14999000,0,14999000
Schiffs- und Luftfahrzeugbedarf,2010,1,10089000,0,10089000
Schiffs- und Luftfahrzeugbedarf,2010,2,17560000,0,17560000
Schiffs- und Luftfahrzeugbedarf,2010,3,18185000,0,18185000
Schiffs- und Luftfahrzeugbedarf,2010,4,13803000,0,13803000
Schiffs- und Luftfahrzeugbedarf,2010,5,20283000,0,20283000
Schiffs- und Luftfahrzeugbedarf,2010,6,25132000,0,25132000
Schiffs- und Luftfahrzeugbedarf,2010,7,33712000,0,33712000
Schiffs- und Luftfahrzeugbedarf,2010,8,29580000,0,29580000
Schiffs- und Luftfahrzeugbedarf,2010,9,17988000,0,17988000
Schiffs- und Luftfahrzeugbedarf,2010,10,15881000,0,15881000
Schiffs- und Luftfahrzeugbedarf,2010,11,24063000,0,24063000
Schiffs- und Luftfahrzeugbedarf,2010,12,73544000,0,73544000
Schiffs- und Luftfahrzeugbedarf,2011,1,65233000,0,65233000
Schiffs- und Luftfahrzeugbedarf,2011,2,35438000,0,35438000
Schiffs- und Luftfahrzeugbedarf,2011,3,92000000,0,92000000
Schiffs- und Luftfahrzeugbedarf,2011,4,39114000,0,39114000
Schiffs- und Luftfahrzeugbedarf,2011,5,195048000,0,195048000
Schiffs- und Luftfahrzeugbedarf,2011,6,37174000,0,37174000
Schiffs- und Luftfahrzeugbedarf,2011,7,39676000,0,39676000
Schiffs- und Luftfahrzeugbedarf,2011,8,28886000,0,28886000
Schiffs- und Luftfahrzeugbedarf,2011,9,26739000,0,26739000
Schiffs- und Luftfahrzeugbedarf,2011,10,79763000,0,79763000
Schiffs- und Luftfahrzeugbedarf,2011,11,44866000,0,44866000
Schiffs- und Luftfahrzeugbedarf,2011,12,52904000,0,52904000
Schiffs- und Luftfahrzeugbedarf,2012,1,222618000,0,222618000
Schiffs- und Luftfahrzeugbedarf,2012,2,240757000,0,240757000
Schiffs- und Luftfahrzeugbedarf,2012,3,211006000,0,211006000
Schiffs- und Luftfahrzeugbedarf,2012,4,250683000,0,250683000
Schiffs- und Luftfahrzeugbedarf,2012,5,231638000,0,231638000
Schiffs- und Luftfahrzeugbedarf,2012,6,258078000,0,258078000
Schiffs- und Luftfahrzeugbedarf,2012,7,249222000,0,249222000
Schiffs- und Luftfahrzeugbedarf,2012,8,613968000,0,613968000
Schiffs- und Luftfahrzeugbedarf,2012,9,282929000,0,282929000
Schiffs- und Luftfahrzeugbedarf,2012,10,410691000,0,410691000
Schiffs- und Luftfahrzeugbedarf,2012,11,317328000,0,317328000
Schiffs- und Luftfahrzeugbedarf,2012,12,421522000,0,421522000
Schiffs- und Luftfahrzeugbedarf,2013,1,303729000,0,303729000
Schiffs- und Luftfahrzeugbedarf,2013,2,280834000,0,280834000
Schiffs- und Luftfahrzeugbedarf,2013,3,267913000,0,267913000
Schiffs- und Luftfahrzeugbedarf,2013,4,320669000,0,320669000
Schiffs- und Luftfahrzeugbedarf,2013,5,295461000,0,295461000
Schiffs- und Luftfahrzeugbedarf,2013,6,288054000,0,288054000
Schiffs- und Luftfahrzeugbedarf,2013,7,316540000,0,316540000
Schiffs- und Luftfahrzeugbedarf,2013,8,334569000,0,334569000
Schiffs- und Luftfahrzeugbedarf,2013,9,298976000,0,298976000
Schiffs- und Luftfahrzeugbedarf,2013,10,309796000,0,309796000
Schiffs- und Luftfahrzeugbedarf,2013,11,306816000,0,306816000
Schiffs- und Luftfahrzeugbedarf,2013,12,300304000,0,300304000
Schiffs- und Luftfahrzeugbedarf,2014,1,291482000,0,291482000
Schiffs- und Luftfahrzeugbedarf,2014,2,241562000,0,241562000
Schiffs- und Luftfahrzeugbedarf,2014,3,250658000,0,250658000
Schiffs- und Luftfahrzeugbedarf,2014,4,271820000,0,271820000
Schiffs- und Luftfahrzeugbedarf,2014,5,331241000,0,331241000
Schiffs- und Luftfahrzeugbedarf,2014,6,305158000,0,305158000
Schiffs- und Luftfahrzeugbedarf,2014,7,336638000,0,336638000
Schiffs- und Luftfahrzeugbedarf,2014,8,432021000,0,432021000
Schiffs- und Luftfahrzeugbedarf,2014,9,344809000,0,344809000
Schiffs- und Luftfahrzeugbedarf,2014,10,260267000,0,260267000
Schiffs- und Luftfahrzeugbedarf,2014,11,204250000,0,204250000
Schiffs- und Luftfahrzeugbedarf,2014,12,206769000,0,206769000
Schiffs- und Luftfahrzeugbedarf,2015,1,177359000,0,177359000
Schiffs- und Luftfahrzeugbedarf,2015,2,178509000,0,178509000
Schiffs- und Luftfahrzeugbedarf,2015,3,215591000,0,215591000
Schiffs- und Luftfahrzeugbedarf,2015,4,220403000,0,220403000
Schiffs- und Luftfahrzeugbedarf,2015,5,247138000,0,247138000
Schiffs- und Luftfahrzeugbedarf,2015,6,258225000,0,258225000
Schiffs- und Luftfahrzeugbedarf,2015,7,248851000,0,248851000
Schiffs- und Luftfahrzeugbedarf,2015,8,228124000,0,228124000
Schiffs- und Luftfahrzeugbedarf,2015,9,215966000,0,215966000
Schiffs- und Luftfahrzeugbedarf,2015,10,213942000,0,213942000
Schiffs- und Luftfahrzeugbedarf,2015,11,176293000,0,176293000
Schiffs- und Luftfahrzeugbedarf,2015,12,168113000,0,168113000
Schiffs- und Luftfahrzeugbedarf,2016,1,163912000,0,163912000
Schiffs- und Luftfahrzeugbedarf,2016,2,139123000,0,139123000
Schiffs- und Luftfahrzeugbedarf,2016,3,188081000,0,188081000
Schiffs- und Luftfahrzeugbedarf,2016,4,203166000,0,203166000
Schiffs- und Luftfahrzeugbedarf,2016,5,226096000,0,226096000
Schiffs- und Luftfahrzeugbedarf,2016,6,249587000,0,249587000
Schiffs- und Luftfahrzeugbedarf,2016,7,250073000,0,250073000
Schiffs- und Luftfahrzeugbedarf,2016,8,242850000,0,242850000
Schiffs- und Luftfahrzeugbedarf,2016,9,241659000,0,241659000
Schiffs- und Luftfahrzeugbedarf,2016,10,249053000,0,249053000
Schiffs- und Luftfahrzeugbedarf,2016,11,225135000,0,225135000
Schiffs- und Luftfahrzeugbedarf,2016,12,218343000,0,218343000
Schiffs- und Luftfahrzeugbedarf,2017,1,244865000,0,244865000
Schiffs- und Luftfahrzeugbedarf,2017,2,208963000,0,208963000
Schiffs- und Luftfahrzeugbedarf,2017,3,222463000,0,222463000
Schiffs- und Luftfahrzeugbedarf,2017,4,279541000,0,279541000
Schiffs- und Luftfahrzeugbedarf,2017,5,276951000,0,276951000
Schiffs- und Luftfahrzeugbedarf,2017,6,269342000,0,269342000
Schiffs- und Luftfahrzeugbedarf,2017,7,272732000,0,272732000
Schiffs- und Luftfahrzeugbedarf,2017,8,263536000,0,263536000
Schiffs- und Luftfahrzeugbedarf,2017,9,261766000,0,261766000
Schiffs- und Luftfahrzeugbedarf,2017,10,266570000,0,266570000
Schiffs- und Luftfahrzeugbedarf,2017,11,248841000,0,248841000
Schiffs- und Luftfahrzeugbedarf,2017,12,221844000,0,221844000
Schiffs- und Luftfahrzeugbedarf,2018,1,244045000,0,244045000
Schiffs- und Luftfahrzeugbedarf,2018,2,258677000,0,258677000
Schiffs- und Luftfahrzeugbedarf,2018,3,250856000,0,250856000
Schiffs- und Luftfahrzeugbedarf,2018,4,290226000,0,290226000
Schiffs- und Luftfahrzeugbedarf,2018,5,340580000,0,340580000
Schiffs- und Luftfahrzeugbedarf,2018,6,359557000,0,359557000
Schiffs- und Luftfahrzeugbedarf,2018,7,350414000,0,350414000
Schiffs- und Luftfahrzeugbedarf,2018,8,398375000,0,398375000
Schiffs- und Luftfahrzeugbedarf,2018,9,365829000,0,365829000
Schiffs- und Luftfahrzeugbedarf,2018,10,375202000,0,375202000
Schiffs- und Luftfahrzeugbedarf,2018,11,316017000,0,316017000
Schiffs- und Luftfahrzeugbedarf,2018,12,265298000,0,265298000
Schiffs- und Luftfahrzeugbedarf,2019,1,283257000,0,283257000
Schiffs- und Luftfahrzeugbedarf,2019,2,266063000,0,266063000
Schiffs- und Luftfahrzeugbedarf,2019,3,291139000,0,291139000
Schiffs- und Luftfahrzeugbedarf,2019,4,299436000,0,299436000
Schiffs- und Luftfahrzeugbedarf,2019,5,330091000,0,330091000
Schiffs- und Luftfahrzeugbedarf,2019,6,303743000,0,303743000
Schiffs- und Luftfahrzeugbedarf,2019,7,331979000,0,331979000
Schiffs- und Luftfahrzeugbedarf,2019,8,319064000,0,319064000
Schiffs- und Luftfahrzeugbedarf,2019,9,305755000,0,305755000
Schiffs- und Luftfahrzeugbedarf,2019,10,335904000,0,335904000
Schiffs- und Luftfahrzeugbedarf,2019,11,262657000,0,262657000
Schiffs- und Luftfahrzeugbedarf,2019,12,262026000,0,262026000
Schiffs- und Luftfahrzeugbedarf,2020,1,256528000,0,256528000
Schiffs- und Luftfahrzeugbedarf,2020,2,234810000,0,234810000
Schiffs- und Luftfahrzeugbedarf,2020,3,166695000,0,166695000
Schiffs- und Luftfahrzeugbedarf,2020,4,74638000,0,74638000
Schiffs- und Luftfahrzeugbedarf,2020,5,58305000,0,58305000
Schiffs- und Luftfahrzeugbedarf,2020,6,75259000,0,75259000
Schiffs- und Luftfahrzeugbedarf,2020,7,106767000,0,106767000
Schiffs- und Luftfahrzeugbedarf,2020,8,103850000,0,103850000
Schiffs- und Luftfahrzeugbedarf,2020,9,100998000,0,100998000
Schiffs- und Luftfahrzeugbedarf,2020,10,112842000,0,112842000
Schiffs- und Luftfahrzeugbedarf,2020,11,95273000,0,95273000
Schiffs- und Luftfahrzeugbedarf,2020,12,108275000,0,108275000
Schiffs- und Luftfahrzeugbedarf,2021,1,118197000,0,118197000
Schiffs- und Luftfahrzeugbedarf,2021,2,117338000,0,117338000
Schiffs- und Luftfahrzeugbedarf,2021,3,153054000,0,153054000
Schiffs- und Luftfahrzeugbedarf,2021,4,141141000,0,141141000
Schiffs- und Luftfahrzeugbedarf,2021,5,149292000,0,149292000
Schiffs- und Luftfahrzeugbedarf,2021,6,169955000,0,169955000
Schiffs- und Luftfahrzeugbedarf,2021,7,204848000,0,204848000
Schiffs- und Luftfahrzeugbedarf,2021,8,213157000,0,213157000
Schiffs- und Luftfahrzeugbedarf,2021,9,201343000,0,201343000
Schiffs- und Luftfahrzeugbedarf,2021,10,239459000,0,239459000
Schiffs- und Luftfahrzeugbedarf,2021,11,229544000,0,229544000
Schiffs- und Luftfahrzeugbedarf,2021,12,227657000,0,227657000
Schiffs- und Luftfahrzeugbedarf,2022,1,225368000,0,225368000
Schiffs- und Luftfahrzeugbedarf,2022,2,234162000,0,234162000
Schiffs- und Luftfahrzeugbedarf,2022,3,344304000,0,344304000
Schiffs- und Luftfahrzeugbedarf,2022,4,410670000,0,410670000
Schiffs- und Luftfahrzeugbedarf,2022,5,474447000,0,474447000
Schiffs- und Luftfahrzeugbedarf,2022,6,503210000,0,503210000
Schiffs- und Luftfahrzeugbedarf,2022,7,520619000,0,520619000
Schiffs- und Luftfahrzeugbedarf,2022,8,535864000,0,535864000
Schiffs- und Luftfahrzeugbedarf,2022,9,508286000,0,508286000
Schiffs- und Luftfahrzeugbedarf,2022,10,491052000,0,491052000
Schiffs- und Luftfahrzeugbedarf,2022,11,421538000,0,421538000
Schiffs- und Luftfahrzeugbedarf,2022,12,375776000,0,375776000
Schiffs- und Luftfahrzeugbedarf,2023,1,363459000,0,363459000
Schiffs- und Luftfahrzeugbedarf,2023,2,355564000,0,355564000
Schiffs- und Luftfahrzeugbedarf,2023,3,377274000,0,377274000
Schiffs- und Luftfahrzeugbedarf,2023,4,363657000,0,363657000
Schiffs- und Luftfahrzeugbedarf,2023,5,378730000,0,378730000
Schiffs- und Luftfahrzeugbedarf,2023,6,375459000,0,375459000
Schiffs- und Luftfahrzeugbedarf,2023,7,404420000,0,404420000
Schiffs- und Luftfahrzeugbedarf,2023,8,484138000,0,484138000
Schiffs- und Luftfahrzeugbedarf,2023,9,496033000,0,496033000
Schiffs- und Luftfahrzeugbedarf,2023,10,496809000,0,496809000
Schiffs- und Luftfahrzeugbedarf,2023,11,389934000,0,389934000
Schiffs- und Luftfahrzeugbedarf,2023,12,334686000,0,334686000
Schiffs- und Luftfahrzeugbedarf,2024,1,346595000,0,346595000
Schiffs- und Luftfahrzeugbedarf,2024,2,344195000,0,344195000
Schiffs- und Luftfahrzeugbedarf,2024,3,365100000,0,365100000
Schiffs- und Luftfahrzeugbedarf,2024,4,434737000,0,434737000
Schiffs- und Luftfahrzeugbedarf,2024,5,426098000,0,426098000
Schiffs- und Luftfahrzeugbedarf,2024,6,439967000,0,439967000
Schiffs- und Luftfahrzeugbedarf,2024,7,454960000,0,454960000
Schiffs- und Luftfahrzeugbedarf,2024,8,449791000,0,449791000
Schiffs- und Luftfahrzeugbedarf,2024,9,406568000,0,406568000
Schiffs- und Luftfahrzeugbedarf,2024,10,447014000,0,447014000
Schiffs- und Luftfahrzeugbedarf,2024,11,392052000,0,392052000
Schiffs- und Luftfahrzeugbedarf,2024,12,353530000,0,353530000
Schweden,2008,1,1784103000,1085995000,2870098000
Schweden,2008,2,1756975000,1177321000,2934296000
Schweden,2008,3,1830097000,1197495000,3027592000
Schweden,2008,4,1874848000,1169201000,3044049000
Schweden,2008,5,1796996000,1247365000,3044361000
Schweden,2008,6,1827442000,1251670000,3079112000
Schweden,2008,7,1490294000,1087868000,2578162000
Schweden,2008,8,1565347000,1079867000,2645214000
Schweden,2008,9,1788166000,1206524000,2994690000
Schweden,2008,10,1749987000,1183399000,2933386000
Schweden,2008,11,1501805000,1016310000,2518115000
Schweden,2008,12,1125361000,969279000,2094640000
Schweden,2009,1,1206040000,793624000,1999664000
Schweden,2009,2,1242055000,820335000,2062390000
Schweden,2009,3,1335876000,914062000,2249938000
Schweden,2009,4,1306475000,792222000,2098697000
Schweden,2009,5,1154552000,774502000,1929054000
Schweden,2009,6,1307697000,842759000,2150456000
Schweden,2009,7,1104888000,792101000,1896989000
Schweden,2009,8,1178101000,783482000,1961583000
Schweden,2009,9,1497258000,918122000,2415380000
Schweden,2009,10,1476986000,913185000,2390171000
Schweden,2009,11,1429136000,923618000,2352754000
Schweden,2009,12,1307406000,898446000,2205852000
Schweden,2010,1,1258976000,822095000,2081071000
Schweden,2010,2,1408248000,936100000,2344348000
Schweden,2010,3,1700551000,1168031000,2868582000
Schweden,2010,4,1598308000,974499000,2572807000
Schweden,2010,5,1645718000,1010363000,2656081000
Schweden,2010,6,1802305000,1266450000,3068755000
Schweden,2010,7,1378790000,1091495000,2470285000
Schweden,2010,8,1497225000,1051062000,2548287000
Schweden,2010,9,1755547000,1104984000,2860531000
Schweden,2010,10,1855174000,1137244000,2992418000
Schweden,2010,11,1786991000,1108403000,2895394000
Schweden,2010,12,1688751000,1149021000,2837772000
Schweden,2011,1,1723669000,1108802000,2832471000
Schweden,2011,2,1761683000,1122220000,2883903000
Schweden,2011,3,2109503000,1302604000,3412107000
Schweden,2011,4,1908151000,1191532000,3099683000
Schweden,2011,5,1973772000,1201318000,3175090000
Schweden,2011,6,1807633000,1252747000,3060380000
Schweden,2011,7,1544992000,1158512000,2703504000
Schweden,2011,8,1856272000,1091366000,2947638000
Schweden,2011,9,1980570000,1224290000,3204860000
Schweden,2011,10,1832136000,1135479000,2967615000
Schweden,2011,11,1864973000,1240604000,3105577000
Schweden,2011,12,1670904000,1085937000,2756841000
Schweden,2012,1,1737180000,1105417000,2842597000
Schweden,2012,2,1835573000,1229640000,3065213000
Schweden,2012,3,2038782000,1175968000,3214750000
Schweden,2012,4,1799170000,1137550000,2936720000
Schweden,2012,5,1817728000,1260082000,3077810000
Schweden,2012,6,1856354000,1150615000,3006969000
Schweden,2012,7,1442463000,1113891000,2556354000
Schweden,2012,8,1748868000,1097307000,2846175000
Schweden,2012,9,1722224000,1213381000,2935605000
Schweden,2012,10,1884962000,1240631000,3125593000
Schweden,2012,11,1757125000,1115875000,2873000000
Schweden,2012,12,1451642000,933588000,2385230000
Schweden,2013,1,1752266000,1139868000,2892134000
Schweden,2013,2,1628454000,1047937000,2676391000
Schweden,2013,3,1846285000,1200561000,3046846000
Schweden,2013,4,1834992000,1207575000,3042567000
Schweden,2013,5,1772273000,1278189000,3050462000
Schweden,2013,6,1725453000,1251319000,2976772000
Schweden,2013,7,1490035000,1146020000,2636055000
Schweden,2013,8,1631186000,1052326000,2683512000
Schweden,2013,9,1826176000,1192598000,3018774000
Schweden,2013,10,1947272000,1295863000,3243135000
Schweden,2013,11,1771080000,1157594000,2928674000
Schweden,2013,12,1474919000,937792000,2412711000
Schweden,2014,1,1713172000,1162784000,2875956000
Schweden,2014,2,1726269000,1141348000,2867617000
Schweden,2014,3,1868098000,1270246000,3138344000
Schweden,2014,4,1825185000,1179689000,3004874000
Schweden,2014,5,1768853000,1085722000,2854575000
Schweden,2014,6,1816145000,1264226000,3080371000
Schweden,2014,7,1619132000,1097497000,2716629000
Schweden,2014,8,1682795000,1084303000,2767098000
Schweden,2014,9,1957459000,1180891000,3138350000
Schweden,2014,10,1966194000,1339244000,3305438000
Schweden,2014,11,1815602000,1203174000,3018776000
Schweden,2014,12,1705087000,1017148000,2722235000
Schweden,2015,1,1771566000,1137520000,2909086000
Schweden,2015,2,1790494000,1070303000,2860797000
Schweden,2015,3,2068076000,1217589000,3285665000
Schweden,2015,4,1806068000,1227024000,3033092000
Schweden,2015,5,1937989000,1168325000,3106314000
Schweden,2015,6,2085304000,1193322000,3278626000
Schweden,2015,7,1826739000,1092431000,2919170000
Schweden,2015,8,1696881000,1143789000,2840670000
Schweden,2015,9,2033290000,1272037000,3305327000
Schweden,2015,10,2208435000,1243226000,3451661000
Schweden,2015,11,2064931000,1188206000,3253137000
Schweden,2015,12,1750546000,1013609000,2764155000
Schweden,2016,1,1860584000,1096929000,2957513000
Schweden,2016,2,1989486000,1228094000,3217580000
Schweden,2016,3,2144577000,1236728000,3381305000
Schweden,2016,4,2193617000,1260946000,3454563000
Schweden,2016,5,2096388000,1179833000,3276221000
Schweden,2016,6,2121540000,1198500000,3320040000
Schweden,2016,7,1644587000,1133546000,2778133000
Schweden,2016,8,1950907000,1085592000,3036499000
Schweden,2016,9,2259366000,1275673000,3535039000
Schweden,2016,10,2341279000,1148487000,3489766000
Schweden,2016,11,2311426000,1308457000,3619883000
Schweden,2016,12,1977117000,1155956000,3133073000
Schweden,2017,1,2065776000,1192097000,3257873000
Schweden,2017,2,2186820000,1242103000,3428923000
Schweden,2017,3,2407260000,1396549000,3803809000
Schweden,2017,4,2138721000,1246159000,3384880000
Schweden,2017,5,2176297000,1334690000,3510987000
Schweden,2017,6,2320540000,1315477000,3636017000
Schweden,2017,7,1906641000,1268999000,3175640000
Schweden,2017,8,2211365000,1224991000,3436356000
Schweden,2017,9,2255687000,1344250000,3599937000
Schweden,2017,10,2324351000,1305224000,3629575000
Schweden,2017,11,2478805000,1348089000,3826894000
Schweden,2017,12,2207753000,1300642000,3508395000
Schweden,2018,1,2365755000,1253780000,3619535000
Schweden,2018,2,2183098000,1301445000,3484543000
Schweden,2018,3,2262186000,1325424000,3587610000
Schweden,2018,4,2217547000,1333826000,3551373000
Schweden,2018,5,2288488000,1272206000,3560694000
Schweden,2018,6,2256207000,1382104000,3638311000
Schweden,2018,7,1893453000,1320154000,3213607000
Schweden,2018,8,2090370000,1183616000,3273986000
Schweden,2018,9,2203512000,1354861000,3558373000
Schweden,2018,10,2314960000,1465442000,3780402000
Schweden,2018,11,2282465000,1423971000,3706436000
Schweden,2018,12,1825304000,1189336000,3014640000
Schweden,2019,1,2154765000,1228571000,3383336000
Schweden,2019,2,2060842000,1197588000,3258430000
Schweden,2019,3,2202220000,1389964000,3592184000
Schweden,2019,4,2066798000,1367114000,3433912000
Schweden,2019,5,2076702000,1392716000,3469418000
Schweden,2019,6,2024431000,1386125000,3410556000
Schweden,2019,7,1877363000,1253821000,3131184000
Schweden,2019,8,1929660000,1145101000,3074761000
Schweden,2019,9,2209316000,1263781000,3473097000
Schweden,2019,10,2318581000,1300334000,3618915000
Schweden,2019,11,2218303000,1279873000,3498176000
Schweden,2019,12,1774254000,1162193000,2936447000
Schweden,2020,1,2059403000,1265611000,3325014000
Schweden,2020,2,2115953000,1398227000,3514180000
Schweden,2020,3,2100316000,1363738000,3464054000
Schweden,2020,4,1571832000,1183901000,2755733000
Schweden,2020,5,1563297000,1054504000,2617801000
Schweden,2020,6,1918057000,1138033000,3056090000
Schweden,2020,7,1576054000,993573000,2569627000
Schweden,2020,8,1832040000,1124090000,2956130000
Schweden,2020,9,2148700000,1253020000,3401720000
Schweden,2020,10,2217333000,1303251000,3520584000
Schweden,2020,11,2251379000,1389564000,3640943000
Schweden,2020,12,1932872000,1214555000,3147427000
Schweden,2021,1,1906356000,1188715000,3095071000
Schweden,2021,2,2156298000,1315971000,3472269000
Schweden,2021,3,2466003000,1523853000,3989856000
Schweden,2021,4,2226079000,1245660000,3471739000
Schweden,2021,5,2249704000,1508922000,3758626000
Schweden,2021,6,2254964000,1502854000,3757818000
Schweden,2021,7,1998777000,1309983000,3308760000
Schweden,2021,8,2025012000,1167362000,3192374000
Schweden,2021,9,2369027000,1545433000,3914460000
Schweden,2021,10,2331847000,1542992000,3874839000
Schweden,2021,11,2465367000,1519809000,3985176000
Schweden,2021,12,2190888000,1480780000,3671668000
Schweden,2022,1,2171468000,1338096000,3509564000
Schweden,2022,2,2443325000,1431278000,3874603000
Schweden,2022,3,2693092000,1797895000,4490987000
Schweden,2022,4,2288827000,1534213000,3823040000
Schweden,2022,5,2507613000,1630270000,4137883000
Schweden,2022,6,2638305000,1603560000,4241865000
Schweden,2022,7,1997707000,1545721000,3543428000
Schweden,2022,8,2345042000,1425763000,3770805000
Schweden,2022,9,2814426000,1658793000,4473219000
Schweden,2022,10,2695805000,1645983000,4341788000
Schweden,2022,11,2836990000,1645864000,4482854000
Schweden,2022,12,2268486000,1455863000,3724349000
Schweden,2023,1,2490965000,1498484000,3989449000
Schweden,2023,2,2434177000,1545121000,3979298000
Schweden,2023,3,2713279000,1829636000,4542915000
Schweden,2023,4,2411836000,1553780000,3965616000
Schweden,2023,5,2702339000,1635787000,4338126000
Schweden,2023,6,2630992000,1569108000,4200100000
Schweden,2023,7,1934203000,1392852000,3327055000
Schweden,2023,8,2589989000,1383549000,3973538000
Schweden,2023,9,2642221000,1612434000,4254655000
Schweden,2023,10,2493494000,1495213000,3988707000
Schweden,2023,11,2616514000,1649008000,4265522000
Schweden,2023,12,2023766000,1389331000,3413097000
Schweden,2024,1,2448259000,1511331000,3959590000
Schweden,2024,2,2466005000,1455881000,3921886000
Schweden,2024,3,2552064000,1690879000,4242943000
Schweden,2024,4,2416937000,1636077000,4053014000
Schweden,2024,5,2391496000,1560155000,3951651000
Schweden,2024,6,2338847000,1499811000,3838658000
Schweden,2024,7,1933292000,1481084000,3414376000
Schweden,2024,8,2155518000,1354130000,3509648000
Schweden,2024,9,2578965000,1432818000,4011783000
Schweden,2024,10,2527183000,1745197000,4272380000
Schweden,2024,11,2386273000,1472351000,3858624000
Schweden,2024,12,1934925000,1449801000,3384726000
Schweiz,2008,1,3252241000,2509416000,5761657000
Schweiz,2008,2,3186092000,2605141000,5791233000
Schweiz,2008,3,3241084000,2515018000,5756102000
Schweiz,2008,4,3475718000,2823093000,6298811000
Schweiz,2008,5,3111483000,2548861000,5660344000
Schweiz,2008,6,3325784000,2674518000,6000302000
Schweiz,2008,7,3280507000,2972627000,6253134000
Schweiz,2008,8,2915207000,2121482000,5036689000
Schweiz,2008,9,3441487000,2607426000,6048913000
Schweiz,2008,10,3698171000,2950694000,6648865000
Schweiz,2008,11,3186718000,2786429000,5973147000
Schweiz,2008,12,2912262000,2183895000,5096157000
Schweiz,2009,1,2838798000,2443490000,5282288000
Schweiz,2009,2,2926211000,2348274000,5274485000
Schweiz,2009,3,3210005000,2589508000,5799513000
Schweiz,2009,4,2770451000,2430877000,5201328000
Schweiz,2009,5,2643411000,2218215000,4861626000
Schweiz,2009,6,2836891000,2194122000,5031013000
Schweiz,2009,7,3232652000,2546523000,5779175000
Schweiz,2009,8,2714407000,2042154000,4756561000
Schweiz,2009,9,2917457000,2422016000,5339473000
Schweiz,2009,10,3067769000,2377270000,5445039000
Schweiz,2009,11,3541485000,2406784000,5948269000
Schweiz,2009,12,2810819000,2076716000,4887535000
Schweiz,2010,1,2846562000,2264523000,5111085000
Schweiz,2010,2,3116982000,2258648000,5375630000
Schweiz,2010,3,3820018000,2923665000,6743683000
Schweiz,2010,4,3386165000,2584157000,5970322000
Schweiz,2010,5,3176343000,3030317000,6206660000
Schweiz,2010,6,3609935000,3110394000,6720329000
Schweiz,2010,7,3442754000,2837749000,6280503000
Schweiz,2010,8,3358962000,2387134000,5746096000
Schweiz,2010,9,3739836000,2817614000,6557450000
Schweiz,2010,10,3818606000,2857605000,6676211000
Schweiz,2010,11,3916352000,2944185000,6860537000
Schweiz,2010,12,3426821000,2490896000,5917717000
Schweiz,2011,1,3569900000,2753060000,6322960000
Schweiz,2011,2,3676150000,2826528000,6502678000
Schweiz,2011,3,4427903000,3257193000,7685096000
Schweiz,2011,4,3595586000,2707099000,6302685000
Schweiz,2011,5,4114583000,3257465000,7372048000
Schweiz,2011,6,3707776000,2966701000,6674477000
Schweiz,2011,7,3861976000,3061515000,6923491000
Schweiz,2011,8,4310421000,3242642000,7553063000
Schweiz,2011,9,4502888000,3320488000,7823376000
Schweiz,2011,10,3978522000,3380245000,7358767000
Schweiz,2011,11,4359682000,3281160000,7640842000
Schweiz,2011,12,3769790000,2942368000,6712158000
Schweiz,2012,1,3991004000,3013591000,7004595000
Schweiz,2012,2,4079348000,3271265000,7350613000
Schweiz,2012,3,4579910000,3133514000,7713424000
Schweiz,2012,4,3971024000,2754984000,6726008000
Schweiz,2012,5,4087392000,3219158000,7306550000
Schweiz,2012,6,4208641000,3229689000,7438330000
Schweiz,2012,7,4041633000,3444371000,7486004000
Schweiz,2012,8,3978049000,3114827000,7092876000
Schweiz,2012,9,3994560000,3218137000,7212697000
Schweiz,2012,10,4362094000,3591870000,7953964000
Schweiz,2012,11,4277753000,3379081000,7656834000
Schweiz,2012,12,3361884000,2404773000,5766657000
Schweiz,2013,1,4045262000,2928205000,6973467000
Schweiz,2013,2,3809053000,2967924000,6776977000
Schweiz,2013,3,4243348000,3027804000,7271152000
Schweiz,2013,4,4128161000,3394084000,7522245000
Schweiz,2013,5,3710776000,3319417000,7030193000
Schweiz,2013,6,3848218000,3546052000,7394270000
Schweiz,2013,7,4070611000,3396672000,7467283000
Schweiz,2013,8,3686574000,2927934000,6614508000
Schweiz,2013,9,3842400000,3207890000,7050290000
Schweiz,2013,10,4175118000,3547011000,7722129000
Schweiz,2013,11,4139430000,3438381000,7577811000
Schweiz,2013,12,3225159000,2620077000,5845236000
Schweiz,2014,1,3843637000,3190258000,7033895000
Schweiz,2014,2,3768712000,3177590000,6946302000
Schweiz,2014,3,4054711000,3401985000,7456696000
Schweiz,2014,4,3876426000,3388116000,7264542000
Schweiz,2014,5,3803679000,3277806000,7081485000
Schweiz,2014,6,3818258000,3170178000,6988436000
Schweiz,2014,7,3970383000,3662454000,7632837000
Schweiz,2014,8,3567843000,2805490000,6373333000
Schweiz,2014,9,3945004000,3135581000,7080585000
Schweiz,2014,10,4295222000,3605816000,7901038000
Schweiz,2014,11,3886866000,3589567000,7476433000
Schweiz,2014,12,3371575000,2987123000,6358698000
Schweiz,2015,1,3847729000,3165954000,7013683000
Schweiz,2015,2,4021538000,3596021000,7617559000
Schweiz,2015,3,4505238000,3601555000,8106793000
Schweiz,2015,4,4127944000,3416410000,7544354000
Schweiz,2015,5,3735861000,3340781000,7076642000
Schweiz,2015,6,4370237000,3774997000,8145234000
Schweiz,2015,7,4242559000,3689651000,7932210000
Schweiz,2015,8,3620981000,3180183000,6801164000
Schweiz,2015,9,4303413000,3407552000,7710965000
Schweiz,2015,10,4281581000,3765356000,8046937000
Schweiz,2015,11,4316068000,3909556000,8225624000
Schweiz,2015,12,3696437000,3240708000,6937145000
Schweiz,2016,1,3811177000,3322065000,7133242000
Schweiz,2016,2,4018225000,3528121000,7546346000
Schweiz,2016,3,4348803000,3651557000,8000360000
Schweiz,2016,4,4211506000,3736695000,7948201000
Schweiz,2016,5,3916580000,3271834000,7188414000
Schweiz,2016,6,4320875000,3767298000,8088173000
Schweiz,2016,7,4055156000,3545816000,7600972000
Schweiz,2016,8,4128112000,3372295000,7500407000
Schweiz,2016,9,4550441000,3744702000,8295143000
Schweiz,2016,10,4337943000,3928186000,8266129000
Schweiz,2016,11,4614234000,4355136000,8969370000
Schweiz,2016,12,3847817000,3672012000,7519829000
Schweiz,2017,1,4424003000,4179678000,8603681000
Schweiz,2017,2,4293106000,3775600000,8068706000
Schweiz,2017,3,5133644000,4370576000,9504220000
Schweiz,2017,4,4294166000,3714229000,8008395000
Schweiz,2017,5,4856322000,3982909000,8839231000
Schweiz,2017,6,4674019000,3695230000,8369249000
Schweiz,2017,7,4187988000,3736070000,7924058000
Schweiz,2017,8,4312156000,3391181000,7703337000
Schweiz,2017,9,4516542000,3690647000,8207189000
Schweiz,2017,10,4558591000,3556890000,8115481000
Schweiz,2017,11,4939402000,4208576000,9147978000
Schweiz,2017,12,3723116000,3387589000,7110705000
Schweiz,2018,1,4540047000,3654608000,8194655000
Schweiz,2018,2,4350024000,3685789000,8035813000
Schweiz,2018,3,4711104000,3913560000,8624664000
Schweiz,2018,4,4421183000,3732128000,8153311000
Schweiz,2018,5,4382262000,3549742000,7932004000
Schweiz,2018,6,4784802000,3940464000,8725266000
Schweiz,2018,7,4383667000,4223212000,8606879000
Schweiz,2018,8,4494536000,3647571000,8142107000
Schweiz,2018,9,4456082000,3822825000,8278907000
Schweiz,2018,10,4962452000,4393676000,9356128000
Schweiz,2018,11,4907960000,4244496000,9152456000
Schweiz,2018,12,3626846000,3104458000,6731304000
Schweiz,2019,1,4651787000,4056617000,8708404000
Schweiz,2019,2,4516250000,3569636000,8085886000
Schweiz,2019,3,4801788000,3969267000,8771055000
Schweiz,2019,4,4793420000,3598682000,8392102000
Schweiz,2019,5,4898459000,4089512000,8987971000
Schweiz,2019,6,4269561000,3651894000,7921455000
Schweiz,2019,7,4855102000,3910823000,8765925000
Schweiz,2019,8,4589859000,3509805000,8099664000
Schweiz,2019,9,4829233000,3696999000,8526232000
Schweiz,2019,10,5135557000,4131939000,9267496000
Schweiz,2019,11,5010552000,4142010000,9152562000
Schweiz,2019,12,3993460000,3496368000,7489828000
Schweiz,2020,1,4872812000,3970002000,8842814000
Schweiz,2020,2,4947494000,3856378000,8803872000
Schweiz,2020,3,5007338000,4657280000,9664618000
Schweiz,2020,4,4369344000,3520452000,7889796000
Schweiz,2020,5,4383574000,3613727000,7997301000
Schweiz,2020,6,4872544000,3479008000,8351552000
Schweiz,2020,7,4755520000,3813644000,8569164000
Schweiz,2020,8,4315215000,3141951000,7457166000
Schweiz,2020,9,4743262000,3799366000,8542628000
Schweiz,2020,10,4907249000,4238781000,9146030000
Schweiz,2020,11,5079028000,4064669000,9143697000
Schweiz,2020,12,4011227000,3401202000,7412429000
Schweiz,2021,1,4630848000,3533921000,8164769000
Schweiz,2021,2,4710609000,3886320000,8596929000
Schweiz,2021,3,5437615000,4497002000,9934617000
Schweiz,2021,4,4967768000,4064080000,9031848000
Schweiz,2021,5,4669472000,4373835000,9043307000
Schweiz,2021,6,4987834000,4164495000,9152329000
Schweiz,2021,7,4830619000,3891333000,8721952000
Schweiz,2021,8,4958970000,4094183000,9053153000
Schweiz,2021,9,5002329000,4084189000,9086518000
Schweiz,2021,10,5336906000,4226052000,9562958000
Schweiz,2021,11,6149935000,4592760000,10742695000
Schweiz,2021,12,4955535000,3839172000,8794707000
Schweiz,2022,1,5221631000,4169745000,9391376000
Schweiz,2022,2,5386055000,4577797000,9963852000
Schweiz,2022,3,6462139000,5232536000,11694675000
Schweiz,2022,4,5369901000,4788823000,10158724000
Schweiz,2022,5,6061059000,4737964000,10799023000
Schweiz,2022,6,5974720000,4581232000,10555952000
Schweiz,2022,7,5806459000,4568227000,10374686000
Schweiz,2022,8,5837212000,4648200000,10485412000
Schweiz,2022,9,6407174000,4430000000,10837174000
Schweiz,2022,10,5966151000,4518821000,10484972000
Schweiz,2022,11,6408665000,4938662000,11347327000
Schweiz,2022,12,5709496000,4541584000,10251080000
Schweiz,2023,1,5605010000,4496938000,10101948000
Schweiz,2023,2,5702220000,4044598000,9746818000
Schweiz,2023,3,6693834000,4687010000,11380844000
Schweiz,2023,4,5009949000,3704679000,8714628000
Schweiz,2023,5,5560570000,4681890000,10242460000
Schweiz,2023,6,5741412000,4572877000,10314289000
Schweiz,2023,7,5301910000,4006453000,9308363000
Schweiz,2023,8,5404474000,4222522000,9626996000
Schweiz,2023,9,5530491000,4263500000,9793991000
Schweiz,2023,10,5490566000,4336852000,9827418000
Schweiz,2023,11,6103022000,5074802000,11177824000
Schweiz,2023,12,4636347000,3665237000,8301584000
Schweiz,2024,1,5814749000,4257166000,10071915000
Schweiz,2024,2,5681023000,4591574000,10272597000
Schweiz,2024,3,5960794000,4648480000,10609274000
Schweiz,2024,4,6464847000,4662645000,11127492000
Schweiz,2024,5,5695102000,4117339000,9812441000
Schweiz,2024,6,5420196000,4402593000,9822789000
Schweiz,2024,7,5712259000,4636368000,10348627000
Schweiz,2024,8,5079642000,3621832000,8701474000
Schweiz,2024,9,5475101000,4771916000,10247017000
Schweiz,2024,10,5654439000,4774400000,10428839000
Schweiz,2024,11,6020562000,4798216000,10818778000
Schweiz,2024,12,5017832000,3990748000,9008580000
Senegal,2008,1,5293000,1079000,6372000
Senegal,2008,2,10065000,826000,10891000
Senegal,2008,3,9898000,662000,10560000
Senegal,2008,4,9768000,661000,10429000
Senegal,2008,5,10288000,472000,10760000
Senegal,2008,6,6269000,475000,6744000
Senegal,2008,7,8243000,465000,8708000
Senegal,2008,8,5431000,352000,5783000
Senegal,2008,9,9687000,414000,10101000
Senegal,2008,10,18417000,236000,18653000
Senegal,2008,11,6444000,102000,6546000
Senegal,2008,12,8213000,301000,8514000
Senegal,2009,1,18351000,382000,18733000
Senegal,2009,2,6017000,497000,6514000
Senegal,2009,3,15689000,967000,16656000
Senegal,2009,4,5709000,545000,6254000
Senegal,2009,5,5233000,705000,5938000
Senegal,2009,6,4756000,439000,5195000
Senegal,2009,7,9099000,692000,9791000
Senegal,2009,8,4186000,1020000,5206000
Senegal,2009,9,4588000,621000,5209000
Senegal,2009,10,5043000,153000,5196000
Senegal,2009,11,6647000,144000,6791000
Senegal,2009,12,5544000,241000,5785000
Senegal,2010,1,3850000,367000,4217000
Senegal,2010,2,5819000,269000,6088000
Senegal,2010,3,7097000,737000,7834000
Senegal,2010,4,3741000,620000,4361000
Senegal,2010,5,5266000,568000,5834000
Senegal,2010,6,6169000,581000,6750000
Senegal,2010,7,9223000,558000,9781000
Senegal,2010,8,5827000,920000,6747000
Senegal,2010,9,4711000,499000,5210000
Senegal,2010,10,6317000,254000,6571000
Senegal,2010,11,8449000,437000,8886000
Senegal,2010,12,6393000,381000,6774000
Senegal,2011,1,6756000,694000,7450000
Senegal,2011,2,6255000,541000,6796000
Senegal,2011,3,11128000,1023000,12151000
Senegal,2011,4,4745000,825000,5570000
Senegal,2011,5,12171000,419000,12590000
Senegal,2011,6,8178000,320000,8498000
Senegal,2011,7,7900000,662000,8562000
Senegal,2011,8,5279000,667000,5946000
Senegal,2011,9,5974000,517000,6491000
Senegal,2011,10,6340000,421000,6761000
Senegal,2011,11,5910000,439000,6349000
Senegal,2011,12,4046000,403000,4449000
Senegal,2012,1,4457000,303000,4760000
Senegal,2012,2,4482000,519000,5001000
Senegal,2012,3,5288000,1493000,6781000
Senegal,2012,4,5785000,1123000,6908000
Senegal,2012,5,4552000,467000,5019000
Senegal,2012,6,7390000,536000,7926000
Senegal,2012,7,18333000,709000,19042000
Senegal,2012,8,4765000,760000,5525000
Senegal,2012,9,6819000,257000,7076000
Senegal,2012,10,4456000,170000,4626000
Senegal,2012,11,6209000,218000,6427000
Senegal,2012,12,5320000,209000,5529000
Senegal,2013,1,5067000,763000,5830000
Senegal,2013,2,5837000,1250000,7087000
Senegal,2013,3,7971000,1640000,9611000
Senegal,2013,4,5305000,1972000,7277000
Senegal,2013,5,7887000,1345000,9232000
Senegal,2013,6,7144000,747000,7891000
Senegal,2013,7,7848000,1881000,9729000
Senegal,2013,8,5262000,1963000,7225000
Senegal,2013,9,5409000,1443000,6852000
Senegal,2013,10,8751000,234000,8985000
Senegal,2013,11,5568000,321000,5889000
Senegal,2013,12,6036000,389000,6425000
Senegal,2014,1,6993000,1149000,8142000
Senegal,2014,2,5819000,1183000,7002000
Senegal,2014,3,6526000,1612000,8138000
Senegal,2014,4,5109000,5121000,10230000
Senegal,2014,5,6728000,951000,7679000
Senegal,2014,6,13186000,1236000,14422000
Senegal,2014,7,9378000,1190000,10568000
Senegal,2014,8,6830000,1260000,8090000
Senegal,2014,9,7266000,1358000,8624000
Senegal,2014,10,14273000,178000,14451000
Senegal,2014,11,7873000,152000,8025000
Senegal,2014,12,9232000,501000,9733000
Senegal,2015,1,6304000,1109000,7413000
Senegal,2015,2,5357000,1144000,6501000
Senegal,2015,3,13121000,2583000,15704000
Senegal,2015,4,8710000,2216000,10926000
Senegal,2015,5,6828000,1706000,8534000
Senegal,2015,6,5923000,836000,6759000
Senegal,2015,7,9865000,1402000,11267000
Senegal,2015,8,9968000,1929000,11897000
Senegal,2015,9,13079000,452000,13531000
Senegal,2015,10,7531000,424000,7955000
Senegal,2015,11,8242000,498000,8740000
Senegal,2015,12,6674000,1302000,7976000
Senegal,2016,1,9563000,1162000,10725000
Senegal,2016,2,6322000,1742000,8064000
Senegal,2016,3,6467000,2647000,9114000
Senegal,2016,4,14406000,1434000,15840000
Senegal,2016,5,10858000,918000,11776000
Senegal,2016,6,10415000,464000,10879000
Senegal,2016,7,8554000,3364000,11918000
Senegal,2016,8,9214000,1599000,10813000
Senegal,2016,9,13024000,896000,13920000
Senegal,2016,10,6496000,626000,7122000
Senegal,2016,11,22007000,121000,22128000
Senegal,2016,12,7682000,556000,8238000
Senegal,2017,1,5736000,1459000,7195000
Senegal,2017,2,7614000,1547000,9161000
Senegal,2017,3,15261000,2071000,17332000
Senegal,2017,4,10046000,2863000,12909000
Senegal,2017,5,10110000,992000,11102000
Senegal,2017,6,8887000,603000,9490000
Senegal,2017,7,8265000,2107000,10372000
Senegal,2017,8,12040000,1875000,13915000
Senegal,2017,9,9887000,1899000,11786000
Senegal,2017,10,8391000,386000,8777000
Senegal,2017,11,10897000,1053000,11950000
Senegal,2017,12,9950000,511000,10461000
Senegal,2018,1,7722000,1376000,9098000
Senegal,2018,2,10431000,2223000,12654000
Senegal,2018,3,10829000,2126000,12955000
Senegal,2018,4,11786000,3246000,15032000
Senegal,2018,5,14124000,2300000,16424000
Senegal,2018,6,11278000,1044000,12322000
Senegal,2018,7,9341000,2522000,11863000
Senegal,2018,8,8045000,4373000,12418000
Senegal,2018,9,9574000,1200000,10774000
Senegal,2018,10,10451000,486000,10937000
Senegal,2018,11,12047000,969000,13016000
Senegal,2018,12,9069000,749000,9818000
Senegal,2019,1,12134000,1546000,13680000
Senegal,2019,2,10149000,1808000,11957000
Senegal,2019,3,10956000,1863000,12819000
Senegal,2019,4,10594000,1780000,12374000
Senegal,2019,5,8790000,1356000,10146000
Senegal,2019,6,8027000,1352000,9379000
Senegal,2019,7,14158000,2280000,16438000
Senegal,2019,8,11176000,4544000,15720000
Senegal,2019,9,11014000,1658000,12672000
Senegal,2019,10,9420000,1689000,11109000
Senegal,2019,11,11500000,1321000,12821000
Senegal,2019,12,9389000,1112000,10501000
Senegal,2020,1,10325000,1196000,11521000
Senegal,2020,2,8882000,1661000,10543000
Senegal,2020,3,12017000,3410000,15427000
Senegal,2020,4,9834000,2331000,12165000
Senegal,2020,5,10116000,704000,10820000
Senegal,2020,6,9407000,2296000,11703000
Senegal,2020,7,14816000,3120000,17936000
Senegal,2020,8,8572000,1825000,10397000
Senegal,2020,9,35488000,813000,36301000
Senegal,2020,10,12186000,859000,13045000
Senegal,2020,11,12812000,647000,13459000
Senegal,2020,12,16350000,615000,16965000
Senegal,2021,1,12720000,683000,13403000
Senegal,2021,2,11510000,1709000,13219000
Senegal,2021,3,17782000,2548000,20330000
Senegal,2021,4,11825000,2595000,14420000
Senegal,2021,5,13850000,2101000,15951000
Senegal,2021,6,16672000,1136000,17808000
Senegal,2021,7,12668000,4115000,16783000
Senegal,2021,8,17936000,2440000,20376000
Senegal,2021,9,24204000,2495000,26699000
Senegal,2021,10,22678000,1395000,24073000
Senegal,2021,11,10913000,2173000,13086000
Senegal,2021,12,16294000,1313000,17607000
Senegal,2022,1,8460000,2879000,11339000
Senegal,2022,2,9895000,2790000,12685000
Senegal,2022,3,14144000,4282000,18426000
Senegal,2022,4,11107000,2429000,13536000
Senegal,2022,5,20575000,2882000,23457000
Senegal,2022,6,19079000,1413000,20492000
Senegal,2022,7,12143000,1666000,13809000
Senegal,2022,8,11043000,1592000,12635000
Senegal,2022,9,19186000,3370000,22556000
Senegal,2022,10,11251000,1389000,12640000
Senegal,2022,11,13758000,831000,14589000
Senegal,2022,12,17196000,1775000,18971000
Senegal,2023,1,11755000,2432000,14187000
Senegal,2023,2,17049000,1991000,19040000
Senegal,2023,3,19666000,2389000,22055000
Senegal,2023,4,11892000,2922000,14814000
Senegal,2023,5,19585000,1552000,21137000
Senegal,2023,6,13902000,2098000,16000000
Senegal,2023,7,14682000,2277000,16959000
Senegal,2023,8,15922000,2205000,18127000
Senegal,2023,9,16615000,1027000,17642000
Senegal,2023,10,14101000,298000,14399000
Senegal,2023,11,18369000,567000,18936000
Senegal,2023,12,12187000,379000,12566000
Senegal,2024,1,16530000,1341000,17871000
Senegal,2024,2,15370000,3065000,18435000
Senegal,2024,3,13495000,2846000,16341000
Senegal,2024,4,14708000,2705000,17413000
Senegal,2024,5,15270000,1124000,16394000
Senegal,2024,6,13424000,1829000,15253000
Senegal,2024,7,16229000,1791000,18020000
Senegal,2024,8,14818000,3098000,17916000
Senegal,2024,9,12171000,16541000,28712000
Senegal,2024,10,11840000,14557000,26397000
Senegal,2024,11,10544000,3932000,14476000
Senegal,2024,12,45792000,17413000,63205000
Serbien (ab 06/2005),2008,1,132679000,59585000,192264000
Serbien (ab 06/2005),2008,2,135688000,57899000,193587000
Serbien (ab 06/2005),2008,3,141520000,63472000,204992000
Serbien (ab 06/2005),2008,4,161542000,59375000,220917000
Serbien (ab 06/2005),2008,5,132511000,63163000,195674000
Serbien (ab 06/2005),2008,6,169231000,69055000,238286000
Serbien (ab 06/2005),2008,7,167031000,82069000,249100000
Serbien (ab 06/2005),2008,8,138226000,71000000,209226000
Serbien (ab 06/2005),2008,9,164709000,72118000,236827000
Serbien (ab 06/2005),2008,10,164253000,64279000,228532000
Serbien (ab 06/2005),2008,11,114336000,54487000,168823000
Serbien (ab 06/2005),2008,12,112921000,49865000,162786000
Serbien (ab 06/2005),2009,1,96007000,39107000,135114000
Serbien (ab 06/2005),2009,2,101775000,45050000,146825000
Serbien (ab 06/2005),2009,3,116137000,55992000,172129000
Serbien (ab 06/2005),2009,4,106037000,44141000,150178000
Serbien (ab 06/2005),2009,5,91983000,47386000,139369000
Serbien (ab 06/2005),2009,6,107526000,52336000,159862000
Serbien (ab 06/2005),2009,7,116170000,58315000,174485000
Serbien (ab 06/2005),2009,8,87797000,41609000,129406000
Serbien (ab 06/2005),2009,9,98037000,56676000,154713000
Serbien (ab 06/2005),2009,10,98536000,53640000,152176000
Serbien (ab 06/2005),2009,11,108120000,53322000,161442000
Serbien (ab 06/2005),2009,12,101773000,43259000,145032000
Serbien (ab 06/2005),2010,1,74008000,41787000,115795000
Serbien (ab 06/2005),2010,2,94933000,54120000,149053000
Serbien (ab 06/2005),2010,3,110558000,69587000,180145000
Serbien (ab 06/2005),2010,4,104779000,56801000,161580000
Serbien (ab 06/2005),2010,5,108209000,57778000,165987000
Serbien (ab 06/2005),2010,6,116181000,65232000,181413000
Serbien (ab 06/2005),2010,7,118753000,65677000,184430000
Serbien (ab 06/2005),2010,8,100943000,51750000,152693000
Serbien (ab 06/2005),2010,9,118084000,63637000,181721000
Serbien (ab 06/2005),2010,10,113570000,65176000,178746000
Serbien (ab 06/2005),2010,11,113306000,66474000,179780000
Serbien (ab 06/2005),2010,12,102821000,59100000,161921000
Serbien (ab 06/2005),2011,1,80632000,58516000,139148000
Serbien (ab 06/2005),2011,2,110611000,70833000,181444000
Serbien (ab 06/2005),2011,3,134993000,92383000,227376000
Serbien (ab 06/2005),2011,4,120129000,80632000,200761000
Serbien (ab 06/2005),2011,5,133160000,72108000,205268000
Serbien (ab 06/2005),2011,6,128181000,73051000,201232000
Serbien (ab 06/2005),2011,7,127864000,83239000,211103000
Serbien (ab 06/2005),2011,8,131988000,76123000,208111000
Serbien (ab 06/2005),2011,9,134725000,70397000,205122000
Serbien (ab 06/2005),2011,10,121306000,71634000,192940000
Serbien (ab 06/2005),2011,11,135951000,78872000,214823000
Serbien (ab 06/2005),2011,12,109024000,70457000,179481000
Serbien (ab 06/2005),2012,1,105655000,66875000,172530000
Serbien (ab 06/2005),2012,2,116366000,72291000,188657000
Serbien (ab 06/2005),2012,3,139641000,84176000,223817000
Serbien (ab 06/2005),2012,4,127208000,82449000,209657000
Serbien (ab 06/2005),2012,5,139546000,83599000,223145000
Serbien (ab 06/2005),2012,6,143421000,90640000,234061000
Serbien (ab 06/2005),2012,7,136882000,94154000,231036000
Serbien (ab 06/2005),2012,8,136153000,75238000,211391000
Serbien (ab 06/2005),2012,9,123925000,74303000,198228000
Serbien (ab 06/2005),2012,10,142024000,90530000,232554000
Serbien (ab 06/2005),2012,11,115872000,106624000,222496000
Serbien (ab 06/2005),2012,12,102841000,74375000,177216000
Serbien (ab 06/2005),2013,1,103967000,85481000,189448000
Serbien (ab 06/2005),2013,2,121465000,88536000,210001000
Serbien (ab 06/2005),2013,3,133728000,93241000,226969000
Serbien (ab 06/2005),2013,4,141351000,104337000,245688000
Serbien (ab 06/2005),2013,5,136995000,95854000,232849000
Serbien (ab 06/2005),2013,6,134585000,92158000,226743000
Serbien (ab 06/2005),2013,7,146901000,131140000,278041000
Serbien (ab 06/2005),2013,8,129700000,96722000,226422000
Serbien (ab 06/2005),2013,9,138901000,110972000,249873000
Serbien (ab 06/2005),2013,10,151103000,117801000,268904000
Serbien (ab 06/2005),2013,11,125163000,108046000,233209000
Serbien (ab 06/2005),2013,12,111514000,95989000,207503000
Serbien (ab 06/2005),2014,1,124102000,98104000,222206000
Serbien (ab 06/2005),2014,2,137538000,110264000,247802000
Serbien (ab 06/2005),2014,3,151315000,112445000,263760000
Serbien (ab 06/2005),2014,4,150093000,107239000,257332000
Serbien (ab 06/2005),2014,5,144654000,101804000,246458000
Serbien (ab 06/2005),2014,6,145856000,112612000,258468000
Serbien (ab 06/2005),2014,7,146732000,111867000,258599000
Serbien (ab 06/2005),2014,8,128869000,97664000,226533000
Serbien (ab 06/2005),2014,9,148720000,104165000,252885000
Serbien (ab 06/2005),2014,10,154943000,115606000,270549000
Serbien (ab 06/2005),2014,11,127893000,97447000,225340000
Serbien (ab 06/2005),2014,12,127270000,91119000,218389000
Serbien (ab 06/2005),2015,1,125103000,91598000,216701000
Serbien (ab 06/2005),2015,2,145290000,107300000,252590000
Serbien (ab 06/2005),2015,3,174735000,120095000,294830000
Serbien (ab 06/2005),2015,4,162039000,101431000,263470000
Serbien (ab 06/2005),2015,5,149700000,114220000,263920000
Serbien (ab 06/2005),2015,6,174499000,116248000,290747000
Serbien (ab 06/2005),2015,7,166465000,141660000,308125000
Serbien (ab 06/2005),2015,8,206889000,121271000,328160000
Serbien (ab 06/2005),2015,9,178097000,141513000,319610000
Serbien (ab 06/2005),2015,10,169479000,128210000,297689000
Serbien (ab 06/2005),2015,11,154973000,132009000,286982000
Serbien (ab 06/2005),2015,12,147314000,114515000,261829000
Serbien (ab 06/2005),2016,1,139632000,110736000,250368000
Serbien (ab 06/2005),2016,2,177118000,138740000,315858000
Serbien (ab 06/2005),2016,3,189502000,150593000,340095000
Serbien (ab 06/2005),2016,4,185254000,156843000,342097000
Serbien (ab 06/2005),2016,5,168239000,138747000,306986000
Serbien (ab 06/2005),2016,6,199822000,146861000,346683000
Serbien (ab 06/2005),2016,7,162382000,128160000,290542000
Serbien (ab 06/2005),2016,8,170427000,134750000,305177000
Serbien (ab 06/2005),2016,9,186914000,150214000,337128000
Serbien (ab 06/2005),2016,10,169967000,149419000,319386000
Serbien (ab 06/2005),2016,11,183682000,148667000,332349000
Serbien (ab 06/2005),2016,12,159319000,128389000,287708000
Serbien (ab 06/2005),2017,1,167719000,127982000,295701000
Serbien (ab 06/2005),2017,2,187241000,142770000,330011000
Serbien (ab 06/2005),2017,3,213093000,175086000,388179000
Serbien (ab 06/2005),2017,4,177447000,137018000,314465000
Serbien (ab 06/2005),2017,5,207484000,157708000,365192000
Serbien (ab 06/2005),2017,6,213509000,170424000,383933000
Serbien (ab 06/2005),2017,7,185870000,164217000,350087000
Serbien (ab 06/2005),2017,8,212349000,173089000,385438000
Serbien (ab 06/2005),2017,9,214178000,171523000,385701000
Serbien (ab 06/2005),2017,10,196914000,149732000,346646000
Serbien (ab 06/2005),2017,11,205092000,164860000,369952000
Serbien (ab 06/2005),2017,12,168431000,135482000,303913000
Serbien (ab 06/2005),2018,1,197535000,152130000,349665000
Serbien (ab 06/2005),2018,2,222497000,154833000,377330000
Serbien (ab 06/2005),2018,3,235723000,172337000,408060000
Serbien (ab 06/2005),2018,4,210593000,164665000,375258000
Serbien (ab 06/2005),2018,5,232738000,161314000,394052000
Serbien (ab 06/2005),2018,6,232772000,182513000,415285000
Serbien (ab 06/2005),2018,7,208075000,195317000,403392000
Serbien (ab 06/2005),2018,8,230068000,171096000,401164000
Serbien (ab 06/2005),2018,9,222376000,165761000,388137000
Serbien (ab 06/2005),2018,10,254530000,185754000,440284000
Serbien (ab 06/2005),2018,11,241047000,167725000,408772000
Serbien (ab 06/2005),2018,12,181096000,132594000,313690000
Serbien (ab 06/2005),2019,1,209494000,170865000,380359000
Serbien (ab 06/2005),2019,2,249597000,181911000,431508000
Serbien (ab 06/2005),2019,3,261821000,183942000,445763000
Serbien (ab 06/2005),2019,4,245183000,195374000,440557000
Serbien (ab 06/2005),2019,5,244469000,181936000,426405000
Serbien (ab 06/2005),2019,6,227589000,183249000,410838000
Serbien (ab 06/2005),2019,7,273898000,207338000,481236000
Serbien (ab 06/2005),2019,8,216391000,185068000,401459000
Serbien (ab 06/2005),2019,9,240969000,189562000,430531000
Serbien (ab 06/2005),2019,10,249135000,201945000,451080000
Serbien (ab 06/2005),2019,11,299650000,190406000,490056000
Serbien (ab 06/2005),2019,12,212845000,157042000,369887000
Serbien (ab 06/2005),2020,1,241665000,182916000,424581000
Serbien (ab 06/2005),2020,2,258196000,194243000,452439000
Serbien (ab 06/2005),2020,3,251660000,199026000,450686000
Serbien (ab 06/2005),2020,4,162776000,123996000,286772000
Serbien (ab 06/2005),2020,5,181070000,150658000,331728000
Serbien (ab 06/2005),2020,6,232409000,186602000,419011000
Serbien (ab 06/2005),2020,7,251632000,192287000,443919000
Serbien (ab 06/2005),2020,8,217918000,164718000,382636000
Serbien (ab 06/2005),2020,9,257613000,201296000,458909000
Serbien (ab 06/2005),2020,10,288543000,205103000,493646000
Serbien (ab 06/2005),2020,11,288432000,220742000,509174000
Serbien (ab 06/2005),2020,12,221374000,183193000,404567000
Serbien (ab 06/2005),2021,1,224442000,183233000,407675000
Serbien (ab 06/2005),2021,2,259537000,213783000,473320000
Serbien (ab 06/2005),2021,3,355131000,250979000,606110000
Serbien (ab 06/2005),2021,4,308459000,225389000,533848000
Serbien (ab 06/2005),2021,5,280012000,192816000,472828000
Serbien (ab 06/2005),2021,6,305365000,221945000,527310000
Serbien (ab 06/2005),2021,7,309290000,247199000,556489000
Serbien (ab 06/2005),2021,8,289022000,231117000,520139000
Serbien (ab 06/2005),2021,9,301363000,248581000,549944000
Serbien (ab 06/2005),2021,10,313041000,255947000,568988000
Serbien (ab 06/2005),2021,11,322976000,280800000,603776000
Serbien (ab 06/2005),2021,12,279975000,230626000,510601000
Serbien (ab 06/2005),2022,1,276551000,245539000,522090000
Serbien (ab 06/2005),2022,2,322655000,297676000,620331000
Serbien (ab 06/2005),2022,3,374791000,345688000,720479000
Serbien (ab 06/2005),2022,4,316729000,300039000,616768000
Serbien (ab 06/2005),2022,5,339249000,335386000,674635000
Serbien (ab 06/2005),2022,6,353987000,336012000,689999000
Serbien (ab 06/2005),2022,7,317571000,327892000,645463000
Serbien (ab 06/2005),2022,8,325097000,337557000,662654000
Serbien (ab 06/2005),2022,9,354284000,378882000,733166000
Serbien (ab 06/2005),2022,10,332783000,369426000,702209000
Serbien (ab 06/2005),2022,11,369496000,396312000,765808000
Serbien (ab 06/2005),2022,12,346406000,302318000,648724000
Serbien (ab 06/2005),2023,1,365169000,312241000,677410000
Serbien (ab 06/2005),2023,2,362404000,349804000,712208000
Serbien (ab 06/2005),2023,3,431300000,427512000,858812000
Serbien (ab 06/2005),2023,4,338094000,340671000,678765000
Serbien (ab 06/2005),2023,5,375872000,387267000,763139000
Serbien (ab 06/2005),2023,6,398533000,435236000,833769000
Serbien (ab 06/2005),2023,7,345355000,366172000,711527000
Serbien (ab 06/2005),2023,8,361855000,335552000,697407000
Serbien (ab 06/2005),2023,9,362551000,368437000,730988000
Serbien (ab 06/2005),2023,10,371563000,382556000,754119000
Serbien (ab 06/2005),2023,11,391781000,393360000,785141000
Serbien (ab 06/2005),2023,12,322011000,294616000,616627000
Serbien (ab 06/2005),2024,1,365419000,361295000,726714000
Serbien (ab 06/2005),2024,2,442812000,379115000,821927000
Serbien (ab 06/2005),2024,3,417050000,388024000,805074000
Serbien (ab 06/2005),2024,4,421489000,432027000,853516000
Serbien (ab 06/2005),2024,5,406250000,342885000,749135000
Serbien (ab 06/2005),2024,6,382592000,376997000,759589000
Serbien (ab 06/2005),2024,7,411252000,406122000,817374000
Serbien (ab 06/2005),2024,8,359773000,365721000,725494000
Serbien (ab 06/2005),2024,9,389653000,425813000,815466000
Serbien (ab 06/2005),2024,10,462398000,445853000,908251000
Serbien (ab 06/2005),2024,11,389367000,406740000,796107000
Serbien (ab 06/2005),2024,12,315128000,313996000,629124000
Serbien und Montenegro (01/1993 bis 05/2005),2008,1,0,0,0
Serbien und Montenegro (01/1993 bis 05/2005),2008,2,0,0,0
Serbien und Montenegro (01/1993 bis 05/2005),2008,3,0,0,0
Serbien und Montenegro (01/1993 bis 05/2005),2008,4,0,0,0
Serbien und Montenegro (01/1993 bis 05/2005),2008,5,0,0,0
Serbien und Montenegro (01/1993 bis 05/2005),2008,6,0,0,0
Serbien und Montenegro (01/1993 bis 05/2005),2008,7,0,0,0
Serbien und Montenegro (01/1993 bis 05/2005),2008,8,0,0,0
Serbien und Montenegro (01/1993 bis 05/2005),2008,9,0,0,0
Serbien und Montenegro (01/1993 bis 05/2005),2008,10,0,0,0
Serbien und Montenegro (01/1993 bis 05/2005),2008,11,0,0,0
Serbien und Montenegro (01/1993 bis 05/2005),2008,12,0,0,0
Serbien und Montenegro (01/1993 bis 05/2005),2009,1,0,0,0
Serbien und Montenegro (01/1993 bis 05/2005),2009,2,0,0,0
Serbien und Montenegro (01/1993 bis 05/2005),2009,3,0,0,0
Serbien und Montenegro (01/1993 bis 05/2005),2009,4,0,0,0
Serbien und Montenegro (01/1993 bis 05/2005),2009,5,0,0,0
Serbien und Montenegro (01/1993 bis 05/2005),2009,6,0,0,0
Serbien und Montenegro (01/1993 bis 05/2005),2009,7,0,0,0
Serbien und Montenegro (01/1993 bis 05/2005),2009,8,0,0,0
Serbien und Montenegro (01/1993 bis 05/2005),2009,9,0,0,0
Serbien und Montenegro (01/1993 bis 05/2005),2009,10,0,0,0
Serbien und Montenegro (01/1993 bis 05/2005),2009,11,0,0,0
Serbien und Montenegro (01/1993 bis 05/2005),2009,12,0,0,0
Serbien und Montenegro (01/1993 bis 05/2005),2010,1,0,0,0
Serbien und Montenegro (01/1993 bis 05/2005),2010,2,0,0,0
Serbien und Montenegro (01/1993 bis 05/2005),2010,3,0,0,0
Serbien und Montenegro (01/1993 bis 05/2005),2010,4,0,0,0
Serbien und Montenegro (01/1993 bis 05/2005),2010,5,0,0,0
Serbien und Montenegro (01/1993 bis 05/2005),2010,6,0,0,0
Serbien und Montenegro (01/1993 bis 05/2005),2010,7,0,0,0
Serbien und Montenegro (01/1993 bis 05/2005),2010,8,0,0,0
Serbien und Montenegro (01/1993 bis 05/2005),2010,9,0,0,0
Serbien und Montenegro (01/1993 bis 05/2005),2010,10,0,0,0
Serbien und Montenegro (01/1993 bis 05/2005),2010,11,0,0,0
Serbien und Montenegro (01/1993 bis 05/2005),2010,12,0,0,0
Serbien und Montenegro (01/1993 bis 05/2005),2011,1,0,0,0
Serbien und Montenegro (01/1993 bis 05/2005),2011,2,0,0,0
Serbien und Montenegro (01/1993 bis 05/2005),2011,3,0,0,0
Serbien und Montenegro (01/1993 bis 05/2005),2011,4,0,0,0
Serbien und Montenegro (01/1993 bis 05/2005),2011,5,0,0,0
Serbien und Montenegro (01/1993 bis 05/2005),2011,6,0,0,0
Serbien und Montenegro (01/1993 bis 05/2005),2011,7,0,0,0
Serbien und Montenegro (01/1993 bis 05/2005),2011,8,0,0,0
Serbien und Montenegro (01/1993 bis 05/2005),2011,9,0,0,0
Serbien und Montenegro (01/1993 bis 05/2005),2011,10,0,0,0
Serbien und Montenegro (01/1993 bis 05/2005),2011,11,0,0,0
Serbien und Montenegro (01/1993 bis 05/2005),2011,12,0,0,0
Serbien und Montenegro (01/1993 bis 05/2005),2012,1,0,0,0
Serbien und Montenegro (01/1993 bis 05/2005),2012,2,0,0,0
Serbien und Montenegro (01/1993 bis 05/2005),2012,3,0,0,0
Serbien und Montenegro (01/1993 bis 05/2005),2012,4,0,0,0
Serbien und Montenegro (01/1993 bis 05/2005),2012,5,0,0,0
Serbien und Montenegro (01/1993 bis 05/2005),2012,6,0,0,0
Serbien und Montenegro (01/1993 bis 05/2005),2012,7,0,0,0
Serbien und Montenegro (01/1993 bis 05/2005),2012,8,0,0,0
Serbien und Montenegro (01/1993 bis 05/2005),2012,9,0,0,0
Serbien und Montenegro (01/1993 bis 05/2005),2012,10,0,0,0
Serbien und Montenegro (01/1993 bis 05/2005),2012,11,0,0,0
Serbien und Montenegro (01/1993 bis 05/2005),2012,12,0,0,0
Serbien und Montenegro (01/1993 bis 05/2005),2013,1,0,0,0
Serbien und Montenegro (01/1993 bis 05/2005),2013,2,0,0,0
Serbien und Montenegro (01/1993 bis 05/2005),2013,3,0,0,0
Serbien und Montenegro (01/1993 bis 05/2005),2013,4,0,0,0
Serbien und Montenegro (01/1993 bis 05/2005),2013,5,0,0,0
Serbien und Montenegro (01/1993 bis 05/2005),2013,6,0,0,0
Serbien und Montenegro (01/1993 bis 05/2005),2013,7,0,0,0
Serbien und Montenegro (01/1993 bis 05/2005),2013,8,0,0,0
Serbien und Montenegro (01/1993 bis 05/2005),2013,9,0,0,0
Serbien und Montenegro (01/1993 bis 05/2005),2013,10,0,0,0
Serbien und Montenegro (01/1993 bis 05/2005),2013,11,0,0,0
Serbien und Montenegro (01/1993 bis 05/2005),2013,12,0,0,0
Serbien und Montenegro (01/1993 bis 05/2005),2014,1,0,0,0
Serbien und Montenegro (01/1993 bis 05/2005),2014,2,0,0,0
Serbien und Montenegro (01/1993 bis 05/2005),2014,3,0,0,0
Serbien und Montenegro (01/1993 bis 05/2005),2014,4,0,0,0
Serbien und Montenegro (01/1993 bis 05/2005),2014,5,0,0,0
Serbien und Montenegro (01/1993 bis 05/2005),2014,6,0,0,0
Serbien und Montenegro (01/1993 bis 05/2005),2014,7,0,0,0
Serbien und Montenegro (01/1993 bis 05/2005),2014,8,0,0,0
Serbien und Montenegro (01/1993 bis 05/2005),2014,9,0,0,0
Serbien und Montenegro (01/1993 bis 05/2005),2014,10,0,0,0
Serbien und Montenegro (01/1993 bis 05/2005),2014,11,0,0,0
Serbien und Montenegro (01/1993 bis 05/2005),2014,12,0,0,0
Serbien und Montenegro (01/1993 bis 05/2005),2015,1,0,0,0
Serbien und Montenegro (01/1993 bis 05/2005),2015,2,0,0,0
Serbien und Montenegro (01/1993 bis 05/2005),2015,3,0,0,0
Serbien und Montenegro (01/1993 bis 05/2005),2015,4,0,0,0
Serbien und Montenegro (01/1993 bis 05/2005),2015,5,0,0,0
Serbien und Montenegro (01/1993 bis 05/2005),2015,6,0,0,0
Serbien und Montenegro (01/1993 bis 05/2005),2015,7,0,0,0
Serbien und Montenegro (01/1993 bis 05/2005),2015,8,0,0,0
Serbien und Montenegro (01/1993 bis 05/2005),2015,9,0,0,0
Serbien und Montenegro (01/1993 bis 05/2005),2015,10,0,0,0
Serbien und Montenegro (01/1993 bis 05/2005),2015,11,0,0,0
Serbien und Montenegro (01/1993 bis 05/2005),2015,12,0,0,0
Serbien und Montenegro (01/1993 bis 05/2005),2016,1,0,0,0
Serbien und Montenegro (01/1993 bis 05/2005),2016,2,0,0,0
Serbien und Montenegro (01/1993 bis 05/2005),2016,3,0,0,0
Serbien und Montenegro (01/1993 bis 05/2005),2016,4,0,0,0
Serbien und Montenegro (01/1993 bis 05/2005),2016,5,0,0,0
Serbien und Montenegro (01/1993 bis 05/2005),2016,6,0,0,0
Serbien und Montenegro (01/1993 bis 05/2005),2016,7,0,0,0
Serbien und Montenegro (01/1993 bis 05/2005),2016,8,0,0,0
Serbien und Montenegro (01/1993 bis 05/2005),2016,9,0,0,0
Serbien und Montenegro (01/1993 bis 05/2005),2016,10,0,0,0
Serbien und Montenegro (01/1993 bis 05/2005),2016,11,0,0,0
Serbien und Montenegro (01/1993 bis 05/2005),2016,12,0,0,0
Serbien und Montenegro (01/1993 bis 05/2005),2017,1,0,0,0
Serbien und Montenegro (01/1993 bis 05/2005),2017,2,0,0,0
Serbien und Montenegro (01/1993 bis 05/2005),2017,3,0,0,0
Serbien und Montenegro (01/1993 bis 05/2005),2017,4,0,0,0
Serbien und Montenegro (01/1993 bis 05/2005),2017,5,0,0,0
Serbien und Montenegro (01/1993 bis 05/2005),2017,6,0,0,0
Serbien und Montenegro (01/1993 bis 05/2005),2017,7,0,0,0
Serbien und Montenegro (01/1993 bis 05/2005),2017,8,0,0,0
Serbien und Montenegro (01/1993 bis 05/2005),2017,9,0,0,0
Serbien und Montenegro (01/1993 bis 05/2005),2017,10,0,0,0
Serbien und Montenegro (01/1993 bis 05/2005),2017,11,0,0,0
Serbien und Montenegro (01/1993 bis 05/2005),2017,12,0,0,0
Serbien und Montenegro (01/1993 bis 05/2005),2018,1,0,0,0
Serbien und Montenegro (01/1993 bis 05/2005),2018,2,0,0,0
Serbien und Montenegro (01/1993 bis 05/2005),2018,3,0,0,0
Serbien und Montenegro (01/1993 bis 05/2005),2018,4,0,0,0
Serbien und Montenegro (01/1993 bis 05/2005),2018,5,0,0,0
Serbien und Montenegro (01/1993 bis 05/2005),2018,6,0,0,0
Serbien und Montenegro (01/1993 bis 05/2005),2018,7,0,0,0
Serbien und Montenegro (01/1993 bis 05/2005),2018,8,0,0,0
Serbien und Montenegro (01/1993 bis 05/2005),2018,9,0,0,0
Serbien und Montenegro (01/1993 bis 05/2005),2018,10,0,0,0
Serbien und Montenegro (01/1993 bis 05/2005),2018,11,0,0,0
Serbien und Montenegro (01/1993 bis 05/2005),2018,12,0,0,0
Serbien und Montenegro (01/1993 bis 05/2005),2019,1,0,0,0
Serbien und Montenegro (01/1993 bis 05/2005),2019,2,0,0,0
Serbien und Montenegro (01/1993 bis 05/2005),2019,3,0,0,0
Serbien und Montenegro (01/1993 bis 05/2005),2019,4,0,0,0
Serbien und Montenegro (01/1993 bis 05/2005),2019,5,0,0,0
Serbien und Montenegro (01/1993 bis 05/2005),2019,6,0,0,0
Serbien und Montenegro (01/1993 bis 05/2005),2019,7,0,0,0
Serbien und Montenegro (01/1993 bis 05/2005),2019,8,0,0,0
Serbien und Montenegro (01/1993 bis 05/2005),2019,9,0,0,0
Serbien und Montenegro (01/1993 bis 05/2005),2019,10,0,0,0
Serbien und Montenegro (01/1993 bis 05/2005),2019,11,0,0,0
Serbien und Montenegro (01/1993 bis 05/2005),2019,12,0,0,0
Serbien und Montenegro (01/1993 bis 05/2005),2020,1,0,0,0
Serbien und Montenegro (01/1993 bis 05/2005),2020,2,0,0,0
Serbien und Montenegro (01/1993 bis 05/2005),2020,3,0,0,0
Serbien und Montenegro (01/1993 bis 05/2005),2020,4,0,0,0
Serbien und Montenegro (01/1993 bis 05/2005),2020,5,0,0,0
Serbien und Montenegro (01/1993 bis 05/2005),2020,6,0,0,0
Serbien und Montenegro (01/1993 bis 05/2005),2020,7,0,0,0
Serbien und Montenegro (01/1993 bis 05/2005),2020,8,0,0,0
Serbien und Montenegro (01/1993 bis 05/2005),2020,9,0,0,0
Serbien und Montenegro (01/1993 bis 05/2005),2020,10,0,0,0
Serbien und Montenegro (01/1993 bis 05/2005),2020,11,0,0,0
Serbien und Montenegro (01/1993 bis 05/2005),2020,12,0,0,0
Serbien und Montenegro (01/1993 bis 05/2005),2021,1,0,0,0
Serbien und Montenegro (01/1993 bis 05/2005),2021,2,0,0,0
Serbien und Montenegro (01/1993 bis 05/2005),2021,3,0,0,0
Serbien und Montenegro (01/1993 bis 05/2005),2021,4,0,0,0
Serbien und Montenegro (01/1993 bis 05/2005),2021,5,0,0,0
Serbien und Montenegro (01/1993 bis 05/2005),2021,6,0,0,0
Serbien und Montenegro (01/1993 bis 05/2005),2021,7,0,0,0
Serbien und Montenegro (01/1993 bis 05/2005),2021,8,0,0,0
Serbien und Montenegro (01/1993 bis 05/2005),2021,9,0,0,0
Serbien und Montenegro (01/1993 bis 05/2005),2021,10,0,0,0
Serbien und Montenegro (01/1993 bis 05/2005),2021,11,0,0,0
Serbien und Montenegro (01/1993 bis 05/2005),2021,12,0,0,0
Serbien und Montenegro (01/1993 bis 05/2005),2022,1,0,0,0
Serbien und Montenegro (01/1993 bis 05/2005),2022,2,0,0,0
Serbien und Montenegro (01/1993 bis 05/2005),2022,3,0,0,0
Serbien und Montenegro (01/1993 bis 05/2005),2022,4,0,0,0
Serbien und Montenegro (01/1993 bis 05/2005),2022,5,0,0,0
Serbien und Montenegro (01/1993 bis 05/2005),2022,6,0,0,0
Serbien und Montenegro (01/1993 bis 05/2005),2022,7,0,0,0
Serbien und Montenegro (01/1993 bis 05/2005),2022,8,0,0,0
Serbien und Montenegro (01/1993 bis 05/2005),2022,9,0,0,0
Serbien und Montenegro (01/1993 bis 05/2005),2022,10,0,0,0
Serbien und Montenegro (01/1993 bis 05/2005),2022,11,0,0,0
Serbien und Montenegro (01/1993 bis 05/2005),2022,12,0,0,0
Serbien und Montenegro (01/1993 bis 05/2005),2023,1,0,0,0
Serbien und Montenegro (01/1993 bis 05/2005),2023,2,0,0,0
Serbien und Montenegro (01/1993 bis 05/2005),2023,3,0,0,0
Serbien und Montenegro (01/1993 bis 05/2005),2023,4,0,0,0
Serbien und Montenegro (01/1993 bis 05/2005),2023,5,0,0,0
Serbien und Montenegro (01/1993 bis 05/2005),2023,6,0,0,0
Serbien und Montenegro (01/1993 bis 05/2005),2023,7,0,0,0
Serbien und Montenegro (01/1993 bis 05/2005),2023,8,0,0,0
Serbien und Montenegro (01/1993 bis 05/2005),2023,9,0,0,0
Serbien und Montenegro (01/1993 bis 05/2005),2023,10,0,0,0
Serbien und Montenegro (01/1993 bis 05/2005),2023,11,0,0,0
Serbien und Montenegro (01/1993 bis 05/2005),2023,12,0,0,0
Serbien und Montenegro (01/1993 bis 05/2005),2024,1,0,0,0
Serbien und Montenegro (01/1993 bis 05/2005),2024,2,0,0,0
Serbien und Montenegro (01/1993 bis 05/2005),2024,3,0,0,0
Serbien und Montenegro (01/1993 bis 05/2005),2024,4,0,0,0
Serbien und Montenegro (01/1993 bis 05/2005),2024,5,0,0,0
Serbien und Montenegro (01/1993 bis 05/2005),2024,6,0,0,0
Serbien und Montenegro (01/1993 bis 05/2005),2024,7,0,0,0
Serbien und Montenegro (01/1993 bis 05/2005),2024,8,0,0,0
Serbien und Montenegro (01/1993 bis 05/2005),2024,9,0,0,0
Serbien und Montenegro (01/1993 bis 05/2005),2024,10,0,0,0
Serbien und Montenegro (01/1993 bis 05/2005),2024,11,0,0,0
Serbien und Montenegro (01/1993 bis 05/2005),2024,12,0,0,0
Seychellen,2008,1,865000,1367000,2232000
Seychellen,2008,2,1497000,984000,2481000
Seychellen,2008,3,850000,1037000,1887000
Seychellen,2008,4,41529000,6905000,48434000
Seychellen,2008,5,1010000,2912000,3922000
Seychellen,2008,6,2221000,356000,2577000
Seychellen,2008,7,1268000,61000,1329000
Seychellen,2008,8,917000,115000,1032000
Seychellen,2008,9,2104000,185000,2289000
Seychellen,2008,10,913000,1707000,2620000
Seychellen,2008,11,1329000,45000,1374000
Seychellen,2008,12,1247000,63000,1310000
Seychellen,2009,1,1080000,724000,1804000
Seychellen,2009,2,1501000,435000,1936000
Seychellen,2009,3,1569000,717000,2286000
Seychellen,2009,4,1254000,881000,2135000
Seychellen,2009,5,973000,933000,1906000
Seychellen,2009,6,834000,34000,868000
Seychellen,2009,7,863000,1243000,2106000
Seychellen,2009,8,1559000,30000,1589000
Seychellen,2009,9,1024000,26000,1050000
Seychellen,2009,10,11840000,39000,11879000
Seychellen,2009,11,1128000,88000,1216000
Seychellen,2009,12,594000,1142000,1736000
Seychellen,2010,1,329000,2857000,3186000
Seychellen,2010,2,592000,1164000,1756000
Seychellen,2010,3,1061000,598000,1659000
Seychellen,2010,4,1092000,87000,1179000
Seychellen,2010,5,1113000,986000,2099000
Seychellen,2010,6,423000,122000,545000
Seychellen,2010,7,437000,58000,495000
Seychellen,2010,8,642000,198000,840000
Seychellen,2010,9,720000,233000,953000
Seychellen,2010,10,340000,595000,935000
Seychellen,2010,11,629000,1455000,2084000
Seychellen,2010,12,1138000,2179000,3317000
Seychellen,2011,1,406000,1795000,2201000
Seychellen,2011,2,471000,702000,1173000
Seychellen,2011,3,979000,278000,1257000
Seychellen,2011,4,906000,957000,1863000
Seychellen,2011,5,1335000,19000,1354000
Seychellen,2011,6,817000,63000,880000
Seychellen,2011,7,762000,90000,852000
Seychellen,2011,8,516000,12000,528000
Seychellen,2011,9,1284000,4000,1288000
Seychellen,2011,10,1170000,71000,1241000
Seychellen,2011,11,762000,121000,883000
Seychellen,2011,12,610000,86000,696000
Seychellen,2012,1,1066000,18000,1084000
Seychellen,2012,2,762000,430000,1192000
Seychellen,2012,3,685000,100000,785000
Seychellen,2012,4,824000,269000,1093000
Seychellen,2012,5,1292000,82000,1374000
Seychellen,2012,6,1019000,180000,1199000
Seychellen,2012,7,481000,28000,509000
Seychellen,2012,8,1074000,5000,1079000
Seychellen,2012,9,1114000,0,1114000
Seychellen,2012,10,1655000,170000,1825000
Seychellen,2012,11,1463000,69000,1532000
Seychellen,2012,12,920000,582000,1502000
Seychellen,2013,1,912000,786000,1698000
Seychellen,2013,2,3102000,99000,3201000
Seychellen,2013,3,840000,26000,866000
Seychellen,2013,4,1771000,186000,1957000
Seychellen,2013,5,4686000,393000,5079000
Seychellen,2013,6,822000,100000,922000
Seychellen,2013,7,3360000,314000,3674000
Seychellen,2013,8,1308000,28000,1336000
Seychellen,2013,9,1769000,53000,1822000
Seychellen,2013,10,2701000,121000,2822000
Seychellen,2013,11,803000,6000,809000
Seychellen,2013,12,3492000,2000,3494000
Seychellen,2014,1,970000,359000,1329000
Seychellen,2014,2,706000,248000,954000
Seychellen,2014,3,1103000,3000,1106000
Seychellen,2014,4,689000,0,689000
Seychellen,2014,5,1147000,150000,1297000
Seychellen,2014,6,722000,72000,794000
Seychellen,2014,7,1053000,3000,1056000
Seychellen,2014,8,838000,5000,843000
Seychellen,2014,9,1088000,29000,1117000
Seychellen,2014,10,1377000,130000,1507000
Seychellen,2014,11,761000,0,761000
Seychellen,2014,12,1314000,6000,1320000
Seychellen,2015,1,535000,0,535000
Seychellen,2015,2,765000,13000,778000
Seychellen,2015,3,1145000,48000,1193000
Seychellen,2015,4,1826000,229000,2055000
Seychellen,2015,5,1164000,0,1164000
Seychellen,2015,6,1373000,150000,1523000
Seychellen,2015,7,830000,89000,919000
Seychellen,2015,8,588000,20000,608000
Seychellen,2015,9,1722000,46000,1768000
Seychellen,2015,10,1635000,0,1635000
Seychellen,2015,11,1121000,408000,1529000
Seychellen,2015,12,1109000,383000,1492000
Seychellen,2016,1,755000,161000,916000
Seychellen,2016,2,931000,199000,1130000
Seychellen,2016,3,1124000,309000,1433000
Seychellen,2016,4,1014000,158000,1172000
Seychellen,2016,5,1822000,163000,1985000
Seychellen,2016,6,988000,117000,1105000
Seychellen,2016,7,1424000,110000,1534000
Seychellen,2016,8,1573000,250000,1823000
Seychellen,2016,9,2182000,437000,2619000
Seychellen,2016,10,1071000,209000,1280000
Seychellen,2016,11,1261000,222000,1483000
Seychellen,2016,12,935000,286000,1221000
Seychellen,2017,1,1212000,131000,1343000
Seychellen,2017,2,1581000,579000,2160000
Seychellen,2017,3,1248000,295000,1543000
Seychellen,2017,4,2012000,476000,2488000
Seychellen,2017,5,1930000,210000,2140000
Seychellen,2017,6,1168000,342000,1510000
Seychellen,2017,7,1577000,254000,1831000
Seychellen,2017,8,2493000,189000,2682000
Seychellen,2017,9,1437000,54000,1491000
Seychellen,2017,10,1495000,275000,1770000
Seychellen,2017,11,1403000,246000,1649000
Seychellen,2017,12,1409000,512000,1921000
Seychellen,2018,1,559000,428000,987000
Seychellen,2018,2,1005000,433000,1438000
Seychellen,2018,3,1877000,130000,2007000
Seychellen,2018,4,988000,74000,1062000
Seychellen,2018,5,1222000,294000,1516000
Seychellen,2018,6,1426000,434000,1860000
Seychellen,2018,7,1110000,1037000,2147000
Seychellen,2018,8,857000,336000,1193000
Seychellen,2018,9,1832000,20000,1852000
Seychellen,2018,10,1106000,194000,1300000
Seychellen,2018,11,1669000,196000,1865000
Seychellen,2018,12,1461000,66000,1527000
Seychellen,2019,1,834000,88000,922000
Seychellen,2019,2,1183000,93000,1276000
Seychellen,2019,3,1057000,135000,1192000
Seychellen,2019,4,1114000,152000,1266000
Seychellen,2019,5,1599000,189000,1788000
Seychellen,2019,6,1114000,441000,1555000
Seychellen,2019,7,67700000,206000,67906000
Seychellen,2019,8,1851000,121000,1972000
Seychellen,2019,9,3104000,212000,3316000
Seychellen,2019,10,2658000,53000,2711000
Seychellen,2019,11,749000,64000,813000
Seychellen,2019,12,1302000,338000,1640000
Seychellen,2020,1,1478000,284000,1762000
Seychellen,2020,2,1391000,69000,1460000
Seychellen,2020,3,67282000,15000,67297000
Seychellen,2020,4,869000,133000,1002000
Seychellen,2020,5,752000,106000,858000
Seychellen,2020,6,1097000,52000,1149000
Seychellen,2020,7,1425000,178000,1603000
Seychellen,2020,8,869000,193000,1062000
Seychellen,2020,9,604000,793000,1397000
Seychellen,2020,10,1390000,203000,1593000
Seychellen,2020,11,989000,1429000,2418000
Seychellen,2020,12,596000,1087000,1683000
Seychellen,2021,1,1828000,1673000,3501000
Seychellen,2021,2,985000,585000,1570000
Seychellen,2021,3,683000,317000,1000000
Seychellen,2021,4,606000,406000,1012000
Seychellen,2021,5,892000,773000,1665000
Seychellen,2021,6,1346000,940000,2286000
Seychellen,2021,7,1208000,597000,1805000
Seychellen,2021,8,2124000,242000,2366000
Seychellen,2021,9,975000,932000,1907000
Seychellen,2021,10,561000,87000,648000
Seychellen,2021,11,1743000,391000,2134000
Seychellen,2021,12,1638000,161000,1799000
Seychellen,2022,1,1709000,137000,1846000
Seychellen,2022,2,3126000,234000,3360000
Seychellen,2022,3,1434000,536000,1970000
Seychellen,2022,4,643000,172000,815000
Seychellen,2022,5,1001000,414000,1415000
Seychellen,2022,6,1317000,180000,1497000
Seychellen,2022,7,692000,3509000,4201000
Seychellen,2022,8,1574000,442000,2016000
Seychellen,2022,9,1586000,186000,1772000
Seychellen,2022,10,936000,166000,1102000
Seychellen,2022,11,8638000,312000,8950000
Seychellen,2022,12,987000,122000,1109000
Seychellen,2023,1,1112000,653000,1765000
Seychellen,2023,2,1533000,1326000,2859000
Seychellen,2023,3,986000,1194000,2180000
Seychellen,2023,4,1419000,1037000,2456000
Seychellen,2023,5,6051000,911000,6962000
Seychellen,2023,6,1793000,7771000,9564000
Seychellen,2023,7,1629000,3342000,4971000
Seychellen,2023,8,841000,2197000,3038000
Seychellen,2023,9,1071000,2340000,3411000
Seychellen,2023,10,2343000,619000,2962000
Seychellen,2023,11,1239000,3135000,4374000
Seychellen,2023,12,780000,3825000,4605000
Seychellen,2024,1,795000,8449000,9244000
Seychellen,2024,2,1087000,4883000,5970000
Seychellen,2024,3,2612000,2027000,4639000
Seychellen,2024,4,1524000,680000,2204000
Seychellen,2024,5,672000,1542000,2214000
Seychellen,2024,6,5085000,841000,5926000
Seychellen,2024,7,1109000,464000,1573000
Seychellen,2024,8,1006000,1113000,2119000
Seychellen,2024,9,798000,1773000,2571000
Seychellen,2024,10,1881000,2573000,4454000
Seychellen,2024,11,1093000,1155000,2248000
Seychellen,2024,12,1095000,681000,1776000
Sierra Leone,2008,1,1030000,805000,1835000
Sierra Leone,2008,2,497000,599000,1096000
Sierra Leone,2008,3,504000,727000,1231000
Sierra Leone,2008,4,694000,531000,1225000
Sierra Leone,2008,5,1018000,1725000,2743000
Sierra Leone,2008,6,1837000,609000,2446000
Sierra Leone,2008,7,470000,198000,668000
Sierra Leone,2008,8,552000,62000,614000
Sierra Leone,2008,9,553000,1314000,1867000
Sierra Leone,2008,10,948000,2266000,3214000
Sierra Leone,2008,11,1258000,339000,1597000
Sierra Leone,2008,12,1035000,790000,1825000
Sierra Leone,2009,1,913000,507000,1420000
Sierra Leone,2009,2,653000,2211000,2864000
Sierra Leone,2009,3,1211000,1558000,2769000
Sierra Leone,2009,4,1047000,169000,1216000
Sierra Leone,2009,5,914000,317000,1231000
Sierra Leone,2009,6,1095000,249000,1344000
Sierra Leone,2009,7,993000,374000,1367000
Sierra Leone,2009,8,855000,301000,1156000
Sierra Leone,2009,9,803000,12000,815000
Sierra Leone,2009,10,698000,518000,1216000
Sierra Leone,2009,11,628000,363000,991000
Sierra Leone,2009,12,605000,1120000,1725000
Sierra Leone,2010,1,567000,38000,605000
Sierra Leone,2010,2,687000,2319000,3006000
Sierra Leone,2010,3,1325000,695000,2020000
Sierra Leone,2010,4,570000,367000,937000
Sierra Leone,2010,5,675000,615000,1290000
Sierra Leone,2010,6,1852000,1095000,2947000
Sierra Leone,2010,7,499000,857000,1356000
Sierra Leone,2010,8,1698000,670000,2368000
Sierra Leone,2010,9,739000,728000,1467000
Sierra Leone,2010,10,1963000,1445000,3408000
Sierra Leone,2010,11,2040000,1355000,3395000
Sierra Leone,2010,12,1341000,1188000,2529000
Sierra Leone,2011,1,3256000,2520000,5776000
Sierra Leone,2011,2,1409000,1024000,2433000
Sierra Leone,2011,3,4176000,1884000,6060000
Sierra Leone,2011,4,3375000,1274000,4649000
Sierra Leone,2011,5,2712000,1712000,4424000
Sierra Leone,2011,6,611000,1252000,1863000
Sierra Leone,2011,7,1193000,1113000,2306000
Sierra Leone,2011,8,2904000,995000,3899000
Sierra Leone,2011,9,998000,1178000,2176000
Sierra Leone,2011,10,2555000,676000,3231000
Sierra Leone,2011,11,1561000,460000,2021000
Sierra Leone,2011,12,9073000,1000,9074000
Sierra Leone,2012,1,1376000,411000,1787000
Sierra Leone,2012,2,1627000,1397000,3024000
Sierra Leone,2012,3,1919000,1788000,3707000
Sierra Leone,2012,4,2567000,1182000,3749000
Sierra Leone,2012,5,2815000,1261000,4076000
Sierra Leone,2012,6,14513000,1354000,15867000
Sierra Leone,2012,7,2717000,302000,3019000
Sierra Leone,2012,8,1247000,72000,1319000
Sierra Leone,2012,9,4170000,1612000,5782000
Sierra Leone,2012,10,1923000,1617000,3540000
Sierra Leone,2012,11,1997000,591000,2588000
Sierra Leone,2012,12,2846000,312000,3158000
Sierra Leone,2013,1,1835000,1766000,3601000
Sierra Leone,2013,2,1981000,1296000,3277000
Sierra Leone,2013,3,1295000,698000,1993000
Sierra Leone,2013,4,2387000,437000,2824000
Sierra Leone,2013,5,1957000,874000,2831000
Sierra Leone,2013,6,1527000,1262000,2789000
Sierra Leone,2013,7,2420000,246000,2666000
Sierra Leone,2013,8,972000,425000,1397000
Sierra Leone,2013,9,2516000,1031000,3547000
Sierra Leone,2013,10,1791000,149000,1940000
Sierra Leone,2013,11,2397000,42000,2439000
Sierra Leone,2013,12,1548000,571000,2119000
Sierra Leone,2014,1,1689000,398000,2087000
Sierra Leone,2014,2,1569000,255000,1824000
Sierra Leone,2014,3,2309000,0,2309000
Sierra Leone,2014,4,1785000,51000,1836000
Sierra Leone,2014,5,2069000,476000,2545000
Sierra Leone,2014,6,2695000,0,2695000
Sierra Leone,2014,7,1866000,34000,1900000
Sierra Leone,2014,8,810000,1567000,2377000
Sierra Leone,2014,9,3464000,331000,3795000
Sierra Leone,2014,10,1575000,578000,2153000
Sierra Leone,2014,11,2159000,450000,2609000
Sierra Leone,2014,12,1922000,501000,2423000
Sierra Leone,2015,1,1667000,807000,2474000
Sierra Leone,2015,2,5190000,1265000,6455000
Sierra Leone,2015,3,1978000,501000,2479000
Sierra Leone,2015,4,2858000,207000,3065000
Sierra Leone,2015,5,2390000,236000,2626000
Sierra Leone,2015,6,1513000,872000,2385000
Sierra Leone,2015,7,2070000,930000,3000000
Sierra Leone,2015,8,1226000,649000,1875000
Sierra Leone,2015,9,1665000,782000,2447000
Sierra Leone,2015,10,2214000,649000,2863000
Sierra Leone,2015,11,2705000,1917000,4622000
Sierra Leone,2015,12,1956000,2202000,4158000
Sierra Leone,2016,1,1761000,833000,2594000
Sierra Leone,2016,2,1325000,89000,1414000
Sierra Leone,2016,3,1676000,931000,2607000
Sierra Leone,2016,4,3082000,117000,3199000
Sierra Leone,2016,5,2098000,158000,2256000
Sierra Leone,2016,6,2366000,2732000,5098000
Sierra Leone,2016,7,1199000,4000,1203000
Sierra Leone,2016,8,1282000,359000,1641000
Sierra Leone,2016,9,1249000,1602000,2851000
Sierra Leone,2016,10,905000,464000,1369000
Sierra Leone,2016,11,1802000,3249000,5051000
Sierra Leone,2016,12,1487000,2865000,4352000
Sierra Leone,2017,1,2312000,186000,2498000
Sierra Leone,2017,2,2331000,2127000,4458000
Sierra Leone,2017,3,2194000,3651000,5845000
Sierra Leone,2017,4,1588000,3401000,4989000
Sierra Leone,2017,5,2206000,2404000,4610000
Sierra Leone,2017,6,1316000,197000,1513000
Sierra Leone,2017,7,1370000,295000,1665000
Sierra Leone,2017,8,1447000,189000,1636000
Sierra Leone,2017,9,2233000,74000,2307000
Sierra Leone,2017,10,1579000,4466000,6045000
Sierra Leone,2017,11,1952000,494000,2446000
Sierra Leone,2017,12,1343000,3334000,4677000
Sierra Leone,2018,1,1057000,1654000,2711000
Sierra Leone,2018,2,1135000,5881000,7016000
Sierra Leone,2018,3,1781000,2377000,4158000
Sierra Leone,2018,4,1696000,91000,1787000
Sierra Leone,2018,5,2612000,660000,3272000
Sierra Leone,2018,6,1285000,159000,1444000
Sierra Leone,2018,7,2646000,2341000,4987000
Sierra Leone,2018,8,1576000,3897000,5473000
Sierra Leone,2018,9,1130000,3088000,4218000
Sierra Leone,2018,10,1231000,1058000,2289000
Sierra Leone,2018,11,1948000,2517000,4465000
Sierra Leone,2018,12,1957000,3673000,5630000
Sierra Leone,2019,1,982000,8417000,9399000
Sierra Leone,2019,2,2025000,356000,2381000
Sierra Leone,2019,3,1579000,4726000,6305000
Sierra Leone,2019,4,1322000,3213000,4535000
Sierra Leone,2019,5,849000,5767000,6616000
Sierra Leone,2019,6,973000,2168000,3141000
Sierra Leone,2019,7,1702000,384000,2086000
Sierra Leone,2019,8,445000,151000,596000
Sierra Leone,2019,9,787000,233000,1020000
Sierra Leone,2019,10,3277000,200000,3477000
Sierra Leone,2019,11,1166000,211000,1377000
Sierra Leone,2019,12,1591000,11150000,12741000
Sierra Leone,2020,1,596000,7033000,7629000
Sierra Leone,2020,2,861000,377000,1238000
Sierra Leone,2020,3,981000,8292000,9273000
Sierra Leone,2020,4,761000,232000,993000
Sierra Leone,2020,5,709000,3161000,3870000
Sierra Leone,2020,6,899000,2525000,3424000
Sierra Leone,2020,7,1108000,129000,1237000
Sierra Leone,2020,8,965000,470000,1435000
Sierra Leone,2020,9,1577000,237000,1814000
Sierra Leone,2020,10,1456000,221000,1677000
Sierra Leone,2020,11,1430000,464000,1894000
Sierra Leone,2020,12,1841000,589000,2430000
Sierra Leone,2021,1,1179000,2698000,3877000
Sierra Leone,2021,2,1014000,3679000,4693000
Sierra Leone,2021,3,1425000,7378000,8803000
Sierra Leone,2021,4,1772000,646000,2418000
Sierra Leone,2021,5,1073000,6169000,7242000
Sierra Leone,2021,6,1116000,2340000,3456000
Sierra Leone,2021,7,1234000,5984000,7218000
Sierra Leone,2021,8,1369000,5462000,6831000
Sierra Leone,2021,9,1001000,1598000,2599000
Sierra Leone,2021,10,1222000,10146000,11368000
Sierra Leone,2021,11,1344000,8262000,9606000
Sierra Leone,2021,12,1843000,11860000,13703000
Sierra Leone,2022,1,1196000,3914000,5110000
Sierra Leone,2022,2,941000,508000,1449000
Sierra Leone,2022,3,1837000,746000,2583000
Sierra Leone,2022,4,1092000,8629000,9721000
Sierra Leone,2022,5,1432000,2078000,3510000
Sierra Leone,2022,6,1252000,1986000,3238000
Sierra Leone,2022,7,1158000,4875000,6033000
Sierra Leone,2022,8,3881000,11886000,15767000
Sierra Leone,2022,9,1838000,3983000,5821000
Sierra Leone,2022,10,1718000,9514000,11232000
Sierra Leone,2022,11,1326000,2191000,3517000
Sierra Leone,2022,12,1919000,318000,2237000
Sierra Leone,2023,1,1209000,290000,1499000
Sierra Leone,2023,2,1116000,3868000,4984000
Sierra Leone,2023,3,1661000,286000,1947000
Sierra Leone,2023,4,850000,6947000,7797000
Sierra Leone,2023,5,795000,259000,1054000
Sierra Leone,2023,6,3086000,434000,3520000
Sierra Leone,2023,7,2747000,4345000,7092000
Sierra Leone,2023,8,2074000,447000,2521000
Sierra Leone,2023,9,1423000,205000,1628000
Sierra Leone,2023,10,977000,905000,1882000
Sierra Leone,2023,11,1489000,335000,1824000
Sierra Leone,2023,12,3490000,3344000,6834000
Sierra Leone,2024,1,1611000,349000,1960000
Sierra Leone,2024,2,1134000,7646000,8780000
Sierra Leone,2024,3,2189000,6136000,8325000
Sierra Leone,2024,4,1388000,710000,2098000
Sierra Leone,2024,5,2036000,14208000,16244000
Sierra Leone,2024,6,5398000,5643000,11041000
Sierra Leone,2024,7,1747000,501000,2248000
Sierra Leone,2024,8,1149000,4225000,5374000
Sierra Leone,2024,9,2646000,2682000,5328000
Sierra Leone,2024,10,2277000,1722000,3999000
Sierra Leone,2024,11,1540000,1687000,3227000
Sierra Leone,2024,12,1478000,3462000,4940000
Simbabwe,2008,1,2745000,20104000,22849000
Simbabwe,2008,2,6137000,3087000,9224000
Simbabwe,2008,3,3280000,3904000,7184000
Simbabwe,2008,4,2316000,4304000,6620000
Simbabwe,2008,5,9402000,845000,10247000
Simbabwe,2008,6,3976000,3275000,7251000
Simbabwe,2008,7,2347000,5450000,7797000
Simbabwe,2008,8,2843000,7808000,10651000
Simbabwe,2008,9,2125000,4344000,6469000
Simbabwe,2008,10,2857000,2275000,5132000
Simbabwe,2008,11,1528000,6225000,7753000
Simbabwe,2008,12,2577000,2178000,4755000
Simbabwe,2009,1,1127000,2852000,3979000
Simbabwe,2009,2,934000,2680000,3614000
Simbabwe,2009,3,1493000,3479000,4972000
Simbabwe,2009,4,1114000,2340000,3454000
Simbabwe,2009,5,2838000,2371000,5209000
Simbabwe,2009,6,887000,2385000,3272000
Simbabwe,2009,7,2148000,4015000,6163000
Simbabwe,2009,8,1079000,1728000,2807000
Simbabwe,2009,9,1088000,2097000,3185000
Simbabwe,2009,10,1449000,2909000,4358000
Simbabwe,2009,11,1762000,2342000,4104000
Simbabwe,2009,12,2677000,2259000,4936000
Simbabwe,2010,1,2422000,2957000,5379000
Simbabwe,2010,2,1716000,3582000,5298000
Simbabwe,2010,3,4254000,8225000,12479000
Simbabwe,2010,4,1311000,2046000,3357000
Simbabwe,2010,5,7151000,4139000,11290000
Simbabwe,2010,6,1458000,2106000,3564000
Simbabwe,2010,7,4853000,2537000,7390000
Simbabwe,2010,8,2309000,1005000,3314000
Simbabwe,2010,9,2123000,1905000,4028000
Simbabwe,2010,10,2852000,2203000,5055000
Simbabwe,2010,11,1795000,1809000,3604000
Simbabwe,2010,12,4039000,1213000,5252000
Simbabwe,2011,1,2401000,3228000,5629000
Simbabwe,2011,2,3284000,1945000,5229000
Simbabwe,2011,3,7764000,6753000,14517000
Simbabwe,2011,4,1203000,3751000,4954000
Simbabwe,2011,5,2805000,4492000,7297000
Simbabwe,2011,6,3039000,4893000,7932000
Simbabwe,2011,7,4140000,3615000,7755000
Simbabwe,2011,8,5473000,3808000,9281000
Simbabwe,2011,9,2494000,1927000,4421000
Simbabwe,2011,10,9310000,2286000,11596000
Simbabwe,2011,11,4830000,3353000,8183000
Simbabwe,2011,12,2603000,3836000,6439000
Simbabwe,2012,1,4250000,5315000,9565000
Simbabwe,2012,2,12265000,5462000,17727000
Simbabwe,2012,3,3093000,5278000,8371000
Simbabwe,2012,4,2497000,5284000,7781000
Simbabwe,2012,5,2652000,4823000,7475000
Simbabwe,2012,6,3477000,3179000,6656000
Simbabwe,2012,7,4066000,2830000,6896000
Simbabwe,2012,8,6763000,5000000,11763000
Simbabwe,2012,9,1832000,3619000,5451000
Simbabwe,2012,10,3016000,5939000,8955000
Simbabwe,2012,11,3790000,1024000,4814000
Simbabwe,2012,12,9597000,1491000,11088000
Simbabwe,2013,1,2032000,4122000,6154000
Simbabwe,2013,2,2286000,1657000,3943000
Simbabwe,2013,3,2569000,2360000,4929000
Simbabwe,2013,4,3093000,18374000,21467000
Simbabwe,2013,5,1726000,2237000,3963000
Simbabwe,2013,6,4044000,2973000,7017000
Simbabwe,2013,7,1464000,3428000,4892000
Simbabwe,2013,8,4810000,4042000,8852000
Simbabwe,2013,9,2216000,3327000,5543000
Simbabwe,2013,10,3782000,8570000,12352000
Simbabwe,2013,11,3836000,3808000,7644000
Simbabwe,2013,12,5956000,3690000,9646000
Simbabwe,2014,1,3253000,4516000,7769000
Simbabwe,2014,2,3293000,13953000,17246000
Simbabwe,2014,3,2264000,5492000,7756000
Simbabwe,2014,4,2224000,3186000,5410000
Simbabwe,2014,5,1233000,2571000,3804000
Simbabwe,2014,6,2405000,1468000,3873000
Simbabwe,2014,7,2557000,1914000,4471000
Simbabwe,2014,8,3354000,3160000,6514000
Simbabwe,2014,9,2694000,3248000,5942000
Simbabwe,2014,10,2053000,8081000,10134000
Simbabwe,2014,11,1828000,2935000,4763000
Simbabwe,2014,12,4189000,4441000,8630000
Simbabwe,2015,1,4447000,2322000,6769000
Simbabwe,2015,2,10885000,2689000,13574000
Simbabwe,2015,3,2723000,2239000,4962000
Simbabwe,2015,4,1666000,4444000,6110000
Simbabwe,2015,5,2561000,2042000,4603000
Simbabwe,2015,6,4179000,3373000,7552000
Simbabwe,2015,7,4370000,4120000,8490000
Simbabwe,2015,8,3299000,4170000,7469000
Simbabwe,2015,9,1619000,5183000,6802000
Simbabwe,2015,10,2774000,3860000,6634000
Simbabwe,2015,11,4078000,3721000,7799000
Simbabwe,2015,12,2466000,2911000,5377000
Simbabwe,2016,1,1594000,8828000,10422000
Simbabwe,2016,2,975000,13505000,14480000
Simbabwe,2016,3,2571000,5485000,8056000
Simbabwe,2016,4,3025000,3173000,6198000
Simbabwe,2016,5,7268000,5167000,12435000
Simbabwe,2016,6,1168000,4356000,5524000
Simbabwe,2016,7,1795000,3128000,4923000
Simbabwe,2016,8,1066000,3406000,4472000
Simbabwe,2016,9,3629000,2904000,6533000
Simbabwe,2016,10,989000,3369000,4358000
Simbabwe,2016,11,1833000,4382000,6215000
Simbabwe,2016,12,1176000,4606000,5782000
Simbabwe,2017,1,726000,3871000,4597000
Simbabwe,2017,2,1861000,5549000,7410000
Simbabwe,2017,3,3051000,3931000,6982000
Simbabwe,2017,4,3379000,3685000,7064000
Simbabwe,2017,5,1765000,5308000,7073000
Simbabwe,2017,6,3971000,3372000,7343000
Simbabwe,2017,7,3226000,6090000,9316000
Simbabwe,2017,8,2404000,6290000,8694000
Simbabwe,2017,9,2047000,8199000,10246000
Simbabwe,2017,10,2144000,3532000,5676000
Simbabwe,2017,11,1688000,5105000,6793000
Simbabwe,2017,12,2649000,4276000,6925000
Simbabwe,2018,1,2668000,2330000,4998000
Simbabwe,2018,2,2892000,2190000,5082000
Simbabwe,2018,3,1915000,2587000,4502000
Simbabwe,2018,4,2808000,4660000,7468000
Simbabwe,2018,5,3637000,5128000,8765000
Simbabwe,2018,6,2950000,3251000,6201000
Simbabwe,2018,7,2821000,4733000,7554000
Simbabwe,2018,8,2563000,4087000,6650000
Simbabwe,2018,9,3931000,3489000,7420000
Simbabwe,2018,10,2506000,3595000,6101000
Simbabwe,2018,11,1527000,3855000,5382000
Simbabwe,2018,12,2638000,2800000,5438000
Simbabwe,2019,1,1287000,3963000,5250000
Simbabwe,2019,2,5774000,3715000,9489000
Simbabwe,2019,3,5505000,2702000,8207000
Simbabwe,2019,4,2769000,3651000,6420000
Simbabwe,2019,5,1878000,3895000,5773000
Simbabwe,2019,6,1510000,3249000,4759000
Simbabwe,2019,7,1061000,3521000,4582000
Simbabwe,2019,8,1804000,3957000,5761000
Simbabwe,2019,9,1159000,3698000,4857000
Simbabwe,2019,10,2263000,4397000,6660000
Simbabwe,2019,11,7136000,3475000,10611000
Simbabwe,2019,12,664000,2313000,2977000
Simbabwe,2020,1,6848000,2433000,9281000
Simbabwe,2020,2,2049000,1212000,3261000
Simbabwe,2020,3,722000,1898000,2620000
Simbabwe,2020,4,923000,1690000,2613000
Simbabwe,2020,5,3738000,1877000,5615000
Simbabwe,2020,6,5658000,1056000,6714000
Simbabwe,2020,7,5959000,2483000,8442000
Simbabwe,2020,8,2282000,1558000,3840000
Simbabwe,2020,9,2424000,5802000,8226000
Simbabwe,2020,10,4389000,3564000,7953000
Simbabwe,2020,11,2196000,2979000,5175000
Simbabwe,2020,12,5409000,1610000,7019000
Simbabwe,2021,1,1769000,1272000,3041000
Simbabwe,2021,2,3893000,1931000,5824000
Simbabwe,2021,3,2731000,1352000,4083000
Simbabwe,2021,4,4371000,1924000,6295000
Simbabwe,2021,5,1486000,1742000,3228000
Simbabwe,2021,6,5415000,2027000,7442000
Simbabwe,2021,7,7765000,3428000,11193000
Simbabwe,2021,8,2107000,3667000,5774000
Simbabwe,2021,9,1642000,4968000,6610000
Simbabwe,2021,10,2667000,5335000,8002000
Simbabwe,2021,11,2782000,3676000,6458000
Simbabwe,2021,12,2262000,2826000,5088000
Simbabwe,2022,1,1447000,2624000,4071000
Simbabwe,2022,2,2187000,2528000,4715000
Simbabwe,2022,3,4508000,2547000,7055000
Simbabwe,2022,4,1328000,2950000,4278000
Simbabwe,2022,5,1987000,5057000,7044000
Simbabwe,2022,6,3523000,5794000,9317000
Simbabwe,2022,7,1541000,5160000,6701000
Simbabwe,2022,8,1616000,5673000,7289000
Simbabwe,2022,9,2024000,6689000,8713000
Simbabwe,2022,10,8530000,6205000,14735000
Simbabwe,2022,11,7068000,5433000,12501000
Simbabwe,2022,12,5499000,4663000,10162000
Simbabwe,2023,1,2414000,5739000,8153000
Simbabwe,2023,2,6969000,4543000,11512000
Simbabwe,2023,3,3829000,7196000,11025000
Simbabwe,2023,4,1904000,5754000,7658000
Simbabwe,2023,5,1823000,5294000,7117000
Simbabwe,2023,6,7150000,7003000,14153000
Simbabwe,2023,7,3879000,6607000,10486000
Simbabwe,2023,8,3751000,4895000,8646000
Simbabwe,2023,9,2166000,7295000,9461000
Simbabwe,2023,10,4401000,8380000,12781000
Simbabwe,2023,11,3152000,6469000,9621000
Simbabwe,2023,12,5302000,3348000,8650000
Simbabwe,2024,1,5349000,4457000,9806000
Simbabwe,2024,2,4022000,6823000,10845000
Simbabwe,2024,3,2331000,7189000,9520000
Simbabwe,2024,4,6465000,7572000,14037000
Simbabwe,2024,5,1884000,6222000,8106000
Simbabwe,2024,6,6823000,8776000,15599000
Simbabwe,2024,7,13179000,11169000,24348000
Simbabwe,2024,8,4483000,12011000,16494000
Simbabwe,2024,9,3802000,9275000,13077000
Simbabwe,2024,10,4919000,10442000,15361000
Simbabwe,2024,11,6282000,8959000,15241000
Simbabwe,2024,12,2688000,8933000,11621000
Singapur,2008,1,450968000,342521000,793489000
Singapur,2008,2,445770000,286891000,732661000
Singapur,2008,3,441544000,289027000,730571000
Singapur,2008,4,470900000,301105000,772005000
Singapur,2008,5,457445000,222030000,679475000
Singapur,2008,6,445484000,346988000,792472000
Singapur,2008,7,474893000,299388000,774281000
Singapur,2008,8,436805000,317298000,754103000
Singapur,2008,9,446960000,380751000,827711000
Singapur,2008,10,460043000,353530000,813573000
Singapur,2008,11,384814000,376683000,761497000
Singapur,2008,12,385489000,280208000,665697000
Singapur,2009,1,388361000,325709000,714070000
Singapur,2009,2,396883000,261382000,658265000
Singapur,2009,3,392173000,213239000,605412000
Singapur,2009,4,381422000,275534000,656956000
Singapur,2009,5,366155000,233329000,599484000
Singapur,2009,6,385575000,221892000,607467000
Singapur,2009,7,490691000,349356000,840047000
Singapur,2009,8,373076000,231831000,604907000
Singapur,2009,9,443648000,343138000,786786000
Singapur,2009,10,449552000,324886000,774438000
Singapur,2009,11,446243000,194686000,640929000
Singapur,2009,12,425107000,310314000,735421000
Singapur,2010,1,388275000,340556000,728831000
Singapur,2010,2,417758000,317051000,734809000
Singapur,2010,3,609002000,340071000,949073000
Singapur,2010,4,453513000,401169000,854682000
Singapur,2010,5,489080000,357288000,846368000
Singapur,2010,6,524818000,373243000,898061000
Singapur,2010,7,494084000,373985000,868069000
Singapur,2010,8,460125000,452623000,912748000
Singapur,2010,9,541521000,460535000,1002056000
Singapur,2010,10,480452000,457024000,937476000
Singapur,2010,11,599554000,425606000,1025160000
Singapur,2010,12,505140000,405950000,911090000
Singapur,2011,1,438268000,448018000,886286000
Singapur,2011,2,440393000,396855000,837248000
Singapur,2011,3,619244000,434064000,1053308000
Singapur,2011,4,503293000,393674000,896967000
Singapur,2011,5,595143000,370082000,965225000
Singapur,2011,6,478699000,398901000,877600000
Singapur,2011,7,550504000,400822000,951326000
Singapur,2011,8,561229000,462300000,1023529000
Singapur,2011,9,583261000,344699000,927960000
Singapur,2011,10,501338000,402971000,904309000
Singapur,2011,11,618422000,374119000,992541000
Singapur,2011,12,551397000,415115000,966512000
Singapur,2012,1,526333000,351636000,877969000
Singapur,2012,2,530242000,332039000,862281000
Singapur,2012,3,586813000,525064000,1111877000
Singapur,2012,4,524664000,441892000,966556000
Singapur,2012,5,591551000,347676000,939227000
Singapur,2012,6,566128000,431313000,997441000
Singapur,2012,7,612897000,425959000,1038856000
Singapur,2012,8,542290000,518116000,1060406000
Singapur,2012,9,513016000,369532000,882548000
Singapur,2012,10,570937000,419551000,990488000
Singapur,2012,11,552590000,614066000,1166656000
Singapur,2012,12,432710000,307335000,740045000
Singapur,2013,1,500352000,447473000,947825000
Singapur,2013,2,465932000,521427000,987359000
Singapur,2013,3,540105000,335178000,875283000
Singapur,2013,4,570893000,505840000,1076733000
Singapur,2013,5,497047000,380483000,877530000
Singapur,2013,6,497411000,345767000,843178000
Singapur,2013,7,593146000,327308000,920454000
Singapur,2013,8,549799000,375492000,925291000
Singapur,2013,9,496330000,380692000,877022000
Singapur,2013,10,608310000,448721000,1057031000
Singapur,2013,11,479878000,398599000,878477000
Singapur,2013,12,508747000,340583000,849330000
Singapur,2014,1,526618000,514446000,1041064000
Singapur,2014,2,471678000,389468000,861146000
Singapur,2014,3,504064000,370802000,874866000
Singapur,2014,4,558804000,435158000,993962000
Singapur,2014,5,474447000,372119000,846566000
Singapur,2014,6,497480000,377240000,874720000
Singapur,2014,7,555202000,279738000,834940000
Singapur,2014,8,510062000,533163000,1043225000
Singapur,2014,9,533347000,393846000,927193000
Singapur,2014,10,573853000,504711000,1078564000
Singapur,2014,11,522307000,410373000,932680000
Singapur,2014,12,561524000,404174000,965698000
Singapur,2015,1,464025000,457378000,921403000
Singapur,2015,2,520198000,538723000,1058921000
Singapur,2015,3,604802000,498025000,1102827000
Singapur,2015,4,542311000,622420000,1164731000
Singapur,2015,5,522049000,358166000,880215000
Singapur,2015,6,585730000,432068000,1017798000
Singapur,2015,7,631275000,456527000,1087802000
Singapur,2015,8,524787000,490448000,1015235000
Singapur,2015,9,553193000,566074000,1119267000
Singapur,2015,10,559473000,571027000,1130500000
Singapur,2015,11,564218000,386403000,950621000
Singapur,2015,12,533248000,491984000,1025232000
Singapur,2016,1,488762000,810024000,1298786000
Singapur,2016,2,504442000,454833000,959275000
Singapur,2016,3,563657000,396454000,960111000
Singapur,2016,4,623821000,312971000,936792000
Singapur,2016,5,523351000,377839000,901190000
Singapur,2016,6,596644000,574168000,1170812000
Singapur,2016,7,583722000,338788000,922510000
Singapur,2016,8,564327000,484819000,1049146000
Singapur,2016,9,581464000,366589000,948053000
Singapur,2016,10,553357000,444466000,997823000
Singapur,2016,11,567375000,366028000,933403000
Singapur,2016,12,556704000,439911000,996615000
Singapur,2017,1,535849000,511654000,1047503000
Singapur,2017,2,519030000,441673000,960703000
Singapur,2017,3,695067000,794010000,1489077000
Singapur,2017,4,546841000,449777000,996618000
Singapur,2017,5,575825000,414670000,990495000
Singapur,2017,6,569766000,553011000,1122777000
Singapur,2017,7,538871000,589233000,1128104000
Singapur,2017,8,652189000,776029000,1428218000
Singapur,2017,9,562337000,478278000,1040615000
Singapur,2017,10,578703000,476634000,1055337000
Singapur,2017,11,610313000,352621000,962934000
Singapur,2017,12,543925000,682834000,1226759000
Singapur,2018,1,573243000,601442000,1174685000
Singapur,2018,2,560471000,566338000,1126809000
Singapur,2018,3,626638000,420684000,1047322000
Singapur,2018,4,775436000,456438000,1231874000
Singapur,2018,5,994062000,640115000,1634177000
Singapur,2018,6,742511000,751948000,1494459000
Singapur,2018,7,670720000,421939000,1092659000
Singapur,2018,8,614336000,428840000,1043176000
Singapur,2018,9,586318000,646217000,1232535000
Singapur,2018,10,638610000,624306000,1262916000
Singapur,2018,11,611688000,589473000,1201161000
Singapur,2018,12,579553000,444094000,1023647000
Singapur,2019,1,617847000,455550000,1073397000
Singapur,2019,2,647958000,480367000,1128325000
Singapur,2019,3,613618000,353279000,966897000
Singapur,2019,4,579452000,536219000,1115671000
Singapur,2019,5,622133000,378830000,1000963000
Singapur,2019,6,536073000,451910000,987983000
Singapur,2019,7,650655000,738036000,1388691000
Singapur,2019,8,588197000,357955000,946152000
Singapur,2019,9,601897000,367261000,969158000
Singapur,2019,10,622224000,692226000,1314450000
Singapur,2019,11,676116000,567924000,1244040000
Singapur,2019,12,549196000,378240000,927436000
Singapur,2020,1,571012000,558536000,1129548000
Singapur,2020,2,625099000,302537000,927636000
Singapur,2020,3,573697000,616296000,1189993000
Singapur,2020,4,551176000,485469000,1036645000
Singapur,2020,5,457621000,591840000,1049461000
Singapur,2020,6,460955000,506394000,967349000
Singapur,2020,7,522041000,328589000,850630000
Singapur,2020,8,428283000,202916000,631199000
Singapur,2020,9,461341000,217296000,678637000
Singapur,2020,10,524234000,319439000,843673000
Singapur,2020,11,487004000,291983000,778987000
Singapur,2020,12,477690000,447354000,925044000
Singapur,2021,1,490339000,261129000,751468000
Singapur,2021,2,495701000,269779000,765480000
Singapur,2021,3,618104000,324180000,942284000
Singapur,2021,4,572911000,321357000,894268000
Singapur,2021,5,698391000,371322000,1069713000
Singapur,2021,6,634718000,344972000,979690000
Singapur,2021,7,617350000,395258000,1012608000
Singapur,2021,8,576680000,544052000,1120732000
Singapur,2021,9,577086000,425105000,1002191000
Singapur,2021,10,615547000,277636000,893183000
Singapur,2021,11,664082000,317321000,981403000
Singapur,2021,12,664819000,387805000,1052624000
Singapur,2022,1,551948000,406608000,958556000
Singapur,2022,2,603496000,562028000,1165524000
Singapur,2022,3,695597000,363526000,1059123000
Singapur,2022,4,645650000,374853000,1020503000
Singapur,2022,5,608307000,1921838000,2530145000
Singapur,2022,6,621223000,394433000,1015656000
Singapur,2022,7,745143000,284993000,1030136000
Singapur,2022,8,806400000,436025000,1242425000
Singapur,2022,9,636597000,788610000,1425207000
Singapur,2022,10,592614000,810567000,1403181000
Singapur,2022,11,627041000,478197000,1105238000
Singapur,2022,12,559036000,267973000,827009000
Singapur,2023,1,569331000,539157000,1108488000
Singapur,2023,2,598922000,814431000,1413353000
Singapur,2023,3,652327000,353166000,1005493000
Singapur,2023,4,524840000,1030013000,1554853000
Singapur,2023,5,575709000,1091400000,1667109000
Singapur,2023,6,1176786000,374146000,1550932000
Singapur,2023,7,541252000,342518000,883770000
Singapur,2023,8,588652000,360508000,949160000
Singapur,2023,9,519556000,354713000,874269000
Singapur,2023,10,566567000,397902000,964469000
Singapur,2023,11,614791000,280983000,895774000
Singapur,2023,12,499267000,342892000,842159000
Singapur,2024,1,569676000,425652000,995328000
Singapur,2024,2,536427000,344129000,880556000
Singapur,2024,3,542176000,440633000,982809000
Singapur,2024,4,567640000,304329000,871969000
Singapur,2024,5,507997000,451489000,959486000
Singapur,2024,6,576412000,268091000,844503000
Singapur,2024,7,1119130000,295529000,1414659000
Singapur,2024,8,537198000,303574000,840772000
Singapur,2024,9,587770000,546328000,1134098000
Singapur,2024,10,520057000,852177000,1372234000
Singapur,2024,11,509909000,296872000,806781000
Singapur,2024,12,459142000,345078000,804220000
Sint Maarten (niederländischer Teil) (ab 2013),2008,1,0,0,0
Sint Maarten (niederländischer Teil) (ab 2013),2008,2,0,0,0
Sint Maarten (niederländischer Teil) (ab 2013),2008,3,0,0,0
Sint Maarten (niederländischer Teil) (ab 2013),2008,4,0,0,0
Sint Maarten (niederländischer Teil) (ab 2013),2008,5,0,0,0
Sint Maarten (niederländischer Teil) (ab 2013),2008,6,0,0,0
Sint Maarten (niederländischer Teil) (ab 2013),2008,7,0,0,0
Sint Maarten (niederländischer Teil) (ab 2013),2008,8,0,0,0
Sint Maarten (niederländischer Teil) (ab 2013),2008,9,0,0,0
Sint Maarten (niederländischer Teil) (ab 2013),2008,10,0,0,0
Sint Maarten (niederländischer Teil) (ab 2013),2008,11,0,0,0
Sint Maarten (niederländischer Teil) (ab 2013),2008,12,0,0,0
Sint Maarten (niederländischer Teil) (ab 2013),2009,1,0,0,0
Sint Maarten (niederländischer Teil) (ab 2013),2009,2,0,0,0
Sint Maarten (niederländischer Teil) (ab 2013),2009,3,0,0,0
Sint Maarten (niederländischer Teil) (ab 2013),2009,4,0,0,0
Sint Maarten (niederländischer Teil) (ab 2013),2009,5,0,0,0
Sint Maarten (niederländischer Teil) (ab 2013),2009,6,0,0,0
Sint Maarten (niederländischer Teil) (ab 2013),2009,7,0,0,0
Sint Maarten (niederländischer Teil) (ab 2013),2009,8,0,0,0
Sint Maarten (niederländischer Teil) (ab 2013),2009,9,0,0,0
Sint Maarten (niederländischer Teil) (ab 2013),2009,10,0,0,0
Sint Maarten (niederländischer Teil) (ab 2013),2009,11,0,0,0
Sint Maarten (niederländischer Teil) (ab 2013),2009,12,0,0,0
Sint Maarten (niederländischer Teil) (ab 2013),2010,1,0,0,0
Sint Maarten (niederländischer Teil) (ab 2013),2010,2,0,0,0
Sint Maarten (niederländischer Teil) (ab 2013),2010,3,0,0,0
Sint Maarten (niederländischer Teil) (ab 2013),2010,4,0,0,0
Sint Maarten (niederländischer Teil) (ab 2013),2010,5,0,0,0
Sint Maarten (niederländischer Teil) (ab 2013),2010,6,0,0,0
Sint Maarten (niederländischer Teil) (ab 2013),2010,7,0,0,0
Sint Maarten (niederländischer Teil) (ab 2013),2010,8,0,0,0
Sint Maarten (niederländischer Teil) (ab 2013),2010,9,0,0,0
Sint Maarten (niederländischer Teil) (ab 2013),2010,10,0,0,0
Sint Maarten (niederländischer Teil) (ab 2013),2010,11,0,0,0
Sint Maarten (niederländischer Teil) (ab 2013),2010,12,0,0,0
Sint Maarten (niederländischer Teil) (ab 2013),2011,1,0,0,0
Sint Maarten (niederländischer Teil) (ab 2013),2011,2,0,0,0
Sint Maarten (niederländischer Teil) (ab 2013),2011,3,0,0,0
Sint Maarten (niederländischer Teil) (ab 2013),2011,4,0,0,0
Sint Maarten (niederländischer Teil) (ab 2013),2011,5,0,0,0
Sint Maarten (niederländischer Teil) (ab 2013),2011,6,0,0,0
Sint Maarten (niederländischer Teil) (ab 2013),2011,7,0,0,0
Sint Maarten (niederländischer Teil) (ab 2013),2011,8,0,0,0
Sint Maarten (niederländischer Teil) (ab 2013),2011,9,0,0,0
Sint Maarten (niederländischer Teil) (ab 2013),2011,10,0,0,0
Sint Maarten (niederländischer Teil) (ab 2013),2011,11,0,0,0
Sint Maarten (niederländischer Teil) (ab 2013),2011,12,0,0,0
Sint Maarten (niederländischer Teil) (ab 2013),2012,1,0,0,0
Sint Maarten (niederländischer Teil) (ab 2013),2012,2,0,0,0
Sint Maarten (niederländischer Teil) (ab 2013),2012,3,0,0,0
Sint Maarten (niederländischer Teil) (ab 2013),2012,4,0,0,0
Sint Maarten (niederländischer Teil) (ab 2013),2012,5,0,0,0
Sint Maarten (niederländischer Teil) (ab 2013),2012,6,0,0,0
Sint Maarten (niederländischer Teil) (ab 2013),2012,7,0,0,0
Sint Maarten (niederländischer Teil) (ab 2013),2012,8,0,0,0
Sint Maarten (niederländischer Teil) (ab 2013),2012,9,0,0,0
Sint Maarten (niederländischer Teil) (ab 2013),2012,10,0,0,0
Sint Maarten (niederländischer Teil) (ab 2013),2012,11,0,0,0
Sint Maarten (niederländischer Teil) (ab 2013),2012,12,0,0,0
Sint Maarten (niederländischer Teil) (ab 2013),2013,1,325000,42000,367000
Sint Maarten (niederländischer Teil) (ab 2013),2013,2,362000,0,362000
Sint Maarten (niederländischer Teil) (ab 2013),2013,3,146000,1000,147000
Sint Maarten (niederländischer Teil) (ab 2013),2013,4,130000,0,130000
Sint Maarten (niederländischer Teil) (ab 2013),2013,5,206000,0,206000
Sint Maarten (niederländischer Teil) (ab 2013),2013,6,354000,5000,359000
Sint Maarten (niederländischer Teil) (ab 2013),2013,7,310000,0,310000
Sint Maarten (niederländischer Teil) (ab 2013),2013,8,334000,8000,342000
Sint Maarten (niederländischer Teil) (ab 2013),2013,9,167000,17000,184000
Sint Maarten (niederländischer Teil) (ab 2013),2013,10,936000,60000,996000
Sint Maarten (niederländischer Teil) (ab 2013),2013,11,280000,58000,338000
Sint Maarten (niederländischer Teil) (ab 2013),2013,12,681000,6000,687000
Sint Maarten (niederländischer Teil) (ab 2013),2014,1,294000,3000,297000
Sint Maarten (niederländischer Teil) (ab 2013),2014,2,188000,0,188000
Sint Maarten (niederländischer Teil) (ab 2013),2014,3,346000,0,346000
Sint Maarten (niederländischer Teil) (ab 2013),2014,4,349000,4000,353000
Sint Maarten (niederländischer Teil) (ab 2013),2014,5,283000,0,283000
Sint Maarten (niederländischer Teil) (ab 2013),2014,6,155000,0,155000
Sint Maarten (niederländischer Teil) (ab 2013),2014,7,167000,18000,185000
Sint Maarten (niederländischer Teil) (ab 2013),2014,8,136000,37000,173000
Sint Maarten (niederländischer Teil) (ab 2013),2014,9,252000,1000,253000
Sint Maarten (niederländischer Teil) (ab 2013),2014,10,345000,1000,346000
Sint Maarten (niederländischer Teil) (ab 2013),2014,11,526000,0,526000
Sint Maarten (niederländischer Teil) (ab 2013),2014,12,764000,0,764000
Sint Maarten (niederländischer Teil) (ab 2013),2015,1,322000,69000,391000
Sint Maarten (niederländischer Teil) (ab 2013),2015,2,652000,4000,656000
Sint Maarten (niederländischer Teil) (ab 2013),2015,3,480000,14000,494000
Sint Maarten (niederländischer Teil) (ab 2013),2015,4,387000,0,387000
Sint Maarten (niederländischer Teil) (ab 2013),2015,5,259000,6000,265000
Sint Maarten (niederländischer Teil) (ab 2013),2015,6,576000,0,576000
Sint Maarten (niederländischer Teil) (ab 2013),2015,7,3370000,0,3370000
Sint Maarten (niederländischer Teil) (ab 2013),2015,8,412000,0,412000
Sint Maarten (niederländischer Teil) (ab 2013),2015,9,526000,0,526000
Sint Maarten (niederländischer Teil) (ab 2013),2015,10,469000,0,469000
Sint Maarten (niederländischer Teil) (ab 2013),2015,11,331000,0,331000
Sint Maarten (niederländischer Teil) (ab 2013),2015,12,695000,3000,698000
Sint Maarten (niederländischer Teil) (ab 2013),2016,1,646000,18000,664000
Sint Maarten (niederländischer Teil) (ab 2013),2016,2,725000,17000,742000
Sint Maarten (niederländischer Teil) (ab 2013),2016,3,375000,6000,381000
Sint Maarten (niederländischer Teil) (ab 2013),2016,4,428000,11000,439000
Sint Maarten (niederländischer Teil) (ab 2013),2016,5,98000,5000,103000
Sint Maarten (niederländischer Teil) (ab 2013),2016,6,788000,0,788000
Sint Maarten (niederländischer Teil) (ab 2013),2016,7,459000,0,459000
Sint Maarten (niederländischer Teil) (ab 2013),2016,8,115000,20000,135000
Sint Maarten (niederländischer Teil) (ab 2013),2016,9,152000,0,152000
Sint Maarten (niederländischer Teil) (ab 2013),2016,10,907000,0,907000
Sint Maarten (niederländischer Teil) (ab 2013),2016,11,444000,1000,445000
Sint Maarten (niederländischer Teil) (ab 2013),2016,12,470000,42000,512000
Sint Maarten (niederländischer Teil) (ab 2013),2017,1,366000,2000,368000
Sint Maarten (niederländischer Teil) (ab 2013),2017,2,311000,18000,329000
Sint Maarten (niederländischer Teil) (ab 2013),2017,3,471000,4000,475000
Sint Maarten (niederländischer Teil) (ab 2013),2017,4,418000,0,418000
Sint Maarten (niederländischer Teil) (ab 2013),2017,5,535000,1000,536000
Sint Maarten (niederländischer Teil) (ab 2013),2017,6,429000,13000,442000
Sint Maarten (niederländischer Teil) (ab 2013),2017,7,1103000,5000,1108000
Sint Maarten (niederländischer Teil) (ab 2013),2017,8,438000,12000,450000
Sint Maarten (niederländischer Teil) (ab 2013),2017,9,60000,0,60000
Sint Maarten (niederländischer Teil) (ab 2013),2017,10,135000,34000,169000
Sint Maarten (niederländischer Teil) (ab 2013),2017,11,388000,1000,389000
Sint Maarten (niederländischer Teil) (ab 2013),2017,12,285000,1000,286000
Sint Maarten (niederländischer Teil) (ab 2013),2018,1,283000,0,283000
Sint Maarten (niederländischer Teil) (ab 2013),2018,2,445000,1000,446000
Sint Maarten (niederländischer Teil) (ab 2013),2018,3,169000,1000,170000
Sint Maarten (niederländischer Teil) (ab 2013),2018,4,205000,14000,219000
Sint Maarten (niederländischer Teil) (ab 2013),2018,5,342000,0,342000
Sint Maarten (niederländischer Teil) (ab 2013),2018,6,156000,1000,157000
Sint Maarten (niederländischer Teil) (ab 2013),2018,7,132000,0,132000
Sint Maarten (niederländischer Teil) (ab 2013),2018,8,122000,1000,123000
Sint Maarten (niederländischer Teil) (ab 2013),2018,9,376000,29000,405000
Sint Maarten (niederländischer Teil) (ab 2013),2018,10,490000,0,490000
Sint Maarten (niederländischer Teil) (ab 2013),2018,11,593000,38000,631000
Sint Maarten (niederländischer Teil) (ab 2013),2018,12,295000,41000,336000
Sint Maarten (niederländischer Teil) (ab 2013),2019,1,211000,8000,219000
Sint Maarten (niederländischer Teil) (ab 2013),2019,2,347000,24000,371000
Sint Maarten (niederländischer Teil) (ab 2013),2019,3,501000,58000,559000
Sint Maarten (niederländischer Teil) (ab 2013),2019,4,305000,2000,307000
Sint Maarten (niederländischer Teil) (ab 2013),2019,5,298000,0,298000
Sint Maarten (niederländischer Teil) (ab 2013),2019,6,522000,4000,526000
Sint Maarten (niederländischer Teil) (ab 2013),2019,7,324000,5000,329000
Sint Maarten (niederländischer Teil) (ab 2013),2019,8,191000,0,191000
Sint Maarten (niederländischer Teil) (ab 2013),2019,9,490000,0,490000
Sint Maarten (niederländischer Teil) (ab 2013),2019,10,245000,0,245000
Sint Maarten (niederländischer Teil) (ab 2013),2019,11,476000,3000,479000
Sint Maarten (niederländischer Teil) (ab 2013),2019,12,270000,0,270000
Sint Maarten (niederländischer Teil) (ab 2013),2020,1,509000,0,509000
Sint Maarten (niederländischer Teil) (ab 2013),2020,2,330000,5000,335000
Sint Maarten (niederländischer Teil) (ab 2013),2020,3,133000,132000,265000
Sint Maarten (niederländischer Teil) (ab 2013),2020,4,192000,0,192000
Sint Maarten (niederländischer Teil) (ab 2013),2020,5,146000,3000,149000
Sint Maarten (niederländischer Teil) (ab 2013),2020,6,58000,2000,60000
Sint Maarten (niederländischer Teil) (ab 2013),2020,7,154000,1000,155000
Sint Maarten (niederländischer Teil) (ab 2013),2020,8,75000,0,75000
Sint Maarten (niederländischer Teil) (ab 2013),2020,9,125000,21000,146000
Sint Maarten (niederländischer Teil) (ab 2013),2020,10,217000,0,217000
Sint Maarten (niederländischer Teil) (ab 2013),2020,11,110000,0,110000
Sint Maarten (niederländischer Teil) (ab 2013),2020,12,889000,0,889000
Sint Maarten (niederländischer Teil) (ab 2013),2021,1,424000,0,424000
Sint Maarten (niederländischer Teil) (ab 2013),2021,2,510000,240000,750000
Sint Maarten (niederländischer Teil) (ab 2013),2021,3,643000,23000,666000
Sint Maarten (niederländischer Teil) (ab 2013),2021,4,340000,14000,354000
Sint Maarten (niederländischer Teil) (ab 2013),2021,5,500000,11000,511000
Sint Maarten (niederländischer Teil) (ab 2013),2021,6,330000,0,330000
Sint Maarten (niederländischer Teil) (ab 2013),2021,7,377000,1000,378000
Sint Maarten (niederländischer Teil) (ab 2013),2021,8,210000,0,210000
Sint Maarten (niederländischer Teil) (ab 2013),2021,9,350000,0,350000
Sint Maarten (niederländischer Teil) (ab 2013),2021,10,495000,8000,503000
Sint Maarten (niederländischer Teil) (ab 2013),2021,11,219000,0,219000
Sint Maarten (niederländischer Teil) (ab 2013),2021,12,528000,14000,542000
Sint Maarten (niederländischer Teil) (ab 2013),2022,1,269000,1000,270000
Sint Maarten (niederländischer Teil) (ab 2013),2022,2,363000,3000,366000
Sint Maarten (niederländischer Teil) (ab 2013),2022,3,222000,7000,229000
Sint Maarten (niederländischer Teil) (ab 2013),2022,4,585000,22000,607000
Sint Maarten (niederländischer Teil) (ab 2013),2022,5,141000,2000,143000
Sint Maarten (niederländischer Teil) (ab 2013),2022,6,211000,24000,235000
Sint Maarten (niederländischer Teil) (ab 2013),2022,7,146000,1000,147000
Sint Maarten (niederländischer Teil) (ab 2013),2022,8,146000,0,146000
Sint Maarten (niederländischer Teil) (ab 2013),2022,9,383000,77000,460000
Sint Maarten (niederländischer Teil) (ab 2013),2022,10,238000,3000,241000
Sint Maarten (niederländischer Teil) (ab 2013),2022,11,347000,3000,350000
Sint Maarten (niederländischer Teil) (ab 2013),2022,12,771000,53000,824000
Sint Maarten (niederländischer Teil) (ab 2013),2023,1,433000,3000,436000
Sint Maarten (niederländischer Teil) (ab 2013),2023,2,895000,2000,897000
Sint Maarten (niederländischer Teil) (ab 2013),2023,3,356000,2000,358000
Sint Maarten (niederländischer Teil) (ab 2013),2023,4,303000,3000,306000
Sint Maarten (niederländischer Teil) (ab 2013),2023,5,161000,0,161000
Sint Maarten (niederländischer Teil) (ab 2013),2023,6,447000,25000,472000
Sint Maarten (niederländischer Teil) (ab 2013),2023,7,324000,0,324000
Sint Maarten (niederländischer Teil) (ab 2013),2023,8,150000,8000,158000
Sint Maarten (niederländischer Teil) (ab 2013),2023,9,272000,5000,277000
Sint Maarten (niederländischer Teil) (ab 2013),2023,10,329000,4000,333000
Sint Maarten (niederländischer Teil) (ab 2013),2023,11,450000,56000,506000
Sint Maarten (niederländischer Teil) (ab 2013),2023,12,288000,1000,289000
Sint Maarten (niederländischer Teil) (ab 2013),2024,1,154000,4000,158000
Sint Maarten (niederländischer Teil) (ab 2013),2024,2,550000,47000,597000
Sint Maarten (niederländischer Teil) (ab 2013),2024,3,252000,2000,254000
Sint Maarten (niederländischer Teil) (ab 2013),2024,4,132000,7000,139000
Sint Maarten (niederländischer Teil) (ab 2013),2024,5,119000,1000,120000
Sint Maarten (niederländischer Teil) (ab 2013),2024,6,384000,0,384000
Sint Maarten (niederländischer Teil) (ab 2013),2024,7,184000,2000,186000
Sint Maarten (niederländischer Teil) (ab 2013),2024,8,431000,17000,448000
Sint Maarten (niederländischer Teil) (ab 2013),2024,9,222000,0,222000
Sint Maarten (niederländischer Teil) (ab 2013),2024,10,232000,1000,233000
Sint Maarten (niederländischer Teil) (ab 2013),2024,11,215000,6000,221000
Sint Maarten (niederländischer Teil) (ab 2013),2024,12,177000,0,177000
Slowakei (ab 1993),2008,1,690117000,686318000,1376435000
Slowakei (ab 1993),2008,2,752734000,746614000,1499348000
Slowakei (ab 1993),2008,3,702565000,736311000,1438876000
Slowakei (ab 1993),2008,4,806494000,730658000,1537152000
Slowakei (ab 1993),2008,5,746347000,727887000,1474234000
Slowakei (ab 1993),2008,6,834218000,832686000,1666904000
Slowakei (ab 1993),2008,7,785783000,683438000,1469221000
Slowakei (ab 1993),2008,8,696816000,673126000,1369942000
Slowakei (ab 1993),2008,9,807266000,755325000,1562591000
Slowakei (ab 1993),2008,10,803032000,767416000,1570448000
Slowakei (ab 1993),2008,11,619419000,657668000,1277087000
Slowakei (ab 1993),2008,12,494204000,495770000,989974000
Slowakei (ab 1993),2009,1,515585000,526922000,1042507000
Slowakei (ab 1993),2009,2,499561000,531257000,1030818000
Slowakei (ab 1993),2009,3,550209000,665379000,1215588000
Slowakei (ab 1993),2009,4,501974000,540598000,1042572000
Slowakei (ab 1993),2009,5,468796000,499985000,968781000
Slowakei (ab 1993),2009,6,534687000,624469000,1159156000
Slowakei (ab 1993),2009,7,522784000,561458000,1084242000
Slowakei (ab 1993),2009,8,546391000,538657000,1085048000
Slowakei (ab 1993),2009,9,610712000,662952000,1273664000
Slowakei (ab 1993),2009,10,648506000,735926000,1384432000
Slowakei (ab 1993),2009,11,626274000,711848000,1338122000
Slowakei (ab 1993),2009,12,552455000,722514000,1274969000
Slowakei (ab 1993),2010,1,565377000,544352000,1109729000
Slowakei (ab 1993),2010,2,620838000,618114000,1238952000
Slowakei (ab 1993),2010,3,753124000,736238000,1489362000
Slowakei (ab 1993),2010,4,653476000,771185000,1424661000
Slowakei (ab 1993),2010,5,692660000,772131000,1464791000
Slowakei (ab 1993),2010,6,761337000,798983000,1560320000
Slowakei (ab 1993),2010,7,703247000,769651000,1472898000
Slowakei (ab 1993),2010,8,728241000,749146000,1477387000
Slowakei (ab 1993),2010,9,837746000,862958000,1700704000
Slowakei (ab 1993),2010,10,865243000,938102000,1803345000
Slowakei (ab 1993),2010,11,838610000,848417000,1687027000
Slowakei (ab 1993),2010,12,694617000,765073000,1459690000
Slowakei (ab 1993),2011,1,772011000,748258000,1520269000
Slowakei (ab 1993),2011,2,830725000,792104000,1622829000
Slowakei (ab 1993),2011,3,993974000,959509000,1953483000
Slowakei (ab 1993),2011,4,873634000,849446000,1723080000
Slowakei (ab 1993),2011,5,884892000,931222000,1816114000
Slowakei (ab 1993),2011,6,912663000,932470000,1845133000
Slowakei (ab 1993),2011,7,758657000,882627000,1641284000
Slowakei (ab 1993),2011,8,870468000,804562000,1675030000
Slowakei (ab 1993),2011,9,963276000,959162000,1922438000
Slowakei (ab 1993),2011,10,886506000,981300000,1867806000
Slowakei (ab 1993),2011,11,905159000,1050899000,1956058000
Slowakei (ab 1993),2011,12,725185000,834534000,1559719000
Slowakei (ab 1993),2012,1,786584000,838401000,1624985000
Slowakei (ab 1993),2012,2,898531000,977802000,1876333000
Slowakei (ab 1993),2012,3,929921000,1111190000,2041111000
Slowakei (ab 1993),2012,4,866838000,1018783000,1885621000
Slowakei (ab 1993),2012,5,916370000,1059693000,1976063000
Slowakei (ab 1993),2012,6,915343000,1025774000,1941117000
Slowakei (ab 1993),2012,7,869054000,975186000,1844240000
Slowakei (ab 1993),2012,8,871229000,903263000,1774492000
Slowakei (ab 1993),2012,9,891100000,1038007000,1929107000
Slowakei (ab 1993),2012,10,919104000,1180928000,2100032000
Slowakei (ab 1993),2012,11,866842000,1088165000,1955007000
Slowakei (ab 1993),2012,12,609315000,797912000,1407227000
Slowakei (ab 1993),2013,1,803943000,891205000,1695148000
Slowakei (ab 1993),2013,2,846101000,984479000,1830580000
Slowakei (ab 1993),2013,3,842291000,960172000,1802463000
Slowakei (ab 1993),2013,4,875966000,1068426000,1944392000
Slowakei (ab 1993),2013,5,874143000,1068638000,1942781000
Slowakei (ab 1993),2013,6,942104000,1006651000,1948755000
Slowakei (ab 1993),2013,7,833701000,929250000,1762951000
Slowakei (ab 1993),2013,8,873605000,959328000,1832933000
Slowakei (ab 1993),2013,9,982667000,1084598000,2067265000
Slowakei (ab 1993),2013,10,1045291000,1218230000,2263521000
Slowakei (ab 1993),2013,11,974925000,1118159000,2093084000
Slowakei (ab 1993),2013,12,742691000,963787000,1706478000
Slowakei (ab 1993),2014,1,919258000,996684000,1915942000
Slowakei (ab 1993),2014,2,922392000,1107876000,2030268000
Slowakei (ab 1993),2014,3,954164000,1113705000,2067869000
Slowakei (ab 1993),2014,4,953910000,1090817000,2044727000
Slowakei (ab 1993),2014,5,924434000,1110462000,2034896000
Slowakei (ab 1993),2014,6,952398000,1083320000,2035718000
Slowakei (ab 1993),2014,7,891684000,1032376000,1924060000
Slowakei (ab 1993),2014,8,848618000,846411000,1695029000
Slowakei (ab 1993),2014,9,1031422000,1151906000,2183328000
Slowakei (ab 1993),2014,10,1039101000,1220308000,2259409000
Slowakei (ab 1993),2014,11,964305000,1116259000,2080564000
Slowakei (ab 1993),2014,12,848844000,963837000,1812681000
Slowakei (ab 1993),2015,1,954141000,996739000,1950880000
Slowakei (ab 1993),2015,2,967798000,1109638000,2077436000
Slowakei (ab 1993),2015,3,1060342000,1127113000,2187455000
Slowakei (ab 1993),2015,4,979337000,1262964000,2242301000
Slowakei (ab 1993),2015,5,981805000,1053032000,2034837000
Slowakei (ab 1993),2015,6,1080212000,1172676000,2252888000
Slowakei (ab 1993),2015,7,1143801000,1192233000,2336034000
Slowakei (ab 1993),2015,8,887803000,952543000,1840346000
Slowakei (ab 1993),2015,9,1123860000,1318658000,2442518000
Slowakei (ab 1993),2015,10,1173244000,1271299000,2444543000
Slowakei (ab 1993),2015,11,1051688000,1184144000,2235832000
Slowakei (ab 1993),2015,12,818374000,975044000,1793418000
Slowakei (ab 1993),2016,1,948345000,1033051000,1981396000
Slowakei (ab 1993),2016,2,1098678000,1213184000,2311862000
Slowakei (ab 1993),2016,3,1111531000,1090535000,2202066000
Slowakei (ab 1993),2016,4,1074130000,1278096000,2352226000
Slowakei (ab 1993),2016,5,1059662000,1174925000,2234587000
Slowakei (ab 1993),2016,6,1142551000,1278432000,2420983000
Slowakei (ab 1993),2016,7,857234000,1074776000,1932010000
Slowakei (ab 1993),2016,8,1070985000,1106950000,2177935000
Slowakei (ab 1993),2016,9,1124553000,1302088000,2426641000
Slowakei (ab 1993),2016,10,1142163000,1322401000,2464564000
Slowakei (ab 1993),2016,11,1132242000,1361128000,2493370000
Slowakei (ab 1993),2016,12,943140000,1125404000,2068544000
Slowakei (ab 1993),2017,1,1021965000,1075659000,2097624000
Slowakei (ab 1993),2017,2,1104462000,1249497000,2353959000
Slowakei (ab 1993),2017,3,1232895000,1407718000,2640613000
Slowakei (ab 1993),2017,4,1091505000,1224904000,2316409000
Slowakei (ab 1993),2017,5,1167971000,1291381000,2459352000
Slowakei (ab 1993),2017,6,1128378000,1271278000,2399656000
Slowakei (ab 1993),2017,7,904862000,1064367000,1969229000
Slowakei (ab 1993),2017,8,1120425000,1170333000,2290758000
Slowakei (ab 1993),2017,9,1189771000,1244094000,2433865000
Slowakei (ab 1993),2017,10,1154352000,1327379000,2481731000
Slowakei (ab 1993),2017,11,1181436000,1343034000,2524470000
Slowakei (ab 1993),2017,12,937646000,1062570000,2000216000
Slowakei (ab 1993),2018,1,1048332000,1164376000,2212708000
Slowakei (ab 1993),2018,2,1116536000,1206053000,2322589000
Slowakei (ab 1993),2018,3,1231812000,1551865000,2783677000
Slowakei (ab 1993),2018,4,1172860000,1323007000,2495867000
Slowakei (ab 1993),2018,5,1225228000,1474494000,2699722000
Slowakei (ab 1993),2018,6,1242191000,1446267000,2688458000
Slowakei (ab 1993),2018,7,1078938000,1354945000,2433883000
Slowakei (ab 1993),2018,8,1223954000,1310059000,2534013000
Slowakei (ab 1993),2018,9,1224916000,1469415000,2694331000
Slowakei (ab 1993),2018,10,1305303000,1637272000,2942575000
Slowakei (ab 1993),2018,11,1313455000,1497327000,2810782000
Slowakei (ab 1993),2018,12,921104000,1201218000,2122322000
Slowakei (ab 1993),2019,1,1198924000,1391952000,2590876000
Slowakei (ab 1993),2019,2,1201234000,1477702000,2678936000
Slowakei (ab 1993),2019,3,1268701000,1562268000,2830969000
Slowakei (ab 1993),2019,4,1143542000,1531205000,2674747000
Slowakei (ab 1993),2019,5,1300833000,1463149000,2763982000
Slowakei (ab 1993),2019,6,1164950000,1585394000,2750344000
Slowakei (ab 1993),2019,7,1061217000,1253878000,2315095000
Slowakei (ab 1993),2019,8,1122543000,1296997000,2419540000
Slowakei (ab 1993),2019,9,1256631000,1633716000,2890347000
Slowakei (ab 1993),2019,10,1325421000,1761091000,3086512000
Slowakei (ab 1993),2019,11,1273451000,1428162000,2701613000
Slowakei (ab 1993),2019,12,908294000,1311388000,2219682000
Slowakei (ab 1993),2020,1,1269646000,1121815000,2391461000
Slowakei (ab 1993),2020,2,1237712000,1319813000,2557525000
Slowakei (ab 1993),2020,3,1144703000,1324714000,2469417000
Slowakei (ab 1993),2020,4,585520000,640889000,1226409000
Slowakei (ab 1993),2020,5,785662000,849831000,1635493000
Slowakei (ab 1993),2020,6,1072737000,1510838000,2583575000
Slowakei (ab 1993),2020,7,1056020000,1058543000,2114563000
Slowakei (ab 1993),2020,8,1157758000,1505871000,2663629000
Slowakei (ab 1993),2020,9,1307146000,1557938000,2865084000
Slowakei (ab 1993),2020,10,1344248000,1456926000,2801174000
Slowakei (ab 1993),2020,11,1326700000,1594090000,2920790000
Slowakei (ab 1993),2020,12,1071994000,1232419000,2304413000
Slowakei (ab 1993),2021,1,1203267000,1166521000,2369788000
Slowakei (ab 1993),2021,2,1298232000,1654550000,2952782000
Slowakei (ab 1993),2021,3,1477448000,1732003000,3209451000
Slowakei (ab 1993),2021,4,1336214000,1324099000,2660313000
Slowakei (ab 1993),2021,5,1238717000,1448218000,2686935000
Slowakei (ab 1993),2021,6,1388146000,1460575000,2848721000
Slowakei (ab 1993),2021,7,1178926000,1187888000,2366814000
Slowakei (ab 1993),2021,8,1079283000,954446000,2033729000
Slowakei (ab 1993),2021,9,1196685000,1156208000,2352893000
Slowakei (ab 1993),2021,10,1248937000,1616613000,2865550000
Slowakei (ab 1993),2021,11,1403482000,1769105000,3172587000
Slowakei (ab 1993),2021,12,1167006000,1569049000,2736055000
Slowakei (ab 1993),2022,1,1317940000,1479131000,2797071000
Slowakei (ab 1993),2022,2,1438593000,1661865000,3100458000
Slowakei (ab 1993),2022,3,1564574000,1698651000,3263225000
Slowakei (ab 1993),2022,4,1319324000,1410007000,2729331000
Slowakei (ab 1993),2022,5,1542369000,1659443000,3201812000
Slowakei (ab 1993),2022,6,1510833000,1912187000,3423020000
Slowakei (ab 1993),2022,7,1288344000,1424538000,2712882000
Slowakei (ab 1993),2022,8,1469167000,1208631000,2677798000
Slowakei (ab 1993),2022,9,1620081000,1973186000,3593267000
Slowakei (ab 1993),2022,10,1477724000,1730930000,3208654000
Slowakei (ab 1993),2022,11,1605398000,1957195000,3562593000
Slowakei (ab 1993),2022,12,1230017000,1388533000,2618550000
Slowakei (ab 1993),2023,1,1456709000,1374448000,2831157000
Slowakei (ab 1993),2023,2,1533983000,1615542000,3149525000
Slowakei (ab 1993),2023,3,1722404000,2337412000,4059816000
Slowakei (ab 1993),2023,4,1395524000,1463461000,2858985000
Slowakei (ab 1993),2023,5,1549011000,1966246000,3515257000
Slowakei (ab 1993),2023,6,1640000000,1839761000,3479761000
Slowakei (ab 1993),2023,7,1278185000,1702003000,2980188000
Slowakei (ab 1993),2023,8,1500278000,1356208000,2856486000
Slowakei (ab 1993),2023,9,1548164000,1933891000,3482055000
Slowakei (ab 1993),2023,10,1528594000,1783603000,3312197000
Slowakei (ab 1993),2023,11,1509525000,1758923000,3268448000
Slowakei (ab 1993),2023,12,1157560000,1421372000,2578932000
Slowakei (ab 1993),2024,1,1445385000,1433310000,2878695000
Slowakei (ab 1993),2024,2,1499860000,1738508000,3238368000
Slowakei (ab 1993),2024,3,1504931000,1744243000,3249174000
Slowakei (ab 1993),2024,4,1600606000,2082226000,3682832000
Slowakei (ab 1993),2024,5,1524720000,1803295000,3328015000
Slowakei (ab 1993),2024,6,1539429000,1698202000,3237631000
Slowakei (ab 1993),2024,7,1385308000,1562349000,2947657000
Slowakei (ab 1993),2024,8,1488029000,1562794000,3050823000
Slowakei (ab 1993),2024,9,1557214000,1780119000,3337333000
Slowakei (ab 1993),2024,10,1685568000,1944346000,3629914000
Slowakei (ab 1993),2024,11,1495897000,1763544000,3259441000
Slowakei (ab 1993),2024,12,1181994000,1379229000,2561223000
Slowenien (ab 05/1992),2008,1,349573000,309690000,659263000
Slowenien (ab 05/1992),2008,2,359720000,327777000,687497000
Slowenien (ab 05/1992),2008,3,382996000,331716000,714712000
Slowenien (ab 05/1992),2008,4,416220000,341716000,757936000
Slowenien (ab 05/1992),2008,5,428090000,315233000,743323000
Slowenien (ab 05/1992),2008,6,367222000,312200000,679422000
Slowenien (ab 05/1992),2008,7,347581000,349732000,697313000
Slowenien (ab 05/1992),2008,8,333969000,264065000,598034000
Slowenien (ab 05/1992),2008,9,364406000,315645000,680051000
Slowenien (ab 05/1992),2008,10,397427000,331541000,728968000
Slowenien (ab 05/1992),2008,11,308568000,304315000,612883000
Slowenien (ab 05/1992),2008,12,258745000,233728000,492473000
Slowenien (ab 05/1992),2009,1,249916000,244641000,494557000
Slowenien (ab 05/1992),2009,2,237506000,239214000,476720000
Slowenien (ab 05/1992),2009,3,264548000,261348000,525896000
Slowenien (ab 05/1992),2009,4,237850000,249442000,487292000
Slowenien (ab 05/1992),2009,5,232571000,226345000,458916000
Slowenien (ab 05/1992),2009,6,253218000,232706000,485924000
Slowenien (ab 05/1992),2009,7,245319000,227237000,472556000
Slowenien (ab 05/1992),2009,8,234971000,218311000,453282000
Slowenien (ab 05/1992),2009,9,289158000,265749000,554907000
Slowenien (ab 05/1992),2009,10,279958000,270785000,550743000
Slowenien (ab 05/1992),2009,11,281740000,267589000,549329000
Slowenien (ab 05/1992),2009,12,242188000,232427000,474615000
Slowenien (ab 05/1992),2010,1,227735000,246402000,474137000
Slowenien (ab 05/1992),2010,2,264598000,249810000,514408000
Slowenien (ab 05/1992),2010,3,309517000,315741000,625258000
Slowenien (ab 05/1992),2010,4,301168000,299505000,600673000
Slowenien (ab 05/1992),2010,5,327879000,294099000,621978000
Slowenien (ab 05/1992),2010,6,315904000,331531000,647435000
Slowenien (ab 05/1992),2010,7,298057000,309045000,607102000
Slowenien (ab 05/1992),2010,8,278189000,268116000,546305000
Slowenien (ab 05/1992),2010,9,330103000,341971000,672074000
Slowenien (ab 05/1992),2010,10,321826000,352517000,674343000
Slowenien (ab 05/1992),2010,11,324381000,338280000,662661000
Slowenien (ab 05/1992),2010,12,290910000,311941000,602851000
Slowenien (ab 05/1992),2011,1,294962000,300254000,595216000
Slowenien (ab 05/1992),2011,2,313179000,342774000,655953000
Slowenien (ab 05/1992),2011,3,370495000,412344000,782839000
Slowenien (ab 05/1992),2011,4,330428000,372089000,702517000
Slowenien (ab 05/1992),2011,5,332002000,387718000,719720000
Slowenien (ab 05/1992),2011,6,342112000,373803000,715915000
Slowenien (ab 05/1992),2011,7,305792000,369332000,675124000
Slowenien (ab 05/1992),2011,8,308805000,339000000,647805000
Slowenien (ab 05/1992),2011,9,368478000,388338000,756816000
Slowenien (ab 05/1992),2011,10,342365000,395005000,737370000
Slowenien (ab 05/1992),2011,11,357072000,410827000,767899000
Slowenien (ab 05/1992),2011,12,288546000,346063000,634609000
Slowenien (ab 05/1992),2012,1,289661000,377612000,667273000
Slowenien (ab 05/1992),2012,2,327442000,388437000,715879000
Slowenien (ab 05/1992),2012,3,354737000,409069000,763806000
Slowenien (ab 05/1992),2012,4,299709000,418992000,718701000
Slowenien (ab 05/1992),2012,5,339995000,380654000,720649000
Slowenien (ab 05/1992),2012,6,334615000,391584000,726199000
Slowenien (ab 05/1992),2012,7,313576000,395488000,709064000
Slowenien (ab 05/1992),2012,8,304553000,335751000,640304000
Slowenien (ab 05/1992),2012,9,329691000,377436000,707127000
Slowenien (ab 05/1992),2012,10,364531000,408755000,773286000
Slowenien (ab 05/1992),2012,11,319150000,385490000,704640000
Slowenien (ab 05/1992),2012,12,273459000,313023000,586482000
Slowenien (ab 05/1992),2013,1,408499000,367823000,776322000
Slowenien (ab 05/1992),2013,2,337562000,370638000,708200000
Slowenien (ab 05/1992),2013,3,349316000,393177000,742493000
Slowenien (ab 05/1992),2013,4,334537000,406406000,740943000
Slowenien (ab 05/1992),2013,5,357560000,360262000,717822000
Slowenien (ab 05/1992),2013,6,324612000,389136000,713748000
Slowenien (ab 05/1992),2013,7,324764000,402782000,727546000
Slowenien (ab 05/1992),2013,8,313485000,323923000,637408000
Slowenien (ab 05/1992),2013,9,347941000,389903000,737844000
Slowenien (ab 05/1992),2013,10,364200000,440855000,805055000
Slowenien (ab 05/1992),2013,11,335334000,396349000,731683000
Slowenien (ab 05/1992),2013,12,298418000,347319000,645737000
Slowenien (ab 05/1992),2014,1,321827000,389111000,710938000
Slowenien (ab 05/1992),2014,2,319946000,397881000,717827000
Slowenien (ab 05/1992),2014,3,348271000,419255000,767526000
Slowenien (ab 05/1992),2014,4,353586000,416839000,770425000
Slowenien (ab 05/1992),2014,5,333927000,402826000,736753000
Slowenien (ab 05/1992),2014,6,335874000,401692000,737566000
Slowenien (ab 05/1992),2014,7,366518000,415564000,782082000
Slowenien (ab 05/1992),2014,8,311716000,353019000,664735000
Slowenien (ab 05/1992),2014,9,373304000,408474000,781778000
Slowenien (ab 05/1992),2014,10,370319000,457642000,827961000
Slowenien (ab 05/1992),2014,11,346713000,400549000,747262000
Slowenien (ab 05/1992),2014,12,318553000,357357000,675910000
Slowenien (ab 05/1992),2015,1,356815000,393350000,750165000
Slowenien (ab 05/1992),2015,2,350846000,398752000,749598000
Slowenien (ab 05/1992),2015,3,496290000,450288000,946578000
Slowenien (ab 05/1992),2015,4,354978000,417096000,772074000
Slowenien (ab 05/1992),2015,5,369791000,429130000,798921000
Slowenien (ab 05/1992),2015,6,386231000,444732000,830963000
Slowenien (ab 05/1992),2015,7,366630000,464384000,831014000
Slowenien (ab 05/1992),2015,8,335094000,358791000,693885000
Slowenien (ab 05/1992),2015,9,391215000,478205000,869420000
Slowenien (ab 05/1992),2015,10,397055000,493352000,890407000
Slowenien (ab 05/1992),2015,11,386598000,478569000,865167000
Slowenien (ab 05/1992),2015,12,361756000,377034000,738790000
Slowenien (ab 05/1992),2016,1,361475000,415423000,776898000
Slowenien (ab 05/1992),2016,2,379532000,428855000,808387000
Slowenien (ab 05/1992),2016,3,415652000,471114000,886766000
Slowenien (ab 05/1992),2016,4,412379000,468868000,881247000
Slowenien (ab 05/1992),2016,5,377651000,447160000,824811000
Slowenien (ab 05/1992),2016,6,425973000,490386000,916359000
Slowenien (ab 05/1992),2016,7,364897000,464868000,829765000
Slowenien (ab 05/1992),2016,8,367154000,421818000,788972000
Slowenien (ab 05/1992),2016,9,436731000,486504000,923235000
Slowenien (ab 05/1992),2016,10,412514000,487222000,899736000
Slowenien (ab 05/1992),2016,11,424052000,488731000,912783000
Slowenien (ab 05/1992),2016,12,370704000,429583000,800287000
Slowenien (ab 05/1992),2017,1,405365000,449842000,855207000
Slowenien (ab 05/1992),2017,2,410489000,477796000,888285000
Slowenien (ab 05/1992),2017,3,475148000,529451000,1004599000
Slowenien (ab 05/1992),2017,4,415382000,493271000,908653000
Slowenien (ab 05/1992),2017,5,441484000,514804000,956288000
Slowenien (ab 05/1992),2017,6,472367000,505422000,977789000
Slowenien (ab 05/1992),2017,7,407213000,503381000,910594000
Slowenien (ab 05/1992),2017,8,417992000,430831000,848823000
Slowenien (ab 05/1992),2017,9,448737000,512904000,961641000
Slowenien (ab 05/1992),2017,10,465533000,531842000,997375000
Slowenien (ab 05/1992),2017,11,480219000,536939000,1017158000
Slowenien (ab 05/1992),2017,12,393172000,441003000,834175000
Slowenien (ab 05/1992),2018,1,459110000,510107000,969217000
Slowenien (ab 05/1992),2018,2,458808000,505760000,964568000
Slowenien (ab 05/1992),2018,3,475474000,543445000,1018919000
Slowenien (ab 05/1992),2018,4,460889000,548296000,1009185000
Slowenien (ab 05/1992),2018,5,452311000,511598000,963909000
Slowenien (ab 05/1992),2018,6,489797000,552697000,1042494000
Slowenien (ab 05/1992),2018,7,485036000,551623000,1036659000
Slowenien (ab 05/1992),2018,8,429042000,508689000,937731000
Slowenien (ab 05/1992),2018,9,469719000,482768000,952487000
Slowenien (ab 05/1992),2018,10,512463000,558286000,1070749000
Slowenien (ab 05/1992),2018,11,488611000,579179000,1067790000
Slowenien (ab 05/1992),2018,12,397585000,450992000,848577000
Slowenien (ab 05/1992),2019,1,455185000,523785000,978970000
Slowenien (ab 05/1992),2019,2,456545000,506868000,963413000
Slowenien (ab 05/1992),2019,3,495770000,578159000,1073929000
Slowenien (ab 05/1992),2019,4,454383000,540972000,995355000
Slowenien (ab 05/1992),2019,5,465048000,526639000,991687000
Slowenien (ab 05/1992),2019,6,446879000,512939000,959818000
Slowenien (ab 05/1992),2019,7,473275000,557289000,1030564000
Slowenien (ab 05/1992),2019,8,407986000,442722000,850708000
Slowenien (ab 05/1992),2019,9,495672000,545146000,1040818000
Slowenien (ab 05/1992),2019,10,479212000,585907000,1065119000
Slowenien (ab 05/1992),2019,11,464142000,536533000,1000675000
Slowenien (ab 05/1992),2019,12,386199000,426560000,812759000
Slowenien (ab 05/1992),2020,1,441142000,490667000,931809000
Slowenien (ab 05/1992),2020,2,460257000,535243000,995500000
Slowenien (ab 05/1992),2020,3,449939000,487613000,937552000
Slowenien (ab 05/1992),2020,4,306526000,334535000,641061000
Slowenien (ab 05/1992),2020,5,332353000,367321000,699674000
Slowenien (ab 05/1992),2020,6,396646000,476926000,873572000
Slowenien (ab 05/1992),2020,7,403514000,463699000,867213000
Slowenien (ab 05/1992),2020,8,362252000,405346000,767598000
Slowenien (ab 05/1992),2020,9,458907000,490717000,949624000
Slowenien (ab 05/1992),2020,10,459166000,502286000,961452000
Slowenien (ab 05/1992),2020,11,463947000,586521000,1050468000
Slowenien (ab 05/1992),2020,12,371833000,447825000,819658000
Slowenien (ab 05/1992),2021,1,427889000,512758000,940647000
Slowenien (ab 05/1992),2021,2,477897000,528398000,1006295000
Slowenien (ab 05/1992),2021,3,555115000,635031000,1190146000
Slowenien (ab 05/1992),2021,4,485579000,556676000,1042255000
Slowenien (ab 05/1992),2021,5,508219000,540024000,1048243000
Slowenien (ab 05/1992),2021,6,544690000,559588000,1104278000
Slowenien (ab 05/1992),2021,7,497260000,504445000,1001705000
Slowenien (ab 05/1992),2021,8,461618000,454212000,915830000
Slowenien (ab 05/1992),2021,9,595965000,535807000,1131772000
Slowenien (ab 05/1992),2021,10,545208000,606478000,1151686000
Slowenien (ab 05/1992),2021,11,559575000,661331000,1220906000
Slowenien (ab 05/1992),2021,12,474516000,505323000,979839000
Slowenien (ab 05/1992),2022,1,552186000,521542000,1073728000
Slowenien (ab 05/1992),2022,2,576763000,547471000,1124234000
Slowenien (ab 05/1992),2022,3,683081000,749667000,1432748000
Slowenien (ab 05/1992),2022,4,576219000,581393000,1157612000
Slowenien (ab 05/1992),2022,5,615344000,610106000,1225450000
Slowenien (ab 05/1992),2022,6,616477000,678618000,1295095000
Slowenien (ab 05/1992),2022,7,567815000,560789000,1128604000
Slowenien (ab 05/1992),2022,8,555179000,496909000,1052088000
Slowenien (ab 05/1992),2022,9,631317000,929802000,1561119000
Slowenien (ab 05/1992),2022,10,552876000,616560000,1169436000
Slowenien (ab 05/1992),2022,11,627384000,762076000,1389460000
Slowenien (ab 05/1992),2022,12,526958000,598798000,1125756000
Slowenien (ab 05/1992),2023,1,578815000,546671000,1125486000
Slowenien (ab 05/1992),2023,2,581793000,599661000,1181454000
Slowenien (ab 05/1992),2023,3,652629000,681475000,1334104000
Slowenien (ab 05/1992),2023,4,529580000,590238000,1119818000
Slowenien (ab 05/1992),2023,5,599424000,606830000,1206254000
Slowenien (ab 05/1992),2023,6,615042000,640355000,1255397000
Slowenien (ab 05/1992),2023,7,530185000,588566000,1118751000
Slowenien (ab 05/1992),2023,8,527410000,463526000,990936000
Slowenien (ab 05/1992),2023,9,555046000,586352000,1141398000
Slowenien (ab 05/1992),2023,10,558791000,633232000,1192023000
Slowenien (ab 05/1992),2023,11,600655000,583749000,1184404000
Slowenien (ab 05/1992),2023,12,495659000,483498000,979157000
Slowenien (ab 05/1992),2024,1,601381000,577975000,1179356000
Slowenien (ab 05/1992),2024,2,602150000,624869000,1227019000
Slowenien (ab 05/1992),2024,3,618830000,607060000,1225890000
Slowenien (ab 05/1992),2024,4,609335000,620286000,1229621000
Slowenien (ab 05/1992),2024,5,646158000,589548000,1235706000
Slowenien (ab 05/1992),2024,6,597762000,566333000,1164095000
Slowenien (ab 05/1992),2024,7,616943000,613012000,1229955000
Slowenien (ab 05/1992),2024,8,546152000,529327000,1075479000
Slowenien (ab 05/1992),2024,9,641092000,598113000,1239205000
Slowenien (ab 05/1992),2024,10,622491000,635875000,1258366000
Slowenien (ab 05/1992),2024,11,610621000,559882000,1170503000
Slowenien (ab 05/1992),2024,12,481971000,488530000,970501000
Somalia,2008,1,51000,9000,60000
Somalia,2008,2,150000,53000,203000
Somalia,2008,3,74000,28000,102000
Somalia,2008,4,60000,21000,81000
Somalia,2008,5,111000,0,111000
Somalia,2008,6,13000,3000,16000
Somalia,2008,7,51000,10000,61000
Somalia,2008,8,85000,5000,90000
Somalia,2008,9,210000,0,210000
Somalia,2008,10,31000,0,31000
Somalia,2008,11,98000,3000,101000
Somalia,2008,12,139000,2000,141000
Somalia,2009,1,84000,76000,160000
Somalia,2009,2,39000,0,39000
Somalia,2009,3,93000,5000,98000
Somalia,2009,4,49000,15000,64000
Somalia,2009,5,110000,1000,111000
Somalia,2009,6,92000,0,92000
Somalia,2009,7,17000,1000,18000
Somalia,2009,8,15000,2000,17000
Somalia,2009,9,7000,4000,11000
Somalia,2009,10,21000,8000,29000
Somalia,2009,11,12000,42000,54000
Somalia,2009,12,57000,42000,99000
Somalia,2010,1,35000,0,35000
Somalia,2010,2,20000,93000,113000
Somalia,2010,3,225000,50000,275000
Somalia,2010,4,26000,0,26000
Somalia,2010,5,0,59000,59000
Somalia,2010,6,46000,0,46000
Somalia,2010,7,1966000,1000,1967000
Somalia,2010,8,177000,55000,232000
Somalia,2010,9,12000,4000,16000
Somalia,2010,10,45000,1000,46000
Somalia,2010,11,9000,33000,42000
Somalia,2010,12,1893000,34000,1927000
Somalia,2011,1,28000,29000,57000
Somalia,2011,2,132000,113000,245000
Somalia,2011,3,412000,80000,492000
Somalia,2011,4,78000,41000,119000
Somalia,2011,5,148000,104000,252000
Somalia,2011,6,154000,62000,216000
Somalia,2011,7,55000,1000,56000
Somalia,2011,8,125000,48000,173000
Somalia,2011,9,547000,1000,548000
Somalia,2011,10,134000,3000,137000
Somalia,2011,11,194000,0,194000
Somalia,2011,12,20000,23000,43000
Somalia,2012,1,73000,0,73000
Somalia,2012,2,33000,73000,106000
Somalia,2012,3,185000,54000,239000
Somalia,2012,4,145000,37000,182000
Somalia,2012,5,80000,96000,176000
Somalia,2012,6,126000,0,126000
Somalia,2012,7,185000,35000,220000
Somalia,2012,8,260000,17000,277000
Somalia,2012,9,113000,19000,132000
Somalia,2012,10,330000,49000,379000
Somalia,2012,11,143000,1000,144000
Somalia,2012,12,191000,7000,198000
Somalia,2013,1,170000,65000,235000
Somalia,2013,2,437000,0,437000
Somalia,2013,3,212000,24000,236000
Somalia,2013,4,110000,162000,272000
Somalia,2013,5,268000,72000,340000
Somalia,2013,6,289000,48000,337000
Somalia,2013,7,797000,81000,878000
Somalia,2013,8,553000,8000,561000
Somalia,2013,9,302000,0,302000
Somalia,2013,10,152000,14000,166000
Somalia,2013,11,209000,3000,212000
Somalia,2013,12,376000,36000,412000
Somalia,2014,1,44000,36000,80000
Somalia,2014,2,491000,31000,522000
Somalia,2014,3,513000,145000,658000
Somalia,2014,4,486000,39000,525000
Somalia,2014,5,493000,17000,510000
Somalia,2014,6,781000,52000,833000
Somalia,2014,7,473000,89000,562000
Somalia,2014,8,245000,3000,248000
Somalia,2014,9,653000,8000,661000
Somalia,2014,10,524000,107000,631000
Somalia,2014,11,109000,20000,129000
Somalia,2014,12,346000,70000,416000
Somalia,2015,1,1428000,18000,1446000
Somalia,2015,2,237000,73000,310000
Somalia,2015,3,1042000,24000,1066000
Somalia,2015,4,616000,73000,689000
Somalia,2015,5,804000,71000,875000
Somalia,2015,6,2003000,15000,2018000
Somalia,2015,7,220000,27000,247000
Somalia,2015,8,356000,112000,468000
Somalia,2015,9,924000,193000,1117000
Somalia,2015,10,2233000,6000,2239000
Somalia,2015,11,3745000,263000,4008000
Somalia,2015,12,1343000,17000,1360000
Somalia,2016,1,338000,12000,350000
Somalia,2016,2,1225000,177000,1402000
Somalia,2016,3,1665000,49000,1714000
Somalia,2016,4,243000,3000,246000
Somalia,2016,5,328000,118000,446000
Somalia,2016,6,263000,96000,359000
Somalia,2016,7,1166000,316000,1482000
Somalia,2016,8,1029000,171000,1200000
Somalia,2016,9,884000,15000,899000
Somalia,2016,10,827000,18000,845000
Somalia,2016,11,828000,26000,854000
Somalia,2016,12,542000,147000,689000
Somalia,2017,1,638000,295000,933000
Somalia,2017,2,686000,59000,745000
Somalia,2017,3,1518000,300000,1818000
Somalia,2017,4,586000,156000,742000
Somalia,2017,5,965000,68000,1033000
Somalia,2017,6,1753000,129000,1882000
Somalia,2017,7,912000,17000,929000
Somalia,2017,8,835000,43000,878000
Somalia,2017,9,1413000,62000,1475000
Somalia,2017,10,1893000,31000,1924000
Somalia,2017,11,1221000,35000,1256000
Somalia,2017,12,998000,0,998000
Somalia,2018,1,1107000,9000,1116000
Somalia,2018,2,2422000,17000,2439000
Somalia,2018,3,2460000,24000,2484000
Somalia,2018,4,1307000,128000,1435000
Somalia,2018,5,1394000,64000,1458000
Somalia,2018,6,2876000,33000,2909000
Somalia,2018,7,2190000,101000,2291000
Somalia,2018,8,3422000,48000,3470000
Somalia,2018,9,1298000,141000,1439000
Somalia,2018,10,1433000,146000,1579000
Somalia,2018,11,1454000,37000,1491000
Somalia,2018,12,1327000,178000,1505000
Somalia,2019,1,10505000,113000,10618000
Somalia,2019,2,2078000,204000,2282000
Somalia,2019,3,898000,125000,1023000
Somalia,2019,4,939000,113000,1052000
Somalia,2019,5,1646000,474000,2120000
Somalia,2019,6,1463000,378000,1841000
Somalia,2019,7,1605000,275000,1880000
Somalia,2019,8,941000,329000,1270000
Somalia,2019,9,2962000,404000,3366000
Somalia,2019,10,1397000,91000,1488000
Somalia,2019,11,1503000,60000,1563000
Somalia,2019,12,1336000,204000,1540000
Somalia,2020,1,622000,520000,1142000
Somalia,2020,2,1126000,38000,1164000
Somalia,2020,3,1352000,109000,1461000
Somalia,2020,4,1797000,161000,1958000
Somalia,2020,5,714000,121000,835000
Somalia,2020,6,11306000,33000,11339000
Somalia,2020,7,1987000,186000,2173000
Somalia,2020,8,1095000,25000,1120000
Somalia,2020,9,1425000,303000,1728000
Somalia,2020,10,1634000,465000,2099000
Somalia,2020,11,1645000,34000,1679000
Somalia,2020,12,4181000,327000,4508000
Somalia,2021,1,1921000,189000,2110000
Somalia,2021,2,982000,285000,1267000
Somalia,2021,3,1816000,433000,2249000
Somalia,2021,4,1658000,417000,2075000
Somalia,2021,5,624000,448000,1072000
Somalia,2021,6,3677000,383000,4060000
Somalia,2021,7,2179000,137000,2316000
Somalia,2021,8,1481000,1484000,2965000
Somalia,2021,9,3205000,863000,4068000
Somalia,2021,10,3090000,432000,3522000
Somalia,2021,11,1669000,772000,2441000
Somalia,2021,12,994000,246000,1240000
Somalia,2022,1,1021000,444000,1465000
Somalia,2022,2,1307000,740000,2047000
Somalia,2022,3,1927000,215000,2142000
Somalia,2022,4,1224000,987000,2211000
Somalia,2022,5,476000,1307000,1783000
Somalia,2022,6,1388000,2363000,3751000
Somalia,2022,7,1742000,364000,2106000
Somalia,2022,8,2528000,2597000,5125000
Somalia,2022,9,1571000,359000,1930000
Somalia,2022,10,1613000,117000,1730000
Somalia,2022,11,1182000,189000,1371000
Somalia,2022,12,898000,300000,1198000
Somalia,2023,1,618000,440000,1058000
Somalia,2023,2,1327000,15000,1342000
Somalia,2023,3,1220000,94000,1314000
Somalia,2023,4,3760000,291000,4051000
Somalia,2023,5,2354000,3026000,5380000
Somalia,2023,6,814000,13000,827000
Somalia,2023,7,354000,292000,646000
Somalia,2023,8,528000,302000,830000
Somalia,2023,9,1219000,265000,1484000
Somalia,2023,10,1870000,195000,2065000
Somalia,2023,11,632000,18000,650000
Somalia,2023,12,1300000,38000,1338000
Somalia,2024,1,1622000,15000,1637000
Somalia,2024,2,1547000,65000,1612000
Somalia,2024,3,2101000,27000,2128000
Somalia,2024,4,1288000,427000,1715000
Somalia,2024,5,7185000,210000,7395000
Somalia,2024,6,3776000,225000,4001000
Somalia,2024,7,1352000,18000,1370000
Somalia,2024,8,603000,285000,888000
Somalia,2024,9,1036000,513000,1549000
Somalia,2024,10,1243000,56000,1299000
Somalia,2024,11,1261000,582000,1843000
Somalia,2024,12,1259000,170000,1429000
Sowjetunion (bis 04/1992),2008,1,0,0,0
Sowjetunion (bis 04/1992),2008,2,0,0,0
Sowjetunion (bis 04/1992),2008,3,0,0,0
Sowjetunion (bis 04/1992),2008,4,0,0,0
Sowjetunion (bis 04/1992),2008,5,0,0,0
Sowjetunion (bis 04/1992),2008,6,0,0,0
Sowjetunion (bis 04/1992),2008,7,0,0,0
Sowjetunion (bis 04/1992),2008,8,0,0,0
Sowjetunion (bis 04/1992),2008,9,0,0,0
Sowjetunion (bis 04/1992),2008,10,0,0,0
Sowjetunion (bis 04/1992),2008,11,0,0,0
Sowjetunion (bis 04/1992),2008,12,0,0,0
Sowjetunion (bis 04/1992),2009,1,0,0,0
Sowjetunion (bis 04/1992),2009,2,0,0,0
Sowjetunion (bis 04/1992),2009,3,0,0,0
Sowjetunion (bis 04/1992),2009,4,0,0,0
Sowjetunion (bis 04/1992),2009,5,0,0,0
Sowjetunion (bis 04/1992),2009,6,0,0,0
Sowjetunion (bis 04/1992),2009,7,0,0,0
Sowjetunion (bis 04/1992),2009,8,0,0,0
Sowjetunion (bis 04/1992),2009,9,0,0,0
Sowjetunion (bis 04/1992),2009,10,0,0,0
Sowjetunion (bis 04/1992),2009,11,0,0,0
Sowjetunion (bis 04/1992),2009,12,0,0,0
Sowjetunion (bis 04/1992),2010,1,0,0,0
Sowjetunion (bis 04/1992),2010,2,0,0,0
Sowjetunion (bis 04/1992),2010,3,0,0,0
Sowjetunion (bis 04/1992),2010,4,0,0,0
Sowjetunion (bis 04/1992),2010,5,0,0,0
Sowjetunion (bis 04/1992),2010,6,0,0,0
Sowjetunion (bis 04/1992),2010,7,0,0,0
Sowjetunion (bis 04/1992),2010,8,0,0,0
Sowjetunion (bis 04/1992),2010,9,0,0,0
Sowjetunion (bis 04/1992),2010,10,0,0,0
Sowjetunion (bis 04/1992),2010,11,0,0,0
Sowjetunion (bis 04/1992),2010,12,0,0,0
Sowjetunion (bis 04/1992),2011,1,0,0,0
Sowjetunion (bis 04/1992),2011,2,0,0,0
Sowjetunion (bis 04/1992),2011,3,0,0,0
Sowjetunion (bis 04/1992),2011,4,0,0,0
Sowjetunion (bis 04/1992),2011,5,0,0,0
Sowjetunion (bis 04/1992),2011,6,0,0,0
Sowjetunion (bis 04/1992),2011,7,0,0,0
Sowjetunion (bis 04/1992),2011,8,0,0,0
Sowjetunion (bis 04/1992),2011,9,0,0,0
Sowjetunion (bis 04/1992),2011,10,0,0,0
Sowjetunion (bis 04/1992),2011,11,0,0,0
Sowjetunion (bis 04/1992),2011,12,0,0,0
Sowjetunion (bis 04/1992),2012,1,0,0,0
Sowjetunion (bis 04/1992),2012,2,0,0,0
Sowjetunion (bis 04/1992),2012,3,0,0,0
Sowjetunion (bis 04/1992),2012,4,0,0,0
Sowjetunion (bis 04/1992),2012,5,0,0,0
Sowjetunion (bis 04/1992),2012,6,0,0,0
Sowjetunion (bis 04/1992),2012,7,0,0,0
Sowjetunion (bis 04/1992),2012,8,0,0,0
Sowjetunion (bis 04/1992),2012,9,0,0,0
Sowjetunion (bis 04/1992),2012,10,0,0,0
Sowjetunion (bis 04/1992),2012,11,0,0,0
Sowjetunion (bis 04/1992),2012,12,0,0,0
Sowjetunion (bis 04/1992),2013,1,0,0,0
Sowjetunion (bis 04/1992),2013,2,0,0,0
Sowjetunion (bis 04/1992),2013,3,0,0,0
Sowjetunion (bis 04/1992),2013,4,0,0,0
Sowjetunion (bis 04/1992),2013,5,0,0,0
Sowjetunion (bis 04/1992),2013,6,0,0,0
Sowjetunion (bis 04/1992),2013,7,0,0,0
Sowjetunion (bis 04/1992),2013,8,0,0,0
Sowjetunion (bis 04/1992),2013,9,0,0,0
Sowjetunion (bis 04/1992),2013,10,0,0,0
Sowjetunion (bis 04/1992),2013,11,0,0,0
Sowjetunion (bis 04/1992),2013,12,0,0,0
Sowjetunion (bis 04/1992),2014,1,0,0,0
Sowjetunion (bis 04/1992),2014,2,0,0,0
Sowjetunion (bis 04/1992),2014,3,0,0,0
Sowjetunion (bis 04/1992),2014,4,0,0,0
Sowjetunion (bis 04/1992),2014,5,0,0,0
Sowjetunion (bis 04/1992),2014,6,0,0,0
Sowjetunion (bis 04/1992),2014,7,0,0,0
Sowjetunion (bis 04/1992),2014,8,0,0,0
Sowjetunion (bis 04/1992),2014,9,0,0,0
Sowjetunion (bis 04/1992),2014,10,0,0,0
Sowjetunion (bis 04/1992),2014,11,0,0,0
Sowjetunion (bis 04/1992),2014,12,0,0,0
Sowjetunion (bis 04/1992),2015,1,0,0,0
Sowjetunion (bis 04/1992),2015,2,0,0,0
Sowjetunion (bis 04/1992),2015,3,0,0,0
Sowjetunion (bis 04/1992),2015,4,0,0,0
Sowjetunion (bis 04/1992),2015,5,0,0,0
Sowjetunion (bis 04/1992),2015,6,0,0,0
Sowjetunion (bis 04/1992),2015,7,0,0,0
Sowjetunion (bis 04/1992),2015,8,0,0,0
Sowjetunion (bis 04/1992),2015,9,0,0,0
Sowjetunion (bis 04/1992),2015,10,0,0,0
Sowjetunion (bis 04/1992),2015,11,0,0,0
Sowjetunion (bis 04/1992),2015,12,0,0,0
Sowjetunion (bis 04/1992),2016,1,0,0,0
Sowjetunion (bis 04/1992),2016,2,0,0,0
Sowjetunion (bis 04/1992),2016,3,0,0,0
Sowjetunion (bis 04/1992),2016,4,0,0,0
Sowjetunion (bis 04/1992),2016,5,0,0,0
Sowjetunion (bis 04/1992),2016,6,0,0,0
Sowjetunion (bis 04/1992),2016,7,0,0,0
Sowjetunion (bis 04/1992),2016,8,0,0,0
Sowjetunion (bis 04/1992),2016,9,0,0,0
Sowjetunion (bis 04/1992),2016,10,0,0,0
Sowjetunion (bis 04/1992),2016,11,0,0,0
Sowjetunion (bis 04/1992),2016,12,0,0,0
Sowjetunion (bis 04/1992),2017,1,0,0,0
Sowjetunion (bis 04/1992),2017,2,0,0,0
Sowjetunion (bis 04/1992),2017,3,0,0,0
Sowjetunion (bis 04/1992),2017,4,0,0,0
Sowjetunion (bis 04/1992),2017,5,0,0,0
Sowjetunion (bis 04/1992),2017,6,0,0,0
Sowjetunion (bis 04/1992),2017,7,0,0,0
Sowjetunion (bis 04/1992),2017,8,0,0,0
Sowjetunion (bis 04/1992),2017,9,0,0,0
Sowjetunion (bis 04/1992),2017,10,0,0,0
Sowjetunion (bis 04/1992),2017,11,0,0,0
Sowjetunion (bis 04/1992),2017,12,0,0,0
Sowjetunion (bis 04/1992),2018,1,0,0,0
Sowjetunion (bis 04/1992),2018,2,0,0,0
Sowjetunion (bis 04/1992),2018,3,0,0,0
Sowjetunion (bis 04/1992),2018,4,0,0,0
Sowjetunion (bis 04/1992),2018,5,0,0,0
Sowjetunion (bis 04/1992),2018,6,0,0,0
Sowjetunion (bis 04/1992),2018,7,0,0,0
Sowjetunion (bis 04/1992),2018,8,0,0,0
Sowjetunion (bis 04/1992),2018,9,0,0,0
Sowjetunion (bis 04/1992),2018,10,0,0,0
Sowjetunion (bis 04/1992),2018,11,0,0,0
Sowjetunion (bis 04/1992),2018,12,0,0,0
Sowjetunion (bis 04/1992),2019,1,0,0,0
Sowjetunion (bis 04/1992),2019,2,0,0,0
Sowjetunion (bis 04/1992),2019,3,0,0,0
Sowjetunion (bis 04/1992),2019,4,0,0,0
Sowjetunion (bis 04/1992),2019,5,0,0,0
Sowjetunion (bis 04/1992),2019,6,0,0,0
Sowjetunion (bis 04/1992),2019,7,0,0,0
Sowjetunion (bis 04/1992),2019,8,0,0,0
Sowjetunion (bis 04/1992),2019,9,0,0,0
Sowjetunion (bis 04/1992),2019,10,0,0,0
Sowjetunion (bis 04/1992),2019,11,0,0,0
Sowjetunion (bis 04/1992),2019,12,0,0,0
Sowjetunion (bis 04/1992),2020,1,0,0,0
Sowjetunion (bis 04/1992),2020,2,0,0,0
Sowjetunion (bis 04/1992),2020,3,0,0,0
Sowjetunion (bis 04/1992),2020,4,0,0,0
Sowjetunion (bis 04/1992),2020,5,0,0,0
Sowjetunion (bis 04/1992),2020,6,0,0,0
Sowjetunion (bis 04/1992),2020,7,0,0,0
Sowjetunion (bis 04/1992),2020,8,0,0,0
Sowjetunion (bis 04/1992),2020,9,0,0,0
Sowjetunion (bis 04/1992),2020,10,0,0,0
Sowjetunion (bis 04/1992),2020,11,0,0,0
Sowjetunion (bis 04/1992),2020,12,0,0,0
Sowjetunion (bis 04/1992),2021,1,0,0,0
Sowjetunion (bis 04/1992),2021,2,0,0,0
Sowjetunion (bis 04/1992),2021,3,0,0,0
Sowjetunion (bis 04/1992),2021,4,0,0,0
Sowjetunion (bis 04/1992),2021,5,0,0,0
Sowjetunion (bis 04/1992),2021,6,0,0,0
Sowjetunion (bis 04/1992),2021,7,0,0,0
Sowjetunion (bis 04/1992),2021,8,0,0,0
Sowjetunion (bis 04/1992),2021,9,0,0,0
Sowjetunion (bis 04/1992),2021,10,0,0,0
Sowjetunion (bis 04/1992),2021,11,0,0,0
Sowjetunion (bis 04/1992),2021,12,0,0,0
Sowjetunion (bis 04/1992),2022,1,0,0,0
Sowjetunion (bis 04/1992),2022,2,0,0,0
Sowjetunion (bis 04/1992),2022,3,0,0,0
Sowjetunion (bis 04/1992),2022,4,0,0,0
Sowjetunion (bis 04/1992),2022,5,0,0,0
Sowjetunion (bis 04/1992),2022,6,0,0,0
Sowjetunion (bis 04/1992),2022,7,0,0,0
Sowjetunion (bis 04/1992),2022,8,0,0,0
Sowjetunion (bis 04/1992),2022,9,0,0,0
Sowjetunion (bis 04/1992),2022,10,0,0,0
Sowjetunion (bis 04/1992),2022,11,0,0,0
Sowjetunion (bis 04/1992),2022,12,0,0,0
Sowjetunion (bis 04/1992),2023,1,0,0,0
Sowjetunion (bis 04/1992),2023,2,0,0,0
Sowjetunion (bis 04/1992),2023,3,0,0,0
Sowjetunion (bis 04/1992),2023,4,0,0,0
Sowjetunion (bis 04/1992),2023,5,0,0,0
Sowjetunion (bis 04/1992),2023,6,0,0,0
Sowjetunion (bis 04/1992),2023,7,0,0,0
Sowjetunion (bis 04/1992),2023,8,0,0,0
Sowjetunion (bis 04/1992),2023,9,0,0,0
Sowjetunion (bis 04/1992),2023,10,0,0,0
Sowjetunion (bis 04/1992),2023,11,0,0,0
Sowjetunion (bis 04/1992),2023,12,0,0,0
Sowjetunion (bis 04/1992),2024,1,0,0,0
Sowjetunion (bis 04/1992),2024,2,0,0,0
Sowjetunion (bis 04/1992),2024,3,0,0,0
Sowjetunion (bis 04/1992),2024,4,0,0,0
Sowjetunion (bis 04/1992),2024,5,0,0,0
Sowjetunion (bis 04/1992),2024,6,0,0,0
Sowjetunion (bis 04/1992),2024,7,0,0,0
Sowjetunion (bis 04/1992),2024,8,0,0,0
Sowjetunion (bis 04/1992),2024,9,0,0,0
Sowjetunion (bis 04/1992),2024,10,0,0,0
Sowjetunion (bis 04/1992),2024,11,0,0,0
Sowjetunion (bis 04/1992),2024,12,0,0,0
Spanien,2008,1,4008572000,1801292000,5809864000
Spanien,2008,2,3968101000,1882799000,5850900000
Spanien,2008,3,3888489000,1776898000,5665387000
Spanien,2008,4,4254086000,1909746000,6163832000
Spanien,2008,5,3906261000,1873240000,5779501000
Spanien,2008,6,3926188000,1813846000,5740034000
Spanien,2008,7,3832501000,1842919000,5675420000
Spanien,2008,8,2695652000,1294945000,3990597000
Spanien,2008,9,3469094000,1764445000,5233539000
Spanien,2008,10,3549173000,1738557000,5287730000
Spanien,2008,11,2876994000,1597204000,4474198000
Spanien,2008,12,2300951000,1404768000,3705719000
Spanien,2009,1,2429651000,1491232000,3920883000
Spanien,2009,2,2452098000,1541877000,3993975000
Spanien,2009,3,2826710000,1981345000,4808055000
Spanien,2009,4,2445256000,1676889000,4122145000
Spanien,2009,5,2427150000,1598950000,4026100000
Spanien,2009,6,2591183000,1618082000,4209265000
Spanien,2009,7,2621788000,1486657000,4108445000
Spanien,2009,8,2072348000,1238100000,3310448000
Spanien,2009,9,2944809000,1614499000,4559308000
Spanien,2009,10,3025717000,1671534000,4697251000
Spanien,2009,11,2858908000,1588597000,4447505000
Spanien,2009,12,2584885000,1450888000,4035773000
Spanien,2010,1,2629945000,1585673000,4215618000
Spanien,2010,2,2729732000,1841144000,4570876000
Spanien,2010,3,3281142000,1965580000,5246722000
Spanien,2010,4,2933925000,1946466000,4880391000
Spanien,2010,5,2886592000,1951131000,4837723000
Spanien,2010,6,3056287000,2012694000,5068981000
Spanien,2010,7,2842312000,1974454000,4816766000
Spanien,2010,8,2240052000,1352863000,3592915000
Spanien,2010,9,2932291000,1681989000,4614280000
Spanien,2010,10,2949428000,1996912000,4946340000
Spanien,2010,11,3058214000,1925133000,4983347000
Spanien,2010,12,2682106000,1720658000,4402764000
Spanien,2011,1,2825401000,1848766000,4674167000
Spanien,2011,2,2950590000,1955998000,4906588000
Spanien,2011,3,3420263000,2186854000,5607117000
Spanien,2011,4,2806745000,1904965000,4711710000
Spanien,2011,5,3133436000,1989929000,5123365000
Spanien,2011,6,3056514000,2043195000,5099709000
Spanien,2011,7,2839873000,1821687000,4661560000
Spanien,2011,8,2369217000,1337964000,3707181000
Spanien,2011,9,3053226000,2011394000,5064620000
Spanien,2011,10,2904691000,1803352000,4708043000
Spanien,2011,11,3074688000,1880520000,4955208000
Spanien,2011,12,2376438000,1706026000,4082464000
Spanien,2012,1,2741690000,1959512000,4701202000
Spanien,2012,2,2823019000,2160760000,4983779000
Spanien,2012,3,2900735000,2220837000,5121572000
Spanien,2012,4,2534952000,1838853000,4373805000
Spanien,2012,5,2742038000,2137448000,4879486000
Spanien,2012,6,2704347000,2084652000,4788999000
Spanien,2012,7,2557464000,1950198000,4507662000
Spanien,2012,8,2088064000,1461546000,3549610000
Spanien,2012,9,2456194000,1830276000,4286470000
Spanien,2012,10,2715145000,1960718000,4675863000
Spanien,2012,11,2645381000,1968677000,4614058000
Spanien,2012,12,2138424000,1633015000,3771439000
Spanien,2013,1,2695252000,2007383000,4702635000
Spanien,2013,2,2584912000,2007121000,4592033000
Spanien,2013,3,2638438000,2083275000,4721713000
Spanien,2013,4,2576025000,2052279000,4628304000
Spanien,2013,5,2785003000,2105773000,4890776000
Spanien,2013,6,2784036000,2070478000,4854514000
Spanien,2013,7,2652226000,1988491000,4640717000
Spanien,2013,8,2020797000,1492181000,3512978000
Spanien,2013,9,2624994000,1838730000,4463724000
Spanien,2013,10,2939540000,2162291000,5101831000
Spanien,2013,11,2738881000,1969729000,4708610000
Spanien,2013,12,2308735000,1861719000,4170454000
Spanien,2014,1,2889444000,1897123000,4786567000
Spanien,2014,2,2965839000,2169950000,5135789000
Spanien,2014,3,2873183000,2129531000,5002714000
Spanien,2014,4,2789959000,2127094000,4917053000
Spanien,2014,5,2965926000,2115285000,5081211000
Spanien,2014,6,2959985000,2268707000,5228692000
Spanien,2014,7,2947814000,2188005000,5135819000
Spanien,2014,8,2265566000,1475984000,3741550000
Spanien,2014,9,3010373000,2062809000,5073182000
Spanien,2014,10,3293909000,2218183000,5512092000
Spanien,2014,11,3017640000,2163792000,5181432000
Spanien,2014,12,2840620000,1988020000,4828640000
Spanien,2015,1,3078117000,2032558000,5110675000
Spanien,2015,2,3208504000,2147203000,5355707000
Spanien,2015,3,3305068000,2351122000,5656190000
Spanien,2015,4,3072436000,2207154000,5279590000
Spanien,2015,5,3282626000,2291998000,5574624000
Spanien,2015,6,3460285000,2295505000,5755790000
Spanien,2015,7,3551304000,2367604000,5918908000
Spanien,2015,8,2488260000,1559351000,4047611000
Spanien,2015,9,3364110000,2268552000,5632662000
Spanien,2015,10,3641814000,2261002000,5902816000
Spanien,2015,11,3351517000,2357794000,5709311000
Spanien,2015,12,2911020000,2302232000,5213252000
Spanien,2016,1,3098815000,2088624000,5187439000
Spanien,2016,2,3397548000,2365632000,5763180000
Spanien,2016,3,3503428000,2339669000,5843097000
Spanien,2016,4,3647091000,2477696000,6124787000
Spanien,2016,5,3432853000,2370483000,5803336000
Spanien,2016,6,3647619000,2459516000,6107135000
Spanien,2016,7,3183122000,2149529000,5332651000
Spanien,2016,8,2739687000,1764910000,4504597000
Spanien,2016,9,3524239000,2379559000,5903798000
Spanien,2016,10,3384348000,2270753000,5655101000
Spanien,2016,11,3845071000,2684784000,6529855000
Spanien,2016,12,3092909000,2518515000,5611424000
Spanien,2017,1,3403224000,2421012000,5824236000
Spanien,2017,2,3604064000,2664169000,6268233000
Spanien,2017,3,4090043000,2933824000,7023867000
Spanien,2017,4,3375741000,2384556000,5760297000
Spanien,2017,5,3768319000,2734333000,6502652000
Spanien,2017,6,3815133000,2862269000,6677402000
Spanien,2017,7,3437135000,2712873000,6150008000
Spanien,2017,8,2994069000,2040907000,5034976000
Spanien,2017,9,3742382000,2651683000,6394065000
Spanien,2017,10,3636121000,2630035000,6266156000
Spanien,2017,11,4030466000,2885530000,6915996000
Spanien,2017,12,3170305000,2474889000,5645194000
Spanien,2018,1,3804533000,2678442000,6482975000
Spanien,2018,2,3700397000,2683670000,6384067000
Spanien,2018,3,3799870000,2907773000,6707643000
Spanien,2018,4,3803549000,3014888000,6818437000
Spanien,2018,5,3821922000,2736370000,6558292000
Spanien,2018,6,3897961000,2958365000,6856326000
Spanien,2018,7,3838200000,2612525000,6450725000
Spanien,2018,8,3010339000,2176836000,5187175000
Spanien,2018,9,3509245000,2574604000,6083849000
Spanien,2018,10,3928121000,2682101000,6610222000
Spanien,2018,11,3902258000,2782268000,6684526000
Spanien,2018,12,3167175000,2591068000,5758243000
Spanien,2019,1,3814390000,2871324000,6685714000
Spanien,2019,2,3785525000,2673708000,6459233000
Spanien,2019,3,4002931000,3079248000,7082179000
Spanien,2019,4,3756566000,2699835000,6456401000
Spanien,2019,5,3833749000,3322081000,7155830000
Spanien,2019,6,3898566000,2988288000,6886854000
Spanien,2019,7,3685771000,2882608000,6568379000
Spanien,2019,8,2870602000,2093036000,4963638000
Spanien,2019,9,3844956000,2654348000,6499304000
Spanien,2019,10,3952733000,2807842000,6760575000
Spanien,2019,11,3695446000,2750545000,6445991000
Spanien,2019,12,3077019000,2303376000,5380395000
Spanien,2020,1,3661138000,2726979000,6388117000
Spanien,2020,2,3575201000,2882023000,6457224000
Spanien,2020,3,3402143000,2628290000,6030433000
Spanien,2020,4,1932806000,1785655000,3718461000
Spanien,2020,5,2339023000,2193710000,4532733000
Spanien,2020,6,3119773000,3073221000,6192994000
Spanien,2020,7,3253415000,2698028000,5951443000
Spanien,2020,8,2517748000,2102978000,4620726000
Spanien,2020,9,3586489000,2742963000,6329452000
Spanien,2020,10,3650852000,2869004000,6519856000
Spanien,2020,11,3592364000,3021240000,6613604000
Spanien,2020,12,2987328000,2556965000,5544293000
Spanien,2021,1,3385174000,2386846000,5772020000
Spanien,2021,2,3472619000,2653970000,6126589000
Spanien,2021,3,4020666000,3357327000,7377993000
Spanien,2021,4,3787212000,2881324000,6668536000
Spanien,2021,5,3726680000,2912861000,6639541000
Spanien,2021,6,3896018000,3103571000,6999589000
Spanien,2021,7,3651827000,2837796000,6489623000
Spanien,2021,8,3043109000,2168932000,5212041000
Spanien,2021,9,3699249000,2485364000,6184613000
Spanien,2021,10,3682877000,2698073000,6380950000
Spanien,2021,11,4050047000,3324463000,7374510000
Spanien,2021,12,3516490000,3369314000,6885804000
Spanien,2022,1,3966361000,3035007000,7001368000
Spanien,2022,2,4018398000,3121728000,7140126000
Spanien,2022,3,4383992000,3519522000,7903514000
Spanien,2022,4,3900154000,3038222000,6938376000
Spanien,2022,5,4471239000,3370425000,7841664000
Spanien,2022,6,4124078000,3079683000,7203761000
Spanien,2022,7,4054297000,2928533000,6982830000
Spanien,2022,8,3571253000,2309904000,5881157000
Spanien,2022,9,4626476000,3347229000,7973705000
Spanien,2022,10,4509427000,3071281000,7580708000
Spanien,2022,11,4763897000,3751099000,8514996000
Spanien,2022,12,3583600000,3063218000,6646818000
Spanien,2023,1,4394892000,3137617000,7532509000
Spanien,2023,2,4495443000,3298040000,7793483000
Spanien,2023,3,5137715000,3865029000,9002744000
Spanien,2023,4,4073074000,2966926000,7040000000
Spanien,2023,5,4686300000,3876837000,8563137000
Spanien,2023,6,4837769000,3450638000,8288407000
Spanien,2023,7,4551757000,3078951000,7630708000
Spanien,2023,8,3776342000,2713599000,6489941000
Spanien,2023,9,4566427000,2849862000,7416289000
Spanien,2023,10,4666765000,2998106000,7664871000
Spanien,2023,11,5165009000,3468778000,8633787000
Spanien,2023,12,3685360000,2931921000,6617281000
Spanien,2024,1,4816180000,3170334000,7986514000
Spanien,2024,2,4706640000,3262811000,7969451000
Spanien,2024,3,4613379000,3394832000,8008211000
Spanien,2024,4,4709951000,3690765000,8400716000
Spanien,2024,5,4701482000,3352176000,8053658000
Spanien,2024,6,4511407000,3421254000,7932661000
Spanien,2024,7,4671377000,3148372000,7819749000
Spanien,2024,8,3752306000,2480278000,6232584000
Spanien,2024,9,4484286000,3018045000,7502331000
Spanien,2024,10,4755492000,3079135000,7834627000
Spanien,2024,11,4376174000,3066234000,7442408000
Spanien,2024,12,4031822000,3152118000,7183940000
Sri Lanka,2008,1,15064000,33847000,48911000
Sri Lanka,2008,2,15079000,29935000,45014000
Sri Lanka,2008,3,14282000,34337000,48619000
Sri Lanka,2008,4,13480000,32042000,45522000
Sri Lanka,2008,5,12548000,24620000,37168000
Sri Lanka,2008,6,18778000,29696000,48474000
Sri Lanka,2008,7,11336000,33184000,44520000
Sri Lanka,2008,8,11551000,31653000,43204000
Sri Lanka,2008,9,10186000,38014000,48200000
Sri Lanka,2008,10,9850000,34569000,44419000
Sri Lanka,2008,11,10348000,30151000,40499000
Sri Lanka,2008,12,11287000,32325000,43612000
Sri Lanka,2009,1,9333000,33961000,43294000
Sri Lanka,2009,2,13389000,29888000,43277000
Sri Lanka,2009,3,9380000,38405000,47785000
Sri Lanka,2009,4,9563000,32681000,42244000
Sri Lanka,2009,5,10565000,24033000,34598000
Sri Lanka,2009,6,16538000,33426000,49964000
Sri Lanka,2009,7,12506000,32261000,44767000
Sri Lanka,2009,8,11348000,28077000,39425000
Sri Lanka,2009,9,10739000,26398000,37137000
Sri Lanka,2009,10,12947000,26005000,38952000
Sri Lanka,2009,11,11769000,24213000,35982000
Sri Lanka,2009,12,22375000,30521000,52896000
Sri Lanka,2010,1,8948000,27931000,36879000
Sri Lanka,2010,2,14748000,28285000,43033000
Sri Lanka,2010,3,12540000,33959000,46499000
Sri Lanka,2010,4,15054000,34685000,49739000
Sri Lanka,2010,5,12595000,27909000,40504000
Sri Lanka,2010,6,15983000,33716000,49699000
Sri Lanka,2010,7,19685000,37291000,56976000
Sri Lanka,2010,8,17379000,41243000,58622000
Sri Lanka,2010,9,25064000,35957000,61021000
Sri Lanka,2010,10,15646000,39282000,54928000
Sri Lanka,2010,11,18985000,32702000,51687000
Sri Lanka,2010,12,19934000,34367000,54301000
Sri Lanka,2011,1,11914000,38204000,50118000
Sri Lanka,2011,2,17208000,35559000,52767000
Sri Lanka,2011,3,21884000,44581000,66465000
Sri Lanka,2011,4,15459000,38325000,53784000
Sri Lanka,2011,5,17827000,38202000,56029000
Sri Lanka,2011,6,16204000,37757000,53961000
Sri Lanka,2011,7,20514000,38386000,58900000
Sri Lanka,2011,8,21910000,44368000,66278000
Sri Lanka,2011,9,20543000,39982000,60525000
Sri Lanka,2011,10,20587000,37694000,58281000
Sri Lanka,2011,11,20561000,39013000,59574000
Sri Lanka,2011,12,19825000,36272000,56097000
Sri Lanka,2012,1,14832000,41598000,56430000
Sri Lanka,2012,2,15835000,42197000,58032000
Sri Lanka,2012,3,18926000,45077000,64003000
Sri Lanka,2012,4,13289000,39467000,52756000
Sri Lanka,2012,5,11513000,34166000,45679000
Sri Lanka,2012,6,14557000,42433000,56990000
Sri Lanka,2012,7,21139000,39891000,61030000
Sri Lanka,2012,8,30390000,44925000,75315000
Sri Lanka,2012,9,27908000,40542000,68450000
Sri Lanka,2012,10,24189000,39533000,63722000
Sri Lanka,2012,11,29484000,40620000,70104000
Sri Lanka,2012,12,16809000,31909000,48718000
Sri Lanka,2013,1,18180000,42334000,60514000
Sri Lanka,2013,2,25581000,37059000,62640000
Sri Lanka,2013,3,26268000,37504000,63772000
Sri Lanka,2013,4,17780000,42648000,60428000
Sri Lanka,2013,5,21944000,34332000,56276000
Sri Lanka,2013,6,30018000,33667000,63685000
Sri Lanka,2013,7,23243000,39860000,63103000
Sri Lanka,2013,8,17762000,39556000,57318000
Sri Lanka,2013,9,20099000,36875000,56974000
Sri Lanka,2013,10,18946000,39196000,58142000
Sri Lanka,2013,11,18176000,37177000,55353000
Sri Lanka,2013,12,15720000,30332000,46052000
Sri Lanka,2014,1,13749000,43852000,57601000
Sri Lanka,2014,2,14459000,33567000,48026000
Sri Lanka,2014,3,19736000,41488000,61224000
Sri Lanka,2014,4,15241000,44067000,59308000
Sri Lanka,2014,5,19910000,33390000,53300000
Sri Lanka,2014,6,14224000,40988000,55212000
Sri Lanka,2014,7,18320000,43955000,62275000
Sri Lanka,2014,8,19441000,42740000,62181000
Sri Lanka,2014,9,20270000,42563000,62833000
Sri Lanka,2014,10,20628000,43370000,63998000
Sri Lanka,2014,11,21006000,36883000,57889000
Sri Lanka,2014,12,20848000,34804000,55652000
Sri Lanka,2015,1,13612000,45995000,59607000
Sri Lanka,2015,2,17122000,38748000,55870000
Sri Lanka,2015,3,22419000,46445000,68864000
Sri Lanka,2015,4,23717000,51473000,75190000
Sri Lanka,2015,5,15905000,38052000,53957000
Sri Lanka,2015,6,32959000,44903000,77862000
Sri Lanka,2015,7,25075000,48501000,73576000
Sri Lanka,2015,8,18490000,44760000,63250000
Sri Lanka,2015,9,21519000,46868000,68387000
Sri Lanka,2015,10,34500000,44301000,78801000
Sri Lanka,2015,11,32402000,39184000,71586000
Sri Lanka,2015,12,28085000,39941000,68026000
Sri Lanka,2016,1,16381000,44576000,60957000
Sri Lanka,2016,2,23316000,48792000,72108000
Sri Lanka,2016,3,39765000,49258000,89023000
Sri Lanka,2016,4,29910000,50412000,80322000
Sri Lanka,2016,5,23648000,38397000,62045000
Sri Lanka,2016,6,23896000,49132000,73028000
Sri Lanka,2016,7,24798000,50566000,75364000
Sri Lanka,2016,8,24061000,53317000,77378000
Sri Lanka,2016,9,29136000,52018000,81154000
Sri Lanka,2016,10,27266000,49701000,76967000
Sri Lanka,2016,11,25686000,48422000,74108000
Sri Lanka,2016,12,27564000,43311000,70875000
Sri Lanka,2017,1,30446000,55313000,85759000
Sri Lanka,2017,2,86003000,55691000,141694000
Sri Lanka,2017,3,26297000,57317000,83614000
Sri Lanka,2017,4,21120000,52862000,73982000
Sri Lanka,2017,5,28586000,48235000,76821000
Sri Lanka,2017,6,94355000,54288000,148643000
Sri Lanka,2017,7,24255000,58264000,82519000
Sri Lanka,2017,8,89743000,57950000,147693000
Sri Lanka,2017,9,24479000,56911000,81390000
Sri Lanka,2017,10,22579000,54769000,77348000
Sri Lanka,2017,11,98742000,58139000,156881000
Sri Lanka,2017,12,23792000,48359000,72151000
Sri Lanka,2018,1,28116000,60610000,88726000
Sri Lanka,2018,2,25259000,73373000,98632000
Sri Lanka,2018,3,25615000,60387000,86002000
Sri Lanka,2018,4,21463000,59584000,81047000
Sri Lanka,2018,5,22895000,52277000,75172000
Sri Lanka,2018,6,22731000,60697000,83428000
Sri Lanka,2018,7,89927000,62039000,151966000
Sri Lanka,2018,8,24000000,63974000,87974000
Sri Lanka,2018,9,22297000,59817000,82114000
Sri Lanka,2018,10,24634000,63373000,88007000
Sri Lanka,2018,11,25097000,58995000,84092000
Sri Lanka,2018,12,18465000,48442000,66907000
Sri Lanka,2019,1,24144000,68923000,93067000
Sri Lanka,2019,2,20195000,61780000,81975000
Sri Lanka,2019,3,23861000,63269000,87130000
Sri Lanka,2019,4,27387000,69012000,96399000
Sri Lanka,2019,5,25121000,57436000,82557000
Sri Lanka,2019,6,31276000,67213000,98489000
Sri Lanka,2019,7,25387000,70044000,95431000
Sri Lanka,2019,8,28702000,61820000,90522000
Sri Lanka,2019,9,30525000,65004000,95529000
Sri Lanka,2019,10,26792000,65465000,92257000
Sri Lanka,2019,11,26279000,54948000,81227000
Sri Lanka,2019,12,27140000,51215000,78355000
Sri Lanka,2020,1,21186000,75520000,96706000
Sri Lanka,2020,2,23989000,61679000,85668000
Sri Lanka,2020,3,24300000,69919000,94219000
Sri Lanka,2020,4,16991000,41713000,58704000
Sri Lanka,2020,5,10848000,35369000,46217000
Sri Lanka,2020,6,14498000,56673000,71171000
Sri Lanka,2020,7,22684000,66088000,88772000
Sri Lanka,2020,8,21612000,62694000,84306000
Sri Lanka,2020,9,18313000,75178000,93491000
Sri Lanka,2020,10,20560000,62257000,82817000
Sri Lanka,2020,11,19526000,62879000,82405000
Sri Lanka,2020,12,18338000,55065000,73403000
Sri Lanka,2021,1,14370000,59131000,73501000
Sri Lanka,2021,2,22777000,67693000,90470000
Sri Lanka,2021,3,21588000,70485000,92073000
Sri Lanka,2021,4,17647000,76840000,94487000
Sri Lanka,2021,5,20791000,64589000,85380000
Sri Lanka,2021,6,19273000,76969000,96242000
Sri Lanka,2021,7,44601000,75968000,120569000
Sri Lanka,2021,8,19155000,75196000,94351000
Sri Lanka,2021,9,20344000,74247000,94591000
Sri Lanka,2021,10,17768000,66999000,84767000
Sri Lanka,2021,11,21146000,77219000,98365000
Sri Lanka,2021,12,26029000,79172000,105201000
Sri Lanka,2022,1,16293000,85910000,102203000
Sri Lanka,2022,2,16281000,78059000,94340000
Sri Lanka,2022,3,21861000,84522000,106383000
Sri Lanka,2022,4,14377000,89721000,104098000
Sri Lanka,2022,5,17630000,97672000,115302000
Sri Lanka,2022,6,17772000,79572000,97344000
Sri Lanka,2022,7,15539000,88439000,103978000
Sri Lanka,2022,8,29424000,92397000,121821000
Sri Lanka,2022,9,17043000,95153000,112196000
Sri Lanka,2022,10,18480000,89387000,107867000
Sri Lanka,2022,11,23039000,97973000,121012000
Sri Lanka,2022,12,13536000,73149000,86685000
Sri Lanka,2023,1,14804000,79764000,94568000
Sri Lanka,2023,2,12653000,68086000,80739000
Sri Lanka,2023,3,19032000,86644000,105676000
Sri Lanka,2023,4,13678000,69194000,82872000
Sri Lanka,2023,5,15314000,78191000,93505000
Sri Lanka,2023,6,14360000,77210000,91570000
Sri Lanka,2023,7,15461000,75063000,90524000
Sri Lanka,2023,8,17284000,72477000,89761000
Sri Lanka,2023,9,21538000,73706000,95244000
Sri Lanka,2023,10,14114000,64056000,78170000
Sri Lanka,2023,11,14760000,67671000,82431000
Sri Lanka,2023,12,13552000,58394000,71946000
Sri Lanka,2024,1,17214000,65236000,82450000
Sri Lanka,2024,2,17860000,88661000,106521000
Sri Lanka,2024,3,17868000,82083000,99951000
Sri Lanka,2024,4,15588000,83120000,98708000
Sri Lanka,2024,5,17224000,76420000,93644000
Sri Lanka,2024,6,21037000,70044000,91081000
Sri Lanka,2024,7,17540000,90438000,107978000
Sri Lanka,2024,8,13879000,73654000,87533000
Sri Lanka,2024,9,18395000,74371000,92766000
Sri Lanka,2024,10,19241000,82092000,101333000
Sri Lanka,2024,11,16666000,76323000,92989000
Sri Lanka,2024,12,19328000,66787000,86115000
St. Barthelemy (ab 2013),2008,1,0,0,0
St. Barthelemy (ab 2013),2008,2,0,0,0
St. Barthelemy (ab 2013),2008,3,0,0,0
St. Barthelemy (ab 2013),2008,4,0,0,0
St. Barthelemy (ab 2013),2008,5,0,0,0
St. Barthelemy (ab 2013),2008,6,0,0,0
St. Barthelemy (ab 2013),2008,7,0,0,0
St. Barthelemy (ab 2013),2008,8,0,0,0
St. Barthelemy (ab 2013),2008,9,0,0,0
St. Barthelemy (ab 2013),2008,10,0,0,0
St. Barthelemy (ab 2013),2008,11,0,0,0
St. Barthelemy (ab 2013),2008,12,0,0,0
St. Barthelemy (ab 2013),2009,1,0,0,0
St. Barthelemy (ab 2013),2009,2,0,0,0
St. Barthelemy (ab 2013),2009,3,0,0,0
St. Barthelemy (ab 2013),2009,4,0,0,0
St. Barthelemy (ab 2013),2009,5,0,0,0
St. Barthelemy (ab 2013),2009,6,0,0,0
St. Barthelemy (ab 2013),2009,7,0,0,0
St. Barthelemy (ab 2013),2009,8,0,0,0
St. Barthelemy (ab 2013),2009,9,0,0,0
St. Barthelemy (ab 2013),2009,10,0,0,0
St. Barthelemy (ab 2013),2009,11,0,0,0
St. Barthelemy (ab 2013),2009,12,0,0,0
St. Barthelemy (ab 2013),2010,1,0,0,0
St. Barthelemy (ab 2013),2010,2,0,0,0
St. Barthelemy (ab 2013),2010,3,0,0,0
St. Barthelemy (ab 2013),2010,4,0,0,0
St. Barthelemy (ab 2013),2010,5,0,0,0
St. Barthelemy (ab 2013),2010,6,0,0,0
St. Barthelemy (ab 2013),2010,7,0,0,0
St. Barthelemy (ab 2013),2010,8,0,0,0
St. Barthelemy (ab 2013),2010,9,0,0,0
St. Barthelemy (ab 2013),2010,10,0,0,0
St. Barthelemy (ab 2013),2010,11,0,0,0
St. Barthelemy (ab 2013),2010,12,0,0,0
St. Barthelemy (ab 2013),2011,1,0,0,0
St. Barthelemy (ab 2013),2011,2,0,0,0
St. Barthelemy (ab 2013),2011,3,0,0,0
St. Barthelemy (ab 2013),2011,4,0,0,0
St. Barthelemy (ab 2013),2011,5,0,0,0
St. Barthelemy (ab 2013),2011,6,0,0,0
St. Barthelemy (ab 2013),2011,7,0,0,0
St. Barthelemy (ab 2013),2011,8,0,0,0
St. Barthelemy (ab 2013),2011,9,0,0,0
St. Barthelemy (ab 2013),2011,10,0,0,0
St. Barthelemy (ab 2013),2011,11,0,0,0
St. Barthelemy (ab 2013),2011,12,0,0,0
St. Barthelemy (ab 2013),2012,1,0,0,0
St. Barthelemy (ab 2013),2012,2,0,0,0
St. Barthelemy (ab 2013),2012,3,0,0,0
St. Barthelemy (ab 2013),2012,4,0,0,0
St. Barthelemy (ab 2013),2012,5,0,0,0
St. Barthelemy (ab 2013),2012,6,0,0,0
St. Barthelemy (ab 2013),2012,7,0,0,0
St. Barthelemy (ab 2013),2012,8,0,0,0
St. Barthelemy (ab 2013),2012,9,0,0,0
St. Barthelemy (ab 2013),2012,10,0,0,0
St. Barthelemy (ab 2013),2012,11,0,0,0
St. Barthelemy (ab 2013),2012,12,0,0,0
St. Barthelemy (ab 2013),2013,1,5000,0,5000
St. Barthelemy (ab 2013),2013,2,9000,0,9000
St. Barthelemy (ab 2013),2013,3,122000,27000,149000
St. Barthelemy (ab 2013),2013,4,51000,2000,53000
St. Barthelemy (ab 2013),2013,5,4000,318000,322000
St. Barthelemy (ab 2013),2013,6,21000,216000,237000
St. Barthelemy (ab 2013),2013,7,10000,10000,20000
St. Barthelemy (ab 2013),2013,8,9000,229000,238000
St. Barthelemy (ab 2013),2013,9,8000,211000,219000
St. Barthelemy (ab 2013),2013,10,30000,189000,219000
St. Barthelemy (ab 2013),2013,11,11000,220000,231000
St. Barthelemy (ab 2013),2013,12,5000,2000,7000
St. Barthelemy (ab 2013),2014,1,5000,166000,171000
St. Barthelemy (ab 2013),2014,2,5000,0,5000
St. Barthelemy (ab 2013),2014,3,243000,323000,566000
St. Barthelemy (ab 2013),2014,4,21000,3000,24000
St. Barthelemy (ab 2013),2014,5,2000,165000,167000
St. Barthelemy (ab 2013),2014,6,23000,211000,234000
St. Barthelemy (ab 2013),2014,7,13000,188000,201000
St. Barthelemy (ab 2013),2014,8,67000,167000,234000
St. Barthelemy (ab 2013),2014,9,13000,0,13000
St. Barthelemy (ab 2013),2014,10,103000,153000,256000
St. Barthelemy (ab 2013),2014,11,112000,194000,306000
St. Barthelemy (ab 2013),2014,12,13000,147000,160000
St. Barthelemy (ab 2013),2015,1,1000,208000,209000
St. Barthelemy (ab 2013),2015,2,20000,2000,22000
St. Barthelemy (ab 2013),2015,3,41000,168000,209000
St. Barthelemy (ab 2013),2015,4,15000,176000,191000
St. Barthelemy (ab 2013),2015,5,5000,278000,283000
St. Barthelemy (ab 2013),2015,6,38000,143000,181000
St. Barthelemy (ab 2013),2015,7,57000,207000,264000
St. Barthelemy (ab 2013),2015,8,140000,177000,317000
St. Barthelemy (ab 2013),2015,9,218000,175000,393000
St. Barthelemy (ab 2013),2015,10,121000,180000,301000
St. Barthelemy (ab 2013),2015,11,20000,0,20000
St. Barthelemy (ab 2013),2015,12,55000,384000,439000
St. Barthelemy (ab 2013),2016,1,78000,1000,79000
St. Barthelemy (ab 2013),2016,2,40000,143000,183000
St. Barthelemy (ab 2013),2016,3,58000,1000,59000
St. Barthelemy (ab 2013),2016,4,106000,140000,246000
St. Barthelemy (ab 2013),2016,5,16000,198000,214000
St. Barthelemy (ab 2013),2016,6,55000,370000,425000
St. Barthelemy (ab 2013),2016,7,74000,158000,232000
St. Barthelemy (ab 2013),2016,8,24000,10000,34000
St. Barthelemy (ab 2013),2016,9,45000,171000,216000
St. Barthelemy (ab 2013),2016,10,594000,171000,765000
St. Barthelemy (ab 2013),2016,11,45000,0,45000
St. Barthelemy (ab 2013),2016,12,95000,179000,274000
St. Barthelemy (ab 2013),2017,1,48000,183000,231000
St. Barthelemy (ab 2013),2017,2,82000,182000,264000
St. Barthelemy (ab 2013),2017,3,17000,185000,202000
St. Barthelemy (ab 2013),2017,4,21000,5000,26000
St. Barthelemy (ab 2013),2017,5,317000,143000,460000
St. Barthelemy (ab 2013),2017,6,69000,153000,222000
St. Barthelemy (ab 2013),2017,7,34000,48000,82000
St. Barthelemy (ab 2013),2017,8,26000,548000,574000
St. Barthelemy (ab 2013),2017,9,42000,183000,225000
St. Barthelemy (ab 2013),2017,10,50000,0,50000
St. Barthelemy (ab 2013),2017,11,76000,165000,241000
St. Barthelemy (ab 2013),2017,12,221000,304000,525000
St. Barthelemy (ab 2013),2018,1,17000,148000,165000
St. Barthelemy (ab 2013),2018,2,44000,155000,199000
St. Barthelemy (ab 2013),2018,3,63000,168000,231000
St. Barthelemy (ab 2013),2018,4,45000,154000,199000
St. Barthelemy (ab 2013),2018,5,151000,329000,480000
St. Barthelemy (ab 2013),2018,6,130000,0,130000
St. Barthelemy (ab 2013),2018,7,23000,120000,143000
St. Barthelemy (ab 2013),2018,8,35000,313000,348000
St. Barthelemy (ab 2013),2018,9,83000,162000,245000
St. Barthelemy (ab 2013),2018,10,256000,431000,687000
St. Barthelemy (ab 2013),2018,11,80000,182000,262000
St. Barthelemy (ab 2013),2018,12,95000,155000,250000
St. Barthelemy (ab 2013),2019,1,25000,224000,249000
St. Barthelemy (ab 2013),2019,2,40000,147000,187000
St. Barthelemy (ab 2013),2019,3,22000,165000,187000
St. Barthelemy (ab 2013),2019,4,15000,298000,313000
St. Barthelemy (ab 2013),2019,5,24000,165000,189000
St. Barthelemy (ab 2013),2019,6,65000,171000,236000
St. Barthelemy (ab 2013),2019,7,171000,193000,364000
St. Barthelemy (ab 2013),2019,8,154000,396000,550000
St. Barthelemy (ab 2013),2019,9,132000,61000,193000
St. Barthelemy (ab 2013),2019,10,154000,247000,401000
St. Barthelemy (ab 2013),2019,11,44000,171000,215000
St. Barthelemy (ab 2013),2019,12,65000,165000,230000
St. Barthelemy (ab 2013),2020,1,148000,136000,284000
St. Barthelemy (ab 2013),2020,2,35000,0,35000
St. Barthelemy (ab 2013),2020,3,79000,165000,244000
St. Barthelemy (ab 2013),2020,4,23000,285000,308000
St. Barthelemy (ab 2013),2020,5,32000,5000,37000
St. Barthelemy (ab 2013),2020,6,8000,5000,13000
St. Barthelemy (ab 2013),2020,7,181000,6000,187000
St. Barthelemy (ab 2013),2020,8,127000,105000,232000
St. Barthelemy (ab 2013),2020,9,471000,156000,627000
St. Barthelemy (ab 2013),2020,10,68000,21000,89000
St. Barthelemy (ab 2013),2020,11,51000,12000,63000
St. Barthelemy (ab 2013),2020,12,92000,0,92000
St. Barthelemy (ab 2013),2021,1,36000,4000,40000
St. Barthelemy (ab 2013),2021,2,36000,0,36000
St. Barthelemy (ab 2013),2021,3,44000,0,44000
St. Barthelemy (ab 2013),2021,4,29000,0,29000
St. Barthelemy (ab 2013),2021,5,21000,6000,27000
St. Barthelemy (ab 2013),2021,6,97000,12000,109000
St. Barthelemy (ab 2013),2021,7,33000,6000,39000
St. Barthelemy (ab 2013),2021,8,75000,0,75000
St. Barthelemy (ab 2013),2021,9,580000,0,580000
St. Barthelemy (ab 2013),2021,10,73000,0,73000
St. Barthelemy (ab 2013),2021,11,257000,170000,427000
St. Barthelemy (ab 2013),2021,12,236000,29000,265000
St. Barthelemy (ab 2013),2022,1,203000,4000,207000
St. Barthelemy (ab 2013),2022,2,102000,294000,396000
St. Barthelemy (ab 2013),2022,3,167000,19000,186000
St. Barthelemy (ab 2013),2022,4,73000,16000,89000
St. Barthelemy (ab 2013),2022,5,162000,20000,182000
St. Barthelemy (ab 2013),2022,6,103000,26000,129000
St. Barthelemy (ab 2013),2022,7,219000,22000,241000
St. Barthelemy (ab 2013),2022,8,67000,0,67000
St. Barthelemy (ab 2013),2022,9,76000,0,76000
St. Barthelemy (ab 2013),2022,10,353000,91000,444000
St. Barthelemy (ab 2013),2022,11,367000,0,367000
St. Barthelemy (ab 2013),2022,12,91000,0,91000
St. Barthelemy (ab 2013),2023,1,134000,7000,141000
St. Barthelemy (ab 2013),2023,2,133000,0,133000
St. Barthelemy (ab 2013),2023,3,67000,11000,78000
St. Barthelemy (ab 2013),2023,4,91000,10000,101000
St. Barthelemy (ab 2013),2023,5,130000,0,130000
St. Barthelemy (ab 2013),2023,6,107000,1000,108000
St. Barthelemy (ab 2013),2023,7,116000,0,116000
St. Barthelemy (ab 2013),2023,8,41000,8000,49000
St. Barthelemy (ab 2013),2023,9,57000,0,57000
St. Barthelemy (ab 2013),2023,10,520000,0,520000
St. Barthelemy (ab 2013),2023,11,65000,0,65000
St. Barthelemy (ab 2013),2023,12,30000,0,30000
St. Barthelemy (ab 2013),2024,1,92000,33000,125000
St. Barthelemy (ab 2013),2024,2,108000,32000,140000
St. Barthelemy (ab 2013),2024,3,87000,43000,130000
St. Barthelemy (ab 2013),2024,4,57000,55000,112000
St. Barthelemy (ab 2013),2024,5,55000,0,55000
St. Barthelemy (ab 2013),2024,6,40000,12000,52000
St. Barthelemy (ab 2013),2024,7,119000,11000,130000
St. Barthelemy (ab 2013),2024,8,44000,2000,46000
St. Barthelemy (ab 2013),2024,9,41000,8000,49000
St. Barthelemy (ab 2013),2024,10,121000,3000,124000
St. Barthelemy (ab 2013),2024,11,38000,0,38000
St. Barthelemy (ab 2013),2024,12,57000,0,57000
"St. Helena, Ascension und Tristan da Cunha",2008,1,86000,0,86000
"St. Helena, Ascension und Tristan da Cunha",2008,2,16000,0,16000
"St. Helena, Ascension und Tristan da Cunha",2008,3,12000,0,12000
"St. Helena, Ascension und Tristan da Cunha",2008,4,5000,0,5000
"St. Helena, Ascension und Tristan da Cunha",2008,5,1000,0,1000
"St. Helena, Ascension und Tristan da Cunha",2008,6,1415000,0,1415000
"St. Helena, Ascension und Tristan da Cunha",2008,7,4000,0,4000
"St. Helena, Ascension und Tristan da Cunha",2008,8,0,0,0
"St. Helena, Ascension und Tristan da Cunha",2008,9,0,0,0
"St. Helena, Ascension und Tristan da Cunha",2008,10,0,0,0
"St. Helena, Ascension und Tristan da Cunha",2008,11,0,0,0
"St. Helena, Ascension und Tristan da Cunha",2008,12,0,0,0
"St. Helena, Ascension und Tristan da Cunha",2009,1,13000,6000,19000
"St. Helena, Ascension und Tristan da Cunha",2009,2,0,0,0
"St. Helena, Ascension und Tristan da Cunha",2009,3,20000,0,20000
"St. Helena, Ascension und Tristan da Cunha",2009,4,89000,0,89000
"St. Helena, Ascension und Tristan da Cunha",2009,5,0,0,0
"St. Helena, Ascension und Tristan da Cunha",2009,6,72000,0,72000
"St. Helena, Ascension und Tristan da Cunha",2009,7,44000,0,44000
"St. Helena, Ascension und Tristan da Cunha",2009,8,2000,0,2000
"St. Helena, Ascension und Tristan da Cunha",2009,9,0,0,0
"St. Helena, Ascension und Tristan da Cunha",2009,10,2000,0,2000
"St. Helena, Ascension und Tristan da Cunha",2009,11,0,1000,1000
"St. Helena, Ascension und Tristan da Cunha",2009,12,5296000,0,5296000
"St. Helena, Ascension und Tristan da Cunha",2010,1,0,0,0
"St. Helena, Ascension und Tristan da Cunha",2010,2,7000,0,7000
"St. Helena, Ascension und Tristan da Cunha",2010,3,0,0,0
"St. Helena, Ascension und Tristan da Cunha",2010,4,1000,0,1000
"St. Helena, Ascension und Tristan da Cunha",2010,5,106000,0,106000
"St. Helena, Ascension und Tristan da Cunha",2010,6,0,0,0
"St. Helena, Ascension und Tristan da Cunha",2010,7,2000,0,2000
"St. Helena, Ascension und Tristan da Cunha",2010,8,0,0,0
"St. Helena, Ascension und Tristan da Cunha",2010,9,10000,0,10000
"St. Helena, Ascension und Tristan da Cunha",2010,10,41000,201000,242000
"St. Helena, Ascension und Tristan da Cunha",2010,11,125000,0,125000
"St. Helena, Ascension und Tristan da Cunha",2010,12,0,0,0
"St. Helena, Ascension und Tristan da Cunha",2011,1,7000,0,7000
"St. Helena, Ascension und Tristan da Cunha",2011,2,27000,0,27000
"St. Helena, Ascension und Tristan da Cunha",2011,3,5000,0,5000
"St. Helena, Ascension und Tristan da Cunha",2011,4,0,0,0
"St. Helena, Ascension und Tristan da Cunha",2011,5,1000,0,1000
"St. Helena, Ascension und Tristan da Cunha",2011,6,1000,0,1000
"St. Helena, Ascension und Tristan da Cunha",2011,7,0,0,0
"St. Helena, Ascension und Tristan da Cunha",2011,8,0,0,0
"St. Helena, Ascension und Tristan da Cunha",2011,9,0,0,0
"St. Helena, Ascension und Tristan da Cunha",2011,10,6000,0,6000
"St. Helena, Ascension und Tristan da Cunha",2011,11,0,0,0
"St. Helena, Ascension und Tristan da Cunha",2011,12,0,0,0
"St. Helena, Ascension und Tristan da Cunha",2012,1,0,0,0
"St. Helena, Ascension und Tristan da Cunha",2012,2,0,0,0
"St. Helena, Ascension und Tristan da Cunha",2012,3,0,0,0
"St. Helena, Ascension und Tristan da Cunha",2012,4,0,0,0
"St. Helena, Ascension und Tristan da Cunha",2012,5,1000,0,1000
"St. Helena, Ascension und Tristan da Cunha",2012,6,1000,0,1000
"St. Helena, Ascension und Tristan da Cunha",2012,7,4000,0,4000
"St. Helena, Ascension und Tristan da Cunha",2012,8,27000,0,27000
"St. Helena, Ascension und Tristan da Cunha",2012,9,3000,0,3000
"St. Helena, Ascension und Tristan da Cunha",2012,10,0,0,0
"St. Helena, Ascension und Tristan da Cunha",2012,11,0,0,0
"St. Helena, Ascension und Tristan da Cunha",2012,12,0,0,0
"St. Helena, Ascension und Tristan da Cunha",2013,1,0,0,0
"St. Helena, Ascension und Tristan da Cunha",2013,2,0,0,0
"St. Helena, Ascension und Tristan da Cunha",2013,3,0,0,0
"St. Helena, Ascension und Tristan da Cunha",2013,4,0,0,0
"St. Helena, Ascension und Tristan da Cunha",2013,5,0,0,0
"St. Helena, Ascension und Tristan da Cunha",2013,6,0,0,0
"St. Helena, Ascension und Tristan da Cunha",2013,7,0,0,0
"St. Helena, Ascension und Tristan da Cunha",2013,8,0,0,0
"St. Helena, Ascension und Tristan da Cunha",2013,9,0,0,0
"St. Helena, Ascension und Tristan da Cunha",2013,10,0,0,0
"St. Helena, Ascension und Tristan da Cunha",2013,11,0,0,0
"St. Helena, Ascension und Tristan da Cunha",2013,12,0,0,0
"St. Helena, Ascension und Tristan da Cunha",2014,1,0,0,0
"St. Helena, Ascension und Tristan da Cunha",2014,2,0,0,0
"St. Helena, Ascension und Tristan da Cunha",2014,3,0,0,0
"St. Helena, Ascension und Tristan da Cunha",2014,4,1000,0,1000
"St. Helena, Ascension und Tristan da Cunha",2014,5,2000,0,2000
"St. Helena, Ascension und Tristan da Cunha",2014,6,0,0,0
"St. Helena, Ascension und Tristan da Cunha",2014,7,0,0,0
"St. Helena, Ascension und Tristan da Cunha",2014,8,0,0,0
"St. Helena, Ascension und Tristan da Cunha",2014,9,2000,0,2000
"St. Helena, Ascension und Tristan da Cunha",2014,10,0,0,0
"St. Helena, Ascension und Tristan da Cunha",2014,11,0,64000,64000
"St. Helena, Ascension und Tristan da Cunha",2014,12,0,0,0
"St. Helena, Ascension und Tristan da Cunha",2015,1,0,0,0
"St. Helena, Ascension und Tristan da Cunha",2015,2,0,0,0
"St. Helena, Ascension und Tristan da Cunha",2015,3,0,0,0
"St. Helena, Ascension und Tristan da Cunha",2015,4,0,0,0
"St. Helena, Ascension und Tristan da Cunha",2015,5,0,0,0
"St. Helena, Ascension und Tristan da Cunha",2015,6,0,0,0
"St. Helena, Ascension und Tristan da Cunha",2015,7,0,0,0
"St. Helena, Ascension und Tristan da Cunha",2015,8,0,0,0
"St. Helena, Ascension und Tristan da Cunha",2015,9,0,0,0
"St. Helena, Ascension und Tristan da Cunha",2015,10,0,0,0
"St. Helena, Ascension und Tristan da Cunha",2015,11,0,0,0
"St. Helena, Ascension und Tristan da Cunha",2015,12,17000,0,17000
"St. Helena, Ascension und Tristan da Cunha",2016,1,0,0,0
"St. Helena, Ascension und Tristan da Cunha",2016,2,46000,0,46000
"St. Helena, Ascension und Tristan da Cunha",2016,3,0,0,0
"St. Helena, Ascension und Tristan da Cunha",2016,4,2000,0,2000
"St. Helena, Ascension und Tristan da Cunha",2016,5,0,0,0
"St. Helena, Ascension und Tristan da Cunha",2016,6,60000,0,60000
"St. Helena, Ascension und Tristan da Cunha",2016,7,0,0,0
"St. Helena, Ascension und Tristan da Cunha",2016,8,0,0,0
"St. Helena, Ascension und Tristan da Cunha",2016,9,0,0,0
"St. Helena, Ascension und Tristan da Cunha",2016,10,0,0,0
"St. Helena, Ascension und Tristan da Cunha",2016,11,5000,28000,33000
"St. Helena, Ascension und Tristan da Cunha",2016,12,1000,0,1000
"St. Helena, Ascension und Tristan da Cunha",2017,1,0,0,0
"St. Helena, Ascension und Tristan da Cunha",2017,2,0,0,0
"St. Helena, Ascension und Tristan da Cunha",2017,3,32000,0,32000
"St. Helena, Ascension und Tristan da Cunha",2017,4,0,0,0
"St. Helena, Ascension und Tristan da Cunha",2017,5,4000,0,4000
"St. Helena, Ascension und Tristan da Cunha",2017,6,0,0,0
"St. Helena, Ascension und Tristan da Cunha",2017,7,0,0,0
"St. Helena, Ascension und Tristan da Cunha",2017,8,1000,25000,26000
"St. Helena, Ascension und Tristan da Cunha",2017,9,0,4000,4000
"St. Helena, Ascension und Tristan da Cunha",2017,10,0,0,0
"St. Helena, Ascension und Tristan da Cunha",2017,11,0,0,0
"St. Helena, Ascension und Tristan da Cunha",2017,12,0,10000,10000
"St. Helena, Ascension und Tristan da Cunha",2018,1,0,0,0
"St. Helena, Ascension und Tristan da Cunha",2018,2,0,11000,11000
"St. Helena, Ascension und Tristan da Cunha",2018,3,0,10000,10000
"St. Helena, Ascension und Tristan da Cunha",2018,4,0,0,0
"St. Helena, Ascension und Tristan da Cunha",2018,5,0,0,0
"St. Helena, Ascension und Tristan da Cunha",2018,6,0,0,0
"St. Helena, Ascension und Tristan da Cunha",2018,7,0,3000,3000
"St. Helena, Ascension und Tristan da Cunha",2018,8,1000,0,1000
"St. Helena, Ascension und Tristan da Cunha",2018,9,25000,16000,41000
"St. Helena, Ascension und Tristan da Cunha",2018,10,40000,11000,51000
"St. Helena, Ascension und Tristan da Cunha",2018,11,21000,0,21000
"St. Helena, Ascension und Tristan da Cunha",2018,12,5000,0,5000
"St. Helena, Ascension und Tristan da Cunha",2019,1,10000,0,10000
"St. Helena, Ascension und Tristan da Cunha",2019,2,5000,0,5000
"St. Helena, Ascension und Tristan da Cunha",2019,3,7000,23000,30000
"St. Helena, Ascension und Tristan da Cunha",2019,4,1000,6000,7000
"St. Helena, Ascension und Tristan da Cunha",2019,5,2000,21000,23000
"St. Helena, Ascension und Tristan da Cunha",2019,6,1000,0,1000
"St. Helena, Ascension und Tristan da Cunha",2019,7,3000,0,3000
"St. Helena, Ascension und Tristan da Cunha",2019,8,7000,2000,9000
"St. Helena, Ascension und Tristan da Cunha",2019,9,2000,0,2000
"St. Helena, Ascension und Tristan da Cunha",2019,10,5000,0,5000
"St. Helena, Ascension und Tristan da Cunha",2019,11,18000,1000,19000
"St. Helena, Ascension und Tristan da Cunha",2019,12,12000,0,12000
"St. Helena, Ascension und Tristan da Cunha",2020,1,30000,5000,35000
"St. Helena, Ascension und Tristan da Cunha",2020,2,42000,0,42000
"St. Helena, Ascension und Tristan da Cunha",2020,3,21000,4000,25000
"St. Helena, Ascension und Tristan da Cunha",2020,4,27000,15000,42000
"St. Helena, Ascension und Tristan da Cunha",2020,5,9000,23000,32000
"St. Helena, Ascension und Tristan da Cunha",2020,6,18000,0,18000
"St. Helena, Ascension und Tristan da Cunha",2020,7,28000,0,28000
"St. Helena, Ascension und Tristan da Cunha",2020,8,13000,0,13000
"St. Helena, Ascension und Tristan da Cunha",2020,9,18000,0,18000
"St. Helena, Ascension und Tristan da Cunha",2020,10,11000,219000,230000
"St. Helena, Ascension und Tristan da Cunha",2020,11,7000,0,7000
"St. Helena, Ascension und Tristan da Cunha",2020,12,7000,1100000,1107000
"St. Helena, Ascension und Tristan da Cunha",2021,1,15000,19000,34000
"St. Helena, Ascension und Tristan da Cunha",2021,2,10000,0,10000
"St. Helena, Ascension und Tristan da Cunha",2021,3,12000,0,12000
"St. Helena, Ascension und Tristan da Cunha",2021,4,7000,0,7000
"St. Helena, Ascension und Tristan da Cunha",2021,5,15000,0,15000
"St. Helena, Ascension und Tristan da Cunha",2021,6,6000,0,6000
"St. Helena, Ascension und Tristan da Cunha",2021,7,21000,301000,322000
"St. Helena, Ascension und Tristan da Cunha",2021,8,26000,0,26000
"St. Helena, Ascension und Tristan da Cunha",2021,9,16000,0,16000
"St. Helena, Ascension und Tristan da Cunha",2021,10,4000,0,4000
"St. Helena, Ascension und Tristan da Cunha",2021,11,0,297000,297000
"St. Helena, Ascension und Tristan da Cunha",2021,12,0,298000,298000
"St. Helena, Ascension und Tristan da Cunha",2022,1,2000,18000,20000
"St. Helena, Ascension und Tristan da Cunha",2022,2,0,322000,322000
"St. Helena, Ascension und Tristan da Cunha",2022,3,8000,44000,52000
"St. Helena, Ascension und Tristan da Cunha",2022,4,0,0,0
"St. Helena, Ascension und Tristan da Cunha",2022,5,0,0,0
"St. Helena, Ascension und Tristan da Cunha",2022,6,0,0,0
"St. Helena, Ascension und Tristan da Cunha",2022,7,5000,0,5000
"St. Helena, Ascension und Tristan da Cunha",2022,8,26000,0,26000
"St. Helena, Ascension und Tristan da Cunha",2022,9,6000,0,6000
"St. Helena, Ascension und Tristan da Cunha",2022,10,0,0,0
"St. Helena, Ascension und Tristan da Cunha",2022,11,0,233000,233000
"St. Helena, Ascension und Tristan da Cunha",2022,12,0,0,0
"St. Helena, Ascension und Tristan da Cunha",2023,1,0,0,0
"St. Helena, Ascension und Tristan da Cunha",2023,2,0,590000,590000
"St. Helena, Ascension und Tristan da Cunha",2023,3,0,0,0
"St. Helena, Ascension und Tristan da Cunha",2023,4,266000,6000,272000
"St. Helena, Ascension und Tristan da Cunha",2023,5,0,0,0
"St. Helena, Ascension und Tristan da Cunha",2023,6,3000,0,3000
"St. Helena, Ascension und Tristan da Cunha",2023,7,1000,0,1000
"St. Helena, Ascension und Tristan da Cunha",2023,8,87000,0,87000
"St. Helena, Ascension und Tristan da Cunha",2023,9,134000,0,134000
"St. Helena, Ascension und Tristan da Cunha",2023,10,87000,0,87000
"St. Helena, Ascension und Tristan da Cunha",2023,11,96000,0,96000
"St. Helena, Ascension und Tristan da Cunha",2023,12,0,0,0
"St. Helena, Ascension und Tristan da Cunha",2024,1,0,0,0
"St. Helena, Ascension und Tristan da Cunha",2024,2,0,0,0
"St. Helena, Ascension und Tristan da Cunha",2024,3,0,0,0
"St. Helena, Ascension und Tristan da Cunha",2024,4,0,0,0
"St. Helena, Ascension und Tristan da Cunha",2024,5,0,0,0
"St. Helena, Ascension und Tristan da Cunha",2024,6,0,0,0
"St. Helena, Ascension und Tristan da Cunha",2024,7,0,0,0
"St. Helena, Ascension und Tristan da Cunha",2024,8,0,18000,18000
"St. Helena, Ascension und Tristan da Cunha",2024,9,0,0,0
"St. Helena, Ascension und Tristan da Cunha",2024,10,35000,0,35000
"St. Helena, Ascension und Tristan da Cunha",2024,11,1000,0,1000
"St. Helena, Ascension und Tristan da Cunha",2024,12,0,0,0
St. Kitts und Nevis,2008,1,138000,59000,197000
St. Kitts und Nevis,2008,2,239000,74000,313000
St. Kitts und Nevis,2008,3,324000,76000,400000
St. Kitts und Nevis,2008,4,191000,48000,239000
St. Kitts und Nevis,2008,5,92000,87000,179000
St. Kitts und Nevis,2008,6,324000,60000,384000
St. Kitts und Nevis,2008,7,265000,52000,317000
St. Kitts und Nevis,2008,8,107000,55000,162000
St. Kitts und Nevis,2008,9,136000,42000,178000
St. Kitts und Nevis,2008,10,209000,41000,250000
St. Kitts und Nevis,2008,11,54000,5000,59000
St. Kitts und Nevis,2008,12,159000,32000,191000
St. Kitts und Nevis,2009,1,12000,50000,62000
St. Kitts und Nevis,2009,2,204000,64000,268000
St. Kitts und Nevis,2009,3,106000,98000,204000
St. Kitts und Nevis,2009,4,116000,59000,175000
St. Kitts und Nevis,2009,5,125000,70000,195000
St. Kitts und Nevis,2009,6,136000,61000,197000
St. Kitts und Nevis,2009,7,202000,55000,257000
St. Kitts und Nevis,2009,8,14000,54000,68000
St. Kitts und Nevis,2009,9,17000,84000,101000
St. Kitts und Nevis,2009,10,29000,70000,99000
St. Kitts und Nevis,2009,11,110000,126000,236000
St. Kitts und Nevis,2009,12,18000,66000,84000
St. Kitts und Nevis,2010,1,0,68000,68000
St. Kitts und Nevis,2010,2,12000,136000,148000
St. Kitts und Nevis,2010,3,1173000,160000,1333000
St. Kitts und Nevis,2010,4,3076000,105000,3181000
St. Kitts und Nevis,2010,5,6000,199000,205000
St. Kitts und Nevis,2010,6,41000,165000,206000
St. Kitts und Nevis,2010,7,6000,218000,224000
St. Kitts und Nevis,2010,8,32000,186000,218000
St. Kitts und Nevis,2010,9,102000,179000,281000
St. Kitts und Nevis,2010,10,124000,231000,355000
St. Kitts und Nevis,2010,11,2000,190000,192000
St. Kitts und Nevis,2010,12,106000,143000,249000
St. Kitts und Nevis,2011,1,4000,197000,201000
St. Kitts und Nevis,2011,2,79000,215000,294000
St. Kitts und Nevis,2011,3,174000,269000,443000
St. Kitts und Nevis,2011,4,134000,234000,368000
St. Kitts und Nevis,2011,5,201000,233000,434000
St. Kitts und Nevis,2011,6,203000,196000,399000
St. Kitts und Nevis,2011,7,125000,239000,364000
St. Kitts und Nevis,2011,8,108000,288000,396000
St. Kitts und Nevis,2011,9,158000,231000,389000
St. Kitts und Nevis,2011,10,110000,274000,384000
St. Kitts und Nevis,2011,11,3422000,285000,3707000
St. Kitts und Nevis,2011,12,71000,151000,222000
St. Kitts und Nevis,2012,1,2197000,206000,2403000
St. Kitts und Nevis,2012,2,159000,242000,401000
St. Kitts und Nevis,2012,3,139000,225000,364000
St. Kitts und Nevis,2012,4,3232000,220000,3452000
St. Kitts und Nevis,2012,5,137000,141000,278000
St. Kitts und Nevis,2012,6,124000,158000,282000
St. Kitts und Nevis,2012,7,115000,273000,388000
St. Kitts und Nevis,2012,8,135000,155000,290000
St. Kitts und Nevis,2012,9,2117000,258000,2375000
St. Kitts und Nevis,2012,10,2243000,142000,2385000
St. Kitts und Nevis,2012,11,54000,152000,206000
St. Kitts und Nevis,2012,12,8192000,160000,8352000
St. Kitts und Nevis,2013,1,71000,129000,200000
St. Kitts und Nevis,2013,2,114000,185000,299000
St. Kitts und Nevis,2013,3,4550000,207000,4757000
St. Kitts und Nevis,2013,4,22289000,286000,22575000
St. Kitts und Nevis,2013,5,9823000,288000,10111000
St. Kitts und Nevis,2013,6,12004000,320000,12324000
St. Kitts und Nevis,2013,7,529000,253000,782000
St. Kitts und Nevis,2013,8,19959000,259000,20218000
St. Kitts und Nevis,2013,9,117000,328000,445000
St. Kitts und Nevis,2013,10,294000,298000,592000
St. Kitts und Nevis,2013,11,331000,356000,687000
St. Kitts und Nevis,2013,12,215000,270000,485000
St. Kitts und Nevis,2014,1,4637000,186000,4823000
St. Kitts und Nevis,2014,2,3060000,296000,3356000
St. Kitts und Nevis,2014,3,19962000,279000,20241000
St. Kitts und Nevis,2014,4,3172000,253000,3425000
St. Kitts und Nevis,2014,5,286000,232000,518000
St. Kitts und Nevis,2014,6,1488000,308000,1796000
St. Kitts und Nevis,2014,7,4363000,349000,4712000
St. Kitts und Nevis,2014,8,12422000,282000,12704000
St. Kitts und Nevis,2014,9,1410000,233000,1643000
St. Kitts und Nevis,2014,10,106000,218000,324000
St. Kitts und Nevis,2014,11,3714000,343000,4057000
St. Kitts und Nevis,2014,12,75000,182000,257000
St. Kitts und Nevis,2015,1,229000,181000,410000
St. Kitts und Nevis,2015,2,118000,358000,476000
St. Kitts und Nevis,2015,3,210000,433000,643000
St. Kitts und Nevis,2015,4,175000,355000,530000
St. Kitts und Nevis,2015,5,80000,412000,492000
St. Kitts und Nevis,2015,6,138000,311000,449000
St. Kitts und Nevis,2015,7,3878000,278000,4156000
St. Kitts und Nevis,2015,8,356000,349000,705000
St. Kitts und Nevis,2015,9,226000,328000,554000
St. Kitts und Nevis,2015,10,204000,300000,504000
St. Kitts und Nevis,2015,11,147000,390000,537000
St. Kitts und Nevis,2015,12,72000,172000,244000
St. Kitts und Nevis,2016,1,213000,222000,435000
St. Kitts und Nevis,2016,2,236000,423000,659000
St. Kitts und Nevis,2016,3,3326000,386000,3712000
St. Kitts und Nevis,2016,4,293000,275000,568000
St. Kitts und Nevis,2016,5,5694000,264000,5958000
St. Kitts und Nevis,2016,6,16575000,230000,16805000
St. Kitts und Nevis,2016,7,90000,392000,482000
St. Kitts und Nevis,2016,8,2871000,297000,3168000
St. Kitts und Nevis,2016,9,3161000,247000,3408000
St. Kitts und Nevis,2016,10,2664000,438000,3102000
St. Kitts und Nevis,2016,11,3270000,359000,3629000
St. Kitts und Nevis,2016,12,351000,303000,654000
St. Kitts und Nevis,2017,1,12594000,363000,12957000
St. Kitts und Nevis,2017,2,229000,424000,653000
St. Kitts und Nevis,2017,3,8845000,580000,9425000
St. Kitts und Nevis,2017,4,4017000,346000,4363000
St. Kitts und Nevis,2017,5,192000,528000,720000
St. Kitts und Nevis,2017,6,642000,297000,939000
St. Kitts und Nevis,2017,7,3007000,240000,3247000
St. Kitts und Nevis,2017,8,252000,454000,706000
St. Kitts und Nevis,2017,9,3500000,332000,3832000
St. Kitts und Nevis,2017,10,202000,548000,750000
St. Kitts und Nevis,2017,11,302000,487000,789000
St. Kitts und Nevis,2017,12,146000,377000,523000
St. Kitts und Nevis,2018,1,339000,358000,697000
St. Kitts und Nevis,2018,2,314000,440000,754000
St. Kitts und Nevis,2018,3,311000,452000,763000
St. Kitts und Nevis,2018,4,287000,442000,729000
St. Kitts und Nevis,2018,5,275000,529000,804000
St. Kitts und Nevis,2018,6,244000,462000,706000
St. Kitts und Nevis,2018,7,293000,605000,898000
St. Kitts und Nevis,2018,8,3944000,505000,4449000
St. Kitts und Nevis,2018,9,220000,491000,711000
St. Kitts und Nevis,2018,10,400000,589000,989000
St. Kitts und Nevis,2018,11,174000,492000,666000
St. Kitts und Nevis,2018,12,153000,285000,438000
St. Kitts und Nevis,2019,1,2015000,358000,2373000
St. Kitts und Nevis,2019,2,305000,469000,774000
St. Kitts und Nevis,2019,3,222000,434000,656000
St. Kitts und Nevis,2019,4,197000,407000,604000
St. Kitts und Nevis,2019,5,594000,290000,884000
St. Kitts und Nevis,2019,6,8147000,402000,8549000
St. Kitts und Nevis,2019,7,90000,293000,383000
St. Kitts und Nevis,2019,8,267000,206000,473000
St. Kitts und Nevis,2019,9,502000,339000,841000
St. Kitts und Nevis,2019,10,303000,320000,623000
St. Kitts und Nevis,2019,11,144000,414000,558000
St. Kitts und Nevis,2019,12,294000,245000,539000
St. Kitts und Nevis,2020,1,494000,368000,862000
St. Kitts und Nevis,2020,2,268000,356000,624000
St. Kitts und Nevis,2020,3,186000,380000,566000
St. Kitts und Nevis,2020,4,122000,91000,213000
St. Kitts und Nevis,2020,5,89000,100000,189000
St. Kitts und Nevis,2020,6,138000,261000,399000
St. Kitts und Nevis,2020,7,127000,349000,476000
St. Kitts und Nevis,2020,8,149000,312000,461000
St. Kitts und Nevis,2020,9,3504000,381000,3885000
St. Kitts und Nevis,2020,10,96000,393000,489000
St. Kitts und Nevis,2020,11,76000,241000,317000
St. Kitts und Nevis,2020,12,63000,211000,274000
St. Kitts und Nevis,2021,1,69000,60000,129000
St. Kitts und Nevis,2021,2,29000,146000,175000
St. Kitts und Nevis,2021,3,117000,121000,238000
St. Kitts und Nevis,2021,4,76000,142000,218000
St. Kitts und Nevis,2021,5,32000,101000,133000
St. Kitts und Nevis,2021,6,95000,121000,216000
St. Kitts und Nevis,2021,7,72000,50000,122000
St. Kitts und Nevis,2021,8,41000,218000,259000
St. Kitts und Nevis,2021,9,313000,177000,490000
St. Kitts und Nevis,2021,10,26000,148000,174000
St. Kitts und Nevis,2021,11,7129000,107000,7236000
St. Kitts und Nevis,2021,12,26000,163000,189000
St. Kitts und Nevis,2022,1,201000,60000,261000
St. Kitts und Nevis,2022,2,82000,168000,250000
St. Kitts und Nevis,2022,3,101000,151000,252000
St. Kitts und Nevis,2022,4,160000,72000,232000
St. Kitts und Nevis,2022,5,222000,59000,281000
St. Kitts und Nevis,2022,6,18000,198000,216000
St. Kitts und Nevis,2022,7,292000,95000,387000
St. Kitts und Nevis,2022,8,65000,125000,190000
St. Kitts und Nevis,2022,9,14000,196000,210000
St. Kitts und Nevis,2022,10,133000,131000,264000
St. Kitts und Nevis,2022,11,78000,187000,265000
St. Kitts und Nevis,2022,12,72000,91000,163000
St. Kitts und Nevis,2023,1,57000,165000,222000
St. Kitts und Nevis,2023,2,132000,136000,268000
St. Kitts und Nevis,2023,3,184000,118000,302000
St. Kitts und Nevis,2023,4,6000,66000,72000
St. Kitts und Nevis,2023,5,29000,135000,164000
St. Kitts und Nevis,2023,6,114000,95000,209000
St. Kitts und Nevis,2023,7,67000,46000,113000
St. Kitts und Nevis,2023,8,100000,72000,172000
St. Kitts und Nevis,2023,9,136000,41000,177000
St. Kitts und Nevis,2023,10,188000,55000,243000
St. Kitts und Nevis,2023,11,66000,68000,134000
St. Kitts und Nevis,2023,12,88000,12000,100000
St. Kitts und Nevis,2024,1,358000,109000,467000
St. Kitts und Nevis,2024,2,103000,44000,147000
St. Kitts und Nevis,2024,3,34000,73000,107000
St. Kitts und Nevis,2024,4,173000,36000,209000
St. Kitts und Nevis,2024,5,34000,29000,63000
St. Kitts und Nevis,2024,6,52000,91000,143000
St. Kitts und Nevis,2024,7,111000,66000,177000
St. Kitts und Nevis,2024,8,103000,97000,200000
St. Kitts und Nevis,2024,9,48000,113000,161000
St. Kitts und Nevis,2024,10,191000,72000,263000
St. Kitts und Nevis,2024,11,437000,221000,658000
St. Kitts und Nevis,2024,12,133000,133000,266000
St. Lucia,2008,1,213000,2000,215000
St. Lucia,2008,2,176000,6000,182000
St. Lucia,2008,3,91000,17000,108000
St. Lucia,2008,4,341000,9000,350000
St. Lucia,2008,5,25000,50000,75000
St. Lucia,2008,6,357000,7000,364000
St. Lucia,2008,7,582000,7000,589000
St. Lucia,2008,8,211000,11000,222000
St. Lucia,2008,9,405000,3000,408000
St. Lucia,2008,10,433000,9000,442000
St. Lucia,2008,11,155000,12000,167000
St. Lucia,2008,12,277000,3000,280000
St. Lucia,2009,1,157000,11000,168000
St. Lucia,2009,2,273000,6000,279000
St. Lucia,2009,3,194000,12000,206000
St. Lucia,2009,4,228000,1000,229000
St. Lucia,2009,5,579000,1000,580000
St. Lucia,2009,6,162000,10000,172000
St. Lucia,2009,7,266000,6000,272000
St. Lucia,2009,8,66000,9000,75000
St. Lucia,2009,9,174000,17000,191000
St. Lucia,2009,10,198000,4000,202000
St. Lucia,2009,11,370000,10000,380000
St. Lucia,2009,12,374000,8000,382000
St. Lucia,2010,1,152000,3000,155000
St. Lucia,2010,2,451000,17000,468000
St. Lucia,2010,3,187000,11000,198000
St. Lucia,2010,4,367000,4000,371000
St. Lucia,2010,5,235000,7000,242000
St. Lucia,2010,6,132000,31000,163000
St. Lucia,2010,7,343000,7000,350000
St. Lucia,2010,8,101000,7000,108000
St. Lucia,2010,9,132000,9000,141000
St. Lucia,2010,10,244000,0,244000
St. Lucia,2010,11,207000,4000,211000
St. Lucia,2010,12,94000,9000,103000
St. Lucia,2011,1,89000,5000,94000
St. Lucia,2011,2,178000,17000,195000
St. Lucia,2011,3,238000,4000,242000
St. Lucia,2011,4,180000,10000,190000
St. Lucia,2011,5,309000,7000,316000
St. Lucia,2011,6,327000,20000,347000
St. Lucia,2011,7,123000,8000,131000
St. Lucia,2011,8,266000,1000,267000
St. Lucia,2011,9,127000,12000,139000
St. Lucia,2011,10,232000,5000,237000
St. Lucia,2011,11,117000,10000,127000
St. Lucia,2011,12,126000,5000,131000
St. Lucia,2012,1,114000,1000,115000
St. Lucia,2012,2,145000,9000,154000
St. Lucia,2012,3,302000,14000,316000
St. Lucia,2012,4,228000,0,228000
St. Lucia,2012,5,281000,3000,284000
St. Lucia,2012,6,302000,6000,308000
St. Lucia,2012,7,1539000,14000,1553000
St. Lucia,2012,8,235000,19000,254000
St. Lucia,2012,9,170000,10000,180000
St. Lucia,2012,10,439000,7000,446000
St. Lucia,2012,11,496000,2000,498000
St. Lucia,2012,12,273000,7000,280000
St. Lucia,2013,1,348000,8000,356000
St. Lucia,2013,2,246000,8000,254000
St. Lucia,2013,3,194000,3000,197000
St. Lucia,2013,4,176000,136000,312000
St. Lucia,2013,5,403000,1000,404000
St. Lucia,2013,6,293000,16000,309000
St. Lucia,2013,7,147000,4000,151000
St. Lucia,2013,8,143000,4000,147000
St. Lucia,2013,9,226000,18000,244000
St. Lucia,2013,10,364000,8000,372000
St. Lucia,2013,11,138000,0,138000
St. Lucia,2013,12,304000,5000,309000
St. Lucia,2014,1,168000,6000,174000
St. Lucia,2014,2,294000,6000,300000
St. Lucia,2014,3,751000,3000,754000
St. Lucia,2014,4,225000,4000,229000
St. Lucia,2014,5,277000,5000,282000
St. Lucia,2014,6,875000,2000,877000
St. Lucia,2014,7,2052000,1000,2053000
St. Lucia,2014,8,232000,46000,278000
St. Lucia,2014,9,327000,9000,336000
St. Lucia,2014,10,381000,6000,387000
St. Lucia,2014,11,170000,0,170000
St. Lucia,2014,12,148000,40000,188000
St. Lucia,2015,1,396000,19000,415000
St. Lucia,2015,2,256000,3000,259000
St. Lucia,2015,3,224000,2000,226000
St. Lucia,2015,4,527000,13000,540000
St. Lucia,2015,5,209000,5000,214000
St. Lucia,2015,6,223000,6000,229000
St. Lucia,2015,7,252000,31000,283000
St. Lucia,2015,8,109000,3000,112000
St. Lucia,2015,9,258000,96000,354000
St. Lucia,2015,10,128000,21000,149000
St. Lucia,2015,11,301000,15000,316000
St. Lucia,2015,12,165000,7000,172000
St. Lucia,2016,1,444000,6000,450000
St. Lucia,2016,2,343000,3000,346000
St. Lucia,2016,3,183000,0,183000
St. Lucia,2016,4,454000,12000,466000
St. Lucia,2016,5,184000,6000,190000
St. Lucia,2016,6,598000,67000,665000
St. Lucia,2016,7,270000,5000,275000
St. Lucia,2016,8,511000,5000,516000
St. Lucia,2016,9,229000,0,229000
St. Lucia,2016,10,516000,4000,520000
St. Lucia,2016,11,381000,57000,438000
St. Lucia,2016,12,198000,24000,222000
St. Lucia,2017,1,164000,0,164000
St. Lucia,2017,2,407000,2000,409000
St. Lucia,2017,3,346000,4000,350000
St. Lucia,2017,4,389000,7000,396000
St. Lucia,2017,5,352000,7000,359000
St. Lucia,2017,6,283000,6000,289000
St. Lucia,2017,7,380000,4000,384000
St. Lucia,2017,8,437000,1000,438000
St. Lucia,2017,9,977000,0,977000
St. Lucia,2017,10,513000,13000,526000
St. Lucia,2017,11,353000,4000,357000
St. Lucia,2017,12,387000,6000,393000
St. Lucia,2018,1,231000,1000,232000
St. Lucia,2018,2,191000,20000,211000
St. Lucia,2018,3,251000,0,251000
St. Lucia,2018,4,223000,2000,225000
St. Lucia,2018,5,186000,15000,201000
St. Lucia,2018,6,193000,4000,197000
St. Lucia,2018,7,1190000,13000,1203000
St. Lucia,2018,8,159000,0,159000
St. Lucia,2018,9,297000,3000,300000
St. Lucia,2018,10,156000,0,156000
St. Lucia,2018,11,224000,5000,229000
St. Lucia,2018,12,210000,6000,216000
St. Lucia,2019,1,168000,8000,176000
St. Lucia,2019,2,176000,0,176000
St. Lucia,2019,3,324000,5000,329000
St. Lucia,2019,4,256000,4000,260000
St. Lucia,2019,5,340000,1000,341000
St. Lucia,2019,6,135000,10000,145000
St. Lucia,2019,7,221000,2000,223000
St. Lucia,2019,8,370000,0,370000
St. Lucia,2019,9,196000,5000,201000
St. Lucia,2019,10,521000,1000,522000
St. Lucia,2019,11,195000,26000,221000
St. Lucia,2019,12,96000,0,96000
St. Lucia,2020,1,420000,6000,426000
St. Lucia,2020,2,107000,5000,112000
St. Lucia,2020,3,149000,0,149000
St. Lucia,2020,4,142000,8000,150000
St. Lucia,2020,5,197000,0,197000
St. Lucia,2020,6,203000,12000,215000
St. Lucia,2020,7,281000,4000,285000
St. Lucia,2020,8,300000,7000,307000
St. Lucia,2020,9,303000,0,303000
St. Lucia,2020,10,528000,1000,529000
St. Lucia,2020,11,197000,10000,207000
St. Lucia,2020,12,250000,8000,258000
St. Lucia,2021,1,201000,0,201000
St. Lucia,2021,2,321000,0,321000
St. Lucia,2021,3,251000,7000,258000
St. Lucia,2021,4,283000,11000,294000
St. Lucia,2021,5,230000,6000,236000
St. Lucia,2021,6,197000,3000,200000
St. Lucia,2021,7,302000,28000,330000
St. Lucia,2021,8,473000,6000,479000
St. Lucia,2021,9,247000,8000,255000
St. Lucia,2021,10,191000,8000,199000
St. Lucia,2021,11,766000,4000,770000
St. Lucia,2021,12,146000,4000,150000
St. Lucia,2022,1,235000,2000,237000
St. Lucia,2022,2,225000,4000,229000
St. Lucia,2022,3,424000,3000,427000
St. Lucia,2022,4,211000,11000,222000
St. Lucia,2022,5,289000,10000,299000
St. Lucia,2022,6,120000,6000,126000
St. Lucia,2022,7,462000,1000,463000
St. Lucia,2022,8,284000,9000,293000
St. Lucia,2022,9,660000,0,660000
St. Lucia,2022,10,370000,1000,371000
St. Lucia,2022,11,323000,15000,338000
St. Lucia,2022,12,211000,2000,213000
St. Lucia,2023,1,248000,0,248000
St. Lucia,2023,2,187000,7000,194000
St. Lucia,2023,3,413000,29000,442000
St. Lucia,2023,4,164000,2000,166000
St. Lucia,2023,5,290000,6000,296000
St. Lucia,2023,6,352000,2000,354000
St. Lucia,2023,7,790000,9000,799000
St. Lucia,2023,8,349000,20000,369000
St. Lucia,2023,9,4136000,1000,4137000
St. Lucia,2023,10,347000,2000,349000
St. Lucia,2023,11,648000,1000,649000
St. Lucia,2023,12,865000,1035000,1900000
St. Lucia,2024,1,407000,0,407000
St. Lucia,2024,2,386000,1000,387000
St. Lucia,2024,3,377000,6000,383000
St. Lucia,2024,4,538000,6000,544000
St. Lucia,2024,5,302000,0,302000
St. Lucia,2024,6,474000,63000,537000
St. Lucia,2024,7,540000,21000,561000
St. Lucia,2024,8,660000,3000,663000
St. Lucia,2024,9,626000,0,626000
St. Lucia,2024,10,411000,0,411000
St. Lucia,2024,11,247000,5000,252000
St. Lucia,2024,12,525000,0,525000
St. Pierre und Miquelon,2008,1,5000,0,5000
St. Pierre und Miquelon,2008,2,0,0,0
St. Pierre und Miquelon,2008,3,23000,0,23000
St. Pierre und Miquelon,2008,4,11000,0,11000
St. Pierre und Miquelon,2008,5,0,0,0
St. Pierre und Miquelon,2008,6,16000,2000,18000
St. Pierre und Miquelon,2008,7,1000,0,1000
St. Pierre und Miquelon,2008,8,0,19000,19000
St. Pierre und Miquelon,2008,9,0,0,0
St. Pierre und Miquelon,2008,10,24000,38000,62000
St. Pierre und Miquelon,2008,11,21000,19000,40000
St. Pierre und Miquelon,2008,12,22000,0,22000
St. Pierre und Miquelon,2009,1,70000,0,70000
St. Pierre und Miquelon,2009,2,66000,0,66000
St. Pierre und Miquelon,2009,3,3000,0,3000
St. Pierre und Miquelon,2009,4,18000,0,18000
St. Pierre und Miquelon,2009,5,22000,0,22000
St. Pierre und Miquelon,2009,6,170000,0,170000
St. Pierre und Miquelon,2009,7,29000,0,29000
St. Pierre und Miquelon,2009,8,0,0,0
St. Pierre und Miquelon,2009,9,1000,0,1000
St. Pierre und Miquelon,2009,10,3000,0,3000
St. Pierre und Miquelon,2009,11,6000,0,6000
St. Pierre und Miquelon,2009,12,0,0,0
St. Pierre und Miquelon,2010,1,2000,0,2000
St. Pierre und Miquelon,2010,2,8000,0,8000
St. Pierre und Miquelon,2010,3,80000,0,80000
St. Pierre und Miquelon,2010,4,0,0,0
St. Pierre und Miquelon,2010,5,1000,0,1000
St. Pierre und Miquelon,2010,6,1000,0,1000
St. Pierre und Miquelon,2010,7,0,0,0
St. Pierre und Miquelon,2010,8,4000,0,4000
St. Pierre und Miquelon,2010,9,0,0,0
St. Pierre und Miquelon,2010,10,6000,0,6000
St. Pierre und Miquelon,2010,11,10000,0,10000
St. Pierre und Miquelon,2010,12,7000,0,7000
St. Pierre und Miquelon,2011,1,2000,0,2000
St. Pierre und Miquelon,2011,2,5000,0,5000
St. Pierre und Miquelon,2011,3,0,0,0
St. Pierre und Miquelon,2011,4,0,0,0
St. Pierre und Miquelon,2011,5,49000,0,49000
St. Pierre und Miquelon,2011,6,3000,0,3000
St. Pierre und Miquelon,2011,7,0,0,0
St. Pierre und Miquelon,2011,8,0,0,0
St. Pierre und Miquelon,2011,9,2000,0,2000
St. Pierre und Miquelon,2011,10,14000,0,14000
St. Pierre und Miquelon,2011,11,1000,0,1000
St. Pierre und Miquelon,2011,12,0,0,0
St. Pierre und Miquelon,2012,1,3000,0,3000
St. Pierre und Miquelon,2012,2,2000,0,2000
St. Pierre und Miquelon,2012,3,0,0,0
St. Pierre und Miquelon,2012,4,0,0,0
St. Pierre und Miquelon,2012,5,0,0,0
St. Pierre und Miquelon,2012,6,1000,0,1000
St. Pierre und Miquelon,2012,7,13000,0,13000
St. Pierre und Miquelon,2012,8,0,0,0
St. Pierre und Miquelon,2012,9,328000,0,328000
St. Pierre und Miquelon,2012,10,7000,0,7000
St. Pierre und Miquelon,2012,11,2000,0,2000
St. Pierre und Miquelon,2012,12,40000,0,40000
St. Pierre und Miquelon,2013,1,2000,0,2000
St. Pierre und Miquelon,2013,2,10000,0,10000
St. Pierre und Miquelon,2013,3,1000,0,1000
St. Pierre und Miquelon,2013,4,9000,0,9000
St. Pierre und Miquelon,2013,5,7000,0,7000
St. Pierre und Miquelon,2013,6,4000,0,4000
St. Pierre und Miquelon,2013,7,3000,0,3000
St. Pierre und Miquelon,2013,8,30000,0,30000
St. Pierre und Miquelon,2013,9,0,0,0
St. Pierre und Miquelon,2013,10,5000,0,5000
St. Pierre und Miquelon,2013,11,411000,0,411000
St. Pierre und Miquelon,2013,12,0,0,0
St. Pierre und Miquelon,2014,1,2000,0,2000
St. Pierre und Miquelon,2014,2,9000,0,9000
St. Pierre und Miquelon,2014,3,26000,0,26000
St. Pierre und Miquelon,2014,4,0,0,0
St. Pierre und Miquelon,2014,5,5000,0,5000
St. Pierre und Miquelon,2014,6,296000,0,296000
St. Pierre und Miquelon,2014,7,2000,0,2000
St. Pierre und Miquelon,2014,8,23000,0,23000
St. Pierre und Miquelon,2014,9,49000,0,49000
St. Pierre und Miquelon,2014,10,45000,0,45000
St. Pierre und Miquelon,2014,11,14000,0,14000
St. Pierre und Miquelon,2014,12,5000,0,5000
St. Pierre und Miquelon,2015,1,0,0,0
St. Pierre und Miquelon,2015,2,25000,0,25000
St. Pierre und Miquelon,2015,3,9000,0,9000
St. Pierre und Miquelon,2015,4,26000,0,26000
St. Pierre und Miquelon,2015,5,54000,0,54000
St. Pierre und Miquelon,2015,6,3000,0,3000
St. Pierre und Miquelon,2015,7,1000,0,1000
St. Pierre und Miquelon,2015,8,35000,0,35000
St. Pierre und Miquelon,2015,9,7000,0,7000
St. Pierre und Miquelon,2015,10,86000,0,86000
St. Pierre und Miquelon,2015,11,19000,0,19000
St. Pierre und Miquelon,2015,12,2000,8000,10000
St. Pierre und Miquelon,2016,1,8000,0,8000
St. Pierre und Miquelon,2016,2,22000,0,22000
St. Pierre und Miquelon,2016,3,19000,0,19000
St. Pierre und Miquelon,2016,4,89000,0,89000
St. Pierre und Miquelon,2016,5,28000,0,28000
St. Pierre und Miquelon,2016,6,9000,0,9000
St. Pierre und Miquelon,2016,7,7000,0,7000
St. Pierre und Miquelon,2016,8,26000,0,26000
St. Pierre und Miquelon,2016,9,7000,0,7000
St. Pierre und Miquelon,2016,10,43000,0,43000
St. Pierre und Miquelon,2016,11,86000,0,86000
St. Pierre und Miquelon,2016,12,7000,0,7000
St. Pierre und Miquelon,2017,1,5000,0,5000
St. Pierre und Miquelon,2017,2,2000,0,2000
St. Pierre und Miquelon,2017,3,3000,0,3000
St. Pierre und Miquelon,2017,4,33000,0,33000
St. Pierre und Miquelon,2017,5,86000,0,86000
St. Pierre und Miquelon,2017,6,4000,0,4000
St. Pierre und Miquelon,2017,7,5000,0,5000
St. Pierre und Miquelon,2017,8,4000,0,4000
St. Pierre und Miquelon,2017,9,1000,0,1000
St. Pierre und Miquelon,2017,10,4000,0,4000
St. Pierre und Miquelon,2017,11,88000,0,88000
St. Pierre und Miquelon,2017,12,0,0,0
St. Pierre und Miquelon,2018,1,86000,0,86000
St. Pierre und Miquelon,2018,2,1000,0,1000
St. Pierre und Miquelon,2018,3,13000,0,13000
St. Pierre und Miquelon,2018,4,3000,0,3000
St. Pierre und Miquelon,2018,5,83000,0,83000
St. Pierre und Miquelon,2018,6,15000,0,15000
St. Pierre und Miquelon,2018,7,23000,0,23000
St. Pierre und Miquelon,2018,8,196000,0,196000
St. Pierre und Miquelon,2018,9,6000,0,6000
St. Pierre und Miquelon,2018,10,20000,0,20000
St. Pierre und Miquelon,2018,11,190000,0,190000
St. Pierre und Miquelon,2018,12,16000,0,16000
St. Pierre und Miquelon,2019,1,5000,0,5000
St. Pierre und Miquelon,2019,2,15000,0,15000
St. Pierre und Miquelon,2019,3,24000,0,24000
St. Pierre und Miquelon,2019,4,180000,0,180000
St. Pierre und Miquelon,2019,5,1000,0,1000
St. Pierre und Miquelon,2019,6,21000,0,21000
St. Pierre und Miquelon,2019,7,16000,0,16000
St. Pierre und Miquelon,2019,8,60000,0,60000
St. Pierre und Miquelon,2019,9,6000,0,6000
St. Pierre und Miquelon,2019,10,11000,0,11000
St. Pierre und Miquelon,2019,11,5000,0,5000
St. Pierre und Miquelon,2019,12,5000,0,5000
St. Pierre und Miquelon,2020,1,15000,0,15000
St. Pierre und Miquelon,2020,2,17000,0,17000
St. Pierre und Miquelon,2020,3,38000,0,38000
St. Pierre und Miquelon,2020,4,4000,0,4000
St. Pierre und Miquelon,2020,5,23000,0,23000
St. Pierre und Miquelon,2020,6,10000,0,10000
St. Pierre und Miquelon,2020,7,5000,0,5000
St. Pierre und Miquelon,2020,8,53000,0,53000
St. Pierre und Miquelon,2020,9,27000,0,27000
St. Pierre und Miquelon,2020,10,4000,0,4000
St. Pierre und Miquelon,2020,11,7000,0,7000
St. Pierre und Miquelon,2020,12,50000,0,50000
St. Pierre und Miquelon,2021,1,17000,0,17000
St. Pierre und Miquelon,2021,2,13000,0,13000
St. Pierre und Miquelon,2021,3,20000,0,20000
St. Pierre und Miquelon,2021,4,29000,0,29000
St. Pierre und Miquelon,2021,5,22000,0,22000
St. Pierre und Miquelon,2021,6,18000,0,18000
St. Pierre und Miquelon,2021,7,0,0,0
St. Pierre und Miquelon,2021,8,27000,0,27000
St. Pierre und Miquelon,2021,9,13000,0,13000
St. Pierre und Miquelon,2021,10,31000,0,31000
St. Pierre und Miquelon,2021,11,6000,0,6000
St. Pierre und Miquelon,2021,12,0,0,0
St. Pierre und Miquelon,2022,1,129000,0,129000
St. Pierre und Miquelon,2022,2,11000,0,11000
St. Pierre und Miquelon,2022,3,39000,0,39000
St. Pierre und Miquelon,2022,4,24000,0,24000
St. Pierre und Miquelon,2022,5,18000,0,18000
St. Pierre und Miquelon,2022,6,13000,0,13000
St. Pierre und Miquelon,2022,7,8000,0,8000
St. Pierre und Miquelon,2022,8,41000,0,41000
St. Pierre und Miquelon,2022,9,4000,0,4000
St. Pierre und Miquelon,2022,10,16000,0,16000
St. Pierre und Miquelon,2022,11,645000,0,645000
St. Pierre und Miquelon,2022,12,7000,0,7000
St. Pierre und Miquelon,2023,1,7000,0,7000
St. Pierre und Miquelon,2023,2,18000,0,18000
St. Pierre und Miquelon,2023,3,15000,0,15000
St. Pierre und Miquelon,2023,4,14000,0,14000
St. Pierre und Miquelon,2023,5,22000,0,22000
St. Pierre und Miquelon,2023,6,21000,0,21000
St. Pierre und Miquelon,2023,7,15000,0,15000
St. Pierre und Miquelon,2023,8,29000,0,29000
St. Pierre und Miquelon,2023,9,3000,0,3000
St. Pierre und Miquelon,2023,10,12000,0,12000
St. Pierre und Miquelon,2023,11,12000,0,12000
St. Pierre und Miquelon,2023,12,31000,0,31000
St. Pierre und Miquelon,2024,1,2000,0,2000
St. Pierre und Miquelon,2024,2,13000,0,13000
St. Pierre und Miquelon,2024,3,11000,0,11000
St. Pierre und Miquelon,2024,4,3000,0,3000
St. Pierre und Miquelon,2024,5,6000,0,6000
St. Pierre und Miquelon,2024,6,4000,0,4000
St. Pierre und Miquelon,2024,7,30000,0,30000
St. Pierre und Miquelon,2024,8,5000,3000,8000
St. Pierre und Miquelon,2024,9,96000,5000,101000
St. Pierre und Miquelon,2024,10,5000,0,5000
St. Pierre und Miquelon,2024,11,4000,0,4000
St. Pierre und Miquelon,2024,12,0,0,0
St. Vincent und die Grenadinen,2008,1,234000,0,234000
St. Vincent und die Grenadinen,2008,2,156000,1000,157000
St. Vincent und die Grenadinen,2008,3,512000,0,512000
St. Vincent und die Grenadinen,2008,4,83000,0,83000
St. Vincent und die Grenadinen,2008,5,1263000,0,1263000
St. Vincent und die Grenadinen,2008,6,237000,0,237000
St. Vincent und die Grenadinen,2008,7,138000,0,138000
St. Vincent und die Grenadinen,2008,8,186000,0,186000
St. Vincent und die Grenadinen,2008,9,241000,0,241000
St. Vincent und die Grenadinen,2008,10,147000,0,147000
St. Vincent und die Grenadinen,2008,11,166000,0,166000
St. Vincent und die Grenadinen,2008,12,642000,9000,651000
St. Vincent und die Grenadinen,2009,1,50000,0,50000
St. Vincent und die Grenadinen,2009,2,105000,24000,129000
St. Vincent und die Grenadinen,2009,3,203000,80000,283000
St. Vincent und die Grenadinen,2009,4,266000,0,266000
St. Vincent und die Grenadinen,2009,5,133000,0,133000
St. Vincent und die Grenadinen,2009,6,82000,0,82000
St. Vincent und die Grenadinen,2009,7,213000,0,213000
St. Vincent und die Grenadinen,2009,8,137000,0,137000
St. Vincent und die Grenadinen,2009,9,178000,3000,181000
St. Vincent und die Grenadinen,2009,10,133000,0,133000
St. Vincent und die Grenadinen,2009,11,195000,0,195000
St. Vincent und die Grenadinen,2009,12,2674000,0,2674000
St. Vincent und die Grenadinen,2010,1,42000,0,42000
St. Vincent und die Grenadinen,2010,2,70000,0,70000
St. Vincent und die Grenadinen,2010,3,120000,0,120000
St. Vincent und die Grenadinen,2010,4,64000,0,64000
St. Vincent und die Grenadinen,2010,5,35000,0,35000
St. Vincent und die Grenadinen,2010,6,105000,0,105000
St. Vincent und die Grenadinen,2010,7,205000,0,205000
St. Vincent und die Grenadinen,2010,8,257000,12000,269000
St. Vincent und die Grenadinen,2010,9,126000,0,126000
St. Vincent und die Grenadinen,2010,10,1570000,0,1570000
St. Vincent und die Grenadinen,2010,11,152000,0,152000
St. Vincent und die Grenadinen,2010,12,48000,0,48000
St. Vincent und die Grenadinen,2011,1,32000,0,32000
St. Vincent und die Grenadinen,2011,2,171000,0,171000
St. Vincent und die Grenadinen,2011,3,33000,0,33000
St. Vincent und die Grenadinen,2011,4,99000,29000,128000
St. Vincent und die Grenadinen,2011,5,117000,0,117000
St. Vincent und die Grenadinen,2011,6,61000,0,61000
St. Vincent und die Grenadinen,2011,7,90000,0,90000
St. Vincent und die Grenadinen,2011,8,58000,0,58000
St. Vincent und die Grenadinen,2011,9,102000,0,102000
St. Vincent und die Grenadinen,2011,10,51000,0,51000
St. Vincent und die Grenadinen,2011,11,139000,0,139000
St. Vincent und die Grenadinen,2011,12,169000,0,169000
St. Vincent und die Grenadinen,2012,1,8000,0,8000
St. Vincent und die Grenadinen,2012,2,139000,0,139000
St. Vincent und die Grenadinen,2012,3,63000,0,63000
St. Vincent und die Grenadinen,2012,4,49000,0,49000
St. Vincent und die Grenadinen,2012,5,210000,0,210000
St. Vincent und die Grenadinen,2012,6,72000,0,72000
St. Vincent und die Grenadinen,2012,7,346000,0,346000
St. Vincent und die Grenadinen,2012,8,116000,0,116000
St. Vincent und die Grenadinen,2012,9,71000,17000,88000
St. Vincent und die Grenadinen,2012,10,185000,0,185000
St. Vincent und die Grenadinen,2012,11,222000,0,222000
St. Vincent und die Grenadinen,2012,12,18000,0,18000
St. Vincent und die Grenadinen,2013,1,136000,0,136000
St. Vincent und die Grenadinen,2013,2,39000,0,39000
St. Vincent und die Grenadinen,2013,3,87000,0,87000
St. Vincent und die Grenadinen,2013,4,128000,0,128000
St. Vincent und die Grenadinen,2013,5,81000,0,81000
St. Vincent und die Grenadinen,2013,6,88000,0,88000
St. Vincent und die Grenadinen,2013,7,100000,0,100000
St. Vincent und die Grenadinen,2013,8,108000,0,108000
St. Vincent und die Grenadinen,2013,9,66000,0,66000
St. Vincent und die Grenadinen,2013,10,255000,0,255000
St. Vincent und die Grenadinen,2013,11,107000,0,107000
St. Vincent und die Grenadinen,2013,12,266000,0,266000
St. Vincent und die Grenadinen,2014,1,43000,0,43000
St. Vincent und die Grenadinen,2014,2,13000,0,13000
St. Vincent und die Grenadinen,2014,3,155000,0,155000
St. Vincent und die Grenadinen,2014,4,596000,0,596000
St. Vincent und die Grenadinen,2014,5,181000,0,181000
St. Vincent und die Grenadinen,2014,6,351000,0,351000
St. Vincent und die Grenadinen,2014,7,148000,0,148000
St. Vincent und die Grenadinen,2014,8,75000,0,75000
St. Vincent und die Grenadinen,2014,9,137000,0,137000
St. Vincent und die Grenadinen,2014,10,144000,0,144000
St. Vincent und die Grenadinen,2014,11,594000,0,594000
St. Vincent und die Grenadinen,2014,12,110000,0,110000
St. Vincent und die Grenadinen,2015,1,259000,0,259000
St. Vincent und die Grenadinen,2015,2,109000,0,109000
St. Vincent und die Grenadinen,2015,3,108000,21000,129000
St. Vincent und die Grenadinen,2015,4,90000,0,90000
St. Vincent und die Grenadinen,2015,5,194000,0,194000
St. Vincent und die Grenadinen,2015,6,459000,1000,460000
St. Vincent und die Grenadinen,2015,7,162000,0,162000
St. Vincent und die Grenadinen,2015,8,108000,0,108000
St. Vincent und die Grenadinen,2015,9,348000,0,348000
St. Vincent und die Grenadinen,2015,10,193000,0,193000
St. Vincent und die Grenadinen,2015,11,37000,0,37000
St. Vincent und die Grenadinen,2015,12,147000,0,147000
St. Vincent und die Grenadinen,2016,1,324000,0,324000
St. Vincent und die Grenadinen,2016,2,161000,0,161000
St. Vincent und die Grenadinen,2016,3,91000,0,91000
St. Vincent und die Grenadinen,2016,4,50000,0,50000
St. Vincent und die Grenadinen,2016,5,146000,18000,164000
St. Vincent und die Grenadinen,2016,6,144000,0,144000
St. Vincent und die Grenadinen,2016,7,105000,0,105000
St. Vincent und die Grenadinen,2016,8,271000,0,271000
St. Vincent und die Grenadinen,2016,9,104000,0,104000
St. Vincent und die Grenadinen,2016,10,218000,0,218000
St. Vincent und die Grenadinen,2016,11,134000,0,134000
St. Vincent und die Grenadinen,2016,12,10000,0,10000
St. Vincent und die Grenadinen,2017,1,66000,0,66000
St. Vincent und die Grenadinen,2017,2,183000,0,183000
St. Vincent und die Grenadinen,2017,3,428000,0,428000
St. Vincent und die Grenadinen,2017,4,110000,0,110000
St. Vincent und die Grenadinen,2017,5,207000,0,207000
St. Vincent und die Grenadinen,2017,6,135000,0,135000
St. Vincent und die Grenadinen,2017,7,167000,0,167000
St. Vincent und die Grenadinen,2017,8,147000,0,147000
St. Vincent und die Grenadinen,2017,9,357000,0,357000
St. Vincent und die Grenadinen,2017,10,145000,0,145000
St. Vincent und die Grenadinen,2017,11,232000,0,232000
St. Vincent und die Grenadinen,2017,12,76000,0,76000
St. Vincent und die Grenadinen,2018,1,42000,0,42000
St. Vincent und die Grenadinen,2018,2,58000,14000,72000
St. Vincent und die Grenadinen,2018,3,114000,3000,117000
St. Vincent und die Grenadinen,2018,4,148000,0,148000
St. Vincent und die Grenadinen,2018,5,65000,5000,70000
St. Vincent und die Grenadinen,2018,6,190000,0,190000
St. Vincent und die Grenadinen,2018,7,178000,0,178000
St. Vincent und die Grenadinen,2018,8,173000,0,173000
St. Vincent und die Grenadinen,2018,9,55000,0,55000
St. Vincent und die Grenadinen,2018,10,162000,0,162000
St. Vincent und die Grenadinen,2018,11,48000,0,48000
St. Vincent und die Grenadinen,2018,12,132000,0,132000
St. Vincent und die Grenadinen,2019,1,144000,0,144000
St. Vincent und die Grenadinen,2019,2,5427000,0,5427000
St. Vincent und die Grenadinen,2019,3,99000,0,99000
St. Vincent und die Grenadinen,2019,4,85000,0,85000
St. Vincent und die Grenadinen,2019,5,215000,0,215000
St. Vincent und die Grenadinen,2019,6,1852000,0,1852000
St. Vincent und die Grenadinen,2019,7,47000,0,47000
St. Vincent und die Grenadinen,2019,8,152000,0,152000
St. Vincent und die Grenadinen,2019,9,132000,78000,210000
St. Vincent und die Grenadinen,2019,10,126000,0,126000
St. Vincent und die Grenadinen,2019,11,204000,0,204000
St. Vincent und die Grenadinen,2019,12,173000,0,173000
St. Vincent und die Grenadinen,2020,1,157000,9000,166000
St. Vincent und die Grenadinen,2020,2,103000,5000,108000
St. Vincent und die Grenadinen,2020,3,435000,77000,512000
St. Vincent und die Grenadinen,2020,4,137000,0,137000
St. Vincent und die Grenadinen,2020,5,138000,81000,219000
St. Vincent und die Grenadinen,2020,6,206000,0,206000
St. Vincent und die Grenadinen,2020,7,165000,32000,197000
St. Vincent und die Grenadinen,2020,8,144000,0,144000
St. Vincent und die Grenadinen,2020,9,319000,0,319000
St. Vincent und die Grenadinen,2020,10,220000,0,220000
St. Vincent und die Grenadinen,2020,11,355000,0,355000
St. Vincent und die Grenadinen,2020,12,168000,0,168000
St. Vincent und die Grenadinen,2021,1,137000,0,137000
St. Vincent und die Grenadinen,2021,2,112000,1000,113000
St. Vincent und die Grenadinen,2021,3,199000,0,199000
St. Vincent und die Grenadinen,2021,4,91000,0,91000
St. Vincent und die Grenadinen,2021,5,171000,0,171000
St. Vincent und die Grenadinen,2021,6,370000,0,370000
St. Vincent und die Grenadinen,2021,7,183000,50000,233000
St. Vincent und die Grenadinen,2021,8,237000,52000,289000
St. Vincent und die Grenadinen,2021,9,362000,85000,447000
St. Vincent und die Grenadinen,2021,10,72000,0,72000
St. Vincent und die Grenadinen,2021,11,249000,0,249000
St. Vincent und die Grenadinen,2021,12,245000,0,245000
St. Vincent und die Grenadinen,2022,1,155000,0,155000
St. Vincent und die Grenadinen,2022,2,216000,0,216000
St. Vincent und die Grenadinen,2022,3,242000,90000,332000
St. Vincent und die Grenadinen,2022,4,60000,127000,187000
St. Vincent und die Grenadinen,2022,5,256000,54000,310000
St. Vincent und die Grenadinen,2022,6,302000,78000,380000
St. Vincent und die Grenadinen,2022,7,317000,45000,362000
St. Vincent und die Grenadinen,2022,8,308000,73000,381000
St. Vincent und die Grenadinen,2022,9,264000,42000,306000
St. Vincent und die Grenadinen,2022,10,207000,67000,274000
St. Vincent und die Grenadinen,2022,11,163000,0,163000
St. Vincent und die Grenadinen,2022,12,102000,74000,176000
St. Vincent und die Grenadinen,2023,1,57000,3000,60000
St. Vincent und die Grenadinen,2023,2,101000,0,101000
St. Vincent und die Grenadinen,2023,3,274000,0,274000
St. Vincent und die Grenadinen,2023,4,173000,0,173000
St. Vincent und die Grenadinen,2023,5,296000,41000,337000
St. Vincent und die Grenadinen,2023,6,165000,105000,270000
St. Vincent und die Grenadinen,2023,7,184000,46000,230000
St. Vincent und die Grenadinen,2023,8,139000,49000,188000
St. Vincent und die Grenadinen,2023,9,73000,110000,183000
St. Vincent und die Grenadinen,2023,10,225000,79000,304000
St. Vincent und die Grenadinen,2023,11,73000,34000,107000
St. Vincent und die Grenadinen,2023,12,153000,34000,187000
St. Vincent und die Grenadinen,2024,1,80000,34000,114000
St. Vincent und die Grenadinen,2024,2,262000,34000,296000
St. Vincent und die Grenadinen,2024,3,184000,0,184000
St. Vincent und die Grenadinen,2024,4,120000,0,120000
St. Vincent und die Grenadinen,2024,5,14259000,47000,14306000
St. Vincent und die Grenadinen,2024,6,554000,59000,613000
St. Vincent und die Grenadinen,2024,7,380000,7000,387000
St. Vincent und die Grenadinen,2024,8,6376000,4000,6380000
St. Vincent und die Grenadinen,2024,9,116000,0,116000
St. Vincent und die Grenadinen,2024,10,240000,0,240000
St. Vincent und die Grenadinen,2024,11,285000,49000,334000
St. Vincent und die Grenadinen,2024,12,831000,0,831000
Sudan,2008,1,16112000,1808000,17920000
Sudan,2008,2,9274000,2598000,11872000
Sudan,2008,3,10962000,4207000,15169000
Sudan,2008,4,18932000,4314000,23246000
Sudan,2008,5,10237000,1492000,11729000
Sudan,2008,6,23234000,2971000,26205000
Sudan,2008,7,21137000,2829000,23966000
Sudan,2008,8,17650000,3577000,21227000
Sudan,2008,9,13495000,2493000,15988000
Sudan,2008,10,26399000,2879000,29278000
Sudan,2008,11,37640000,1782000,39422000
Sudan,2008,12,21125000,2916000,24041000
Sudan,2009,1,8037000,1556000,9593000
Sudan,2009,2,19492000,1695000,21187000
Sudan,2009,3,17633000,2346000,19979000
Sudan,2009,4,8441000,2359000,10800000
Sudan,2009,5,13374000,1423000,14797000
Sudan,2009,6,20543000,1303000,21846000
Sudan,2009,7,30578000,922000,31500000
Sudan,2009,8,14836000,713000,15549000
Sudan,2009,9,18614000,345000,18959000
Sudan,2009,10,17757000,1323000,19080000
Sudan,2009,11,12081000,621000,12702000
Sudan,2009,12,21451000,746000,22197000
Sudan,2010,1,19541000,635000,20176000
Sudan,2010,2,10035000,475000,10510000
Sudan,2010,3,25755000,1731000,27486000
Sudan,2010,4,29754000,1818000,31572000
Sudan,2010,5,7199000,2108000,9307000
Sudan,2010,6,23571000,2259000,25830000
Sudan,2010,7,28300000,1939000,30239000
Sudan,2010,8,19988000,1114000,21102000
Sudan,2010,9,12069000,1614000,13683000
Sudan,2010,10,20482000,1069000,21551000
Sudan,2010,11,16711000,1372000,18083000
Sudan,2010,12,24773000,908000,25681000
Sudan,2011,1,36782000,2144000,38926000
Sudan,2011,2,9476000,1180000,10656000
Sudan,2011,3,51546000,1436000,52982000
Sudan,2011,4,11367000,2945000,14312000
Sudan,2011,5,38130000,2605000,40735000
Sudan,2011,6,32871000,2267000,35138000
Sudan,2011,7,32063000,4008000,36071000
Sudan,2011,8,17101000,1907000,19008000
Sudan,2011,9,21005000,1815000,22820000
Sudan,2011,10,17296000,1123000,18419000
Sudan,2011,11,21413000,1264000,22677000
Sudan,2011,12,23055000,842000,23897000
Sudan,2012,1,11773000,834000,12607000
Sudan,2012,2,25745000,698000,26443000
Sudan,2012,3,9739000,1514000,11253000
Sudan,2012,4,9868000,1891000,11759000
Sudan,2012,5,20975000,1252000,22227000
Sudan,2012,6,12011000,2913000,14924000
Sudan,2012,7,12778000,1691000,14469000
Sudan,2012,8,9031000,2616000,11647000
Sudan,2012,9,14011000,2068000,16079000
Sudan,2012,10,17848000,776000,18624000
Sudan,2012,11,12071000,1638000,13709000
Sudan,2012,12,8154000,802000,8956000
Sudan,2013,1,8456000,1313000,9769000
Sudan,2013,2,13223000,1633000,14856000
Sudan,2013,3,27442000,668000,28110000
Sudan,2013,4,15327000,1384000,16711000
Sudan,2013,5,11523000,1341000,12864000
Sudan,2013,6,29844000,877000,30721000
Sudan,2013,7,8635000,2263000,10898000
Sudan,2013,8,21525000,1782000,23307000
Sudan,2013,9,11368000,1068000,12436000
Sudan,2013,10,33932000,1044000,34976000
Sudan,2013,11,7757000,962000,8719000
Sudan,2013,12,34644000,741000,35385000
Sudan,2014,1,8089000,646000,8735000
Sudan,2014,2,15871000,210000,16081000
Sudan,2014,3,17082000,1065000,18147000
Sudan,2014,4,6214000,1743000,7957000
Sudan,2014,5,11621000,1371000,12992000
Sudan,2014,6,8889000,2769000,11658000
Sudan,2014,7,38983000,2469000,41452000
Sudan,2014,8,5815000,987000,6802000
Sudan,2014,9,7520000,1637000,9157000
Sudan,2014,10,10648000,1246000,11894000
Sudan,2014,11,14622000,1401000,16023000
Sudan,2014,12,11696000,1474000,13170000
Sudan,2015,1,9103000,1528000,10631000
Sudan,2015,2,5967000,842000,6809000
Sudan,2015,3,26427000,1101000,27528000
Sudan,2015,4,10526000,3302000,13828000
Sudan,2015,5,15001000,2607000,17608000
Sudan,2015,6,32062000,2179000,34241000
Sudan,2015,7,15789000,1941000,17730000
Sudan,2015,8,10334000,1018000,11352000
Sudan,2015,9,11401000,736000,12137000
Sudan,2015,10,10198000,2749000,12947000
Sudan,2015,11,8893000,1688000,10581000
Sudan,2015,12,13645000,1387000,15032000
Sudan,2016,1,7911000,1346000,9257000
Sudan,2016,2,19544000,890000,20434000
Sudan,2016,3,8452000,1533000,9985000
Sudan,2016,4,19010000,2427000,21437000
Sudan,2016,5,7708000,981000,8689000
Sudan,2016,6,9024000,2297000,11321000
Sudan,2016,7,19935000,1256000,21191000
Sudan,2016,8,18546000,438000,18984000
Sudan,2016,9,10400000,1822000,12222000
Sudan,2016,10,11503000,621000,12124000
Sudan,2016,11,7997000,1302000,9299000
Sudan,2016,12,30488000,1611000,32099000
Sudan,2017,1,9639000,977000,10616000
Sudan,2017,2,69950000,577000,70527000
Sudan,2017,3,10464000,1951000,12415000
Sudan,2017,4,10278000,1523000,11801000
Sudan,2017,5,13151000,2071000,15222000
Sudan,2017,6,15747000,2334000,18081000
Sudan,2017,7,19486000,1369000,20855000
Sudan,2017,8,10132000,1258000,11390000
Sudan,2017,9,12763000,3297000,16060000
Sudan,2017,10,22819000,3017000,25836000
Sudan,2017,11,20985000,877000,21862000
Sudan,2017,12,16082000,932000,17014000
Sudan,2018,1,10212000,177000,10389000
Sudan,2018,2,14015000,602000,14617000
Sudan,2018,3,11655000,1440000,13095000
Sudan,2018,4,19577000,1358000,20935000
Sudan,2018,5,12422000,2734000,15156000
Sudan,2018,6,11466000,1410000,12876000
Sudan,2018,7,8289000,1287000,9576000
Sudan,2018,8,12395000,998000,13393000
Sudan,2018,9,15076000,1414000,16490000
Sudan,2018,10,12487000,699000,13186000
Sudan,2018,11,16859000,777000,17636000
Sudan,2018,12,11764000,1681000,13445000
Sudan,2019,1,6678000,1407000,8085000
Sudan,2019,2,21186000,1176000,22362000
Sudan,2019,3,23617000,906000,24523000
Sudan,2019,4,10422000,919000,11341000
Sudan,2019,5,14987000,1448000,16435000
Sudan,2019,6,16410000,1305000,17715000
Sudan,2019,7,14105000,1190000,15295000
Sudan,2019,8,12366000,1231000,13597000
Sudan,2019,9,8977000,669000,9646000
Sudan,2019,10,8522000,977000,9499000
Sudan,2019,11,9458000,1033000,10491000
Sudan,2019,12,8683000,151000,8834000
Sudan,2020,1,10016000,1606000,11622000
Sudan,2020,2,26816000,1893000,28709000
Sudan,2020,3,32318000,861000,33179000
Sudan,2020,4,9161000,2398000,11559000
Sudan,2020,5,13494000,499000,13993000
Sudan,2020,6,13925000,653000,14578000
Sudan,2020,7,8467000,28000,8495000
Sudan,2020,8,13007000,1511000,14518000
Sudan,2020,9,9216000,1494000,10710000
Sudan,2020,10,9754000,2635000,12389000
Sudan,2020,11,6195000,519000,6714000
Sudan,2020,12,7968000,1967000,9935000
Sudan,2021,1,6058000,251000,6309000
Sudan,2021,2,5943000,1806000,7749000
Sudan,2021,3,23385000,2966000,26351000
Sudan,2021,4,3928000,852000,4780000
Sudan,2021,5,7649000,546000,8195000
Sudan,2021,6,9771000,716000,10487000
Sudan,2021,7,11179000,3510000,14689000
Sudan,2021,8,9570000,2945000,12515000
Sudan,2021,9,12720000,1017000,13737000
Sudan,2021,10,6283000,984000,7267000
Sudan,2021,11,4993000,1415000,6408000
Sudan,2021,12,8641000,549000,9190000
Sudan,2022,1,9454000,2254000,11708000
Sudan,2022,2,7165000,605000,7770000
Sudan,2022,3,9432000,31000,9463000
Sudan,2022,4,29259000,1317000,30576000
Sudan,2022,5,6941000,1433000,8374000
Sudan,2022,6,4611000,2364000,6975000
Sudan,2022,7,11367000,2703000,14070000
Sudan,2022,8,8127000,5732000,13859000
Sudan,2022,9,13507000,1567000,15074000
Sudan,2022,10,12180000,3315000,15495000
Sudan,2022,11,13455000,3213000,16668000
Sudan,2022,12,16040000,1411000,17451000
Sudan,2023,1,9374000,2402000,11776000
Sudan,2023,2,6520000,1496000,8016000
Sudan,2023,3,10249000,2924000,13173000
Sudan,2023,4,7012000,696000,7708000
Sudan,2023,5,225000,2505000,2730000
Sudan,2023,6,1248000,2738000,3986000
Sudan,2023,7,1597000,1306000,2903000
Sudan,2023,8,1132000,2759000,3891000
Sudan,2023,9,1445000,4849000,6294000
Sudan,2023,10,1245000,2798000,4043000
Sudan,2023,11,1284000,3513000,4797000
Sudan,2023,12,1846000,1713000,3559000
Sudan,2024,1,1044000,775000,1819000
Sudan,2024,2,506000,1199000,1705000
Sudan,2024,3,974000,747000,1721000
Sudan,2024,4,1496000,3824000,5320000
Sudan,2024,5,3403000,259000,3662000
Sudan,2024,6,2449000,1397000,3846000
Sudan,2024,7,883000,323000,1206000
Sudan,2024,8,1330000,1517000,2847000
Sudan,2024,9,574000,1722000,2296000
Sudan,2024,10,1262000,2445000,3707000
Sudan,2024,11,1837000,1044000,2881000
Sudan,2024,12,1166000,862000,2028000
Suriname,2008,1,1524000,134000,1658000
Suriname,2008,2,1107000,5000,1112000
Suriname,2008,3,858000,289000,1147000
Suriname,2008,4,1246000,2000,1248000
Suriname,2008,5,1168000,29000,1197000
Suriname,2008,6,756000,297000,1053000
Suriname,2008,7,985000,383000,1368000
Suriname,2008,8,635000,5016000,5651000
Suriname,2008,9,1250000,4102000,5352000
Suriname,2008,10,1423000,13000,1436000
Suriname,2008,11,984000,3000,987000
Suriname,2008,12,1314000,5620000,6934000
Suriname,2009,1,1171000,641000,1812000
Suriname,2009,2,1038000,18366000,19404000
Suriname,2009,3,824000,2265000,3089000
Suriname,2009,4,1255000,2368000,3623000
Suriname,2009,5,1167000,757000,1924000
Suriname,2009,6,1082000,936000,2018000
Suriname,2009,7,1270000,377000,1647000
Suriname,2009,8,1064000,2969000,4033000
Suriname,2009,9,1210000,1777000,2987000
Suriname,2009,10,4713000,2031000,6744000
Suriname,2009,11,692000,173000,865000
Suriname,2009,12,1538000,1858000,3396000
Suriname,2010,1,655000,922000,1577000
Suriname,2010,2,4821000,416000,5237000
Suriname,2010,3,3560000,7381000,10941000
Suriname,2010,4,1054000,1837000,2891000
Suriname,2010,5,1940000,5303000,7243000
Suriname,2010,6,1503000,3000000,4503000
Suriname,2010,7,1063000,2310000,3373000
Suriname,2010,8,1235000,14531000,15766000
Suriname,2010,9,2620000,3566000,6186000
Suriname,2010,10,1554000,1174000,2728000
Suriname,2010,11,1714000,757000,2471000
Suriname,2010,12,603000,2388000,2991000
Suriname,2011,1,2748000,192000,2940000
Suriname,2011,2,960000,154000,1114000
Suriname,2011,3,1032000,1726000,2758000
Suriname,2011,4,948000,281000,1229000
Suriname,2011,5,1437000,578000,2015000
Suriname,2011,6,909000,136000,1045000
Suriname,2011,7,882000,220000,1102000
Suriname,2011,8,629000,238000,867000
Suriname,2011,9,4986000,199000,5185000
Suriname,2011,10,4478000,273000,4751000
Suriname,2011,11,831000,1279000,2110000
Suriname,2011,12,1889000,207000,2096000
Suriname,2012,1,1128000,1353000,2481000
Suriname,2012,2,2585000,2963000,5548000
Suriname,2012,3,2868000,969000,3837000
Suriname,2012,4,1846000,1910000,3756000
Suriname,2012,5,1534000,2072000,3606000
Suriname,2012,6,2045000,724000,2769000
Suriname,2012,7,1801000,766000,2567000
Suriname,2012,8,1196000,522000,1718000
Suriname,2012,9,1935000,289000,2224000
Suriname,2012,10,1497000,349000,1846000
Suriname,2012,11,3559000,124000,3683000
Suriname,2012,12,1420000,281000,1701000
Suriname,2013,1,1484000,319000,1803000
Suriname,2013,2,4393000,466000,4859000
Suriname,2013,3,1515000,262000,1777000
Suriname,2013,4,1787000,560000,2347000
Suriname,2013,5,1666000,246000,1912000
Suriname,2013,6,2040000,625000,2665000
Suriname,2013,7,2483000,44000,2527000
Suriname,2013,8,6464000,92000,6556000
Suriname,2013,9,1893000,22000,1915000
Suriname,2013,10,5957000,928000,6885000
Suriname,2013,11,2890000,301000,3191000
Suriname,2013,12,2511000,266000,2777000
Suriname,2014,1,8107000,277000,8384000
Suriname,2014,2,1149000,23000,1172000
Suriname,2014,3,2178000,268000,2446000
Suriname,2014,4,1913000,294000,2207000
Suriname,2014,5,2454000,322000,2776000
Suriname,2014,6,1073000,70000,1143000
Suriname,2014,7,1799000,106000,1905000
Suriname,2014,8,1387000,81000,1468000
Suriname,2014,9,2116000,4899000,7015000
Suriname,2014,10,1758000,9228000,10986000
Suriname,2014,11,3959000,3859000,7818000
Suriname,2014,12,1356000,87000,1443000
Suriname,2015,1,1602000,430000,2032000
Suriname,2015,2,3347000,656000,4003000
Suriname,2015,3,1988000,993000,2981000
Suriname,2015,4,1309000,6641000,7950000
Suriname,2015,5,1632000,200000,1832000
Suriname,2015,6,2091000,728000,2819000
Suriname,2015,7,2008000,532000,2540000
Suriname,2015,8,5231000,885000,6116000
Suriname,2015,9,2275000,306000,2581000
Suriname,2015,10,1093000,680000,1773000
Suriname,2015,11,3908000,802000,4710000
Suriname,2015,12,1486000,370000,1856000
Suriname,2016,1,1737000,1058000,2795000
Suriname,2016,2,1995000,428000,2423000
Suriname,2016,3,3943000,1257000,5200000
Suriname,2016,4,5167000,159000,5326000
Suriname,2016,5,1595000,4627000,6222000
Suriname,2016,6,1445000,381000,1826000
Suriname,2016,7,1188000,779000,1967000
Suriname,2016,8,1950000,617000,2567000
Suriname,2016,9,2271000,291000,2562000
Suriname,2016,10,1191000,849000,2040000
Suriname,2016,11,1781000,814000,2595000
Suriname,2016,12,1048000,390000,1438000
Suriname,2017,1,1867000,362000,2229000
Suriname,2017,2,1390000,58000,1448000
Suriname,2017,3,1887000,77000,1964000
Suriname,2017,4,1017000,209000,1226000
Suriname,2017,5,3166000,119000,3285000
Suriname,2017,6,1907000,192000,2099000
Suriname,2017,7,1123000,110000,1233000
Suriname,2017,8,1016000,147000,1163000
Suriname,2017,9,2014000,68000,2082000
Suriname,2017,10,1524000,99000,1623000
Suriname,2017,11,2264000,28000,2292000
Suriname,2017,12,933000,37000,970000
Suriname,2018,1,1748000,59000,1807000
Suriname,2018,2,1517000,82000,1599000
Suriname,2018,3,2003000,77000,2080000
Suriname,2018,4,1665000,84000,1749000
Suriname,2018,5,4000000,102000,4102000
Suriname,2018,6,1294000,72000,1366000
Suriname,2018,7,992000,83000,1075000
Suriname,2018,8,2293000,49000,2342000
Suriname,2018,9,1424000,76000,1500000
Suriname,2018,10,2089000,63000,2152000
Suriname,2018,11,1359000,37000,1396000
Suriname,2018,12,1515000,51000,1566000
Suriname,2019,1,854000,104000,958000
Suriname,2019,2,1556000,73000,1629000
Suriname,2019,3,2395000,54000,2449000
Suriname,2019,4,1204000,173000,1377000
Suriname,2019,5,5361000,235000,5596000
Suriname,2019,6,878000,133000,1011000
Suriname,2019,7,1915000,213000,2128000
Suriname,2019,8,2163000,113000,2276000
Suriname,2019,9,899000,65000,964000
Suriname,2019,10,1836000,156000,1992000
Suriname,2019,11,4873000,22000,4895000
Suriname,2019,12,2021000,202000,2223000
Suriname,2020,1,2187000,45000,2232000
Suriname,2020,2,1536000,131000,1667000
Suriname,2020,3,2379000,101000,2480000
Suriname,2020,4,2197000,142000,2339000
Suriname,2020,5,1239000,133000,1372000
Suriname,2020,6,1884000,147000,2031000
Suriname,2020,7,4186000,47000,4233000
Suriname,2020,8,1112000,163000,1275000
Suriname,2020,9,1552000,198000,1750000
Suriname,2020,10,2890000,84000,2974000
Suriname,2020,11,1747000,212000,1959000
Suriname,2020,12,579000,47000,626000
Suriname,2021,1,1776000,30000,1806000
Suriname,2021,2,4210000,197000,4407000
Suriname,2021,3,2755000,108000,2863000
Suriname,2021,4,2673000,114000,2787000
Suriname,2021,5,2100000,90000,2190000
Suriname,2021,6,3798000,194000,3992000
Suriname,2021,7,2320000,130000,2450000
Suriname,2021,8,942000,572000,1514000
Suriname,2021,9,2762000,386000,3148000
Suriname,2021,10,2156000,178000,2334000
Suriname,2021,11,2105000,198000,2303000
Suriname,2021,12,3084000,182000,3266000
Suriname,2022,1,2783000,59000,2842000
Suriname,2022,2,1568000,210000,1778000
Suriname,2022,3,3224000,540000,3764000
Suriname,2022,4,1604000,391000,1995000
Suriname,2022,5,6487000,163000,6650000
Suriname,2022,6,3050000,332000,3382000
Suriname,2022,7,6705000,554000,7259000
Suriname,2022,8,4491000,624000,5115000
Suriname,2022,9,3553000,184000,3737000
Suriname,2022,10,2212000,512000,2724000
Suriname,2022,11,3779000,244000,4023000
Suriname,2022,12,1494000,235000,1729000
Suriname,2023,1,2363000,286000,2649000
Suriname,2023,2,4843000,351000,5194000
Suriname,2023,3,3185000,443000,3628000
Suriname,2023,4,3142000,226000,3368000
Suriname,2023,5,2437000,275000,2712000
Suriname,2023,6,1384000,399000,1783000
Suriname,2023,7,2847000,182000,3029000
Suriname,2023,8,3518000,439000,3957000
Suriname,2023,9,2481000,212000,2693000
Suriname,2023,10,2848000,235000,3083000
Suriname,2023,11,2203000,270000,2473000
Suriname,2023,12,2959000,151000,3110000
Suriname,2024,1,4648000,152000,4800000
Suriname,2024,2,1783000,176000,1959000
Suriname,2024,3,3859000,153000,4012000
Suriname,2024,4,2612000,981000,3593000
Suriname,2024,5,11940000,114000,12054000
Suriname,2024,6,5428000,591000,6019000
Suriname,2024,7,1744000,154000,1898000
Suriname,2024,8,2769000,131000,2900000
Suriname,2024,9,3382000,263000,3645000
Suriname,2024,10,2443000,309000,2752000
Suriname,2024,11,4662000,140000,4802000
Suriname,2024,12,2278000,89000,2367000
Svalbard (bis 1996),2008,1,0,0,0
Svalbard (bis 1996),2008,2,0,0,0
Svalbard (bis 1996),2008,3,0,0,0
Svalbard (bis 1996),2008,4,0,0,0
Svalbard (bis 1996),2008,5,0,0,0
Svalbard (bis 1996),2008,6,0,0,0
Svalbard (bis 1996),2008,7,0,0,0
Svalbard (bis 1996),2008,8,0,0,0
Svalbard (bis 1996),2008,9,0,0,0
Svalbard (bis 1996),2008,10,0,0,0
Svalbard (bis 1996),2008,11,0,0,0
Svalbard (bis 1996),2008,12,0,0,0
Svalbard (bis 1996),2009,1,0,0,0
Svalbard (bis 1996),2009,2,0,0,0
Svalbard (bis 1996),2009,3,0,0,0
Svalbard (bis 1996),2009,4,0,0,0
Svalbard (bis 1996),2009,5,0,0,0
Svalbard (bis 1996),2009,6,0,0,0
Svalbard (bis 1996),2009,7,0,0,0
Svalbard (bis 1996),2009,8,0,0,0
Svalbard (bis 1996),2009,9,0,0,0
Svalbard (bis 1996),2009,10,0,0,0
Svalbard (bis 1996),2009,11,0,0,0
Svalbard (bis 1996),2009,12,0,0,0
Svalbard (bis 1996),2010,1,0,0,0
Svalbard (bis 1996),2010,2,0,0,0
Svalbard (bis 1996),2010,3,0,0,0
Svalbard (bis 1996),2010,4,0,0,0
Svalbard (bis 1996),2010,5,0,0,0
Svalbard (bis 1996),2010,6,0,0,0
Svalbard (bis 1996),2010,7,0,0,0
Svalbard (bis 1996),2010,8,0,0,0
Svalbard (bis 1996),2010,9,0,0,0
Svalbard (bis 1996),2010,10,0,0,0
Svalbard (bis 1996),2010,11,0,0,0
Svalbard (bis 1996),2010,12,0,0,0
Svalbard (bis 1996),2011,1,0,0,0
Svalbard (bis 1996),2011,2,0,0,0
Svalbard (bis 1996),2011,3,0,0,0
Svalbard (bis 1996),2011,4,0,0,0
Svalbard (bis 1996),2011,5,0,0,0
Svalbard (bis 1996),2011,6,0,0,0
Svalbard (bis 1996),2011,7,0,0,0
Svalbard (bis 1996),2011,8,0,0,0
Svalbard (bis 1996),2011,9,0,0,0
Svalbard (bis 1996),2011,10,0,0,0
Svalbard (bis 1996),2011,11,0,0,0
Svalbard (bis 1996),2011,12,0,0,0
Svalbard (bis 1996),2012,1,0,0,0
Svalbard (bis 1996),2012,2,0,0,0
Svalbard (bis 1996),2012,3,0,0,0
Svalbard (bis 1996),2012,4,0,0,0
Svalbard (bis 1996),2012,5,0,0,0
Svalbard (bis 1996),2012,6,0,0,0
Svalbard (bis 1996),2012,7,0,0,0
Svalbard (bis 1996),2012,8,0,0,0
Svalbard (bis 1996),2012,9,0,0,0
Svalbard (bis 1996),2012,10,0,0,0
Svalbard (bis 1996),2012,11,0,0,0
Svalbard (bis 1996),2012,12,0,0,0
Svalbard (bis 1996),2013,1,0,0,0
Svalbard (bis 1996),2013,2,0,0,0
Svalbard (bis 1996),2013,3,0,0,0
Svalbard (bis 1996),2013,4,0,0,0
Svalbard (bis 1996),2013,5,0,0,0
Svalbard (bis 1996),2013,6,0,0,0
Svalbard (bis 1996),2013,7,0,0,0
Svalbard (bis 1996),2013,8,0,0,0
Svalbard (bis 1996),2013,9,0,0,0
Svalbard (bis 1996),2013,10,0,0,0
Svalbard (bis 1996),2013,11,0,0,0
Svalbard (bis 1996),2013,12,0,0,0
Svalbard (bis 1996),2014,1,0,0,0
Svalbard (bis 1996),2014,2,0,0,0
Svalbard (bis 1996),2014,3,0,0,0
Svalbard (bis 1996),2014,4,0,0,0
Svalbard (bis 1996),2014,5,0,0,0
Svalbard (bis 1996),2014,6,0,0,0
Svalbard (bis 1996),2014,7,0,0,0
Svalbard (bis 1996),2014,8,0,0,0
Svalbard (bis 1996),2014,9,0,0,0
Svalbard (bis 1996),2014,10,0,0,0
Svalbard (bis 1996),2014,11,0,0,0
Svalbard (bis 1996),2014,12,0,0,0
Svalbard (bis 1996),2015,1,0,0,0
Svalbard (bis 1996),2015,2,0,0,0
Svalbard (bis 1996),2015,3,0,0,0
Svalbard (bis 1996),2015,4,0,0,0
Svalbard (bis 1996),2015,5,0,0,0
Svalbard (bis 1996),2015,6,0,0,0
Svalbard (bis 1996),2015,7,0,0,0
Svalbard (bis 1996),2015,8,0,0,0
Svalbard (bis 1996),2015,9,0,0,0
Svalbard (bis 1996),2015,10,0,0,0
Svalbard (bis 1996),2015,11,0,0,0
Svalbard (bis 1996),2015,12,0,0,0
Svalbard (bis 1996),2016,1,0,0,0
Svalbard (bis 1996),2016,2,0,0,0
Svalbard (bis 1996),2016,3,0,0,0
Svalbard (bis 1996),2016,4,0,0,0
Svalbard (bis 1996),2016,5,0,0,0
Svalbard (bis 1996),2016,6,0,0,0
Svalbard (bis 1996),2016,7,0,0,0
Svalbard (bis 1996),2016,8,0,0,0
Svalbard (bis 1996),2016,9,0,0,0
Svalbard (bis 1996),2016,10,0,0,0
Svalbard (bis 1996),2016,11,0,0,0
Svalbard (bis 1996),2016,12,0,0,0
Svalbard (bis 1996),2017,1,0,0,0
Svalbard (bis 1996),2017,2,0,0,0
Svalbard (bis 1996),2017,3,0,0,0
Svalbard (bis 1996),2017,4,0,0,0
Svalbard (bis 1996),2017,5,0,0,0
Svalbard (bis 1996),2017,6,0,0,0
Svalbard (bis 1996),2017,7,0,0,0
Svalbard (bis 1996),2017,8,0,0,0
Svalbard (bis 1996),2017,9,0,0,0
Svalbard (bis 1996),2017,10,0,0,0
Svalbard (bis 1996),2017,11,0,0,0
Svalbard (bis 1996),2017,12,0,0,0
Svalbard (bis 1996),2018,1,0,0,0
Svalbard (bis 1996),2018,2,0,0,0
Svalbard (bis 1996),2018,3,0,0,0
Svalbard (bis 1996),2018,4,0,0,0
Svalbard (bis 1996),2018,5,0,0,0
Svalbard (bis 1996),2018,6,0,0,0
Svalbard (bis 1996),2018,7,0,0,0
Svalbard (bis 1996),2018,8,0,0,0
Svalbard (bis 1996),2018,9,0,0,0
Svalbard (bis 1996),2018,10,0,0,0
Svalbard (bis 1996),2018,11,0,0,0
Svalbard (bis 1996),2018,12,0,0,0
Svalbard (bis 1996),2019,1,0,0,0
Svalbard (bis 1996),2019,2,0,0,0
Svalbard (bis 1996),2019,3,0,0,0
Svalbard (bis 1996),2019,4,0,0,0
Svalbard (bis 1996),2019,5,0,0,0
Svalbard (bis 1996),2019,6,0,0,0
Svalbard (bis 1996),2019,7,0,0,0
Svalbard (bis 1996),2019,8,0,0,0
Svalbard (bis 1996),2019,9,0,0,0
Svalbard (bis 1996),2019,10,0,0,0
Svalbard (bis 1996),2019,11,0,0,0
Svalbard (bis 1996),2019,12,0,0,0
Svalbard (bis 1996),2020,1,0,0,0
Svalbard (bis 1996),2020,2,0,0,0
Svalbard (bis 1996),2020,3,0,0,0
Svalbard (bis 1996),2020,4,0,0,0
Svalbard (bis 1996),2020,5,0,0,0
Svalbard (bis 1996),2020,6,0,0,0
Svalbard (bis 1996),2020,7,0,0,0
Svalbard (bis 1996),2020,8,0,0,0
Svalbard (bis 1996),2020,9,0,0,0
Svalbard (bis 1996),2020,10,0,0,0
Svalbard (bis 1996),2020,11,0,0,0
Svalbard (bis 1996),2020,12,0,0,0
Svalbard (bis 1996),2021,1,0,0,0
Svalbard (bis 1996),2021,2,0,0,0
Svalbard (bis 1996),2021,3,0,0,0
Svalbard (bis 1996),2021,4,0,0,0
Svalbard (bis 1996),2021,5,0,0,0
Svalbard (bis 1996),2021,6,0,0,0
Svalbard (bis 1996),2021,7,0,0,0
Svalbard (bis 1996),2021,8,0,0,0
Svalbard (bis 1996),2021,9,0,0,0
Svalbard (bis 1996),2021,10,0,0,0
Svalbard (bis 1996),2021,11,0,0,0
Svalbard (bis 1996),2021,12,0,0,0
Svalbard (bis 1996),2022,1,0,0,0
Svalbard (bis 1996),2022,2,0,0,0
Svalbard (bis 1996),2022,3,0,0,0
Svalbard (bis 1996),2022,4,0,0,0
Svalbard (bis 1996),2022,5,0,0,0
Svalbard (bis 1996),2022,6,0,0,0
Svalbard (bis 1996),2022,7,0,0,0
Svalbard (bis 1996),2022,8,0,0,0
Svalbard (bis 1996),2022,9,0,0,0
Svalbard (bis 1996),2022,10,0,0,0
Svalbard (bis 1996),2022,11,0,0,0
Svalbard (bis 1996),2022,12,0,0,0
Svalbard (bis 1996),2023,1,0,0,0
Svalbard (bis 1996),2023,2,0,0,0
Svalbard (bis 1996),2023,3,0,0,0
Svalbard (bis 1996),2023,4,0,0,0
Svalbard (bis 1996),2023,5,0,0,0
Svalbard (bis 1996),2023,6,0,0,0
Svalbard (bis 1996),2023,7,0,0,0
Svalbard (bis 1996),2023,8,0,0,0
Svalbard (bis 1996),2023,9,0,0,0
Svalbard (bis 1996),2023,10,0,0,0
Svalbard (bis 1996),2023,11,0,0,0
Svalbard (bis 1996),2023,12,0,0,0
Svalbard (bis 1996),2024,1,0,0,0
Svalbard (bis 1996),2024,2,0,0,0
Svalbard (bis 1996),2024,3,0,0,0
Svalbard (bis 1996),2024,4,0,0,0
Svalbard (bis 1996),2024,5,0,0,0
Svalbard (bis 1996),2024,6,0,0,0
Svalbard (bis 1996),2024,7,0,0,0
Svalbard (bis 1996),2024,8,0,0,0
Svalbard (bis 1996),2024,9,0,0,0
Svalbard (bis 1996),2024,10,0,0,0
Svalbard (bis 1996),2024,11,0,0,0
Svalbard (bis 1996),2024,12,0,0,0
Südafrika,2008,1,634794000,457885000,1092679000
Südafrika,2008,2,773852000,458185000,1232037000
Südafrika,2008,3,610424000,483928000,1094352000
Südafrika,2008,4,671261000,455809000,1127070000
Südafrika,2008,5,580151000,453475000,1033626000
Südafrika,2008,6,617593000,434555000,1052148000
Südafrika,2008,7,747402000,479720000,1227122000
Südafrika,2008,8,543464000,449211000,992675000
Südafrika,2008,9,641091000,451554000,1092645000
Südafrika,2008,10,642047000,459407000,1101454000
Südafrika,2008,11,419086000,382271000,801357000
Südafrika,2008,12,413734000,367741000,781475000
Südafrika,2009,1,427581000,389014000,816595000
Südafrika,2009,2,471410000,359288000,830698000
Südafrika,2009,3,456274000,363904000,820178000
Südafrika,2009,4,388855000,298407000,687262000
Südafrika,2009,5,396440000,266449000,662889000
Südafrika,2009,6,468180000,333428000,801608000
Südafrika,2009,7,549194000,282155000,831349000
Südafrika,2009,8,456647000,283265000,739912000
Südafrika,2009,9,551597000,337482000,889079000
Südafrika,2009,10,593287000,294423000,887710000
Südafrika,2009,11,487137000,316456000,803593000
Südafrika,2009,12,493146000,416096000,909242000
Südafrika,2010,1,518362000,337964000,856326000
Südafrika,2010,2,586060000,331852000,917912000
Südafrika,2010,3,733906000,418168000,1152074000
Südafrika,2010,4,608362000,455117000,1063479000
Südafrika,2010,5,618321000,548355000,1166676000
Südafrika,2010,6,678862000,468003000,1146865000
Südafrika,2010,7,763695000,496814000,1260509000
Südafrika,2010,8,658225000,457333000,1115558000
Südafrika,2010,9,699199000,428093000,1127292000
Südafrika,2010,10,654786000,438465000,1093251000
Südafrika,2010,11,540385000,561679000,1102064000
Südafrika,2010,12,595601000,419857000,1015458000
Südafrika,2011,1,658325000,515374000,1173699000
Südafrika,2011,2,672084000,494467000,1166551000
Südafrika,2011,3,705284000,584614000,1289898000
Südafrika,2011,4,670482000,465329000,1135811000
Südafrika,2011,5,749264000,517731000,1266995000
Südafrika,2011,6,702291000,528520000,1230811000
Südafrika,2011,7,810019000,548777000,1358796000
Südafrika,2011,8,838223000,599911000,1438134000
Südafrika,2011,9,825042000,525664000,1350706000
Südafrika,2011,10,740235000,512359000,1252594000
Südafrika,2011,11,620425000,490557000,1110982000
Südafrika,2011,12,673216000,432119000,1105335000
Südafrika,2012,1,692957000,449839000,1142796000
Südafrika,2012,2,693843000,440792000,1134635000
Südafrika,2012,3,789056000,454329000,1243385000
Südafrika,2012,4,729270000,379736000,1109006000
Südafrika,2012,5,705216000,397783000,1102999000
Südafrika,2012,6,721795000,453353000,1175148000
Südafrika,2012,7,786156000,398344000,1184500000
Südafrika,2012,8,815211000,504133000,1319344000
Südafrika,2012,9,750932000,383237000,1134169000
Südafrika,2012,10,750828000,471185000,1222013000
Südafrika,2012,11,653126000,409208000,1062334000
Südafrika,2012,12,725102000,363882000,1088984000
Südafrika,2013,1,743404000,428241000,1171645000
Südafrika,2013,2,766968000,366911000,1133879000
Südafrika,2013,3,762764000,451825000,1214589000
Südafrika,2013,4,777214000,537084000,1314298000
Südafrika,2013,5,771042000,344195000,1115237000
Südafrika,2013,6,760733000,424748000,1185481000
Südafrika,2013,7,810948000,351370000,1162318000
Südafrika,2013,8,694262000,411849000,1106111000
Südafrika,2013,9,638513000,368496000,1007009000
Südafrika,2013,10,647751000,372854000,1020605000
Südafrika,2013,11,573154000,355486000,928640000
Südafrika,2013,12,581054000,354212000,935266000
Südafrika,2014,1,572533000,401101000,973634000
Südafrika,2014,2,640943000,450800000,1091743000
Südafrika,2014,3,616674000,475976000,1092650000
Südafrika,2014,4,650449000,417045000,1067494000
Südafrika,2014,5,664413000,369222000,1033635000
Südafrika,2014,6,688531000,364935000,1053466000
Südafrika,2014,7,807864000,350912000,1158776000
Südafrika,2014,8,699987000,423005000,1122992000
Südafrika,2014,9,809606000,404310000,1213916000
Südafrika,2014,10,787627000,405665000,1193292000
Südafrika,2014,11,628238000,434981000,1063219000
Südafrika,2014,12,732206000,403230000,1135436000
Südafrika,2015,1,754523000,396877000,1151400000
Südafrika,2015,2,745236000,490658000,1235894000
Südafrika,2015,3,941565000,589331000,1530896000
Südafrika,2015,4,854466000,508300000,1362766000
Südafrika,2015,5,747796000,499475000,1247271000
Südafrika,2015,6,842013000,499488000,1341501000
Südafrika,2015,7,939725000,516155000,1455880000
Südafrika,2015,8,793752000,500683000,1294435000
Südafrika,2015,9,908194000,499140000,1407334000
Südafrika,2015,10,757437000,489380000,1246817000
Südafrika,2015,11,620246000,472251000,1092497000
Südafrika,2015,12,720627000,440519000,1161146000
Südafrika,2016,1,645208000,388808000,1034016000
Südafrika,2016,2,693560000,440370000,1133930000
Südafrika,2016,3,766555000,491415000,1257970000
Südafrika,2016,4,755235000,471383000,1226618000
Südafrika,2016,5,692673000,533030000,1225703000
Südafrika,2016,6,801582000,578053000,1379635000
Südafrika,2016,7,734568000,513281000,1247849000
Südafrika,2016,8,828307000,552211000,1380518000
Südafrika,2016,9,828198000,512585000,1340783000
Südafrika,2016,10,686714000,604670000,1291384000
Südafrika,2016,11,599907000,536244000,1136151000
Südafrika,2016,12,777873000,598002000,1375875000
Südafrika,2017,1,788341000,503728000,1292069000
Südafrika,2017,2,775442000,502499000,1277941000
Südafrika,2017,3,896138000,807050000,1703188000
Südafrika,2017,4,771380000,632632000,1404012000
Südafrika,2017,5,910868000,696042000,1606910000
Südafrika,2017,6,832368000,613675000,1446043000
Südafrika,2017,7,812817000,670322000,1483139000
Südafrika,2017,8,863383000,683168000,1546551000
Südafrika,2017,9,827936000,551286000,1379222000
Südafrika,2017,10,782591000,477890000,1260481000
Südafrika,2017,11,590141000,554138000,1144279000
Südafrika,2017,12,675339000,584109000,1259448000
Südafrika,2018,1,739989000,543984000,1283973000
Südafrika,2018,2,643366000,485484000,1128850000
Südafrika,2018,3,721794000,600618000,1322412000
Südafrika,2018,4,718245000,613059000,1331304000
Südafrika,2018,5,780596000,505566000,1286162000
Südafrika,2018,6,828479000,765392000,1593871000
Südafrika,2018,7,836318000,656190000,1492508000
Südafrika,2018,8,895916000,702823000,1598739000
Südafrika,2018,9,773760000,726197000,1499957000
Südafrika,2018,10,760654000,854319000,1614973000
Südafrika,2018,11,597879000,839656000,1437535000
Südafrika,2018,12,559292000,730191000,1289483000
Südafrika,2019,1,802765000,846904000,1649669000
Südafrika,2019,2,772833000,492504000,1265337000
Südafrika,2019,3,731737000,772236000,1503973000
Südafrika,2019,4,722646000,783233000,1505879000
Südafrika,2019,5,854511000,851302000,1705813000
Südafrika,2019,6,759688000,682330000,1442018000
Südafrika,2019,7,955666000,774424000,1730090000
Südafrika,2019,8,820962000,789298000,1610260000
Südafrika,2019,9,794309000,999923000,1794232000
Südafrika,2019,10,664233000,891391000,1555624000
Südafrika,2019,11,522810000,896868000,1419678000
Südafrika,2019,12,832667000,817899000,1650566000
Südafrika,2020,1,804102000,823007000,1627109000
Südafrika,2020,2,742209000,607123000,1349332000
Südafrika,2020,3,610048000,964774000,1574822000
Südafrika,2020,4,289472000,564784000,854256000
Südafrika,2020,5,326055000,316251000,642306000
Südafrika,2020,6,408629000,385992000,794621000
Südafrika,2020,7,544899000,715045000,1259944000
Südafrika,2020,8,578554000,646077000,1224631000
Südafrika,2020,9,646992000,811246000,1458238000
Südafrika,2020,10,572341000,801533000,1373874000
Südafrika,2020,11,481864000,1035569000,1517433000
Südafrika,2020,12,535392000,855908000,1391300000
Südafrika,2021,1,663278000,959689000,1622967000
Südafrika,2021,2,689706000,880694000,1570400000
Südafrika,2021,3,712523000,1184503000,1897026000
Südafrika,2021,4,607159000,1068496000,1675655000
Südafrika,2021,5,615969000,1131781000,1747750000
Südafrika,2021,6,705672000,1228614000,1934286000
Südafrika,2021,7,754513000,980280000,1734793000
Südafrika,2021,8,752740000,1007646000,1760386000
Südafrika,2021,9,730499000,1029055000,1759554000
Südafrika,2021,10,587734000,996769000,1584503000
Südafrika,2021,11,541637000,861383000,1403020000
Südafrika,2021,12,617072000,951309000,1568381000
Südafrika,2022,1,673567000,1071648000,1745215000
Südafrika,2022,2,739843000,886935000,1626778000
Südafrika,2022,3,853854000,1522043000,2375897000
Südafrika,2022,4,767382000,1187967000,1955349000
Südafrika,2022,5,911945000,1321815000,2233760000
Südafrika,2022,6,843301000,1057025000,1900326000
Südafrika,2022,7,873238000,1328293000,2201531000
Südafrika,2022,8,893269000,1234561000,2127830000
Südafrika,2022,9,928233000,1233704000,2161937000
Südafrika,2022,10,795822000,1298843000,2094665000
Südafrika,2022,11,694982000,1138259000,1833241000
Südafrika,2022,12,812842000,1069434000,1882276000
Südafrika,2023,1,786653000,1251708000,2038361000
Südafrika,2023,2,843824000,881566000,1725390000
Südafrika,2023,3,903562000,1163422000,2066984000
Südafrika,2023,4,770133000,1048515000,1818648000
Südafrika,2023,5,832607000,1177665000,2010272000
Südafrika,2023,6,873111000,982942000,1856053000
Südafrika,2023,7,858878000,733190000,1592068000
Südafrika,2023,8,911760000,1007893000,1919653000
Südafrika,2023,9,804008000,974415000,1778423000
Südafrika,2023,10,750175000,891001000,1641176000
Südafrika,2023,11,745602000,920581000,1666183000
Südafrika,2023,12,774161000,939843000,1714004000
Südafrika,2024,1,851990000,872559000,1724549000
Südafrika,2024,2,808141000,658939000,1467080000
Südafrika,2024,3,788817000,1011199000,1800016000
Südafrika,2024,4,849242000,841229000,1690471000
Südafrika,2024,5,788281000,1040924000,1829205000
Südafrika,2024,6,673355000,959210000,1632565000
Südafrika,2024,7,786657000,857639000,1644296000
Südafrika,2024,8,722393000,995583000,1717976000
Südafrika,2024,9,741205000,703166000,1444371000
Südafrika,2024,10,705763000,920011000,1625774000
Südafrika,2024,11,684359000,802332000,1486691000
Südafrika,2024,12,711713000,853776000,1565489000
Südgeorgien u.d.Südlichen Sandwichinseln (ab 2001),2008,1,282000,0,282000
Südgeorgien u.d.Südlichen Sandwichinseln (ab 2001),2008,2,29000,0,29000
Südgeorgien u.d.Südlichen Sandwichinseln (ab 2001),2008,3,12000,0,12000
Südgeorgien u.d.Südlichen Sandwichinseln (ab 2001),2008,4,39000,0,39000
Südgeorgien u.d.Südlichen Sandwichinseln (ab 2001),2008,5,448000,0,448000
Südgeorgien u.d.Südlichen Sandwichinseln (ab 2001),2008,6,22000,0,22000
Südgeorgien u.d.Südlichen Sandwichinseln (ab 2001),2008,7,34000,0,34000
Südgeorgien u.d.Südlichen Sandwichinseln (ab 2001),2008,8,2000,0,2000
Südgeorgien u.d.Südlichen Sandwichinseln (ab 2001),2008,9,3000,0,3000
Südgeorgien u.d.Südlichen Sandwichinseln (ab 2001),2008,10,0,0,0
Südgeorgien u.d.Südlichen Sandwichinseln (ab 2001),2008,11,30000,0,30000
Südgeorgien u.d.Südlichen Sandwichinseln (ab 2001),2008,12,16000,0,16000
Südgeorgien u.d.Südlichen Sandwichinseln (ab 2001),2009,1,138000,0,138000
Südgeorgien u.d.Südlichen Sandwichinseln (ab 2001),2009,2,361000,0,361000
Südgeorgien u.d.Südlichen Sandwichinseln (ab 2001),2009,3,84000,0,84000
Südgeorgien u.d.Südlichen Sandwichinseln (ab 2001),2009,4,45000,0,45000
Südgeorgien u.d.Südlichen Sandwichinseln (ab 2001),2009,5,68000,52000,120000
Südgeorgien u.d.Südlichen Sandwichinseln (ab 2001),2009,6,24000,0,24000
Südgeorgien u.d.Südlichen Sandwichinseln (ab 2001),2009,7,18000,0,18000
Südgeorgien u.d.Südlichen Sandwichinseln (ab 2001),2009,8,1000,0,1000
Südgeorgien u.d.Südlichen Sandwichinseln (ab 2001),2009,9,7000,0,7000
Südgeorgien u.d.Südlichen Sandwichinseln (ab 2001),2009,10,10000,0,10000
Südgeorgien u.d.Südlichen Sandwichinseln (ab 2001),2009,11,29000,0,29000
Südgeorgien u.d.Südlichen Sandwichinseln (ab 2001),2009,12,20000,0,20000
Südgeorgien u.d.Südlichen Sandwichinseln (ab 2001),2010,1,47000,0,47000
Südgeorgien u.d.Südlichen Sandwichinseln (ab 2001),2010,2,44000,0,44000
Südgeorgien u.d.Südlichen Sandwichinseln (ab 2001),2010,3,3000,9000,12000
Südgeorgien u.d.Südlichen Sandwichinseln (ab 2001),2010,4,25000,0,25000
Südgeorgien u.d.Südlichen Sandwichinseln (ab 2001),2010,5,58000,0,58000
Südgeorgien u.d.Südlichen Sandwichinseln (ab 2001),2010,6,87000,0,87000
Südgeorgien u.d.Südlichen Sandwichinseln (ab 2001),2010,7,37000,0,37000
Südgeorgien u.d.Südlichen Sandwichinseln (ab 2001),2010,8,0,0,0
Südgeorgien u.d.Südlichen Sandwichinseln (ab 2001),2010,9,0,0,0
Südgeorgien u.d.Südlichen Sandwichinseln (ab 2001),2010,10,0,0,0
Südgeorgien u.d.Südlichen Sandwichinseln (ab 2001),2010,11,0,0,0
Südgeorgien u.d.Südlichen Sandwichinseln (ab 2001),2010,12,0,0,0
Südgeorgien u.d.Südlichen Sandwichinseln (ab 2001),2011,1,0,0,0
Südgeorgien u.d.Südlichen Sandwichinseln (ab 2001),2011,2,0,0,0
Südgeorgien u.d.Südlichen Sandwichinseln (ab 2001),2011,3,0,0,0
Südgeorgien u.d.Südlichen Sandwichinseln (ab 2001),2011,4,0,0,0
Südgeorgien u.d.Südlichen Sandwichinseln (ab 2001),2011,5,0,0,0
Südgeorgien u.d.Südlichen Sandwichinseln (ab 2001),2011,6,0,0,0
Südgeorgien u.d.Südlichen Sandwichinseln (ab 2001),2011,7,0,22000,22000
Südgeorgien u.d.Südlichen Sandwichinseln (ab 2001),2011,8,0,0,0
Südgeorgien u.d.Südlichen Sandwichinseln (ab 2001),2011,9,0,0,0
Südgeorgien u.d.Südlichen Sandwichinseln (ab 2001),2011,10,0,0,0
Südgeorgien u.d.Südlichen Sandwichinseln (ab 2001),2011,11,0,0,0
Südgeorgien u.d.Südlichen Sandwichinseln (ab 2001),2011,12,0,0,0
Südgeorgien u.d.Südlichen Sandwichinseln (ab 2001),2012,1,0,0,0
Südgeorgien u.d.Südlichen Sandwichinseln (ab 2001),2012,2,0,0,0
Südgeorgien u.d.Südlichen Sandwichinseln (ab 2001),2012,3,0,0,0
Südgeorgien u.d.Südlichen Sandwichinseln (ab 2001),2012,4,0,0,0
Südgeorgien u.d.Südlichen Sandwichinseln (ab 2001),2012,5,0,0,0
Südgeorgien u.d.Südlichen Sandwichinseln (ab 2001),2012,6,0,0,0
Südgeorgien u.d.Südlichen Sandwichinseln (ab 2001),2012,7,0,0,0
Südgeorgien u.d.Südlichen Sandwichinseln (ab 2001),2012,8,0,0,0
Südgeorgien u.d.Südlichen Sandwichinseln (ab 2001),2012,9,0,0,0
Südgeorgien u.d.Südlichen Sandwichinseln (ab 2001),2012,10,0,0,0
Südgeorgien u.d.Südlichen Sandwichinseln (ab 2001),2012,11,0,0,0
Südgeorgien u.d.Südlichen Sandwichinseln (ab 2001),2012,12,0,0,0
Südgeorgien u.d.Südlichen Sandwichinseln (ab 2001),2013,1,11000,0,11000
Südgeorgien u.d.Südlichen Sandwichinseln (ab 2001),2013,2,0,0,0
Südgeorgien u.d.Südlichen Sandwichinseln (ab 2001),2013,3,0,0,0
Südgeorgien u.d.Südlichen Sandwichinseln (ab 2001),2013,4,0,0,0
Südgeorgien u.d.Südlichen Sandwichinseln (ab 2001),2013,5,1000,0,1000
Südgeorgien u.d.Südlichen Sandwichinseln (ab 2001),2013,6,0,0,0
Südgeorgien u.d.Südlichen Sandwichinseln (ab 2001),2013,7,0,0,0
Südgeorgien u.d.Südlichen Sandwichinseln (ab 2001),2013,8,0,0,0
Südgeorgien u.d.Südlichen Sandwichinseln (ab 2001),2013,9,0,0,0
Südgeorgien u.d.Südlichen Sandwichinseln (ab 2001),2013,10,0,0,0
Südgeorgien u.d.Südlichen Sandwichinseln (ab 2001),2013,11,0,0,0
Südgeorgien u.d.Südlichen Sandwichinseln (ab 2001),2013,12,0,0,0
Südgeorgien u.d.Südlichen Sandwichinseln (ab 2001),2014,1,0,0,0
Südgeorgien u.d.Südlichen Sandwichinseln (ab 2001),2014,2,0,0,0
Südgeorgien u.d.Südlichen Sandwichinseln (ab 2001),2014,3,0,0,0
Südgeorgien u.d.Südlichen Sandwichinseln (ab 2001),2014,4,0,0,0
Südgeorgien u.d.Südlichen Sandwichinseln (ab 2001),2014,5,65000,0,65000
Südgeorgien u.d.Südlichen Sandwichinseln (ab 2001),2014,6,0,0,0
Südgeorgien u.d.Südlichen Sandwichinseln (ab 2001),2014,7,0,0,0
Südgeorgien u.d.Südlichen Sandwichinseln (ab 2001),2014,8,0,0,0
Südgeorgien u.d.Südlichen Sandwichinseln (ab 2001),2014,9,0,0,0
Südgeorgien u.d.Südlichen Sandwichinseln (ab 2001),2014,10,0,0,0
Südgeorgien u.d.Südlichen Sandwichinseln (ab 2001),2014,11,0,0,0
Südgeorgien u.d.Südlichen Sandwichinseln (ab 2001),2014,12,0,0,0
Südgeorgien u.d.Südlichen Sandwichinseln (ab 2001),2015,1,0,0,0
Südgeorgien u.d.Südlichen Sandwichinseln (ab 2001),2015,2,0,0,0
Südgeorgien u.d.Südlichen Sandwichinseln (ab 2001),2015,3,0,0,0
Südgeorgien u.d.Südlichen Sandwichinseln (ab 2001),2015,4,0,0,0
Südgeorgien u.d.Südlichen Sandwichinseln (ab 2001),2015,5,0,0,0
Südgeorgien u.d.Südlichen Sandwichinseln (ab 2001),2015,6,0,0,0
Südgeorgien u.d.Südlichen Sandwichinseln (ab 2001),2015,7,0,0,0
Südgeorgien u.d.Südlichen Sandwichinseln (ab 2001),2015,8,0,0,0
Südgeorgien u.d.Südlichen Sandwichinseln (ab 2001),2015,9,0,0,0
Südgeorgien u.d.Südlichen Sandwichinseln (ab 2001),2015,10,0,0,0
Südgeorgien u.d.Südlichen Sandwichinseln (ab 2001),2015,11,0,0,0
Südgeorgien u.d.Südlichen Sandwichinseln (ab 2001),2015,12,0,0,0
Südgeorgien u.d.Südlichen Sandwichinseln (ab 2001),2016,1,0,0,0
Südgeorgien u.d.Südlichen Sandwichinseln (ab 2001),2016,2,0,0,0
Südgeorgien u.d.Südlichen Sandwichinseln (ab 2001),2016,3,0,0,0
Südgeorgien u.d.Südlichen Sandwichinseln (ab 2001),2016,4,0,0,0
Südgeorgien u.d.Südlichen Sandwichinseln (ab 2001),2016,5,0,0,0
Südgeorgien u.d.Südlichen Sandwichinseln (ab 2001),2016,6,0,0,0
Südgeorgien u.d.Südlichen Sandwichinseln (ab 2001),2016,7,0,0,0
Südgeorgien u.d.Südlichen Sandwichinseln (ab 2001),2016,8,0,0,0
Südgeorgien u.d.Südlichen Sandwichinseln (ab 2001),2016,9,0,0,0
Südgeorgien u.d.Südlichen Sandwichinseln (ab 2001),2016,10,0,0,0
Südgeorgien u.d.Südlichen Sandwichinseln (ab 2001),2016,11,0,0,0
Südgeorgien u.d.Südlichen Sandwichinseln (ab 2001),2016,12,1000,0,1000
Südgeorgien u.d.Südlichen Sandwichinseln (ab 2001),2017,1,4000,0,4000
Südgeorgien u.d.Südlichen Sandwichinseln (ab 2001),2017,2,0,0,0
Südgeorgien u.d.Südlichen Sandwichinseln (ab 2001),2017,3,0,0,0
Südgeorgien u.d.Südlichen Sandwichinseln (ab 2001),2017,4,0,0,0
Südgeorgien u.d.Südlichen Sandwichinseln (ab 2001),2017,5,0,0,0
Südgeorgien u.d.Südlichen Sandwichinseln (ab 2001),2017,6,5000,0,5000
Südgeorgien u.d.Südlichen Sandwichinseln (ab 2001),2017,7,0,0,0
Südgeorgien u.d.Südlichen Sandwichinseln (ab 2001),2017,8,0,0,0
Südgeorgien u.d.Südlichen Sandwichinseln (ab 2001),2017,9,0,0,0
Südgeorgien u.d.Südlichen Sandwichinseln (ab 2001),2017,10,0,0,0
Südgeorgien u.d.Südlichen Sandwichinseln (ab 2001),2017,11,0,0,0
Südgeorgien u.d.Südlichen Sandwichinseln (ab 2001),2017,12,0,0,0
Südgeorgien u.d.Südlichen Sandwichinseln (ab 2001),2018,1,0,0,0
Südgeorgien u.d.Südlichen Sandwichinseln (ab 2001),2018,2,0,0,0
Südgeorgien u.d.Südlichen Sandwichinseln (ab 2001),2018,3,0,0,0
Südgeorgien u.d.Südlichen Sandwichinseln (ab 2001),2018,4,0,0,0
Südgeorgien u.d.Südlichen Sandwichinseln (ab 2001),2018,5,0,0,0
Südgeorgien u.d.Südlichen Sandwichinseln (ab 2001),2018,6,0,0,0
Südgeorgien u.d.Südlichen Sandwichinseln (ab 2001),2018,7,0,0,0
Südgeorgien u.d.Südlichen Sandwichinseln (ab 2001),2018,8,0,0,0
Südgeorgien u.d.Südlichen Sandwichinseln (ab 2001),2018,9,0,0,0
Südgeorgien u.d.Südlichen Sandwichinseln (ab 2001),2018,10,0,0,0
Südgeorgien u.d.Südlichen Sandwichinseln (ab 2001),2018,11,0,0,0
Südgeorgien u.d.Südlichen Sandwichinseln (ab 2001),2018,12,0,0,0
Südgeorgien u.d.Südlichen Sandwichinseln (ab 2001),2019,1,0,0,0
Südgeorgien u.d.Südlichen Sandwichinseln (ab 2001),2019,2,0,0,0
Südgeorgien u.d.Südlichen Sandwichinseln (ab 2001),2019,3,0,0,0
Südgeorgien u.d.Südlichen Sandwichinseln (ab 2001),2019,4,0,0,0
Südgeorgien u.d.Südlichen Sandwichinseln (ab 2001),2019,5,0,3000,3000
Südgeorgien u.d.Südlichen Sandwichinseln (ab 2001),2019,6,0,1000,1000
Südgeorgien u.d.Südlichen Sandwichinseln (ab 2001),2019,7,0,0,0
Südgeorgien u.d.Südlichen Sandwichinseln (ab 2001),2019,8,0,0,0
Südgeorgien u.d.Südlichen Sandwichinseln (ab 2001),2019,9,0,0,0
Südgeorgien u.d.Südlichen Sandwichinseln (ab 2001),2019,10,0,0,0
Südgeorgien u.d.Südlichen Sandwichinseln (ab 2001),2019,11,0,0,0
Südgeorgien u.d.Südlichen Sandwichinseln (ab 2001),2019,12,0,0,0
Südgeorgien u.d.Südlichen Sandwichinseln (ab 2001),2020,1,0,0,0
Südgeorgien u.d.Südlichen Sandwichinseln (ab 2001),2020,2,0,0,0
Südgeorgien u.d.Südlichen Sandwichinseln (ab 2001),2020,3,0,0,0
Südgeorgien u.d.Südlichen Sandwichinseln (ab 2001),2020,4,0,0,0
Südgeorgien u.d.Südlichen Sandwichinseln (ab 2001),2020,5,0,0,0
Südgeorgien u.d.Südlichen Sandwichinseln (ab 2001),2020,6,0,0,0
Südgeorgien u.d.Südlichen Sandwichinseln (ab 2001),2020,7,0,0,0
Südgeorgien u.d.Südlichen Sandwichinseln (ab 2001),2020,8,0,0,0
Südgeorgien u.d.Südlichen Sandwichinseln (ab 2001),2020,9,0,0,0
Südgeorgien u.d.Südlichen Sandwichinseln (ab 2001),2020,10,0,0,0
Südgeorgien u.d.Südlichen Sandwichinseln (ab 2001),2020,11,0,0,0
Südgeorgien u.d.Südlichen Sandwichinseln (ab 2001),2020,12,0,0,0
Südgeorgien u.d.Südlichen Sandwichinseln (ab 2001),2021,1,0,0,0
Südgeorgien u.d.Südlichen Sandwichinseln (ab 2001),2021,2,0,0,0
Südgeorgien u.d.Südlichen Sandwichinseln (ab 2001),2021,3,0,0,0
Südgeorgien u.d.Südlichen Sandwichinseln (ab 2001),2021,4,0,0,0
Südgeorgien u.d.Südlichen Sandwichinseln (ab 2001),2021,5,0,0,0
Südgeorgien u.d.Südlichen Sandwichinseln (ab 2001),2021,6,0,0,0
Südgeorgien u.d.Südlichen Sandwichinseln (ab 2001),2021,7,0,0,0
Südgeorgien u.d.Südlichen Sandwichinseln (ab 2001),2021,8,0,0,0
Südgeorgien u.d.Südlichen Sandwichinseln (ab 2001),2021,9,0,0,0
Südgeorgien u.d.Südlichen Sandwichinseln (ab 2001),2021,10,0,0,0
Südgeorgien u.d.Südlichen Sandwichinseln (ab 2001),2021,11,0,0,0
Südgeorgien u.d.Südlichen Sandwichinseln (ab 2001),2021,12,0,0,0
Südgeorgien u.d.Südlichen Sandwichinseln (ab 2001),2022,1,3000,0,3000
Südgeorgien u.d.Südlichen Sandwichinseln (ab 2001),2022,2,0,0,0
Südgeorgien u.d.Südlichen Sandwichinseln (ab 2001),2022,3,0,0,0
Südgeorgien u.d.Südlichen Sandwichinseln (ab 2001),2022,4,0,0,0
Südgeorgien u.d.Südlichen Sandwichinseln (ab 2001),2022,5,0,0,0
Südgeorgien u.d.Südlichen Sandwichinseln (ab 2001),2022,6,0,7000,7000
Südgeorgien u.d.Südlichen Sandwichinseln (ab 2001),2022,7,0,0,0
Südgeorgien u.d.Südlichen Sandwichinseln (ab 2001),2022,8,0,0,0
Südgeorgien u.d.Südlichen Sandwichinseln (ab 2001),2022,9,0,0,0
Südgeorgien u.d.Südlichen Sandwichinseln (ab 2001),2022,10,0,0,0
Südgeorgien u.d.Südlichen Sandwichinseln (ab 2001),2022,11,0,0,0
Südgeorgien u.d.Südlichen Sandwichinseln (ab 2001),2022,12,0,0,0
Südgeorgien u.d.Südlichen Sandwichinseln (ab 2001),2023,1,0,0,0
Südgeorgien u.d.Südlichen Sandwichinseln (ab 2001),2023,2,0,0,0
Südgeorgien u.d.Südlichen Sandwichinseln (ab 2001),2023,3,0,0,0
Südgeorgien u.d.Südlichen Sandwichinseln (ab 2001),2023,4,0,0,0
Südgeorgien u.d.Südlichen Sandwichinseln (ab 2001),2023,5,0,0,0
Südgeorgien u.d.Südlichen Sandwichinseln (ab 2001),2023,6,0,0,0
Südgeorgien u.d.Südlichen Sandwichinseln (ab 2001),2023,7,0,0,0
Südgeorgien u.d.Südlichen Sandwichinseln (ab 2001),2023,8,0,0,0
Südgeorgien u.d.Südlichen Sandwichinseln (ab 2001),2023,9,0,0,0
Südgeorgien u.d.Südlichen Sandwichinseln (ab 2001),2023,10,0,0,0
Südgeorgien u.d.Südlichen Sandwichinseln (ab 2001),2023,11,0,0,0
Südgeorgien u.d.Südlichen Sandwichinseln (ab 2001),2023,12,0,0,0
Südgeorgien u.d.Südlichen Sandwichinseln (ab 2001),2024,1,0,0,0
Südgeorgien u.d.Südlichen Sandwichinseln (ab 2001),2024,2,0,0,0
Südgeorgien u.d.Südlichen Sandwichinseln (ab 2001),2024,3,0,0,0
Südgeorgien u.d.Südlichen Sandwichinseln (ab 2001),2024,4,0,0,0
Südgeorgien u.d.Südlichen Sandwichinseln (ab 2001),2024,5,0,0,0
Südgeorgien u.d.Südlichen Sandwichinseln (ab 2001),2024,6,0,0,0
Südgeorgien u.d.Südlichen Sandwichinseln (ab 2001),2024,7,0,0,0
Südgeorgien u.d.Südlichen Sandwichinseln (ab 2001),2024,8,0,3000,3000
Südgeorgien u.d.Südlichen Sandwichinseln (ab 2001),2024,9,0,0,0
Südgeorgien u.d.Südlichen Sandwichinseln (ab 2001),2024,10,0,0,0
Südgeorgien u.d.Südlichen Sandwichinseln (ab 2001),2024,11,0,0,0
Südgeorgien u.d.Südlichen Sandwichinseln (ab 2001),2024,12,0,0,0
Südsudan (ab 2013),2008,1,0,0,0
Südsudan (ab 2013),2008,2,0,0,0
Südsudan (ab 2013),2008,3,0,0,0
Südsudan (ab 2013),2008,4,0,0,0
Südsudan (ab 2013),2008,5,0,0,0
Südsudan (ab 2013),2008,6,0,0,0
Südsudan (ab 2013),2008,7,0,0,0
Südsudan (ab 2013),2008,8,0,0,0
Südsudan (ab 2013),2008,9,0,0,0
Südsudan (ab 2013),2008,10,0,0,0
Südsudan (ab 2013),2008,11,0,0,0
Südsudan (ab 2013),2008,12,0,0,0
Südsudan (ab 2013),2009,1,0,0,0
Südsudan (ab 2013),2009,2,0,0,0
Südsudan (ab 2013),2009,3,0,0,0
Südsudan (ab 2013),2009,4,0,0,0
Südsudan (ab 2013),2009,5,0,0,0
Südsudan (ab 2013),2009,6,0,0,0
Südsudan (ab 2013),2009,7,0,0,0
Südsudan (ab 2013),2009,8,0,0,0
Südsudan (ab 2013),2009,9,0,0,0
Südsudan (ab 2013),2009,10,0,0,0
Südsudan (ab 2013),2009,11,0,0,0
Südsudan (ab 2013),2009,12,0,0,0
Südsudan (ab 2013),2010,1,0,0,0
Südsudan (ab 2013),2010,2,0,0,0
Südsudan (ab 2013),2010,3,0,0,0
Südsudan (ab 2013),2010,4,0,0,0
Südsudan (ab 2013),2010,5,0,0,0
Südsudan (ab 2013),2010,6,0,0,0
Südsudan (ab 2013),2010,7,0,0,0
Südsudan (ab 2013),2010,8,0,0,0
Südsudan (ab 2013),2010,9,0,0,0
Südsudan (ab 2013),2010,10,0,0,0
Südsudan (ab 2013),2010,11,0,0,0
Südsudan (ab 2013),2010,12,0,0,0
Südsudan (ab 2013),2011,1,0,0,0
Südsudan (ab 2013),2011,2,0,0,0
Südsudan (ab 2013),2011,3,0,0,0
Südsudan (ab 2013),2011,4,0,0,0
Südsudan (ab 2013),2011,5,0,0,0
Südsudan (ab 2013),2011,6,0,0,0
Südsudan (ab 2013),2011,7,0,0,0
Südsudan (ab 2013),2011,8,0,0,0
Südsudan (ab 2013),2011,9,0,0,0
Südsudan (ab 2013),2011,10,0,0,0
Südsudan (ab 2013),2011,11,0,0,0
Südsudan (ab 2013),2011,12,0,0,0
Südsudan (ab 2013),2012,1,0,0,0
Südsudan (ab 2013),2012,2,0,0,0
Südsudan (ab 2013),2012,3,0,0,0
Südsudan (ab 2013),2012,4,0,0,0
Südsudan (ab 2013),2012,5,0,0,0
Südsudan (ab 2013),2012,6,0,0,0
Südsudan (ab 2013),2012,7,0,0,0
Südsudan (ab 2013),2012,8,0,0,0
Südsudan (ab 2013),2012,9,0,0,0
Südsudan (ab 2013),2012,10,0,0,0
Südsudan (ab 2013),2012,11,0,0,0
Südsudan (ab 2013),2012,12,0,0,0
Südsudan (ab 2013),2013,1,240000,0,240000
Südsudan (ab 2013),2013,2,804000,0,804000
Südsudan (ab 2013),2013,3,358000,1000,359000
Südsudan (ab 2013),2013,4,3256000,0,3256000
Südsudan (ab 2013),2013,5,326000,0,326000
Südsudan (ab 2013),2013,6,413000,0,413000
Südsudan (ab 2013),2013,7,455000,2000,457000
Südsudan (ab 2013),2013,8,459000,4000,463000
Südsudan (ab 2013),2013,9,1134000,0,1134000
Südsudan (ab 2013),2013,10,2845000,3000,2848000
Südsudan (ab 2013),2013,11,414000,1000,415000
Südsudan (ab 2013),2013,12,457000,0,457000
Südsudan (ab 2013),2014,1,41000,1000,42000
Südsudan (ab 2013),2014,2,259000,1000,260000
Südsudan (ab 2013),2014,3,1123000,1000,1124000
Südsudan (ab 2013),2014,4,481000,0,481000
Südsudan (ab 2013),2014,5,146000,0,146000
Südsudan (ab 2013),2014,6,215000,0,215000
Südsudan (ab 2013),2014,7,417000,2000,419000
Südsudan (ab 2013),2014,8,558000,0,558000
Südsudan (ab 2013),2014,9,313000,3000,316000
Südsudan (ab 2013),2014,10,754000,0,754000
Südsudan (ab 2013),2014,11,313000,0,313000
Südsudan (ab 2013),2014,12,128000,24000,152000
Südsudan (ab 2013),2015,1,364000,7000,371000
Südsudan (ab 2013),2015,2,554000,0,554000
Südsudan (ab 2013),2015,3,229000,9000,238000
Südsudan (ab 2013),2015,4,386000,25000,411000
Südsudan (ab 2013),2015,5,330000,0,330000
Südsudan (ab 2013),2015,6,451000,0,451000
Südsudan (ab 2013),2015,7,4381000,0,4381000
Südsudan (ab 2013),2015,8,196000,8000,204000
Südsudan (ab 2013),2015,9,230000,1000,231000
Südsudan (ab 2013),2015,10,899000,7000,906000
Südsudan (ab 2013),2015,11,662000,2000,664000
Südsudan (ab 2013),2015,12,589000,27000,616000
Südsudan (ab 2013),2016,1,347000,0,347000
Südsudan (ab 2013),2016,2,271000,32000,303000
Südsudan (ab 2013),2016,3,374000,22000,396000
Südsudan (ab 2013),2016,4,1490000,32000,1522000
Südsudan (ab 2013),2016,5,222000,8000,230000
Südsudan (ab 2013),2016,6,319000,33000,352000
Südsudan (ab 2013),2016,7,1021000,12000,1033000
Südsudan (ab 2013),2016,8,114000,38000,152000
Südsudan (ab 2013),2016,9,289000,33000,322000
Südsudan (ab 2013),2016,10,99000,29000,128000
Südsudan (ab 2013),2016,11,197000,14000,211000
Südsudan (ab 2013),2016,12,318000,9000,327000
Südsudan (ab 2013),2017,1,370000,0,370000
Südsudan (ab 2013),2017,2,96000,12000,108000
Südsudan (ab 2013),2017,3,357000,5000,362000
Südsudan (ab 2013),2017,4,181000,0,181000
Südsudan (ab 2013),2017,5,248000,0,248000
Südsudan (ab 2013),2017,6,697000,16000,713000
Südsudan (ab 2013),2017,7,522000,15000,537000
Südsudan (ab 2013),2017,8,120000,2000,122000
Südsudan (ab 2013),2017,9,599000,9000,608000
Südsudan (ab 2013),2017,10,459000,5000,464000
Südsudan (ab 2013),2017,11,94000,9000,103000
Südsudan (ab 2013),2017,12,222000,13000,235000
Südsudan (ab 2013),2018,1,723000,0,723000
Südsudan (ab 2013),2018,2,323000,19000,342000
Südsudan (ab 2013),2018,3,362000,6000,368000
Südsudan (ab 2013),2018,4,0,8000,8000
Südsudan (ab 2013),2018,5,123000,10000,133000
Südsudan (ab 2013),2018,6,177000,58000,235000
Südsudan (ab 2013),2018,7,188000,3000,191000
Südsudan (ab 2013),2018,8,421000,1000,422000
Südsudan (ab 2013),2018,9,408000,0,408000
Südsudan (ab 2013),2018,10,1654000,4000,1658000
Südsudan (ab 2013),2018,11,206000,0,206000
Südsudan (ab 2013),2018,12,400000,16000,416000
Südsudan (ab 2013),2019,1,308000,4000,312000
Südsudan (ab 2013),2019,2,43000,7000,50000
Südsudan (ab 2013),2019,3,245000,0,245000
Südsudan (ab 2013),2019,4,2668000,2000,2670000
Südsudan (ab 2013),2019,5,1033000,24000,1057000
Südsudan (ab 2013),2019,6,1096000,0,1096000
Südsudan (ab 2013),2019,7,1094000,0,1094000
Südsudan (ab 2013),2019,8,203000,0,203000
Südsudan (ab 2013),2019,9,1462000,0,1462000
Südsudan (ab 2013),2019,10,613000,2000,615000
Südsudan (ab 2013),2019,11,480000,7000,487000
Südsudan (ab 2013),2019,12,269000,9000,278000
Südsudan (ab 2013),2020,1,170000,0,170000
Südsudan (ab 2013),2020,2,232000,0,232000
Südsudan (ab 2013),2020,3,446000,0,446000
Südsudan (ab 2013),2020,4,1031000,2000,1033000
Südsudan (ab 2013),2020,5,142000,3000,145000
Südsudan (ab 2013),2020,6,2104000,0,2104000
Südsudan (ab 2013),2020,7,1115000,0,1115000
Südsudan (ab 2013),2020,8,451000,0,451000
Südsudan (ab 2013),2020,9,967000,0,967000
Südsudan (ab 2013),2020,10,339000,5000,344000
Südsudan (ab 2013),2020,11,263000,0,263000
Südsudan (ab 2013),2020,12,826000,1000,827000
Südsudan (ab 2013),2021,1,1694000,3000,1697000
Südsudan (ab 2013),2021,2,311000,0,311000
Südsudan (ab 2013),2021,3,258000,0,258000
Südsudan (ab 2013),2021,4,369000,4000,373000
Südsudan (ab 2013),2021,5,380000,0,380000
Südsudan (ab 2013),2021,6,998000,0,998000
Südsudan (ab 2013),2021,7,600000,120000,720000
Südsudan (ab 2013),2021,8,255000,0,255000
Südsudan (ab 2013),2021,9,382000,0,382000
Südsudan (ab 2013),2021,10,833000,0,833000
Südsudan (ab 2013),2021,11,1410000,0,1410000
Südsudan (ab 2013),2021,12,625000,0,625000
Südsudan (ab 2013),2022,1,285000,0,285000
Südsudan (ab 2013),2022,2,18000,0,18000
Südsudan (ab 2013),2022,3,339000,2000,341000
Südsudan (ab 2013),2022,4,371000,0,371000
Südsudan (ab 2013),2022,5,435000,1000,436000
Südsudan (ab 2013),2022,6,75000,0,75000
Südsudan (ab 2013),2022,7,875000,0,875000
Südsudan (ab 2013),2022,8,618000,1000,619000
Südsudan (ab 2013),2022,9,772000,1000,773000
Südsudan (ab 2013),2022,10,891000,15000,906000
Südsudan (ab 2013),2022,11,470000,12000,482000
Südsudan (ab 2013),2022,12,253000,11000,264000
Südsudan (ab 2013),2023,1,1536000,4000,1540000
Südsudan (ab 2013),2023,2,458000,3000,461000
Südsudan (ab 2013),2023,3,401000,13000,414000
Südsudan (ab 2013),2023,4,304000,0,304000
Südsudan (ab 2013),2023,5,415000,2000,417000
Südsudan (ab 2013),2023,6,413000,25000,438000
Südsudan (ab 2013),2023,7,644000,234000,878000
Südsudan (ab 2013),2023,8,371000,0,371000
Südsudan (ab 2013),2023,9,1307000,0,1307000
Südsudan (ab 2013),2023,10,886000,0,886000
Südsudan (ab 2013),2023,11,1038000,0,1038000
Südsudan (ab 2013),2023,12,988000,0,988000
Südsudan (ab 2013),2024,1,558000,0,558000
Südsudan (ab 2013),2024,2,741000,0,741000
Südsudan (ab 2013),2024,3,773000,20000,793000
Südsudan (ab 2013),2024,4,331000,9000,340000
Südsudan (ab 2013),2024,5,313000,0,313000
Südsudan (ab 2013),2024,6,477000,0,477000
Südsudan (ab 2013),2024,7,571000,0,571000
Südsudan (ab 2013),2024,8,351000,0,351000
Südsudan (ab 2013),2024,9,538000,0,538000
Südsudan (ab 2013),2024,10,563000,279000,842000
Südsudan (ab 2013),2024,11,553000,0,553000
Südsudan (ab 2013),2024,12,446000,9000,455000
Tadschikistan (ab 05/1992),2008,1,707000,492000,1199000
Tadschikistan (ab 05/1992),2008,2,3344000,1461000,4805000
Tadschikistan (ab 05/1992),2008,3,1060000,845000,1905000
Tadschikistan (ab 05/1992),2008,4,2607000,1095000,3702000
Tadschikistan (ab 05/1992),2008,5,2329000,521000,2850000
Tadschikistan (ab 05/1992),2008,6,1373000,930000,2303000
Tadschikistan (ab 05/1992),2008,7,5581000,233000,5814000
Tadschikistan (ab 05/1992),2008,8,2249000,154000,2403000
Tadschikistan (ab 05/1992),2008,9,2247000,155000,2402000
Tadschikistan (ab 05/1992),2008,10,875000,447000,1322000
Tadschikistan (ab 05/1992),2008,11,2020000,33000,2053000
Tadschikistan (ab 05/1992),2008,12,2007000,308000,2315000
Tadschikistan (ab 05/1992),2009,1,925000,464000,1389000
Tadschikistan (ab 05/1992),2009,2,1663000,4000,1667000
Tadschikistan (ab 05/1992),2009,3,1628000,1000,1629000
Tadschikistan (ab 05/1992),2009,4,1501000,119000,1620000
Tadschikistan (ab 05/1992),2009,5,2322000,141000,2463000
Tadschikistan (ab 05/1992),2009,6,3199000,48000,3247000
Tadschikistan (ab 05/1992),2009,7,3028000,542000,3570000
Tadschikistan (ab 05/1992),2009,8,3887000,138000,4025000
Tadschikistan (ab 05/1992),2009,9,1383000,120000,1503000
Tadschikistan (ab 05/1992),2009,10,1579000,71000,1650000
Tadschikistan (ab 05/1992),2009,11,2103000,130000,2233000
Tadschikistan (ab 05/1992),2009,12,2487000,1000,2488000
Tadschikistan (ab 05/1992),2010,1,1354000,198000,1552000
Tadschikistan (ab 05/1992),2010,2,1032000,578000,1610000
Tadschikistan (ab 05/1992),2010,3,4629000,211000,4840000
Tadschikistan (ab 05/1992),2010,4,6484000,189000,6673000
Tadschikistan (ab 05/1992),2010,5,3739000,0,3739000
Tadschikistan (ab 05/1992),2010,6,1390000,113000,1503000
Tadschikistan (ab 05/1992),2010,7,7120000,37000,7157000
Tadschikistan (ab 05/1992),2010,8,4102000,344000,4446000
Tadschikistan (ab 05/1992),2010,9,2737000,0,2737000
Tadschikistan (ab 05/1992),2010,10,1201000,129000,1330000
Tadschikistan (ab 05/1992),2010,11,1191000,369000,1560000
Tadschikistan (ab 05/1992),2010,12,788000,378000,1166000
Tadschikistan (ab 05/1992),2011,1,658000,277000,935000
Tadschikistan (ab 05/1992),2011,2,542000,238000,780000
Tadschikistan (ab 05/1992),2011,3,1723000,262000,1985000
Tadschikistan (ab 05/1992),2011,4,2717000,166000,2883000
Tadschikistan (ab 05/1992),2011,5,1811000,269000,2080000
Tadschikistan (ab 05/1992),2011,6,1807000,88000,1895000
Tadschikistan (ab 05/1992),2011,7,1368000,113000,1481000
Tadschikistan (ab 05/1992),2011,8,1916000,19000,1935000
Tadschikistan (ab 05/1992),2011,9,2158000,59000,2217000
Tadschikistan (ab 05/1992),2011,10,2028000,65000,2093000
Tadschikistan (ab 05/1992),2011,11,4278000,38000,4316000
Tadschikistan (ab 05/1992),2011,12,3949000,130000,4079000
Tadschikistan (ab 05/1992),2012,1,2109000,150000,2259000
Tadschikistan (ab 05/1992),2012,2,3419000,116000,3535000
Tadschikistan (ab 05/1992),2012,3,1351000,278000,1629000
Tadschikistan (ab 05/1992),2012,4,2089000,202000,2291000
Tadschikistan (ab 05/1992),2012,5,2736000,457000,3193000
Tadschikistan (ab 05/1992),2012,6,1384000,342000,1726000
Tadschikistan (ab 05/1992),2012,7,4429000,243000,4672000
Tadschikistan (ab 05/1992),2012,8,3291000,66000,3357000
Tadschikistan (ab 05/1992),2012,9,1760000,181000,1941000
Tadschikistan (ab 05/1992),2012,10,1806000,220000,2026000
Tadschikistan (ab 05/1992),2012,11,2472000,401000,2873000
Tadschikistan (ab 05/1992),2012,12,1554000,272000,1826000
Tadschikistan (ab 05/1992),2013,1,828000,654000,1482000
Tadschikistan (ab 05/1992),2013,2,4113000,553000,4666000
Tadschikistan (ab 05/1992),2013,3,1423000,99000,1522000
Tadschikistan (ab 05/1992),2013,4,1719000,285000,2004000
Tadschikistan (ab 05/1992),2013,5,4139000,337000,4476000
Tadschikistan (ab 05/1992),2013,6,1661000,435000,2096000
Tadschikistan (ab 05/1992),2013,7,4348000,220000,4568000
Tadschikistan (ab 05/1992),2013,8,2196000,426000,2622000
Tadschikistan (ab 05/1992),2013,9,5117000,295000,5412000
Tadschikistan (ab 05/1992),2013,10,2215000,41000,2256000
Tadschikistan (ab 05/1992),2013,11,1982000,358000,2340000
Tadschikistan (ab 05/1992),2013,12,6081000,40000,6121000
Tadschikistan (ab 05/1992),2014,1,3419000,546000,3965000
Tadschikistan (ab 05/1992),2014,2,3451000,39000,3490000
Tadschikistan (ab 05/1992),2014,3,1557000,257000,1814000
Tadschikistan (ab 05/1992),2014,4,3400000,429000,3829000
Tadschikistan (ab 05/1992),2014,5,3297000,16000,3313000
Tadschikistan (ab 05/1992),2014,6,2444000,311000,2755000
Tadschikistan (ab 05/1992),2014,7,4766000,294000,5060000
Tadschikistan (ab 05/1992),2014,8,3869000,156000,4025000
Tadschikistan (ab 05/1992),2014,9,4104000,291000,4395000
Tadschikistan (ab 05/1992),2014,10,8063000,169000,8232000
Tadschikistan (ab 05/1992),2014,11,3347000,34000,3381000
Tadschikistan (ab 05/1992),2014,12,2797000,209000,3006000
Tadschikistan (ab 05/1992),2015,1,1542000,169000,1711000
Tadschikistan (ab 05/1992),2015,2,6245000,40000,6285000
Tadschikistan (ab 05/1992),2015,3,4171000,37000,4208000
Tadschikistan (ab 05/1992),2015,4,6495000,228000,6723000
Tadschikistan (ab 05/1992),2015,5,2553000,134000,2687000
Tadschikistan (ab 05/1992),2015,6,2515000,491000,3006000
Tadschikistan (ab 05/1992),2015,7,2365000,205000,2570000
Tadschikistan (ab 05/1992),2015,8,1646000,89000,1735000
Tadschikistan (ab 05/1992),2015,9,1861000,416000,2277000
Tadschikistan (ab 05/1992),2015,10,4469000,16000,4485000
Tadschikistan (ab 05/1992),2015,11,7479000,47000,7526000
Tadschikistan (ab 05/1992),2015,12,3333000,38000,3371000
Tadschikistan (ab 05/1992),2016,1,1392000,79000,1471000
Tadschikistan (ab 05/1992),2016,2,1087000,170000,1257000
Tadschikistan (ab 05/1992),2016,3,2528000,66000,2594000
Tadschikistan (ab 05/1992),2016,4,2084000,81000,2165000
Tadschikistan (ab 05/1992),2016,5,1221000,47000,1268000
Tadschikistan (ab 05/1992),2016,6,2940000,154000,3094000
Tadschikistan (ab 05/1992),2016,7,2491000,4000,2495000
Tadschikistan (ab 05/1992),2016,8,6068000,2000,6070000
Tadschikistan (ab 05/1992),2016,9,3146000,301000,3447000
Tadschikistan (ab 05/1992),2016,10,3648000,126000,3774000
Tadschikistan (ab 05/1992),2016,11,7354000,185000,7539000
Tadschikistan (ab 05/1992),2016,12,5089000,88000,5177000
Tadschikistan (ab 05/1992),2017,1,908000,278000,1186000
Tadschikistan (ab 05/1992),2017,2,2203000,159000,2362000
Tadschikistan (ab 05/1992),2017,3,1580000,148000,1728000
Tadschikistan (ab 05/1992),2017,4,1668000,45000,1713000
Tadschikistan (ab 05/1992),2017,5,6088000,147000,6235000
Tadschikistan (ab 05/1992),2017,6,2321000,252000,2573000
Tadschikistan (ab 05/1992),2017,7,11769000,239000,12008000
Tadschikistan (ab 05/1992),2017,8,4002000,82000,4084000
Tadschikistan (ab 05/1992),2017,9,1328000,106000,1434000
Tadschikistan (ab 05/1992),2017,10,6687000,81000,6768000
Tadschikistan (ab 05/1992),2017,11,8430000,108000,8538000
Tadschikistan (ab 05/1992),2017,12,7666000,101000,7767000
Tadschikistan (ab 05/1992),2018,1,4481000,72000,4553000
Tadschikistan (ab 05/1992),2018,2,5665000,77000,5742000
Tadschikistan (ab 05/1992),2018,3,6486000,92000,6578000
Tadschikistan (ab 05/1992),2018,4,2896000,357000,3253000
Tadschikistan (ab 05/1992),2018,5,4023000,143000,4166000
Tadschikistan (ab 05/1992),2018,6,3607000,230000,3837000
Tadschikistan (ab 05/1992),2018,7,3599000,232000,3831000
Tadschikistan (ab 05/1992),2018,8,1654000,63000,1717000
Tadschikistan (ab 05/1992),2018,9,5024000,5000,5029000
Tadschikistan (ab 05/1992),2018,10,6410000,153000,6563000
Tadschikistan (ab 05/1992),2018,11,2444000,75000,2519000
Tadschikistan (ab 05/1992),2018,12,1516000,55000,1571000
Tadschikistan (ab 05/1992),2019,1,1415000,78000,1493000
Tadschikistan (ab 05/1992),2019,2,1694000,125000,1819000
Tadschikistan (ab 05/1992),2019,3,2137000,270000,2407000
Tadschikistan (ab 05/1992),2019,4,2703000,184000,2887000
Tadschikistan (ab 05/1992),2019,5,2586000,152000,2738000
Tadschikistan (ab 05/1992),2019,6,1325000,94000,1419000
Tadschikistan (ab 05/1992),2019,7,1793000,67000,1860000
Tadschikistan (ab 05/1992),2019,8,1901000,158000,2059000
Tadschikistan (ab 05/1992),2019,9,1300000,384000,1684000
Tadschikistan (ab 05/1992),2019,10,4788000,182000,4970000
Tadschikistan (ab 05/1992),2019,11,3518000,127000,3645000
Tadschikistan (ab 05/1992),2019,12,3453000,280000,3733000
Tadschikistan (ab 05/1992),2020,1,1119000,347000,1466000
Tadschikistan (ab 05/1992),2020,2,4747000,214000,4961000
Tadschikistan (ab 05/1992),2020,3,1835000,278000,2113000
Tadschikistan (ab 05/1992),2020,4,1970000,113000,2083000
Tadschikistan (ab 05/1992),2020,5,815000,454000,1269000
Tadschikistan (ab 05/1992),2020,6,1304000,126000,1430000
Tadschikistan (ab 05/1992),2020,7,2534000,323000,2857000
Tadschikistan (ab 05/1992),2020,8,1551000,295000,1846000
Tadschikistan (ab 05/1992),2020,9,6286000,317000,6603000
Tadschikistan (ab 05/1992),2020,10,4641000,423000,5064000
Tadschikistan (ab 05/1992),2020,11,4016000,504000,4520000
Tadschikistan (ab 05/1992),2020,12,4999000,286000,5285000
Tadschikistan (ab 05/1992),2021,1,4126000,337000,4463000
Tadschikistan (ab 05/1992),2021,2,3001000,292000,3293000
Tadschikistan (ab 05/1992),2021,3,3324000,285000,3609000
Tadschikistan (ab 05/1992),2021,4,2681000,306000,2987000
Tadschikistan (ab 05/1992),2021,5,2930000,224000,3154000
Tadschikistan (ab 05/1992),2021,6,2054000,205000,2259000
Tadschikistan (ab 05/1992),2021,7,2230000,112000,2342000
Tadschikistan (ab 05/1992),2021,8,1705000,125000,1830000
Tadschikistan (ab 05/1992),2021,9,1878000,225000,2103000
Tadschikistan (ab 05/1992),2021,10,2285000,257000,2542000
Tadschikistan (ab 05/1992),2021,11,3392000,296000,3688000
Tadschikistan (ab 05/1992),2021,12,3098000,214000,3312000
Tadschikistan (ab 05/1992),2022,1,2032000,260000,2292000
Tadschikistan (ab 05/1992),2022,2,5874000,188000,6062000
Tadschikistan (ab 05/1992),2022,3,3099000,246000,3345000
Tadschikistan (ab 05/1992),2022,4,2006000,258000,2264000
Tadschikistan (ab 05/1992),2022,5,2547000,380000,2927000
Tadschikistan (ab 05/1992),2022,6,5701000,408000,6109000
Tadschikistan (ab 05/1992),2022,7,5266000,110000,5376000
Tadschikistan (ab 05/1992),2022,8,3582000,134000,3716000
Tadschikistan (ab 05/1992),2022,9,5196000,57000,5253000
Tadschikistan (ab 05/1992),2022,10,6220000,65000,6285000
Tadschikistan (ab 05/1992),2022,11,6302000,107000,6409000
Tadschikistan (ab 05/1992),2022,12,9032000,62000,9094000
Tadschikistan (ab 05/1992),2023,1,7763000,124000,7887000
Tadschikistan (ab 05/1992),2023,2,8374000,164000,8538000
Tadschikistan (ab 05/1992),2023,3,12255000,98000,12353000
Tadschikistan (ab 05/1992),2023,4,8588000,104000,8692000
Tadschikistan (ab 05/1992),2023,5,6776000,414000,7190000
Tadschikistan (ab 05/1992),2023,6,7554000,388000,7942000
Tadschikistan (ab 05/1992),2023,7,7489000,219000,7708000
Tadschikistan (ab 05/1992),2023,8,5061000,181000,5242000
Tadschikistan (ab 05/1992),2023,9,4522000,455000,4977000
Tadschikistan (ab 05/1992),2023,10,3455000,517000,3972000
Tadschikistan (ab 05/1992),2023,11,3798000,440000,4238000
Tadschikistan (ab 05/1992),2023,12,3574000,780000,4354000
Tadschikistan (ab 05/1992),2024,1,3152000,237000,3389000
Tadschikistan (ab 05/1992),2024,2,5474000,200000,5674000
Tadschikistan (ab 05/1992),2024,3,4299000,318000,4617000
Tadschikistan (ab 05/1992),2024,4,5593000,274000,5867000
Tadschikistan (ab 05/1992),2024,5,2596000,427000,3023000
Tadschikistan (ab 05/1992),2024,6,4703000,260000,4963000
Tadschikistan (ab 05/1992),2024,7,3911000,139000,4050000
Tadschikistan (ab 05/1992),2024,8,4690000,220000,4910000
Tadschikistan (ab 05/1992),2024,9,3612000,213000,3825000
Tadschikistan (ab 05/1992),2024,10,4189000,230000,4419000
Tadschikistan (ab 05/1992),2024,11,3696000,225000,3921000
Tadschikistan (ab 05/1992),2024,12,4133000,124000,4257000
Taiwan,2008,1,535577000,566075000,1101652000
Taiwan,2008,2,362356000,476325000,838681000
Taiwan,2008,3,453926000,447707000,901633000
Taiwan,2008,4,409727000,467600000,877327000
Taiwan,2008,5,414090000,432614000,846704000
Taiwan,2008,6,395442000,431772000,827214000
Taiwan,2008,7,511873000,473716000,985589000
Taiwan,2008,8,401470000,459254000,860724000
Taiwan,2008,9,420463000,481011000,901474000
Taiwan,2008,10,349172000,521869000,871041000
Taiwan,2008,11,302470000,496155000,798625000
Taiwan,2008,12,266976000,398853000,665829000
Taiwan,2009,1,215507000,442390000,657897000
Taiwan,2009,2,220615000,343151000,563766000
Taiwan,2009,3,281504000,359561000,641065000
Taiwan,2009,4,266151000,356279000,622430000
Taiwan,2009,5,269591000,312440000,582031000
Taiwan,2009,6,331287000,347634000,678921000
Taiwan,2009,7,394905000,379768000,774673000
Taiwan,2009,8,385248000,384564000,769812000
Taiwan,2009,9,372431000,427400000,799831000
Taiwan,2009,10,407643000,490472000,898115000
Taiwan,2009,11,380423000,494107000,874530000
Taiwan,2009,12,360009000,396991000,757000000
Taiwan,2010,1,358152000,458850000,817002000
Taiwan,2010,2,403872000,381639000,785511000
Taiwan,2010,3,591623000,455988000,1047611000
Taiwan,2010,4,484199000,464382000,948581000
Taiwan,2010,5,517406000,620647000,1138053000
Taiwan,2010,6,556098000,568776000,1124874000
Taiwan,2010,7,490596000,501160000,991756000
Taiwan,2010,8,509546000,555287000,1064833000
Taiwan,2010,9,527253000,610459000,1137712000
Taiwan,2010,10,533036000,585335000,1118371000
Taiwan,2010,11,591151000,771093000,1362244000
Taiwan,2010,12,484404000,560159000,1044563000
Taiwan,2011,1,513640000,672486000,1186126000
Taiwan,2011,2,503975000,587130000,1091105000
Taiwan,2011,3,595477000,588558000,1184035000
Taiwan,2011,4,536357000,573909000,1110266000
Taiwan,2011,5,602606000,551610000,1154216000
Taiwan,2011,6,499606000,547906000,1047512000
Taiwan,2011,7,565018000,560177000,1125195000
Taiwan,2011,8,503356000,591513000,1094869000
Taiwan,2011,9,562387000,532222000,1094609000
Taiwan,2011,10,459376000,619906000,1079282000
Taiwan,2011,11,497115000,552930000,1050045000
Taiwan,2011,12,430244000,472816000,903060000
Taiwan,2012,1,439707000,583568000,1023275000
Taiwan,2012,2,471010000,556146000,1027156000
Taiwan,2012,3,488928000,524802000,1013730000
Taiwan,2012,4,451480000,538577000,990057000
Taiwan,2012,5,488227000,603794000,1092021000
Taiwan,2012,6,477974000,553751000,1031725000
Taiwan,2012,7,500877000,591852000,1092729000
Taiwan,2012,8,534994000,567061000,1102055000
Taiwan,2012,9,441023000,527592000,968615000
Taiwan,2012,10,561118000,576383000,1137501000
Taiwan,2012,11,449930000,471780000,921710000
Taiwan,2012,12,485748000,413644000,899392000
Taiwan,2013,1,471342000,590755000,1062097000
Taiwan,2013,2,464927000,467862000,932789000
Taiwan,2013,3,511398000,476290000,987688000
Taiwan,2013,4,507612000,575394000,1083006000
Taiwan,2013,5,467149000,543733000,1010882000
Taiwan,2013,6,477688000,493977000,971665000
Taiwan,2013,7,520732000,540162000,1060894000
Taiwan,2013,8,495455000,498155000,993610000
Taiwan,2013,9,482336000,563199000,1045535000
Taiwan,2013,10,537267000,651376000,1188643000
Taiwan,2013,11,529969000,604478000,1134447000
Taiwan,2013,12,418357000,466361000,884718000
Taiwan,2014,1,503673000,612603000,1116276000
Taiwan,2014,2,491305000,510594000,1001899000
Taiwan,2014,3,722561000,541157000,1263718000
Taiwan,2014,4,531057000,635717000,1166774000
Taiwan,2014,5,592421000,543521000,1135942000
Taiwan,2014,6,520104000,595315000,1115419000
Taiwan,2014,7,624591000,656546000,1281137000
Taiwan,2014,8,547771000,584926000,1132697000
Taiwan,2014,9,696605000,617940000,1314545000
Taiwan,2014,10,659313000,634771000,1294084000
Taiwan,2014,11,479592000,634476000,1114068000
Taiwan,2014,12,507450000,566597000,1074047000
Taiwan,2015,1,488871000,649962000,1138833000
Taiwan,2015,2,570970000,647094000,1218064000
Taiwan,2015,3,684375000,720513000,1404888000
Taiwan,2015,4,680095000,641951000,1322046000
Taiwan,2015,5,702191000,648647000,1350838000
Taiwan,2015,6,651597000,703768000,1355365000
Taiwan,2015,7,800984000,694381000,1495365000
Taiwan,2015,8,635246000,675500000,1310746000
Taiwan,2015,9,589951000,704853000,1294804000
Taiwan,2015,10,582829000,729501000,1312330000
Taiwan,2015,11,500709000,704808000,1205517000
Taiwan,2015,12,500226000,645576000,1145802000
Taiwan,2016,1,594842000,719572000,1314414000
Taiwan,2016,2,570854000,695051000,1265905000
Taiwan,2016,3,574635000,720258000,1294893000
Taiwan,2016,4,632238000,697625000,1329863000
Taiwan,2016,5,582304000,724128000,1306432000
Taiwan,2016,6,647335000,706990000,1354325000
Taiwan,2016,7,599567000,671845000,1271412000
Taiwan,2016,8,637265000,769247000,1406512000
Taiwan,2016,9,729592000,725856000,1455448000
Taiwan,2016,10,756183000,748015000,1504198000
Taiwan,2016,11,607633000,740556000,1348189000
Taiwan,2016,12,610577000,651012000,1261589000
Taiwan,2017,1,598512000,809388000,1407900000
Taiwan,2017,2,570584000,732639000,1303223000
Taiwan,2017,3,737144000,828410000,1565554000
Taiwan,2017,4,610870000,728930000,1339800000
Taiwan,2017,5,627906000,845123000,1473029000
Taiwan,2017,6,609669000,827174000,1436843000
Taiwan,2017,7,659890000,825728000,1485618000
Taiwan,2017,8,650950000,848056000,1499006000
Taiwan,2017,9,690024000,765980000,1456004000
Taiwan,2017,10,616333000,821759000,1438092000
Taiwan,2017,11,655510000,805857000,1461367000
Taiwan,2017,12,651929000,648478000,1300407000
Taiwan,2018,1,684077000,916362000,1600439000
Taiwan,2018,2,538668000,765789000,1304457000
Taiwan,2018,3,709819000,798533000,1508352000
Taiwan,2018,4,641435000,815407000,1456842000
Taiwan,2018,5,677903000,815555000,1493458000
Taiwan,2018,6,636920000,904013000,1540933000
Taiwan,2018,7,759718000,926601000,1686319000
Taiwan,2018,8,762086000,885517000,1647603000
Taiwan,2018,9,674953000,823057000,1498010000
Taiwan,2018,10,678547000,944057000,1622604000
Taiwan,2018,11,611119000,866168000,1477287000
Taiwan,2018,12,516273000,728440000,1244713000
Taiwan,2019,1,635375000,1014301000,1649676000
Taiwan,2019,2,593437000,829297000,1422734000
Taiwan,2019,3,720487000,839893000,1560380000
Taiwan,2019,4,619562000,864811000,1484373000
Taiwan,2019,5,663107000,856451000,1519558000
Taiwan,2019,6,594783000,784864000,1379647000
Taiwan,2019,7,735424000,908339000,1643763000
Taiwan,2019,8,655248000,806739000,1461987000
Taiwan,2019,9,625603000,871612000,1497215000
Taiwan,2019,10,741933000,879844000,1621777000
Taiwan,2019,11,611814000,778777000,1390591000
Taiwan,2019,12,601143000,681876000,1283019000
Taiwan,2020,1,730666000,895014000,1625680000
Taiwan,2020,2,730721000,787254000,1517975000
Taiwan,2020,3,718338000,780357000,1498695000
Taiwan,2020,4,619959000,811101000,1431060000
Taiwan,2020,5,563959000,716870000,1280829000
Taiwan,2020,6,712931000,779998000,1492929000
Taiwan,2020,7,730012000,812465000,1542477000
Taiwan,2020,8,584649000,712705000,1297354000
Taiwan,2020,9,735763000,786005000,1521768000
Taiwan,2020,10,767116000,820312000,1587428000
Taiwan,2020,11,647225000,834946000,1482171000
Taiwan,2020,12,649268000,816584000,1465852000
Taiwan,2021,1,694190000,834601000,1528791000
Taiwan,2021,2,691277000,801403000,1492680000
Taiwan,2021,3,905786000,950470000,1856256000
Taiwan,2021,4,761833000,887283000,1649116000
Taiwan,2021,5,759261000,975711000,1734972000
Taiwan,2021,6,770920000,1079532000,1850452000
Taiwan,2021,7,756907000,913244000,1670151000
Taiwan,2021,8,680920000,1105143000,1786063000
Taiwan,2021,9,681231000,1195753000,1876984000
Taiwan,2021,10,752023000,1141675000,1893698000
Taiwan,2021,11,925060000,1231402000,2156462000
Taiwan,2021,12,953583000,1086057000,2039640000
Taiwan,2022,1,742447000,1368897000,2111344000
Taiwan,2022,2,872318000,1194690000,2067008000
Taiwan,2022,3,947107000,1267677000,2214784000
Taiwan,2022,4,901880000,1253896000,2155776000
Taiwan,2022,5,906679000,1455156000,2361835000
Taiwan,2022,6,963540000,1476651000,2440191000
Taiwan,2022,7,879481000,1332842000,2212323000
Taiwan,2022,8,815257000,1390799000,2206056000
Taiwan,2022,9,945395000,1468001000,2413396000
Taiwan,2022,10,942092000,1735540000,2677632000
Taiwan,2022,11,943440000,1762676000,2706116000
Taiwan,2022,12,1175619000,1281240000,2456859000
Taiwan,2023,1,759950000,1426159000,2186109000
Taiwan,2023,2,837816000,1337237000,2175053000
Taiwan,2023,3,974593000,1386714000,2361307000
Taiwan,2023,4,796758000,1306939000,2103697000
Taiwan,2023,5,830068000,1377782000,2207850000
Taiwan,2023,6,903466000,1378215000,2281681000
Taiwan,2023,7,784196000,1360444000,2144640000
Taiwan,2023,8,785651000,1318606000,2104257000
Taiwan,2023,9,898517000,1288739000,2187256000
Taiwan,2023,10,705233000,1396041000,2101274000
Taiwan,2023,11,828604000,1138417000,1967021000
Taiwan,2023,12,787222000,1084784000,1872006000
Taiwan,2024,1,698731000,1239528000,1938259000
Taiwan,2024,2,757727000,1141039000,1898766000
Taiwan,2024,3,981655000,1124915000,2106570000
Taiwan,2024,4,970310000,1111729000,2082039000
Taiwan,2024,5,808313000,1161572000,1969885000
Taiwan,2024,6,801925000,1189358000,1991283000
Taiwan,2024,7,882944000,1166222000,2049166000
Taiwan,2024,8,745811000,990781000,1736592000
Taiwan,2024,9,732017000,1299915000,2031932000
Taiwan,2024,10,795806000,1212668000,2008474000
Taiwan,2024,11,857571000,1129410000,1986981000
Taiwan,2024,12,692539000,1225008000,1917547000
Thailand,2008,1,238708000,282111000,520819000
Thailand,2008,2,204968000,284008000,488976000
Thailand,2008,3,264100000,267192000,531292000
Thailand,2008,4,243511000,295400000,538911000
Thailand,2008,5,174998000,269173000,444171000
Thailand,2008,6,200145000,265351000,465496000
Thailand,2008,7,208062000,267836000,475898000
Thailand,2008,8,195374000,262881000,458255000
Thailand,2008,9,195935000,309554000,505489000
Thailand,2008,10,205751000,319394000,525145000
Thailand,2008,11,222543000,333660000,556203000
Thailand,2008,12,164692000,259408000,424100000
Thailand,2009,1,190572000,269740000,460312000
Thailand,2009,2,165102000,246080000,411182000
Thailand,2009,3,178019000,277341000,455360000
Thailand,2009,4,140580000,238394000,378974000
Thailand,2009,5,181083000,208311000,389394000
Thailand,2009,6,158015000,251609000,409624000
Thailand,2009,7,198105000,244813000,442918000
Thailand,2009,8,179083000,244569000,423652000
Thailand,2009,9,169002000,266612000,435614000
Thailand,2009,10,189516000,261239000,450755000
Thailand,2009,11,171834000,274090000,445924000
Thailand,2009,12,200439000,248661000,449100000
Thailand,2010,1,167642000,305949000,473591000
Thailand,2010,2,178468000,254774000,433242000
Thailand,2010,3,242164000,340272000,582436000
Thailand,2010,4,217381000,295316000,512697000
Thailand,2010,5,252552000,289441000,541993000
Thailand,2010,6,258121000,321931000,580052000
Thailand,2010,7,261496000,332380000,593876000
Thailand,2010,8,212703000,317406000,530109000
Thailand,2010,9,250192000,354525000,604717000
Thailand,2010,10,241134000,341836000,582970000
Thailand,2010,11,244679000,395504000,640183000
Thailand,2010,12,252168000,308501000,560669000
Thailand,2011,1,236949000,344508000,581457000
Thailand,2011,2,233566000,316272000,549838000
Thailand,2011,3,281997000,412057000,694054000
Thailand,2011,4,227983000,324250000,552233000
Thailand,2011,5,313930000,343514000,657444000
Thailand,2011,6,261842000,317182000,579024000
Thailand,2011,7,281106000,331473000,612579000
Thailand,2011,8,296321000,379899000,676220000
Thailand,2011,9,281822000,372113000,653935000
Thailand,2011,10,231699000,352861000,584560000
Thailand,2011,11,244047000,308728000,552775000
Thailand,2011,12,306997000,268534000,575531000
Thailand,2012,1,258372000,303453000,561825000
Thailand,2012,2,252128000,305683000,557811000
Thailand,2012,3,330332000,353453000,683785000
Thailand,2012,4,288768000,306674000,595442000
Thailand,2012,5,319652000,353851000,673503000
Thailand,2012,6,396940000,354091000,751031000
Thailand,2012,7,480906000,361478000,842384000
Thailand,2012,8,414253000,351057000,765310000
Thailand,2012,9,369401000,349024000,718425000
Thailand,2012,10,392397000,393157000,785554000
Thailand,2012,11,382981000,387985000,770966000
Thailand,2012,12,331174000,321033000,652207000
Thailand,2013,1,327728000,371908000,699636000
Thailand,2013,2,325545000,297677000,623222000
Thailand,2013,3,330083000,363458000,693541000
Thailand,2013,4,360223000,399018000,759241000
Thailand,2013,5,322526000,329690000,652216000
Thailand,2013,6,337373000,346246000,683619000
Thailand,2013,7,354826000,376745000,731571000
Thailand,2013,8,318839000,355959000,674798000
Thailand,2013,9,327934000,387265000,715199000
Thailand,2013,10,315525000,387601000,703126000
Thailand,2013,11,281342000,342659000,624001000
Thailand,2013,12,327629000,320576000,648205000
Thailand,2014,1,302715000,361685000,664400000
Thailand,2014,2,271886000,330284000,602170000
Thailand,2014,3,312461000,395751000,708212000
Thailand,2014,4,382862000,346359000,729221000
Thailand,2014,5,347676000,332774000,680450000
Thailand,2014,6,324527000,385152000,709679000
Thailand,2014,7,358358000,399416000,757774000
Thailand,2014,8,305380000,396829000,702209000
Thailand,2014,9,316700000,417636000,734336000
Thailand,2014,10,340441000,457095000,797536000
Thailand,2014,11,346003000,433604000,779607000
Thailand,2014,12,300053000,396829000,696882000
Thailand,2015,1,267886000,375243000,643129000
Thailand,2015,2,292462000,369105000,661567000
Thailand,2015,3,354261000,457788000,812049000
Thailand,2015,4,332878000,420261000,753139000
Thailand,2015,5,316765000,395120000,711885000
Thailand,2015,6,360428000,424117000,784545000
Thailand,2015,7,383653000,448808000,832461000
Thailand,2015,8,322166000,410700000,732866000
Thailand,2015,9,315065000,456304000,771369000
Thailand,2015,10,377185000,470405000,847590000
Thailand,2015,11,376475000,444510000,820985000
Thailand,2015,12,336068000,383624000,719692000
Thailand,2016,1,299880000,466821000,766701000
Thailand,2016,2,357890000,413819000,771709000
Thailand,2016,3,382006000,486290000,868296000
Thailand,2016,4,380280000,430945000,811225000
Thailand,2016,5,372964000,407218000,780182000
Thailand,2016,6,390081000,455067000,845148000
Thailand,2016,7,353520000,426840000,780360000
Thailand,2016,8,361844000,457750000,819594000
Thailand,2016,9,450269000,463166000,913435000
Thailand,2016,10,378994000,475874000,854868000
Thailand,2016,11,348113000,459522000,807635000
Thailand,2016,12,321617000,432352000,753969000
Thailand,2017,1,331950000,487632000,819582000
Thailand,2017,2,350401000,436898000,787299000
Thailand,2017,3,415225000,543845000,959070000
Thailand,2017,4,358646000,450712000,809358000
Thailand,2017,5,402996000,522967000,925963000
Thailand,2017,6,418386000,507950000,926336000
Thailand,2017,7,424905000,504537000,929442000
Thailand,2017,8,406488000,527145000,933633000
Thailand,2017,9,417529000,499809000,917338000
Thailand,2017,10,380031000,526579000,906610000
Thailand,2017,11,420110000,542685000,962795000
Thailand,2017,12,356556000,440149000,796705000
Thailand,2018,1,383443000,523387000,906830000
Thailand,2018,2,372668000,486530000,859198000
Thailand,2018,3,413944000,514296000,928240000
Thailand,2018,4,458704000,498357000,957061000
Thailand,2018,5,422858000,457086000,879944000
Thailand,2018,6,479671000,536815000,1016486000
Thailand,2018,7,421928000,542360000,964288000
Thailand,2018,8,391850000,537773000,929623000
Thailand,2018,9,385891000,518900000,904791000
Thailand,2018,10,505865000,547308000,1053173000
Thailand,2018,11,433135000,535963000,969098000
Thailand,2018,12,397782000,423950000,821732000
Thailand,2019,1,435383000,584912000,1020295000
Thailand,2019,2,389962000,474268000,864230000
Thailand,2019,3,422012000,463853000,885865000
Thailand,2019,4,374962000,504973000,879935000
Thailand,2019,5,392724000,461238000,853962000
Thailand,2019,6,366409000,470218000,836627000
Thailand,2019,7,470801000,527420000,998221000
Thailand,2019,8,391215000,468988000,860203000
Thailand,2019,9,434230000,524117000,958347000
Thailand,2019,10,422150000,544252000,966402000
Thailand,2019,11,413912000,529267000,943179000
Thailand,2019,12,506280000,441978000,948258000
Thailand,2020,1,382429000,553188000,935617000
Thailand,2020,2,365206000,459233000,824439000
Thailand,2020,3,405189000,535793000,940982000
Thailand,2020,4,318807000,398474000,717281000
Thailand,2020,5,280742000,403222000,683964000
Thailand,2020,6,342665000,411005000,753670000
Thailand,2020,7,383555000,454962000,838517000
Thailand,2020,8,297113000,411655000,708768000
Thailand,2020,9,337626000,496204000,833830000
Thailand,2020,10,375857000,517356000,893213000
Thailand,2020,11,357922000,524595000,882517000
Thailand,2020,12,344048000,462862000,806910000
Thailand,2021,1,359548000,500198000,859746000
Thailand,2021,2,383672000,496401000,880073000
Thailand,2021,3,501316000,620052000,1121368000
Thailand,2021,4,438970000,572853000,1011823000
Thailand,2021,5,414801000,580399000,995200000
Thailand,2021,6,410546000,585352000,995898000
Thailand,2021,7,406077000,575287000,981364000
Thailand,2021,8,392059000,523638000,915697000
Thailand,2021,9,393534000,631384000,1024918000
Thailand,2021,10,353628000,621491000,975119000
Thailand,2021,11,461945000,646195000,1108140000
Thailand,2021,12,407788000,575738000,983526000
Thailand,2022,1,386816000,624029000,1010845000
Thailand,2022,2,441051000,589713000,1030764000
Thailand,2022,3,468410000,710613000,1179023000
Thailand,2022,4,423848000,688457000,1112305000
Thailand,2022,5,528892000,738212000,1267104000
Thailand,2022,6,462966000,687498000,1150464000
Thailand,2022,7,458491000,696873000,1155364000
Thailand,2022,8,462139000,728370000,1190509000
Thailand,2022,9,478897000,839020000,1317917000
Thailand,2022,10,439031000,846004000,1285035000
Thailand,2022,11,473037000,838425000,1311462000
Thailand,2022,12,411465000,672487000,1083952000
Thailand,2023,1,447546000,783595000,1231141000
Thailand,2023,2,439024000,707198000,1146222000
Thailand,2023,3,522205000,824097000,1346302000
Thailand,2023,4,431682000,692591000,1124273000
Thailand,2023,5,442638000,713478000,1156116000
Thailand,2023,6,463739000,758252000,1221991000
Thailand,2023,7,491146000,698134000,1189280000
Thailand,2023,8,466460000,737244000,1203704000
Thailand,2023,9,422217000,726529000,1148746000
Thailand,2023,10,403633000,740377000,1144010000
Thailand,2023,11,441130000,707829000,1148959000
Thailand,2023,12,359122000,604304000,963426000
Thailand,2024,1,419106000,601506000,1020612000
Thailand,2024,2,415469000,680657000,1096126000
Thailand,2024,3,400689000,654913000,1055602000
Thailand,2024,4,418259000,814281000,1232540000
Thailand,2024,5,371507000,714085000,1085592000
Thailand,2024,6,466647000,678284000,1144931000
Thailand,2024,7,544738000,681495000,1226233000
Thailand,2024,8,386317000,692172000,1078489000
Thailand,2024,9,404085000,785622000,1189707000
Thailand,2024,10,383246000,845388000,1228634000
Thailand,2024,11,478514000,763281000,1241795000
Thailand,2024,12,362456000,706425000,1068881000
Timor-Leste (ab 2001),2008,1,85000,365000,450000
Timor-Leste (ab 2001),2008,2,7000,45000,52000
Timor-Leste (ab 2001),2008,3,26000,96000,122000
Timor-Leste (ab 2001),2008,4,61000,170000,231000
Timor-Leste (ab 2001),2008,5,13000,39000,52000
Timor-Leste (ab 2001),2008,6,10000,0,10000
Timor-Leste (ab 2001),2008,7,44000,219000,263000
Timor-Leste (ab 2001),2008,8,7000,309000,316000
Timor-Leste (ab 2001),2008,9,21000,693000,714000
Timor-Leste (ab 2001),2008,10,34000,339000,373000
Timor-Leste (ab 2001),2008,11,167000,538000,705000
Timor-Leste (ab 2001),2008,12,655000,331000,986000
Timor-Leste (ab 2001),2009,1,301000,0,301000
Timor-Leste (ab 2001),2009,2,483000,70000,553000
Timor-Leste (ab 2001),2009,3,264000,152000,416000
Timor-Leste (ab 2001),2009,4,233000,26000,259000
Timor-Leste (ab 2001),2009,5,50000,270000,320000
Timor-Leste (ab 2001),2009,6,300000,64000,364000
Timor-Leste (ab 2001),2009,7,39000,80000,119000
Timor-Leste (ab 2001),2009,8,106000,220000,326000
Timor-Leste (ab 2001),2009,9,15000,36000,51000
Timor-Leste (ab 2001),2009,10,36000,1044000,1080000
Timor-Leste (ab 2001),2009,11,416000,172000,588000
Timor-Leste (ab 2001),2009,12,0,118000,118000
Timor-Leste (ab 2001),2010,1,0,131000,131000
Timor-Leste (ab 2001),2010,2,24000,177000,201000
Timor-Leste (ab 2001),2010,3,7000,112000,119000
Timor-Leste (ab 2001),2010,4,10000,32000,42000
Timor-Leste (ab 2001),2010,5,34000,78000,112000
Timor-Leste (ab 2001),2010,6,12000,6000,18000
Timor-Leste (ab 2001),2010,7,15000,287000,302000
Timor-Leste (ab 2001),2010,8,14000,703000,717000
Timor-Leste (ab 2001),2010,9,19000,1172000,1191000
Timor-Leste (ab 2001),2010,10,61000,1028000,1089000
Timor-Leste (ab 2001),2010,11,10000,1547000,1557000
Timor-Leste (ab 2001),2010,12,20000,582000,602000
Timor-Leste (ab 2001),2011,1,33000,513000,546000
Timor-Leste (ab 2001),2011,2,33000,469000,502000
Timor-Leste (ab 2001),2011,3,75000,836000,911000
Timor-Leste (ab 2001),2011,4,2000,721000,723000
Timor-Leste (ab 2001),2011,5,0,822000,822000
Timor-Leste (ab 2001),2011,6,7000,517000,524000
Timor-Leste (ab 2001),2011,7,61000,554000,615000
Timor-Leste (ab 2001),2011,8,15000,2701000,2716000
Timor-Leste (ab 2001),2011,9,15000,1723000,1738000
Timor-Leste (ab 2001),2011,10,51000,919000,970000
Timor-Leste (ab 2001),2011,11,64000,1062000,1126000
Timor-Leste (ab 2001),2011,12,94000,880000,974000
Timor-Leste (ab 2001),2012,1,12000,595000,607000
Timor-Leste (ab 2001),2012,2,68000,379000,447000
Timor-Leste (ab 2001),2012,3,110000,547000,657000
Timor-Leste (ab 2001),2012,4,10000,9000,19000
Timor-Leste (ab 2001),2012,5,63000,18000,81000
Timor-Leste (ab 2001),2012,6,8000,18000,26000
Timor-Leste (ab 2001),2012,7,64000,186000,250000
Timor-Leste (ab 2001),2012,8,18000,511000,529000
Timor-Leste (ab 2001),2012,9,1000,531000,532000
Timor-Leste (ab 2001),2012,10,38000,1388000,1426000
Timor-Leste (ab 2001),2012,11,1000,777000,778000
Timor-Leste (ab 2001),2012,12,187000,22000,209000
Timor-Leste (ab 2001),2013,1,20000,859000,879000
Timor-Leste (ab 2001),2013,2,4000,422000,426000
Timor-Leste (ab 2001),2013,3,3000,389000,392000
Timor-Leste (ab 2001),2013,4,14000,731000,745000
Timor-Leste (ab 2001),2013,5,0,595000,595000
Timor-Leste (ab 2001),2013,6,2000,263000,265000
Timor-Leste (ab 2001),2013,7,17000,185000,202000
Timor-Leste (ab 2001),2013,8,16000,32000,48000
Timor-Leste (ab 2001),2013,9,8000,1187000,1195000
Timor-Leste (ab 2001),2013,10,32000,445000,477000
Timor-Leste (ab 2001),2013,11,18000,315000,333000
Timor-Leste (ab 2001),2013,12,8000,536000,544000
Timor-Leste (ab 2001),2014,1,0,397000,397000
Timor-Leste (ab 2001),2014,2,0,976000,976000
Timor-Leste (ab 2001),2014,3,5000,423000,428000
Timor-Leste (ab 2001),2014,4,1000,364000,365000
Timor-Leste (ab 2001),2014,5,21000,291000,312000
Timor-Leste (ab 2001),2014,6,38000,423000,461000
Timor-Leste (ab 2001),2014,7,0,548000,548000
Timor-Leste (ab 2001),2014,8,1000,115000,116000
Timor-Leste (ab 2001),2014,9,33000,1958000,1991000
Timor-Leste (ab 2001),2014,10,7000,2057000,2064000
Timor-Leste (ab 2001),2014,11,2000,2017000,2019000
Timor-Leste (ab 2001),2014,12,0,976000,976000
Timor-Leste (ab 2001),2015,1,202000,1166000,1368000
Timor-Leste (ab 2001),2015,2,0,731000,731000
Timor-Leste (ab 2001),2015,3,53000,137000,190000
Timor-Leste (ab 2001),2015,4,20000,234000,254000
Timor-Leste (ab 2001),2015,5,6000,70000,76000
Timor-Leste (ab 2001),2015,6,216000,22000,238000
Timor-Leste (ab 2001),2015,7,1000,5000,6000
Timor-Leste (ab 2001),2015,8,207000,70000,277000
Timor-Leste (ab 2001),2015,9,4000,44000,48000
Timor-Leste (ab 2001),2015,10,23000,200000,223000
Timor-Leste (ab 2001),2015,11,9000,226000,235000
Timor-Leste (ab 2001),2015,12,0,81000,81000
Timor-Leste (ab 2001),2016,1,0,153000,153000
Timor-Leste (ab 2001),2016,2,0,414000,414000
Timor-Leste (ab 2001),2016,3,21000,43000,64000
Timor-Leste (ab 2001),2016,4,2000,9000,11000
Timor-Leste (ab 2001),2016,5,5000,339000,344000
Timor-Leste (ab 2001),2016,6,29000,97000,126000
Timor-Leste (ab 2001),2016,7,17000,26000,43000
Timor-Leste (ab 2001),2016,8,1000,75000,76000
Timor-Leste (ab 2001),2016,9,16000,64000,80000
Timor-Leste (ab 2001),2016,10,79000,52000,131000
Timor-Leste (ab 2001),2016,11,2000,19000,21000
Timor-Leste (ab 2001),2016,12,0,62000,62000
Timor-Leste (ab 2001),2017,1,12000,169000,181000
Timor-Leste (ab 2001),2017,2,0,367000,367000
Timor-Leste (ab 2001),2017,3,1363000,487000,1850000
Timor-Leste (ab 2001),2017,4,181000,284000,465000
Timor-Leste (ab 2001),2017,5,4000,939000,943000
Timor-Leste (ab 2001),2017,6,254000,70000,324000
Timor-Leste (ab 2001),2017,7,121000,64000,185000
Timor-Leste (ab 2001),2017,8,8000,516000,524000
Timor-Leste (ab 2001),2017,9,9000,283000,292000
Timor-Leste (ab 2001),2017,10,25000,283000,308000
Timor-Leste (ab 2001),2017,11,5000,36000,41000
Timor-Leste (ab 2001),2017,12,2000,176000,178000
Timor-Leste (ab 2001),2018,1,0,78000,78000
Timor-Leste (ab 2001),2018,2,90000,223000,313000
Timor-Leste (ab 2001),2018,3,0,287000,287000
Timor-Leste (ab 2001),2018,4,0,46000,46000
Timor-Leste (ab 2001),2018,5,8000,155000,163000
Timor-Leste (ab 2001),2018,6,9000,167000,176000
Timor-Leste (ab 2001),2018,7,1000,51000,52000
Timor-Leste (ab 2001),2018,8,14000,80000,94000
Timor-Leste (ab 2001),2018,9,2000,284000,286000
Timor-Leste (ab 2001),2018,10,3000,53000,56000
Timor-Leste (ab 2001),2018,11,0,885000,885000
Timor-Leste (ab 2001),2018,12,91000,27000,118000
Timor-Leste (ab 2001),2019,1,160000,137000,297000
Timor-Leste (ab 2001),2019,2,2000,199000,201000
Timor-Leste (ab 2001),2019,3,8000,45000,53000
Timor-Leste (ab 2001),2019,4,1000,88000,89000
Timor-Leste (ab 2001),2019,5,4000,91000,95000
Timor-Leste (ab 2001),2019,6,19000,124000,143000
Timor-Leste (ab 2001),2019,7,52000,52000,104000
Timor-Leste (ab 2001),2019,8,15000,46000,61000
Timor-Leste (ab 2001),2019,9,2000,256000,258000
Timor-Leste (ab 2001),2019,10,7000,40000,47000
Timor-Leste (ab 2001),2019,11,41000,84000,125000
Timor-Leste (ab 2001),2019,12,2000,55000,57000
Timor-Leste (ab 2001),2020,1,54000,40000,94000
Timor-Leste (ab 2001),2020,2,72000,58000,130000
Timor-Leste (ab 2001),2020,3,8000,76000,84000
Timor-Leste (ab 2001),2020,4,0,46000,46000
Timor-Leste (ab 2001),2020,5,0,46000,46000
Timor-Leste (ab 2001),2020,6,2000,32000,34000
Timor-Leste (ab 2001),2020,7,37000,52000,89000
Timor-Leste (ab 2001),2020,8,17000,64000,81000
Timor-Leste (ab 2001),2020,9,17000,74000,91000
Timor-Leste (ab 2001),2020,10,41000,67000,108000
Timor-Leste (ab 2001),2020,11,30000,71000,101000
Timor-Leste (ab 2001),2020,12,3000,25000,28000
Timor-Leste (ab 2001),2021,1,356000,20000,376000
Timor-Leste (ab 2001),2021,2,133000,28000,161000
Timor-Leste (ab 2001),2021,3,74000,93000,167000
Timor-Leste (ab 2001),2021,4,218000,16000,234000
Timor-Leste (ab 2001),2021,5,1148000,41000,1189000
Timor-Leste (ab 2001),2021,6,198000,24000,222000
Timor-Leste (ab 2001),2021,7,62000,69000,131000
Timor-Leste (ab 2001),2021,8,57000,4000,61000
Timor-Leste (ab 2001),2021,9,5000,0,5000
Timor-Leste (ab 2001),2021,10,8000,14000,22000
Timor-Leste (ab 2001),2021,11,20000,20000,40000
Timor-Leste (ab 2001),2021,12,27000,51000,78000
Timor-Leste (ab 2001),2022,1,2039000,30000,2069000
Timor-Leste (ab 2001),2022,2,22000,796000,818000
Timor-Leste (ab 2001),2022,3,11000,932000,943000
Timor-Leste (ab 2001),2022,4,36000,6000,42000
Timor-Leste (ab 2001),2022,5,1057000,642000,1699000
Timor-Leste (ab 2001),2022,6,43000,3000,46000
Timor-Leste (ab 2001),2022,7,36000,0,36000
Timor-Leste (ab 2001),2022,8,46000,1000,47000
Timor-Leste (ab 2001),2022,9,467000,14000,481000
Timor-Leste (ab 2001),2022,10,52000,1000,53000
Timor-Leste (ab 2001),2022,11,427000,1796000,2223000
Timor-Leste (ab 2001),2022,12,159000,2000,161000
Timor-Leste (ab 2001),2023,1,9000,1000,10000
Timor-Leste (ab 2001),2023,2,0,448000,448000
Timor-Leste (ab 2001),2023,3,6000,1000,7000
Timor-Leste (ab 2001),2023,4,91000,55000,146000
Timor-Leste (ab 2001),2023,5,35000,63000,98000
Timor-Leste (ab 2001),2023,6,52000,9000,61000
Timor-Leste (ab 2001),2023,7,8000,91000,99000
Timor-Leste (ab 2001),2023,8,7000,10000,17000
Timor-Leste (ab 2001),2023,9,190000,0,190000
Timor-Leste (ab 2001),2023,10,14000,1000,15000
Timor-Leste (ab 2001),2023,11,42000,16000,58000
Timor-Leste (ab 2001),2023,12,22000,7000,29000
Timor-Leste (ab 2001),2024,1,6000,6000,12000
Timor-Leste (ab 2001),2024,2,0,7000,7000
Timor-Leste (ab 2001),2024,3,69000,1000,70000
Timor-Leste (ab 2001),2024,4,0,1000,1000
Timor-Leste (ab 2001),2024,5,146000,4000,150000
Timor-Leste (ab 2001),2024,6,2000,10000,12000
Timor-Leste (ab 2001),2024,7,95000,26000,121000
Timor-Leste (ab 2001),2024,8,119000,0,119000
Timor-Leste (ab 2001),2024,9,20000,1000,21000
Timor-Leste (ab 2001),2024,10,0,134000,134000
Timor-Leste (ab 2001),2024,11,239000,191000,430000
Timor-Leste (ab 2001),2024,12,14000,1000,15000
Togo,2008,1,2691000,11242000,13933000
Togo,2008,2,3274000,7251000,10525000
Togo,2008,3,4187000,3852000,8039000
Togo,2008,4,3633000,4243000,7876000
Togo,2008,5,2965000,11252000,14217000
Togo,2008,6,3442000,10582000,14024000
Togo,2008,7,4129000,8081000,12210000
Togo,2008,8,3041000,6205000,9246000
Togo,2008,9,3190000,6817000,10007000
Togo,2008,10,3298000,7533000,10831000
Togo,2008,11,4333000,3734000,8067000
Togo,2008,12,3808000,7973000,11781000
Togo,2009,1,3241000,8223000,11464000
Togo,2009,2,3091000,21802000,24893000
Togo,2009,3,3358000,6538000,9896000
Togo,2009,4,4591000,24002000,28593000
Togo,2009,5,3240000,10749000,13989000
Togo,2009,6,2681000,11699000,14380000
Togo,2009,7,4525000,12376000,16901000
Togo,2009,8,2133000,6079000,8212000
Togo,2009,9,2189000,4247000,6436000
Togo,2009,10,5333000,4252000,9585000
Togo,2009,11,2930000,10173000,13103000
Togo,2009,12,3128000,14648000,17776000
Togo,2010,1,5843000,17198000,23041000
Togo,2010,2,2383000,11926000,14309000
Togo,2010,3,3771000,10448000,14219000
Togo,2010,4,2796000,7735000,10531000
Togo,2010,5,4845000,11540000,16385000
Togo,2010,6,3850000,5921000,9771000
Togo,2010,7,3257000,5289000,8546000
Togo,2010,8,2724000,12709000,15433000
Togo,2010,9,3617000,7012000,10629000
Togo,2010,10,3351000,5382000,8733000
Togo,2010,11,3720000,9604000,13324000
Togo,2010,12,3653000,8373000,12026000
Togo,2011,1,7040000,18285000,25325000
Togo,2011,2,2757000,16198000,18955000
Togo,2011,3,4347000,13467000,17814000
Togo,2011,4,3271000,28021000,31292000
Togo,2011,5,5251000,11520000,16771000
Togo,2011,6,6217000,16876000,23093000
Togo,2011,7,3430000,13700000,17130000
Togo,2011,8,4809000,14958000,19767000
Togo,2011,9,4434000,8760000,13194000
Togo,2011,10,3093000,8358000,11451000
Togo,2011,11,4242000,5807000,10049000
Togo,2011,12,7658000,5589000,13247000
Togo,2012,1,3720000,3235000,6955000
Togo,2012,2,4497000,2533000,7030000
Togo,2012,3,4289000,6889000,11178000
Togo,2012,4,4405000,2846000,7251000
Togo,2012,5,3137000,931000,4068000
Togo,2012,6,4481000,2540000,7021000
Togo,2012,7,3498000,2370000,5868000
Togo,2012,8,3928000,3650000,7578000
Togo,2012,9,4097000,6624000,10721000
Togo,2012,10,3027000,5497000,8524000
Togo,2012,11,4635000,2565000,7200000
Togo,2012,12,3146000,560000,3706000
Togo,2013,1,3088000,3121000,6209000
Togo,2013,2,2542000,2318000,4860000
Togo,2013,3,4645000,1935000,6580000
Togo,2013,4,4084000,3640000,7724000
Togo,2013,5,4298000,1752000,6050000
Togo,2013,6,2700000,1016000,3716000
Togo,2013,7,7098000,1778000,8876000
Togo,2013,8,8281000,922000,9203000
Togo,2013,9,3016000,2180000,5196000
Togo,2013,10,3358000,1476000,4834000
Togo,2013,11,4774000,120000,4894000
Togo,2013,12,18683000,662000,19345000
Togo,2014,1,4119000,2076000,6195000
Togo,2014,2,6951000,5960000,12911000
Togo,2014,3,6967000,113000,7080000
Togo,2014,4,4447000,781000,5228000
Togo,2014,5,6539000,13000,6552000
Togo,2014,6,4285000,652000,4937000
Togo,2014,7,3915000,3466000,7381000
Togo,2014,8,2733000,317000,3050000
Togo,2014,9,3658000,106000,3764000
Togo,2014,10,4236000,323000,4559000
Togo,2014,11,4030000,306000,4336000
Togo,2014,12,5680000,142000,5822000
Togo,2015,1,3098000,946000,4044000
Togo,2015,2,4251000,732000,4983000
Togo,2015,3,4754000,1033000,5787000
Togo,2015,4,3769000,493000,4262000
Togo,2015,5,3974000,219000,4193000
Togo,2015,6,4516000,904000,5420000
Togo,2015,7,5909000,175000,6084000
Togo,2015,8,4432000,3346000,7778000
Togo,2015,9,5870000,891000,6761000
Togo,2015,10,4601000,1205000,5806000
Togo,2015,11,4304000,461000,4765000
Togo,2015,12,3357000,39000,3396000
Togo,2016,1,1899000,650000,2549000
Togo,2016,2,3099000,274000,3373000
Togo,2016,3,3105000,826000,3931000
Togo,2016,4,3134000,200000,3334000
Togo,2016,5,5965000,68000,6033000
Togo,2016,6,3490000,375000,3865000
Togo,2016,7,2852000,29000,2881000
Togo,2016,8,2817000,33000,2850000
Togo,2016,9,3392000,319000,3711000
Togo,2016,10,2486000,74000,2560000
Togo,2016,11,3135000,50000,3185000
Togo,2016,12,3388000,443000,3831000
Togo,2017,1,2534000,600000,3134000
Togo,2017,2,2353000,79000,2432000
Togo,2017,3,3510000,400000,3910000
Togo,2017,4,2669000,81000,2750000
Togo,2017,5,4141000,467000,4608000
Togo,2017,6,3946000,19000,3965000
Togo,2017,7,3679000,749000,4428000
Togo,2017,8,3809000,367000,4176000
Togo,2017,9,3190000,118000,3308000
Togo,2017,10,3290000,58000,3348000
Togo,2017,11,4567000,34000,4601000
Togo,2017,12,2787000,62000,2849000
Togo,2018,1,2799000,17000,2816000
Togo,2018,2,2700000,108000,2808000
Togo,2018,3,3733000,81000,3814000
Togo,2018,4,2153000,1043000,3196000
Togo,2018,5,5908000,1272000,7180000
Togo,2018,6,2991000,1740000,4731000
Togo,2018,7,2759000,39000,2798000
Togo,2018,8,3935000,660000,4595000
Togo,2018,9,4700000,859000,5559000
Togo,2018,10,6070000,102000,6172000
Togo,2018,11,8329000,162000,8491000
Togo,2018,12,3094000,16000,3110000
Togo,2019,1,2591000,36000,2627000
Togo,2019,2,3742000,148000,3890000
Togo,2019,3,3805000,111000,3916000
Togo,2019,4,3121000,126000,3247000
Togo,2019,5,4704000,47000,4751000
Togo,2019,6,6011000,277000,6288000
Togo,2019,7,4821000,95000,4916000
Togo,2019,8,4521000,914000,5435000
Togo,2019,9,4117000,422000,4539000
Togo,2019,10,5243000,1336000,6579000
Togo,2019,11,6082000,639000,6721000
Togo,2019,12,4010000,324000,4334000
Togo,2020,1,3458000,1054000,4512000
Togo,2020,2,5828000,195000,6023000
Togo,2020,3,4320000,530000,4850000
Togo,2020,4,3528000,628000,4156000
Togo,2020,5,4025000,384000,4409000
Togo,2020,6,5220000,71000,5291000
Togo,2020,7,7662000,313000,7975000
Togo,2020,8,7893000,103000,7996000
Togo,2020,9,6757000,882000,7639000
Togo,2020,10,7040000,204000,7244000
Togo,2020,11,7220000,206000,7426000
Togo,2020,12,5250000,30000,5280000
Togo,2021,1,3808000,136000,3944000
Togo,2021,2,3421000,143000,3564000
Togo,2021,3,5183000,707000,5890000
Togo,2021,4,5232000,1592000,6824000
Togo,2021,5,6278000,1055000,7333000
Togo,2021,6,6440000,735000,7175000
Togo,2021,7,5557000,471000,6028000
Togo,2021,8,6028000,1172000,7200000
Togo,2021,9,5474000,581000,6055000
Togo,2021,10,4210000,93000,4303000
Togo,2021,11,4529000,157000,4686000
Togo,2021,12,16327000,23000,16350000
Togo,2022,1,4884000,518000,5402000
Togo,2022,2,4363000,2213000,6576000
Togo,2022,3,5502000,1728000,7230000
Togo,2022,4,3604000,1808000,5412000
Togo,2022,5,5178000,5536000,10714000
Togo,2022,6,5463000,314000,5777000
Togo,2022,7,10330000,2264000,12594000
Togo,2022,8,6848000,51000,6899000
Togo,2022,9,6363000,1555000,7918000
Togo,2022,10,4012000,1971000,5983000
Togo,2022,11,6234000,98000,6332000
Togo,2022,12,7706000,480000,8186000
Togo,2023,1,5984000,146000,6130000
Togo,2023,2,4850000,87000,4937000
Togo,2023,3,6125000,239000,6364000
Togo,2023,4,3129000,118000,3247000
Togo,2023,5,7978000,100000,8078000
Togo,2023,6,7081000,205000,7286000
Togo,2023,7,3944000,1332000,5276000
Togo,2023,8,4762000,530000,5292000
Togo,2023,9,3368000,92000,3460000
Togo,2023,10,5542000,28000,5570000
Togo,2023,11,6486000,8000,6494000
Togo,2023,12,3215000,105000,3320000
Togo,2024,1,4925000,808000,5733000
Togo,2024,2,4972000,109000,5081000
Togo,2024,3,4956000,560000,5516000
Togo,2024,4,5030000,434000,5464000
Togo,2024,5,5070000,3228000,8298000
Togo,2024,6,4083000,413000,4496000
Togo,2024,7,4993000,1175000,6168000
Togo,2024,8,4969000,324000,5293000
Togo,2024,9,4002000,110000,4112000
Togo,2024,10,4443000,515000,4958000
Togo,2024,11,4455000,489000,4944000
Togo,2024,12,4500000,199000,4699000
Tokelau (ab 2001),2008,1,264000,0,264000
Tokelau (ab 2001),2008,2,92000,0,92000
Tokelau (ab 2001),2008,3,804000,0,804000
Tokelau (ab 2001),2008,4,2000,0,2000
Tokelau (ab 2001),2008,5,119000,0,119000
Tokelau (ab 2001),2008,6,32000,0,32000
Tokelau (ab 2001),2008,7,4000,0,4000
Tokelau (ab 2001),2008,8,0,2000,2000
Tokelau (ab 2001),2008,9,25000,5000,30000
Tokelau (ab 2001),2008,10,17000,0,17000
Tokelau (ab 2001),2008,11,7000,0,7000
Tokelau (ab 2001),2008,12,186000,40000,226000
Tokelau (ab 2001),2009,1,186000,6000,192000
Tokelau (ab 2001),2009,2,819000,27000,846000
Tokelau (ab 2001),2009,3,166000,15000,181000
Tokelau (ab 2001),2009,4,483000,0,483000
Tokelau (ab 2001),2009,5,282000,59000,341000
Tokelau (ab 2001),2009,6,236000,0,236000
Tokelau (ab 2001),2009,7,176000,9000,185000
Tokelau (ab 2001),2009,8,35000,0,35000
Tokelau (ab 2001),2009,9,8000,0,8000
Tokelau (ab 2001),2009,10,2000,0,2000
Tokelau (ab 2001),2009,11,4000,0,4000
Tokelau (ab 2001),2009,12,180000,3000,183000
Tokelau (ab 2001),2010,1,4837000,0,4837000
Tokelau (ab 2001),2010,2,14000,0,14000
Tokelau (ab 2001),2010,3,11000,0,11000
Tokelau (ab 2001),2010,4,331000,0,331000
Tokelau (ab 2001),2010,5,33000,0,33000
Tokelau (ab 2001),2010,6,19000,0,19000
Tokelau (ab 2001),2010,7,23000,0,23000
Tokelau (ab 2001),2010,8,0,0,0
Tokelau (ab 2001),2010,9,46000,0,46000
Tokelau (ab 2001),2010,10,85000,66000,151000
Tokelau (ab 2001),2010,11,17000,0,17000
Tokelau (ab 2001),2010,12,135000,113000,248000
Tokelau (ab 2001),2011,1,2000,0,2000
Tokelau (ab 2001),2011,2,0,0,0
Tokelau (ab 2001),2011,3,57000,0,57000
Tokelau (ab 2001),2011,4,0,8000,8000
Tokelau (ab 2001),2011,5,0,0,0
Tokelau (ab 2001),2011,6,10000,0,10000
Tokelau (ab 2001),2011,7,10000,0,10000
Tokelau (ab 2001),2011,8,13000,0,13000
Tokelau (ab 2001),2011,9,38000,0,38000
Tokelau (ab 2001),2011,10,3000,0,3000
Tokelau (ab 2001),2011,11,0,0,0
Tokelau (ab 2001),2011,12,59000,0,59000
Tokelau (ab 2001),2012,1,6000,0,6000
Tokelau (ab 2001),2012,2,0,0,0
Tokelau (ab 2001),2012,3,0,0,0
Tokelau (ab 2001),2012,4,0,0,0
Tokelau (ab 2001),2012,5,2000,0,2000
Tokelau (ab 2001),2012,6,6000,0,6000
Tokelau (ab 2001),2012,7,2000,0,2000
Tokelau (ab 2001),2012,8,33000,0,33000
Tokelau (ab 2001),2012,9,20000,0,20000
Tokelau (ab 2001),2012,10,8000,0,8000
Tokelau (ab 2001),2012,11,16000,0,16000
Tokelau (ab 2001),2012,12,9000,0,9000
Tokelau (ab 2001),2013,1,2000,0,2000
Tokelau (ab 2001),2013,2,7000,0,7000
Tokelau (ab 2001),2013,3,10000,0,10000
Tokelau (ab 2001),2013,4,0,0,0
Tokelau (ab 2001),2013,5,175000,0,175000
Tokelau (ab 2001),2013,6,0,0,0
Tokelau (ab 2001),2013,7,0,0,0
Tokelau (ab 2001),2013,8,39000,0,39000
Tokelau (ab 2001),2013,9,0,0,0
Tokelau (ab 2001),2013,10,278000,0,278000
Tokelau (ab 2001),2013,11,0,0,0
Tokelau (ab 2001),2013,12,33000,0,33000
Tokelau (ab 2001),2014,1,1000,14000,15000
Tokelau (ab 2001),2014,2,0,0,0
Tokelau (ab 2001),2014,3,0,0,0
Tokelau (ab 2001),2014,4,0,0,0
Tokelau (ab 2001),2014,5,6000,0,6000
Tokelau (ab 2001),2014,6,1000,0,1000
Tokelau (ab 2001),2014,7,0,0,0
Tokelau (ab 2001),2014,8,5000,3000,8000
Tokelau (ab 2001),2014,9,0,2000,2000
Tokelau (ab 2001),2014,10,3000,15000,18000
Tokelau (ab 2001),2014,11,0,1000,1000
Tokelau (ab 2001),2014,12,3000,3000,6000
Tokelau (ab 2001),2015,1,2000,14000,16000
Tokelau (ab 2001),2015,2,16000,6000,22000
Tokelau (ab 2001),2015,3,6000,0,6000
Tokelau (ab 2001),2015,4,5000,0,5000
Tokelau (ab 2001),2015,5,5000,22000,27000
Tokelau (ab 2001),2015,6,11000,1000,12000
Tokelau (ab 2001),2015,7,0,13000,13000
Tokelau (ab 2001),2015,8,6000,0,6000
Tokelau (ab 2001),2015,9,4000,0,4000
Tokelau (ab 2001),2015,10,0,0,0
Tokelau (ab 2001),2015,11,1000,0,1000
Tokelau (ab 2001),2015,12,5000,11000,16000
Tokelau (ab 2001),2016,1,17000,0,17000
Tokelau (ab 2001),2016,2,2000,34000,36000
Tokelau (ab 2001),2016,3,19000,16000,35000
Tokelau (ab 2001),2016,4,0,0,0
Tokelau (ab 2001),2016,5,6000,0,6000
Tokelau (ab 2001),2016,6,19000,0,19000
Tokelau (ab 2001),2016,7,22000,0,22000
Tokelau (ab 2001),2016,8,1000,0,1000
Tokelau (ab 2001),2016,9,0,10000,10000
Tokelau (ab 2001),2016,10,2000,0,2000
Tokelau (ab 2001),2016,11,4000,2000,6000
Tokelau (ab 2001),2016,12,0,1000,1000
Tokelau (ab 2001),2017,1,7000,15000,22000
Tokelau (ab 2001),2017,2,16000,3000,19000
Tokelau (ab 2001),2017,3,25000,0,25000
Tokelau (ab 2001),2017,4,3000,38000,41000
Tokelau (ab 2001),2017,5,0,0,0
Tokelau (ab 2001),2017,6,66000,0,66000
Tokelau (ab 2001),2017,7,115000,0,115000
Tokelau (ab 2001),2017,8,1000,10000,11000
Tokelau (ab 2001),2017,9,1000,0,1000
Tokelau (ab 2001),2017,10,3851000,0,3851000
Tokelau (ab 2001),2017,11,121000,1000,122000
Tokelau (ab 2001),2017,12,0,132000,132000
Tokelau (ab 2001),2018,1,48000,0,48000
Tokelau (ab 2001),2018,2,0,1000,1000
Tokelau (ab 2001),2018,3,6000,0,6000
Tokelau (ab 2001),2018,4,2000,0,2000
Tokelau (ab 2001),2018,5,6000,0,6000
Tokelau (ab 2001),2018,6,12000,0,12000
Tokelau (ab 2001),2018,7,14000,0,14000
Tokelau (ab 2001),2018,8,26000,5000,31000
Tokelau (ab 2001),2018,9,16000,25000,41000
Tokelau (ab 2001),2018,10,66000,20822000,20888000
Tokelau (ab 2001),2018,11,437000,11000,448000
Tokelau (ab 2001),2018,12,5000,4000,9000
Tokelau (ab 2001),2019,1,3000,11000,14000
Tokelau (ab 2001),2019,2,4000,1000,5000
Tokelau (ab 2001),2019,3,18000,0,18000
Tokelau (ab 2001),2019,4,1000,5000,6000
Tokelau (ab 2001),2019,5,19000,140000,159000
Tokelau (ab 2001),2019,6,2000,3000,5000
Tokelau (ab 2001),2019,7,32000,0,32000
Tokelau (ab 2001),2019,8,22000,8000,30000
Tokelau (ab 2001),2019,9,24000,87000,111000
Tokelau (ab 2001),2019,10,9000,1000,10000
Tokelau (ab 2001),2019,11,1000,14000,15000
Tokelau (ab 2001),2019,12,38000,0,38000
Tokelau (ab 2001),2020,1,94000,11000,105000
Tokelau (ab 2001),2020,2,44000,6000,50000
Tokelau (ab 2001),2020,3,243000,3000,246000
Tokelau (ab 2001),2020,4,2000,11000,13000
Tokelau (ab 2001),2020,5,17000,0,17000
Tokelau (ab 2001),2020,6,18000,448000,466000
Tokelau (ab 2001),2020,7,11000,253000,264000
Tokelau (ab 2001),2020,8,1000,0,1000
Tokelau (ab 2001),2020,9,4000,0,4000
Tokelau (ab 2001),2020,10,1000,46000,47000
Tokelau (ab 2001),2020,11,0,44000,44000
Tokelau (ab 2001),2020,12,10000,1000,11000
Tokelau (ab 2001),2021,1,17000,29000,46000
Tokelau (ab 2001),2021,2,27000,36000,63000
Tokelau (ab 2001),2021,3,0,1000,1000
Tokelau (ab 2001),2021,4,215000,0,215000
Tokelau (ab 2001),2021,5,0,0,0
Tokelau (ab 2001),2021,6,2000,0,2000
Tokelau (ab 2001),2021,7,109000,4000,113000
Tokelau (ab 2001),2021,8,2297000,0,2297000
Tokelau (ab 2001),2021,9,58000,0,58000
Tokelau (ab 2001),2021,10,8000,9000,17000
Tokelau (ab 2001),2021,11,41000,15000,56000
Tokelau (ab 2001),2021,12,1000,16000,17000
Tokelau (ab 2001),2022,1,51000,11000,62000
Tokelau (ab 2001),2022,2,40000,23000,63000
Tokelau (ab 2001),2022,3,17000,9000,26000
Tokelau (ab 2001),2022,4,0,3000,3000
Tokelau (ab 2001),2022,5,0,96000,96000
Tokelau (ab 2001),2022,6,3000,0,3000
Tokelau (ab 2001),2022,7,11000,10000,21000
Tokelau (ab 2001),2022,8,27000,0,27000
Tokelau (ab 2001),2022,9,809000,0,809000
Tokelau (ab 2001),2022,10,23000,2000,25000
Tokelau (ab 2001),2022,11,161000,46000,207000
Tokelau (ab 2001),2022,12,168000,84000,252000
Tokelau (ab 2001),2023,1,136000,5000,141000
Tokelau (ab 2001),2023,2,29000,22000,51000
Tokelau (ab 2001),2023,3,4000,0,4000
Tokelau (ab 2001),2023,4,6000,25000,31000
Tokelau (ab 2001),2023,5,0,0,0
Tokelau (ab 2001),2023,6,0,0,0
Tokelau (ab 2001),2023,7,8000,5000,13000
Tokelau (ab 2001),2023,8,15000,0,15000
Tokelau (ab 2001),2023,9,0,0,0
Tokelau (ab 2001),2023,10,4000,14000,18000
Tokelau (ab 2001),2023,11,10000,0,10000
Tokelau (ab 2001),2023,12,56000,8000,64000
Tokelau (ab 2001),2024,1,42000,0,42000
Tokelau (ab 2001),2024,2,17000,0,17000
Tokelau (ab 2001),2024,3,24000,8000,32000
Tokelau (ab 2001),2024,4,0,3000,3000
Tokelau (ab 2001),2024,5,0,4000,4000
Tokelau (ab 2001),2024,6,2000,14000,16000
Tokelau (ab 2001),2024,7,8000,6000,14000
Tokelau (ab 2001),2024,8,0,66000,66000
Tokelau (ab 2001),2024,9,134000,16000,150000
Tokelau (ab 2001),2024,10,13000,0,13000
Tokelau (ab 2001),2024,11,0,3000,3000
Tokelau (ab 2001),2024,12,0,1000,1000
Tonga,2008,1,17000,14000,31000
Tonga,2008,2,6000,6000,12000
Tonga,2008,3,126000,10000,136000
Tonga,2008,4,2000,3000,5000
Tonga,2008,5,9000,13000,22000
Tonga,2008,6,47000,5000,52000
Tonga,2008,7,17000,4000,21000
Tonga,2008,8,1000,0,1000
Tonga,2008,9,5000,7000,12000
Tonga,2008,10,0,0,0
Tonga,2008,11,30000,0,30000
Tonga,2008,12,81000,0,81000
Tonga,2009,1,13000,7000,20000
Tonga,2009,2,55000,6000,61000
Tonga,2009,3,1226000,10000,1236000
Tonga,2009,4,102000,0,102000
Tonga,2009,5,63000,0,63000
Tonga,2009,6,35000,0,35000
Tonga,2009,7,24000,0,24000
Tonga,2009,8,0,0,0
Tonga,2009,9,188000,1000,189000
Tonga,2009,10,13000,3000,16000
Tonga,2009,11,2000,3000,5000
Tonga,2009,12,0,0,0
Tonga,2010,1,17000,0,17000
Tonga,2010,2,77000,0,77000
Tonga,2010,3,77000,0,77000
Tonga,2010,4,0,0,0
Tonga,2010,5,0,0,0
Tonga,2010,6,6000,0,6000
Tonga,2010,7,0,0,0
Tonga,2010,8,0,0,0
Tonga,2010,9,0,0,0
Tonga,2010,10,0,0,0
Tonga,2010,11,1000,0,1000
Tonga,2010,12,0,0,0
Tonga,2011,1,0,0,0
Tonga,2011,2,0,0,0
Tonga,2011,3,109000,9000,118000
Tonga,2011,4,14000,0,14000
Tonga,2011,5,0,0,0
Tonga,2011,6,0,0,0
Tonga,2011,7,0,0,0
Tonga,2011,8,0,1038000,1038000
Tonga,2011,9,0,0,0
Tonga,2011,10,197000,0,197000
Tonga,2011,11,0,0,0
Tonga,2011,12,0,0,0
Tonga,2012,1,0,0,0
Tonga,2012,2,0,0,0
Tonga,2012,3,0,2000,2000
Tonga,2012,4,0,0,0
Tonga,2012,5,0,0,0
Tonga,2012,6,15000,0,15000
Tonga,2012,7,4000,0,4000
Tonga,2012,8,311000,0,311000
Tonga,2012,9,0,0,0
Tonga,2012,10,0,6000,6000
Tonga,2012,11,10000,0,10000
Tonga,2012,12,13000,2000,15000
Tonga,2013,1,46000,0,46000
Tonga,2013,2,0,0,0
Tonga,2013,3,128000,0,128000
Tonga,2013,4,5000,0,5000
Tonga,2013,5,161000,0,161000
Tonga,2013,6,8000,0,8000
Tonga,2013,7,23000,0,23000
Tonga,2013,8,1449000,0,1449000
Tonga,2013,9,19000,0,19000
Tonga,2013,10,12000,0,12000
Tonga,2013,11,0,0,0
Tonga,2013,12,0,0,0
Tonga,2014,1,0,0,0
Tonga,2014,2,0,0,0
Tonga,2014,3,0,0,0
Tonga,2014,4,0,1000,1000
Tonga,2014,5,1000,0,1000
Tonga,2014,6,1000,0,1000
Tonga,2014,7,1000,0,1000
Tonga,2014,8,0,0,0
Tonga,2014,9,10000,0,10000
Tonga,2014,10,3000,0,3000
Tonga,2014,11,7000,0,7000
Tonga,2014,12,0,6000,6000
Tonga,2015,1,0,0,0
Tonga,2015,2,7000,0,7000
Tonga,2015,3,160000,0,160000
Tonga,2015,4,19000,0,19000
Tonga,2015,5,79000,0,79000
Tonga,2015,6,7000,0,7000
Tonga,2015,7,13000,0,13000
Tonga,2015,8,130000,0,130000
Tonga,2015,9,12000,0,12000
Tonga,2015,10,18000,0,18000
Tonga,2015,11,1000,35000,36000
Tonga,2015,12,262000,1000,263000
Tonga,2016,1,4000,6000,10000
Tonga,2016,2,1000,0,1000
Tonga,2016,3,40000,0,40000
Tonga,2016,4,24000,2000,26000
Tonga,2016,5,26000,0,26000
Tonga,2016,6,113000,2000,115000
Tonga,2016,7,13000,0,13000
Tonga,2016,8,124000,0,124000
Tonga,2016,9,48000,0,48000
Tonga,2016,10,26000,0,26000
Tonga,2016,11,11000,0,11000
Tonga,2016,12,34000,0,34000
Tonga,2017,1,9000,0,9000
Tonga,2017,2,7000,0,7000
Tonga,2017,3,2000,12000,14000
Tonga,2017,4,0,0,0
Tonga,2017,5,13000,0,13000
Tonga,2017,6,12000,0,12000
Tonga,2017,7,5000,0,5000
Tonga,2017,8,5000,0,5000
Tonga,2017,9,39000,10000,49000
Tonga,2017,10,9000,0,9000
Tonga,2017,11,13000,6000,19000
Tonga,2017,12,1000,1000,2000
Tonga,2018,1,0,0,0
Tonga,2018,2,10000,0,10000
Tonga,2018,3,46000,0,46000
Tonga,2018,4,0,0,0
Tonga,2018,5,5000,0,5000
Tonga,2018,6,11000,0,11000
Tonga,2018,7,28000,5000,33000
Tonga,2018,8,1000,0,1000
Tonga,2018,9,8000,6000,14000
Tonga,2018,10,34000,12000,46000
Tonga,2018,11,5000,80000,85000
Tonga,2018,12,17000,0,17000
Tonga,2019,1,77000,0,77000
Tonga,2019,2,17000,8000,25000
Tonga,2019,3,6000,0,6000
Tonga,2019,4,9000,0,9000
Tonga,2019,5,0,0,0
Tonga,2019,6,12000,0,12000
Tonga,2019,7,52000,0,52000
Tonga,2019,8,0,0,0
Tonga,2019,9,0,36000,36000
Tonga,2019,10,21000,1000,22000
Tonga,2019,11,39000,0,39000
Tonga,2019,12,0,0,0
Tonga,2020,1,1000,0,1000
Tonga,2020,2,61000,0,61000
Tonga,2020,3,0,0,0
Tonga,2020,4,19000,0,19000
Tonga,2020,5,53000,0,53000
Tonga,2020,6,16000,0,16000
Tonga,2020,7,10000,0,10000
Tonga,2020,8,0,0,0
Tonga,2020,9,2000,0,2000
Tonga,2020,10,0,0,0
Tonga,2020,11,7000,0,7000
Tonga,2020,12,59000,0,59000
Tonga,2021,1,0,0,0
Tonga,2021,2,0,0,0
Tonga,2021,3,28000,0,28000
Tonga,2021,4,7000,0,7000
Tonga,2021,5,6000,0,6000
Tonga,2021,6,10000,0,10000
Tonga,2021,7,0,0,0
Tonga,2021,8,8000,0,8000
Tonga,2021,9,0,0,0
Tonga,2021,10,10000,0,10000
Tonga,2021,11,0,16000,16000
Tonga,2021,12,22000,0,22000
Tonga,2022,1,94000,2000,96000
Tonga,2022,2,32000,0,32000
Tonga,2022,3,5000,0,5000
Tonga,2022,4,11000,0,11000
Tonga,2022,5,0,0,0
Tonga,2022,6,16000,0,16000
Tonga,2022,7,0,0,0
Tonga,2022,8,99000,0,99000
Tonga,2022,9,7000,0,7000
Tonga,2022,10,12000,0,12000
Tonga,2022,11,0,0,0
Tonga,2022,12,64000,0,64000
Tonga,2023,1,1000,0,1000
Tonga,2023,2,1000,247000,248000
Tonga,2023,3,1000,0,1000
Tonga,2023,4,6000,0,6000
Tonga,2023,5,0,0,0
Tonga,2023,6,76000,0,76000
Tonga,2023,7,0,0,0
Tonga,2023,8,1000,13000,14000
Tonga,2023,9,0,0,0
Tonga,2023,10,38000,0,38000
Tonga,2023,11,0,0,0
Tonga,2023,12,0,0,0
Tonga,2024,1,63000,26000,89000
Tonga,2024,2,0,0,0
Tonga,2024,3,84000,281000,365000
Tonga,2024,4,6000,0,6000
Tonga,2024,5,0,16000,16000
Tonga,2024,6,0,0,0
Tonga,2024,7,8000,0,8000
Tonga,2024,8,4000,96000,100000
Tonga,2024,9,4000,0,4000
Tonga,2024,10,0,0,0
Tonga,2024,11,0,0,0
Tonga,2024,12,0,0,0
Trinidad und Tobago,2008,1,16340000,176000,16516000
Trinidad und Tobago,2008,2,16369000,115000,16484000
Trinidad und Tobago,2008,3,8219000,82000,8301000
Trinidad und Tobago,2008,4,12177000,1101000,13278000
Trinidad und Tobago,2008,5,16618000,100000,16718000
Trinidad und Tobago,2008,6,20992000,948000,21940000
Trinidad und Tobago,2008,7,11584000,4847000,16431000
Trinidad und Tobago,2008,8,7764000,406000,8170000
Trinidad und Tobago,2008,9,39903000,313000,40216000
Trinidad und Tobago,2008,10,17042000,2157000,19199000
Trinidad und Tobago,2008,11,30412000,8733000,39145000
Trinidad und Tobago,2008,12,20043000,9673000,29716000
Trinidad und Tobago,2009,1,25013000,130000,25143000
Trinidad und Tobago,2009,2,12143000,3287000,15430000
Trinidad und Tobago,2009,3,39145000,1954000,41099000
Trinidad und Tobago,2009,4,12115000,12022000,24137000
Trinidad und Tobago,2009,5,5885000,1012000,6897000
Trinidad und Tobago,2009,6,11477000,145000,11622000
Trinidad und Tobago,2009,7,8982000,216000,9198000
Trinidad und Tobago,2009,8,9240000,21110000,30350000
Trinidad und Tobago,2009,9,14086000,220000,14306000
Trinidad und Tobago,2009,10,8709000,1374000,10083000
Trinidad und Tobago,2009,11,10457000,14445000,24902000
Trinidad und Tobago,2009,12,15739000,6223000,21962000
Trinidad und Tobago,2010,1,15129000,3636000,18765000
Trinidad und Tobago,2010,2,11145000,3758000,14903000
Trinidad und Tobago,2010,3,10050000,6175000,16225000
Trinidad und Tobago,2010,4,9576000,12023000,21599000
Trinidad und Tobago,2010,5,8588000,3796000,12384000
Trinidad und Tobago,2010,6,15510000,1373000,16883000
Trinidad und Tobago,2010,7,7670000,1186000,8856000
Trinidad und Tobago,2010,8,20108000,422000,20530000
Trinidad und Tobago,2010,9,13018000,19546000,32564000
Trinidad und Tobago,2010,10,7080000,15227000,22307000
Trinidad und Tobago,2010,11,6233000,8458000,14691000
Trinidad und Tobago,2010,12,5431000,16506000,21937000
Trinidad und Tobago,2011,1,6374000,5347000,11721000
Trinidad und Tobago,2011,2,6337000,2275000,8612000
Trinidad und Tobago,2011,3,9292000,30533000,39825000
Trinidad und Tobago,2011,4,7810000,39402000,47212000
Trinidad und Tobago,2011,5,9450000,3368000,12818000
Trinidad und Tobago,2011,6,5628000,8573000,14201000
Trinidad und Tobago,2011,7,6290000,12722000,19012000
Trinidad und Tobago,2011,8,11128000,2676000,13804000
Trinidad und Tobago,2011,9,8015000,12230000,20245000
Trinidad und Tobago,2011,10,7446000,652000,8098000
Trinidad und Tobago,2011,11,9266000,12685000,21951000
Trinidad und Tobago,2011,12,9583000,3192000,12775000
Trinidad und Tobago,2012,1,7278000,14237000,21515000
Trinidad und Tobago,2012,2,10050000,6522000,16572000
Trinidad und Tobago,2012,3,8855000,7323000,16178000
Trinidad und Tobago,2012,4,7143000,9392000,16535000
Trinidad und Tobago,2012,5,8732000,4808000,13540000
Trinidad und Tobago,2012,6,14419000,2064000,16483000
Trinidad und Tobago,2012,7,19915000,5236000,25151000
Trinidad und Tobago,2012,8,11269000,2434000,13703000
Trinidad und Tobago,2012,9,9247000,12607000,21854000
Trinidad und Tobago,2012,10,9182000,14171000,23353000
Trinidad und Tobago,2012,11,13302000,1125000,14427000
Trinidad und Tobago,2012,12,9220000,1892000,11112000
Trinidad und Tobago,2013,1,9610000,2865000,12475000
Trinidad und Tobago,2013,2,5319000,1689000,7008000
Trinidad und Tobago,2013,3,5799000,24534000,30333000
Trinidad und Tobago,2013,4,9394000,1774000,11168000
Trinidad und Tobago,2013,5,13782000,2714000,16496000
Trinidad und Tobago,2013,6,11700000,11786000,23486000
Trinidad und Tobago,2013,7,10724000,3396000,14120000
Trinidad und Tobago,2013,8,7702000,1851000,9553000
Trinidad und Tobago,2013,9,8867000,5240000,14107000
Trinidad und Tobago,2013,10,12048000,5034000,17082000
Trinidad und Tobago,2013,11,7177000,44813000,51990000
Trinidad und Tobago,2013,12,8491000,11584000,20075000
Trinidad und Tobago,2014,1,12275000,32827000,45102000
Trinidad und Tobago,2014,2,9382000,52739000,62121000
Trinidad und Tobago,2014,3,9051000,49382000,58433000
Trinidad und Tobago,2014,4,18717000,10681000,29398000
Trinidad und Tobago,2014,5,7854000,786000,8640000
Trinidad und Tobago,2014,6,8738000,2615000,11353000
Trinidad und Tobago,2014,7,7427000,4670000,12097000
Trinidad und Tobago,2014,8,6332000,2340000,8672000
Trinidad und Tobago,2014,9,12883000,5705000,18588000
Trinidad und Tobago,2014,10,8559000,7108000,15667000
Trinidad und Tobago,2014,11,8081000,5704000,13785000
Trinidad und Tobago,2014,12,9080000,3123000,12203000
Trinidad und Tobago,2015,1,8233000,5343000,13576000
Trinidad und Tobago,2015,2,8401000,8248000,16649000
Trinidad und Tobago,2015,3,8886000,17850000,26736000
Trinidad und Tobago,2015,4,9868000,7918000,17786000
Trinidad und Tobago,2015,5,9412000,8356000,17768000
Trinidad und Tobago,2015,6,12935000,3421000,16356000
Trinidad und Tobago,2015,7,11279000,4277000,15556000
Trinidad und Tobago,2015,8,9212000,4593000,13805000
Trinidad und Tobago,2015,9,15367000,16137000,31504000
Trinidad und Tobago,2015,10,11705000,7327000,19032000
Trinidad und Tobago,2015,11,7440000,9716000,17156000
Trinidad und Tobago,2015,12,6963000,4102000,11065000
Trinidad und Tobago,2016,1,4972000,2766000,7738000
Trinidad und Tobago,2016,2,10309000,4544000,14853000
Trinidad und Tobago,2016,3,7467000,3809000,11276000
Trinidad und Tobago,2016,4,9976000,5566000,15542000
Trinidad und Tobago,2016,5,8477000,2844000,11321000
Trinidad und Tobago,2016,6,8299000,2460000,10759000
Trinidad und Tobago,2016,7,41534000,1262000,42796000
Trinidad und Tobago,2016,8,9936000,764000,10700000
Trinidad und Tobago,2016,9,9803000,2798000,12601000
Trinidad und Tobago,2016,10,6865000,2093000,8958000
Trinidad und Tobago,2016,11,9391000,5604000,14995000
Trinidad und Tobago,2016,12,6391000,2467000,8858000
Trinidad und Tobago,2017,1,7394000,10076000,17470000
Trinidad und Tobago,2017,2,5236000,9194000,14430000
Trinidad und Tobago,2017,3,5391000,5436000,10827000
Trinidad und Tobago,2017,4,6117000,10346000,16463000
Trinidad und Tobago,2017,5,6200000,13460000,19660000
Trinidad und Tobago,2017,6,6031000,7796000,13827000
Trinidad und Tobago,2017,7,12915000,9047000,21962000
Trinidad und Tobago,2017,8,10545000,10233000,20778000
Trinidad und Tobago,2017,9,5175000,9040000,14215000
Trinidad und Tobago,2017,10,6357000,6941000,13298000
Trinidad und Tobago,2017,11,6978000,10769000,17747000
Trinidad und Tobago,2017,12,6803000,6647000,13450000
Trinidad und Tobago,2018,1,5721000,6815000,12536000
Trinidad und Tobago,2018,2,6304000,6981000,13285000
Trinidad und Tobago,2018,3,7912000,6636000,14548000
Trinidad und Tobago,2018,4,9357000,5926000,15283000
Trinidad und Tobago,2018,5,7645000,8157000,15802000
Trinidad und Tobago,2018,6,7927000,6640000,14567000
Trinidad und Tobago,2018,7,8800000,4555000,13355000
Trinidad und Tobago,2018,8,7353000,7045000,14398000
Trinidad und Tobago,2018,9,7318000,7605000,14923000
Trinidad und Tobago,2018,10,7439000,5702000,13141000
Trinidad und Tobago,2018,11,8654000,4132000,12786000
Trinidad und Tobago,2018,12,8068000,7403000,15471000
Trinidad und Tobago,2019,1,6942000,3190000,10132000
Trinidad und Tobago,2019,2,6604000,12657000,19261000
Trinidad und Tobago,2019,3,7838000,6227000,14065000
Trinidad und Tobago,2019,4,7882000,3240000,11122000
Trinidad und Tobago,2019,5,7584000,7988000,15572000
Trinidad und Tobago,2019,6,14235000,4162000,18397000
Trinidad und Tobago,2019,7,7588000,2782000,10370000
Trinidad und Tobago,2019,8,7819000,3090000,10909000
Trinidad und Tobago,2019,9,5336000,2675000,8011000
Trinidad und Tobago,2019,10,7271000,26035000,33306000
Trinidad und Tobago,2019,11,7845000,7574000,15419000
Trinidad und Tobago,2019,12,12673000,3753000,16426000
Trinidad und Tobago,2020,1,5640000,4977000,10617000
Trinidad und Tobago,2020,2,5602000,3444000,9046000
Trinidad und Tobago,2020,3,10972000,4919000,15891000
Trinidad und Tobago,2020,4,5083000,5737000,10820000
Trinidad und Tobago,2020,5,6349000,2088000,8437000
Trinidad und Tobago,2020,6,7085000,1652000,8737000
Trinidad und Tobago,2020,7,7442000,454000,7896000
Trinidad und Tobago,2020,8,11341000,3614000,14955000
Trinidad und Tobago,2020,9,7294000,7733000,15027000
Trinidad und Tobago,2020,10,7071000,1020000,8091000
Trinidad und Tobago,2020,11,6908000,641000,7549000
Trinidad und Tobago,2020,12,19605000,2069000,21674000
Trinidad und Tobago,2021,1,13180000,2706000,15886000
Trinidad und Tobago,2021,2,7274000,1067000,8341000
Trinidad und Tobago,2021,3,12764000,2105000,14869000
Trinidad und Tobago,2021,4,7862000,1263000,9125000
Trinidad und Tobago,2021,5,5380000,5225000,10605000
Trinidad und Tobago,2021,6,6621000,2565000,9186000
Trinidad und Tobago,2021,7,5567000,4706000,10273000
Trinidad und Tobago,2021,8,6432000,3921000,10353000
Trinidad und Tobago,2021,9,6680000,27806000,34486000
Trinidad und Tobago,2021,10,8368000,4429000,12797000
Trinidad und Tobago,2021,11,7463000,7874000,15337000
Trinidad und Tobago,2021,12,12135000,7611000,19746000
Trinidad und Tobago,2022,1,7137000,7180000,14317000
Trinidad und Tobago,2022,2,9797000,37713000,47510000
Trinidad und Tobago,2022,3,9751000,5830000,15581000
Trinidad und Tobago,2022,4,8046000,46596000,54642000
Trinidad und Tobago,2022,5,6989000,11021000,18010000
Trinidad und Tobago,2022,6,7451000,55558000,63009000
Trinidad und Tobago,2022,7,8826000,18612000,27438000
Trinidad und Tobago,2022,8,8505000,8070000,16575000
Trinidad und Tobago,2022,9,19709000,11176000,30885000
Trinidad und Tobago,2022,10,9493000,10372000,19865000
Trinidad und Tobago,2022,11,9247000,8679000,17926000
Trinidad und Tobago,2022,12,8976000,8830000,17806000
Trinidad und Tobago,2023,1,6157000,9754000,15911000
Trinidad und Tobago,2023,2,7870000,64075000,71945000
Trinidad und Tobago,2023,3,10572000,13190000,23762000
Trinidad und Tobago,2023,4,10176000,9564000,19740000
Trinidad und Tobago,2023,5,15046000,7513000,22559000
Trinidad und Tobago,2023,6,15028000,6616000,21644000
Trinidad und Tobago,2023,7,12775000,4333000,17108000
Trinidad und Tobago,2023,8,11949000,30377000,42326000
Trinidad und Tobago,2023,9,12553000,6853000,19406000
Trinidad und Tobago,2023,10,10613000,2612000,13225000
Trinidad und Tobago,2023,11,16748000,6409000,23157000
Trinidad und Tobago,2023,12,12121000,6354000,18475000
Trinidad und Tobago,2024,1,9247000,4059000,13306000
Trinidad und Tobago,2024,2,8673000,2115000,10788000
Trinidad und Tobago,2024,3,14048000,3580000,17628000
Trinidad und Tobago,2024,4,8169000,7797000,15966000
Trinidad und Tobago,2024,5,10153000,4951000,15104000
Trinidad und Tobago,2024,6,6687000,5290000,11977000
Trinidad und Tobago,2024,7,10669000,9873000,20542000
Trinidad und Tobago,2024,8,8882000,12911000,21793000
Trinidad und Tobago,2024,9,11861000,9626000,21487000
Trinidad und Tobago,2024,10,13095000,7782000,20877000
Trinidad und Tobago,2024,11,8981000,12212000,21193000
Trinidad und Tobago,2024,12,9253000,10570000,19823000
Tschad,2008,1,2998000,343000,3341000
Tschad,2008,2,1775000,431000,2206000
Tschad,2008,3,2572000,77000,2649000
Tschad,2008,4,3826000,2020000,5846000
Tschad,2008,5,1888000,698000,2586000
Tschad,2008,6,1892000,896000,2788000
Tschad,2008,7,2533000,321000,2854000
Tschad,2008,8,3359000,862000,4221000
Tschad,2008,9,1481000,296000,1777000
Tschad,2008,10,2158000,0,2158000
Tschad,2008,11,2639000,402000,3041000
Tschad,2008,12,3652000,324000,3976000
Tschad,2009,1,1980000,243000,2223000
Tschad,2009,2,1867000,607000,2474000
Tschad,2009,3,1884000,0,1884000
Tschad,2009,4,1246000,509000,1755000
Tschad,2009,5,1462000,287000,1749000
Tschad,2009,6,2176000,602000,2778000
Tschad,2009,7,1224000,439000,1663000
Tschad,2009,8,1871000,375000,2246000
Tschad,2009,9,785000,99000,884000
Tschad,2009,10,1087000,106000,1193000
Tschad,2009,11,555000,481000,1036000
Tschad,2009,12,714000,0,714000
Tschad,2010,1,566000,25000,591000
Tschad,2010,2,2199000,0,2199000
Tschad,2010,3,1928000,285000,2213000
Tschad,2010,4,1887000,107000,1994000
Tschad,2010,5,1447000,0,1447000
Tschad,2010,6,1734000,160000,1894000
Tschad,2010,7,1165000,80000,1245000
Tschad,2010,8,1881000,648000,2529000
Tschad,2010,9,1694000,484000,2178000
Tschad,2010,10,2421000,22770000,25191000
Tschad,2010,11,1574000,43456000,45030000
Tschad,2010,12,1488000,9000,1497000
Tschad,2011,1,599000,3000,602000
Tschad,2011,2,786000,95000,881000
Tschad,2011,3,1071000,1555000,2626000
Tschad,2011,4,1659000,1765000,3424000
Tschad,2011,5,986000,2091000,3077000
Tschad,2011,6,1071000,1599000,2670000
Tschad,2011,7,1007000,2910000,3917000
Tschad,2011,8,961000,1743000,2704000
Tschad,2011,9,525000,341000,866000
Tschad,2011,10,1221000,307000,1528000
Tschad,2011,11,1155000,250000,1405000
Tschad,2011,12,1016000,168000,1184000
Tschad,2012,1,2306000,3000,2309000
Tschad,2012,2,789000,24000,813000
Tschad,2012,3,1010000,580000,1590000
Tschad,2012,4,1384000,1233000,2617000
Tschad,2012,5,1432000,161000,1593000
Tschad,2012,6,1596000,298000,1894000
Tschad,2012,7,1809000,327000,2136000
Tschad,2012,8,2457000,6000,2463000
Tschad,2012,9,1517000,174000,1691000
Tschad,2012,10,1229000,94000,1323000
Tschad,2012,11,1920000,148000,2068000
Tschad,2012,12,1556000,215000,1771000
Tschad,2013,1,808000,86000,894000
Tschad,2013,2,1147000,75000,1222000
Tschad,2013,3,1409000,880000,2289000
Tschad,2013,4,1179000,43000,1222000
Tschad,2013,5,1228000,219000,1447000
Tschad,2013,6,1120000,220000,1340000
Tschad,2013,7,1084000,132000,1216000
Tschad,2013,8,1034000,392000,1426000
Tschad,2013,9,1492000,480000,1972000
Tschad,2013,10,1378000,20000,1398000
Tschad,2013,11,2238000,37000,2275000
Tschad,2013,12,1522000,87000,1609000
Tschad,2014,1,1577000,84000,1661000
Tschad,2014,2,6915000,0,6915000
Tschad,2014,3,4425000,291000,4716000
Tschad,2014,4,4306000,143000,4449000
Tschad,2014,5,1616000,1794000,3410000
Tschad,2014,6,3711000,187000,3898000
Tschad,2014,7,1062000,451000,1513000
Tschad,2014,8,1251000,99000,1350000
Tschad,2014,9,1874000,163000,2037000
Tschad,2014,10,1501000,165000,1666000
Tschad,2014,11,1708000,0,1708000
Tschad,2014,12,5279000,18000,5297000
Tschad,2015,1,1106000,77000,1183000
Tschad,2015,2,1128000,0,1128000
Tschad,2015,3,1848000,19000,1867000
Tschad,2015,4,1641000,46000,1687000
Tschad,2015,5,1828000,83000,1911000
Tschad,2015,6,1938000,79000,2017000
Tschad,2015,7,1764000,815000,2579000
Tschad,2015,8,1411000,45000,1456000
Tschad,2015,9,919000,375000,1294000
Tschad,2015,10,1486000,430000,1916000
Tschad,2015,11,1264000,356000,1620000
Tschad,2015,12,1250000,879000,2129000
Tschad,2016,1,928000,517000,1445000
Tschad,2016,2,2125000,5000,2130000
Tschad,2016,3,2662000,47000,2709000
Tschad,2016,4,1019000,254000,1273000
Tschad,2016,5,1561000,112000,1673000
Tschad,2016,6,2913000,620000,3533000
Tschad,2016,7,1518000,0,1518000
Tschad,2016,8,1427000,319000,1746000
Tschad,2016,9,1683000,0,1683000
Tschad,2016,10,1019000,384000,1403000
Tschad,2016,11,645000,1253000,1898000
Tschad,2016,12,920000,185000,1105000
Tschad,2017,1,479000,331000,810000
Tschad,2017,2,873000,305000,1178000
Tschad,2017,3,781000,185000,966000
Tschad,2017,4,723000,332000,1055000
Tschad,2017,5,961000,229000,1190000
Tschad,2017,6,617000,265000,882000
Tschad,2017,7,764000,13000,777000
Tschad,2017,8,644000,801000,1445000
Tschad,2017,9,830000,67000,897000
Tschad,2017,10,948000,78000,1026000
Tschad,2017,11,582000,117000,699000
Tschad,2017,12,1733000,0,1733000
Tschad,2018,1,796000,1000,797000
Tschad,2018,2,541000,11000,552000
Tschad,2018,3,768000,34000,802000
Tschad,2018,4,992000,24000,1016000
Tschad,2018,5,1202000,0,1202000
Tschad,2018,6,1220000,95000,1315000
Tschad,2018,7,731000,38000,769000
Tschad,2018,8,987000,14000,1001000
Tschad,2018,9,3631000,2000,3633000
Tschad,2018,10,1435000,758000,2193000
Tschad,2018,11,788000,212000,1000000
Tschad,2018,12,558000,105000,663000
Tschad,2019,1,1097000,136000,1233000
Tschad,2019,2,1216000,64000,1280000
Tschad,2019,3,1467000,1000,1468000
Tschad,2019,4,1219000,4000,1223000
Tschad,2019,5,817000,3000,820000
Tschad,2019,6,927000,425000,1352000
Tschad,2019,7,882000,58895000,59777000
Tschad,2019,8,890000,3000,893000
Tschad,2019,9,867000,20000,887000
Tschad,2019,10,782000,349000,1131000
Tschad,2019,11,2333000,50000,2383000
Tschad,2019,12,2843000,123000,2966000
Tschad,2020,1,856000,1000,857000
Tschad,2020,2,900000,3000,903000
Tschad,2020,3,1031000,152000,1183000
Tschad,2020,4,939000,1285000,2224000
Tschad,2020,5,458000,20000,478000
Tschad,2020,6,809000,58049000,58858000
Tschad,2020,7,1470000,2000,1472000
Tschad,2020,8,829000,24000,853000
Tschad,2020,9,1204000,36392000,37596000
Tschad,2020,10,732000,30613000,31345000
Tschad,2020,11,1423000,32847000,34270000
Tschad,2020,12,1042000,76835000,77877000
Tschad,2021,1,2087000,42227000,44314000
Tschad,2021,2,908000,92351000,93259000
Tschad,2021,3,1458000,53857000,55315000
Tschad,2021,4,919000,65346000,66265000
Tschad,2021,5,781000,66537000,67318000
Tschad,2021,6,633000,54730000,55363000
Tschad,2021,7,499000,126275000,126774000
Tschad,2021,8,884000,65377000,66261000
Tschad,2021,9,2120000,58915000,61035000
Tschad,2021,10,1209000,132175000,133384000
Tschad,2021,11,1410000,72184000,73594000
Tschad,2021,12,1363000,71392000,72755000
Tschad,2022,1,1464000,614000,2078000
Tschad,2022,2,1516000,323000,1839000
Tschad,2022,3,1469000,100000,1569000
Tschad,2022,4,953000,250000,1203000
Tschad,2022,5,2222000,96111000,98333000
Tschad,2022,6,3265000,212505000,215770000
Tschad,2022,7,1190000,243271000,244461000
Tschad,2022,8,1405000,101801000,103206000
Tschad,2022,9,1220000,193390000,194610000
Tschad,2022,10,2888000,87770000,90658000
Tschad,2022,11,2817000,197651000,200468000
Tschad,2022,12,660000,71630000,72290000
Tschad,2023,1,846000,424000,1270000
Tschad,2023,2,990000,75553000,76543000
Tschad,2023,3,790000,150571000,151361000
Tschad,2023,4,1519000,74875000,76394000
Tschad,2023,5,777000,68084000,68861000
Tschad,2023,6,1334000,473000,1807000
Tschad,2023,7,1964000,531000,2495000
Tschad,2023,8,1042000,422000,1464000
Tschad,2023,9,1446000,672000,2118000
Tschad,2023,10,2340000,82182000,84522000
Tschad,2023,11,1184000,161921000,163105000
Tschad,2023,12,1495000,74977000,76472000
Tschad,2024,1,1647000,1627000,3274000
Tschad,2024,2,1793000,140027000,141820000
Tschad,2024,3,1184000,76395000,77579000
Tschad,2024,4,1954000,166410000,168364000
Tschad,2024,5,1047000,984000,2031000
Tschad,2024,6,1409000,149420000,150829000
Tschad,2024,7,1888000,75011000,76899000
Tschad,2024,8,1122000,73770000,74892000
Tschad,2024,9,1686000,64306000,65992000
Tschad,2024,10,3044000,1060000,4104000
Tschad,2024,11,3941000,70398000,74339000
Tschad,2024,12,3171000,132500000,135671000
Tschechien (ab 1993),2008,1,2281230000,2186652000,4467882000
Tschechien (ab 1993),2008,2,2365848000,2257642000,4623490000
Tschechien (ab 1993),2008,3,2426462000,2329598000,4756060000
Tschechien (ab 1993),2008,4,2592354000,2486144000,5078498000
Tschechien (ab 1993),2008,5,2301664000,2315133000,4616797000
Tschechien (ab 1993),2008,6,2385474000,2457548000,4843022000
Tschechien (ab 1993),2008,7,2361672000,2306502000,4668174000
Tschechien (ab 1993),2008,8,2131976000,2157036000,4289012000
Tschechien (ab 1993),2008,9,2443268000,2484463000,4927731000
Tschechien (ab 1993),2008,10,2459671000,2553811000,5013482000
Tschechien (ab 1993),2008,11,2133775000,2199185000,4332960000
Tschechien (ab 1993),2008,12,1717204000,1814298000,3531502000
Tschechien (ab 1993),2009,1,1740275000,1713455000,3453730000
Tschechien (ab 1993),2009,2,1582229000,1799250000,3381479000
Tschechien (ab 1993),2009,3,1776042000,2206476000,3982518000
Tschechien (ab 1993),2009,4,1807960000,2022363000,3830323000
Tschechien (ab 1993),2009,5,1705139000,1838961000,3544100000
Tschechien (ab 1993),2009,6,1831129000,2083788000,3914917000
Tschechien (ab 1993),2009,7,1802839000,1859072000,3661911000
Tschechien (ab 1993),2009,8,1778236000,1889540000,3667776000
Tschechien (ab 1993),2009,9,2139217000,2264391000,4403608000
Tschechien (ab 1993),2009,10,2099897000,2303059000,4402956000
Tschechien (ab 1993),2009,11,2017896000,2144694000,4162590000
Tschechien (ab 1993),2009,12,1751160000,1880885000,3632045000
Tschechien (ab 1993),2010,1,1808637000,1910120000,3718757000
Tschechien (ab 1993),2010,2,1835256000,2113497000,3948753000
Tschechien (ab 1993),2010,3,2310519000,2486174000,4796693000
Tschechien (ab 1993),2010,4,2054552000,2285010000,4339562000
Tschechien (ab 1993),2010,5,2113817000,2378124000,4491941000
Tschechien (ab 1993),2010,6,2365773000,2461282000,4827055000
Tschechien (ab 1993),2010,7,2043369000,2266884000,4310253000
Tschechien (ab 1993),2010,8,2195285000,2315002000,4510287000
Tschechien (ab 1993),2010,9,2516118000,2644726000,5160844000
Tschechien (ab 1993),2010,10,2604623000,2786099000,5390722000
Tschechien (ab 1993),2010,11,2616945000,2720692000,5337637000
Tschechien (ab 1993),2010,12,2243355000,2333899000,4577254000
Tschechien (ab 1993),2011,1,2325112000,2400356000,4725468000
Tschechien (ab 1993),2011,2,2397931000,2585610000,4983541000
Tschechien (ab 1993),2011,3,2781768000,2964431000,5746199000
Tschechien (ab 1993),2011,4,2543474000,2648348000,5191822000
Tschechien (ab 1993),2011,5,2671605000,2822693000,5494298000
Tschechien (ab 1993),2011,6,2686645000,2907870000,5594515000
Tschechien (ab 1993),2011,7,2361528000,2538094000,4899622000
Tschechien (ab 1993),2011,8,2562703000,2564518000,5127221000
Tschechien (ab 1993),2011,9,2695993000,2928949000,5624942000
Tschechien (ab 1993),2011,10,2650220000,2880888000,5531108000
Tschechien (ab 1993),2011,11,2785631000,2892493000,5678124000
Tschechien (ab 1993),2011,12,2361867000,2549975000,4911842000
Tschechien (ab 1993),2012,1,2502286000,2573490000,5075776000
Tschechien (ab 1993),2012,2,2716683000,2722118000,5438801000
Tschechien (ab 1993),2012,3,2820032000,2995890000,5815922000
Tschechien (ab 1993),2012,4,2617228000,2654010000,5271238000
Tschechien (ab 1993),2012,5,2605445000,2804660000,5410105000
Tschechien (ab 1993),2012,6,2650999000,2794020000,5445019000
Tschechien (ab 1993),2012,7,2484156000,2651834000,5135990000
Tschechien (ab 1993),2012,8,2631217000,2512167000,5143384000
Tschechien (ab 1993),2012,9,2653475000,2736209000,5389684000
Tschechien (ab 1993),2012,10,2933343000,3042870000,5976213000
Tschechien (ab 1993),2012,11,2666002000,2818121000,5484123000
Tschechien (ab 1993),2012,12,2006247000,2187607000,4193854000
Tschechien (ab 1993),2013,1,2520055000,2472059000,4992114000
Tschechien (ab 1993),2013,2,2493638000,2566231000,5059869000
Tschechien (ab 1993),2013,3,2585960000,2775300000,5361260000
Tschechien (ab 1993),2013,4,2584047000,2842894000,5426941000
Tschechien (ab 1993),2013,5,2454480000,2697289000,5151769000
Tschechien (ab 1993),2013,6,2616345000,2739887000,5356232000
Tschechien (ab 1993),2013,7,2488919000,2646823000,5135742000
Tschechien (ab 1993),2013,8,2570166000,2598293000,5168459000
Tschechien (ab 1993),2013,9,2706457000,2991502000,5697959000
Tschechien (ab 1993),2013,10,2991852000,3183820000,6175672000
Tschechien (ab 1993),2013,11,2840283000,3046294000,5886577000
Tschechien (ab 1993),2013,12,2201506000,2449923000,4651429000
Tschechien (ab 1993),2014,1,2888629000,2791429000,5680058000
Tschechien (ab 1993),2014,2,2693142000,2992637000,5685779000
Tschechien (ab 1993),2014,3,2742726000,3188811000,5931537000
Tschechien (ab 1993),2014,4,2852767000,3118799000,5971566000
Tschechien (ab 1993),2014,5,2693854000,3025420000,5719274000
Tschechien (ab 1993),2014,6,2855241000,3066993000,5922234000
Tschechien (ab 1993),2014,7,2856945000,3224726000,6081671000
Tschechien (ab 1993),2014,8,2480601000,2651339000,5131940000
Tschechien (ab 1993),2014,9,2980109000,3366367000,6346476000
Tschechien (ab 1993),2014,10,3014037000,3415753000,6429790000
Tschechien (ab 1993),2014,11,2906871000,3183067000,6089938000
Tschechien (ab 1993),2014,12,2504203000,2734859000,5239062000
Tschechien (ab 1993),2015,1,2814317000,2904348000,5718665000
Tschechien (ab 1993),2015,2,2835311000,3099086000,5934397000
Tschechien (ab 1993),2015,3,3155108000,3369269000,6524377000
Tschechien (ab 1993),2015,4,2849113000,3260033000,6109146000
Tschechien (ab 1993),2015,5,3010825000,3168232000,6179057000
Tschechien (ab 1993),2015,6,3174847000,3275143000,6449990000
Tschechien (ab 1993),2015,7,3100459000,3372510000,6472969000
Tschechien (ab 1993),2015,8,2742983000,2809005000,5551988000
Tschechien (ab 1993),2015,9,3410153000,3568344000,6978497000
Tschechien (ab 1993),2015,10,3367986000,3731620000,7099606000
Tschechien (ab 1993),2015,11,3317252000,3611389000,6928641000
Tschechien (ab 1993),2015,12,2701569000,3024448000,5726017000
Tschechien (ab 1993),2016,1,2872579000,3197139000,6069718000
Tschechien (ab 1993),2016,2,3036523000,3517237000,6553760000
Tschechien (ab 1993),2016,3,3240950000,3633886000,6874836000
Tschechien (ab 1993),2016,4,3260216000,3572726000,6832942000
Tschechien (ab 1993),2016,5,3191604000,3505858000,6697462000
Tschechien (ab 1993),2016,6,3426065000,3692316000,7118381000
Tschechien (ab 1993),2016,7,2783882000,3042266000,5826148000
Tschechien (ab 1993),2016,8,3183505000,3380584000,6564089000
Tschechien (ab 1993),2016,9,3373998000,3720750000,7094748000
Tschechien (ab 1993),2016,10,3374441000,3737506000,7111947000
Tschechien (ab 1993),2016,11,3481138000,3944407000,7425545000
Tschechien (ab 1993),2016,12,2869931000,3302677000,6172608000
Tschechien (ab 1993),2017,1,3301371000,3640194000,6941565000
Tschechien (ab 1993),2017,2,3380590000,3689892000,7070482000
Tschechien (ab 1993),2017,3,3697457000,4109616000,7807073000
Tschechien (ab 1993),2017,4,3462883000,3725839000,7188722000
Tschechien (ab 1993),2017,5,3563700000,4017130000,7580830000
Tschechien (ab 1993),2017,6,3633530000,3810497000,7444027000
Tschechien (ab 1993),2017,7,3097402000,3349191000,6446593000
Tschechien (ab 1993),2017,8,3430111000,3678743000,7108854000
Tschechien (ab 1993),2017,9,3564080000,3917666000,7481746000
Tschechien (ab 1993),2017,10,3688584000,4068213000,7756797000
Tschechien (ab 1993),2017,11,3823905000,4194513000,8018418000
Tschechien (ab 1993),2017,12,3060409000,3543036000,6603445000
Tschechien (ab 1993),2018,1,3539537000,3913639000,7453176000
Tschechien (ab 1993),2018,2,3459307000,3791985000,7251292000
Tschechien (ab 1993),2018,3,3689278000,4117327000,7806605000
Tschechien (ab 1993),2018,4,3637531000,4059992000,7697523000
Tschechien (ab 1993),2018,5,3823048000,3897800000,7720848000
Tschechien (ab 1993),2018,6,3836903000,4207904000,8044807000
Tschechien (ab 1993),2018,7,3511355000,3649573000,7160928000
Tschechien (ab 1993),2018,8,3638744000,3702200000,7340944000
Tschechien (ab 1993),2018,9,3931756000,3957074000,7888830000
Tschechien (ab 1993),2018,10,4150177000,4464831000,8615008000
Tschechien (ab 1993),2018,11,4028197000,4511882000,8540079000
Tschechien (ab 1993),2018,12,3016663000,3329529000,6346192000
Tschechien (ab 1993),2019,1,3597754000,3945378000,7543132000
Tschechien (ab 1993),2019,2,3615160000,3980434000,7595594000
Tschechien (ab 1993),2019,3,3746367000,4230170000,7976537000
Tschechien (ab 1993),2019,4,3695287000,4058301000,7753588000
Tschechien (ab 1993),2019,5,3731702000,3943715000,7675417000
Tschechien (ab 1993),2019,6,3709770000,4062035000,7771805000
Tschechien (ab 1993),2019,7,3544868000,3713401000,7258269000
Tschechien (ab 1993),2019,8,3506038000,3670346000,7176384000
Tschechien (ab 1993),2019,9,3918805000,4278301000,8197106000
Tschechien (ab 1993),2019,10,4139091000,4242239000,8381330000
Tschechien (ab 1993),2019,11,4091890000,4202438000,8294328000
Tschechien (ab 1993),2019,12,3167133000,3343106000,6510239000
Tschechien (ab 1993),2020,1,3660570000,3820580000,7481150000
Tschechien (ab 1993),2020,2,3651866000,3937967000,7589833000
Tschechien (ab 1993),2020,3,3663918000,3643646000,7307564000
Tschechien (ab 1993),2020,4,2487318000,2327122000,4814440000
Tschechien (ab 1993),2020,5,2605108000,2849063000,5454171000
Tschechien (ab 1993),2020,6,2975306000,3534596000,6509902000
Tschechien (ab 1993),2020,7,3076222000,3596573000,6672795000
Tschechien (ab 1993),2020,8,3124286000,3255310000,6379596000
Tschechien (ab 1993),2020,9,3632712000,4041379000,7674091000
Tschechien (ab 1993),2020,10,3734895000,4368285000,8103180000
Tschechien (ab 1993),2020,11,3780657000,4542477000,8323134000
Tschechien (ab 1993),2020,12,3171665000,3853658000,7025323000
Tschechien (ab 1993),2021,1,3439828000,3698179000,7138007000
Tschechien (ab 1993),2021,2,3659289000,3971714000,7631003000
Tschechien (ab 1993),2021,3,4257236000,4643701000,8900937000
Tschechien (ab 1993),2021,4,3923879000,4216579000,8140458000
Tschechien (ab 1993),2021,5,3995668000,4054159000,8049827000
Tschechien (ab 1993),2021,6,4176301000,4213374000,8389675000
Tschechien (ab 1993),2021,7,3669484000,3856850000,7526334000
Tschechien (ab 1993),2021,8,3641938000,3536488000,7178426000
Tschechien (ab 1993),2021,9,3947817000,4148710000,8096527000
Tschechien (ab 1993),2021,10,4185788000,4434303000,8620091000
Tschechien (ab 1993),2021,11,4434023000,4704841000,9138864000
Tschechien (ab 1993),2021,12,3947566000,4250278000,8197844000
Tschechien (ab 1993),2022,1,4384741000,4285280000,8670021000
Tschechien (ab 1993),2022,2,4512792000,4382163000,8894955000
Tschechien (ab 1993),2022,3,5282196000,5157187000,10439383000
Tschechien (ab 1993),2022,4,4396985000,4704684000,9101669000
Tschechien (ab 1993),2022,5,4922293000,5319734000,10242027000
Tschechien (ab 1993),2022,6,4878403000,5262410000,10140813000
Tschechien (ab 1993),2022,7,4189712000,4730508000,8920220000
Tschechien (ab 1993),2022,8,4650776000,4986787000,9637563000
Tschechien (ab 1993),2022,9,4989850000,5577018000,10566868000
Tschechien (ab 1993),2022,10,4676148000,4946986000,9623134000
Tschechien (ab 1993),2022,11,5087023000,5456972000,10543995000
Tschechien (ab 1993),2022,12,3873361000,4507313000,8380674000
Tschechien (ab 1993),2023,1,4691250000,4854474000,9545724000
Tschechien (ab 1993),2023,2,4384614000,5069139000,9453753000
Tschechien (ab 1993),2023,3,5167374000,5859767000,11027141000
Tschechien (ab 1993),2023,4,4241534000,4757051000,8998585000
Tschechien (ab 1993),2023,5,4558436000,5311120000,9869556000
Tschechien (ab 1993),2023,6,4744315000,5591972000,10336287000
Tschechien (ab 1993),2023,7,3899000000,4581762000,8480762000
Tschechien (ab 1993),2023,8,4300775000,4726147000,9026922000
Tschechien (ab 1993),2023,9,4380456000,5074990000,9455446000
Tschechien (ab 1993),2023,10,4441635000,5300875000,9742510000
Tschechien (ab 1993),2023,11,4543210000,5536616000,10079826000
Tschechien (ab 1993),2023,12,3512455000,4234527000,7746982000
Tschechien (ab 1993),2024,1,4479010000,5315132000,9794142000
Tschechien (ab 1993),2024,2,4436090000,5021621000,9457711000
Tschechien (ab 1993),2024,3,4532014000,4990756000,9522770000
Tschechien (ab 1993),2024,4,4490942000,5432536000,9923478000
Tschechien (ab 1993),2024,5,4284687000,4631370000,8916057000
Tschechien (ab 1993),2024,6,4318941000,4915984000,9234925000
Tschechien (ab 1993),2024,7,4084119000,4557712000,8641831000
Tschechien (ab 1993),2024,8,4181146000,4679627000,8860773000
Tschechien (ab 1993),2024,9,4298911000,5279976000,9578887000
Tschechien (ab 1993),2024,10,4386380000,5392365000,9778745000
Tschechien (ab 1993),2024,11,4333301000,5791909000,10125210000
Tschechien (ab 1993),2024,12,3661975000,4371945000,8033920000
Tschechoslowakei (bis 1992),2008,1,0,0,0
Tschechoslowakei (bis 1992),2008,2,0,0,0
Tschechoslowakei (bis 1992),2008,3,0,0,0
Tschechoslowakei (bis 1992),2008,4,0,0,0
Tschechoslowakei (bis 1992),2008,5,0,0,0
Tschechoslowakei (bis 1992),2008,6,0,0,0
Tschechoslowakei (bis 1992),2008,7,0,0,0
Tschechoslowakei (bis 1992),2008,8,0,0,0
Tschechoslowakei (bis 1992),2008,9,0,0,0
Tschechoslowakei (bis 1992),2008,10,0,0,0
Tschechoslowakei (bis 1992),2008,11,0,0,0
Tschechoslowakei (bis 1992),2008,12,0,0,0
Tschechoslowakei (bis 1992),2009,1,0,0,0
Tschechoslowakei (bis 1992),2009,2,0,0,0
Tschechoslowakei (bis 1992),2009,3,0,0,0
Tschechoslowakei (bis 1992),2009,4,0,0,0
Tschechoslowakei (bis 1992),2009,5,0,0,0
Tschechoslowakei (bis 1992),2009,6,0,0,0
Tschechoslowakei (bis 1992),2009,7,0,0,0
Tschechoslowakei (bis 1992),2009,8,0,0,0
Tschechoslowakei (bis 1992),2009,9,0,0,0
Tschechoslowakei (bis 1992),2009,10,0,0,0
Tschechoslowakei (bis 1992),2009,11,0,0,0
Tschechoslowakei (bis 1992),2009,12,0,0,0
Tschechoslowakei (bis 1992),2010,1,0,0,0
Tschechoslowakei (bis 1992),2010,2,0,0,0
Tschechoslowakei (bis 1992),2010,3,0,0,0
Tschechoslowakei (bis 1992),2010,4,0,0,0
Tschechoslowakei (bis 1992),2010,5,0,0,0
Tschechoslowakei (bis 1992),2010,6,0,0,0
Tschechoslowakei (bis 1992),2010,7,0,0,0
Tschechoslowakei (bis 1992),2010,8,0,0,0
Tschechoslowakei (bis 1992),2010,9,0,0,0
Tschechoslowakei (bis 1992),2010,10,0,0,0
Tschechoslowakei (bis 1992),2010,11,0,0,0
Tschechoslowakei (bis 1992),2010,12,0,0,0
Tschechoslowakei (bis 1992),2011,1,0,0,0
Tschechoslowakei (bis 1992),2011,2,0,0,0
Tschechoslowakei (bis 1992),2011,3,0,0,0
Tschechoslowakei (bis 1992),2011,4,0,0,0
Tschechoslowakei (bis 1992),2011,5,0,0,0
Tschechoslowakei (bis 1992),2011,6,0,0,0
Tschechoslowakei (bis 1992),2011,7,0,0,0
Tschechoslowakei (bis 1992),2011,8,0,0,0
Tschechoslowakei (bis 1992),2011,9,0,0,0
Tschechoslowakei (bis 1992),2011,10,0,0,0
Tschechoslowakei (bis 1992),2011,11,0,0,0
Tschechoslowakei (bis 1992),2011,12,0,0,0
Tschechoslowakei (bis 1992),2012,1,0,0,0
Tschechoslowakei (bis 1992),2012,2,0,0,0
Tschechoslowakei (bis 1992),2012,3,0,0,0
Tschechoslowakei (bis 1992),2012,4,0,0,0
Tschechoslowakei (bis 1992),2012,5,0,0,0
Tschechoslowakei (bis 1992),2012,6,0,0,0
Tschechoslowakei (bis 1992),2012,7,0,0,0
Tschechoslowakei (bis 1992),2012,8,0,0,0
Tschechoslowakei (bis 1992),2012,9,0,0,0
Tschechoslowakei (bis 1992),2012,10,0,0,0
Tschechoslowakei (bis 1992),2012,11,0,0,0
Tschechoslowakei (bis 1992),2012,12,0,0,0
Tschechoslowakei (bis 1992),2013,1,0,0,0
Tschechoslowakei (bis 1992),2013,2,0,0,0
Tschechoslowakei (bis 1992),2013,3,0,0,0
Tschechoslowakei (bis 1992),2013,4,0,0,0
Tschechoslowakei (bis 1992),2013,5,0,0,0
Tschechoslowakei (bis 1992),2013,6,0,0,0
Tschechoslowakei (bis 1992),2013,7,0,0,0
Tschechoslowakei (bis 1992),2013,8,0,0,0
Tschechoslowakei (bis 1992),2013,9,0,0,0
Tschechoslowakei (bis 1992),2013,10,0,0,0
Tschechoslowakei (bis 1992),2013,11,0,0,0
Tschechoslowakei (bis 1992),2013,12,0,0,0
Tschechoslowakei (bis 1992),2014,1,0,0,0
Tschechoslowakei (bis 1992),2014,2,0,0,0
Tschechoslowakei (bis 1992),2014,3,0,0,0
Tschechoslowakei (bis 1992),2014,4,0,0,0
Tschechoslowakei (bis 1992),2014,5,0,0,0
Tschechoslowakei (bis 1992),2014,6,0,0,0
Tschechoslowakei (bis 1992),2014,7,0,0,0
Tschechoslowakei (bis 1992),2014,8,0,0,0
Tschechoslowakei (bis 1992),2014,9,0,0,0
Tschechoslowakei (bis 1992),2014,10,0,0,0
Tschechoslowakei (bis 1992),2014,11,0,0,0
Tschechoslowakei (bis 1992),2014,12,0,0,0
Tschechoslowakei (bis 1992),2015,1,0,0,0
Tschechoslowakei (bis 1992),2015,2,0,0,0
Tschechoslowakei (bis 1992),2015,3,0,0,0
Tschechoslowakei (bis 1992),2015,4,0,0,0
Tschechoslowakei (bis 1992),2015,5,0,0,0
Tschechoslowakei (bis 1992),2015,6,0,0,0
Tschechoslowakei (bis 1992),2015,7,0,0,0
Tschechoslowakei (bis 1992),2015,8,0,0,0
Tschechoslowakei (bis 1992),2015,9,0,0,0
Tschechoslowakei (bis 1992),2015,10,0,0,0
Tschechoslowakei (bis 1992),2015,11,0,0,0
Tschechoslowakei (bis 1992),2015,12,0,0,0
Tschechoslowakei (bis 1992),2016,1,0,0,0
Tschechoslowakei (bis 1992),2016,2,0,0,0
Tschechoslowakei (bis 1992),2016,3,0,0,0
Tschechoslowakei (bis 1992),2016,4,0,0,0
Tschechoslowakei (bis 1992),2016,5,0,0,0
Tschechoslowakei (bis 1992),2016,6,0,0,0
Tschechoslowakei (bis 1992),2016,7,0,0,0
Tschechoslowakei (bis 1992),2016,8,0,0,0
Tschechoslowakei (bis 1992),2016,9,0,0,0
Tschechoslowakei (bis 1992),2016,10,0,0,0
Tschechoslowakei (bis 1992),2016,11,0,0,0
Tschechoslowakei (bis 1992),2016,12,0,0,0
Tschechoslowakei (bis 1992),2017,1,0,0,0
Tschechoslowakei (bis 1992),2017,2,0,0,0
Tschechoslowakei (bis 1992),2017,3,0,0,0
Tschechoslowakei (bis 1992),2017,4,0,0,0
Tschechoslowakei (bis 1992),2017,5,0,0,0
Tschechoslowakei (bis 1992),2017,6,0,0,0
Tschechoslowakei (bis 1992),2017,7,0,0,0
Tschechoslowakei (bis 1992),2017,8,0,0,0
Tschechoslowakei (bis 1992),2017,9,0,0,0
Tschechoslowakei (bis 1992),2017,10,0,0,0
Tschechoslowakei (bis 1992),2017,11,0,0,0
Tschechoslowakei (bis 1992),2017,12,0,0,0
Tschechoslowakei (bis 1992),2018,1,0,0,0
Tschechoslowakei (bis 1992),2018,2,0,0,0
Tschechoslowakei (bis 1992),2018,3,0,0,0
Tschechoslowakei (bis 1992),2018,4,0,0,0
Tschechoslowakei (bis 1992),2018,5,0,0,0
Tschechoslowakei (bis 1992),2018,6,0,0,0
Tschechoslowakei (bis 1992),2018,7,0,0,0
Tschechoslowakei (bis 1992),2018,8,0,0,0
Tschechoslowakei (bis 1992),2018,9,0,0,0
Tschechoslowakei (bis 1992),2018,10,0,0,0
Tschechoslowakei (bis 1992),2018,11,0,0,0
Tschechoslowakei (bis 1992),2018,12,0,0,0
Tschechoslowakei (bis 1992),2019,1,0,0,0
Tschechoslowakei (bis 1992),2019,2,0,0,0
Tschechoslowakei (bis 1992),2019,3,0,0,0
Tschechoslowakei (bis 1992),2019,4,0,0,0
Tschechoslowakei (bis 1992),2019,5,0,0,0
Tschechoslowakei (bis 1992),2019,6,0,0,0
Tschechoslowakei (bis 1992),2019,7,0,0,0
Tschechoslowakei (bis 1992),2019,8,0,0,0
Tschechoslowakei (bis 1992),2019,9,0,0,0
Tschechoslowakei (bis 1992),2019,10,0,0,0
Tschechoslowakei (bis 1992),2019,11,0,0,0
Tschechoslowakei (bis 1992),2019,12,0,0,0
Tschechoslowakei (bis 1992),2020,1,0,0,0
Tschechoslowakei (bis 1992),2020,2,0,0,0
Tschechoslowakei (bis 1992),2020,3,0,0,0
Tschechoslowakei (bis 1992),2020,4,0,0,0
Tschechoslowakei (bis 1992),2020,5,0,0,0
Tschechoslowakei (bis 1992),2020,6,0,0,0
Tschechoslowakei (bis 1992),2020,7,0,0,0
Tschechoslowakei (bis 1992),2020,8,0,0,0
Tschechoslowakei (bis 1992),2020,9,0,0,0
Tschechoslowakei (bis 1992),2020,10,0,0,0
Tschechoslowakei (bis 1992),2020,11,0,0,0
Tschechoslowakei (bis 1992),2020,12,0,0,0
Tschechoslowakei (bis 1992),2021,1,0,0,0
Tschechoslowakei (bis 1992),2021,2,0,0,0
Tschechoslowakei (bis 1992),2021,3,0,0,0
Tschechoslowakei (bis 1992),2021,4,0,0,0
Tschechoslowakei (bis 1992),2021,5,0,0,0
Tschechoslowakei (bis 1992),2021,6,0,0,0
Tschechoslowakei (bis 1992),2021,7,0,0,0
Tschechoslowakei (bis 1992),2021,8,0,0,0
Tschechoslowakei (bis 1992),2021,9,0,0,0
Tschechoslowakei (bis 1992),2021,10,0,0,0
Tschechoslowakei (bis 1992),2021,11,0,0,0
Tschechoslowakei (bis 1992),2021,12,0,0,0
Tschechoslowakei (bis 1992),2022,1,0,0,0
Tschechoslowakei (bis 1992),2022,2,0,0,0
Tschechoslowakei (bis 1992),2022,3,0,0,0
Tschechoslowakei (bis 1992),2022,4,0,0,0
Tschechoslowakei (bis 1992),2022,5,0,0,0
Tschechoslowakei (bis 1992),2022,6,0,0,0
Tschechoslowakei (bis 1992),2022,7,0,0,0
Tschechoslowakei (bis 1992),2022,8,0,0,0
Tschechoslowakei (bis 1992),2022,9,0,0,0
Tschechoslowakei (bis 1992),2022,10,0,0,0
Tschechoslowakei (bis 1992),2022,11,0,0,0
Tschechoslowakei (bis 1992),2022,12,0,0,0
Tschechoslowakei (bis 1992),2023,1,0,0,0
Tschechoslowakei (bis 1992),2023,2,0,0,0
Tschechoslowakei (bis 1992),2023,3,0,0,0
Tschechoslowakei (bis 1992),2023,4,0,0,0
Tschechoslowakei (bis 1992),2023,5,0,0,0
Tschechoslowakei (bis 1992),2023,6,0,0,0
Tschechoslowakei (bis 1992),2023,7,0,0,0
Tschechoslowakei (bis 1992),2023,8,0,0,0
Tschechoslowakei (bis 1992),2023,9,0,0,0
Tschechoslowakei (bis 1992),2023,10,0,0,0
Tschechoslowakei (bis 1992),2023,11,0,0,0
Tschechoslowakei (bis 1992),2023,12,0,0,0
Tschechoslowakei (bis 1992),2024,1,0,0,0
Tschechoslowakei (bis 1992),2024,2,0,0,0
Tschechoslowakei (bis 1992),2024,3,0,0,0
Tschechoslowakei (bis 1992),2024,4,0,0,0
Tschechoslowakei (bis 1992),2024,5,0,0,0
Tschechoslowakei (bis 1992),2024,6,0,0,0
Tschechoslowakei (bis 1992),2024,7,0,0,0
Tschechoslowakei (bis 1992),2024,8,0,0,0
Tschechoslowakei (bis 1992),2024,9,0,0,0
Tschechoslowakei (bis 1992),2024,10,0,0,0
Tschechoslowakei (bis 1992),2024,11,0,0,0
Tschechoslowakei (bis 1992),2024,12,0,0,0
Tunesien,2008,1,116465000,91313000,207778000
Tunesien,2008,2,102120000,92625000,194745000
Tunesien,2008,3,112742000,91800000,204542000
Tunesien,2008,4,128070000,100028000,228098000
Tunesien,2008,5,129853000,122710000,252563000
Tunesien,2008,6,112278000,140026000,252304000
Tunesien,2008,7,112725000,110498000,223223000
Tunesien,2008,8,107581000,135286000,242867000
Tunesien,2008,9,94291000,141299000,235590000
Tunesien,2008,10,123857000,100503000,224360000
Tunesien,2008,11,90699000,133355000,224054000
Tunesien,2008,12,94728000,86430000,181158000
Tunesien,2009,1,70697000,107003000,177700000
Tunesien,2009,2,85755000,109844000,195599000
Tunesien,2009,3,89068000,96837000,185905000
Tunesien,2009,4,97684000,82043000,179727000
Tunesien,2009,5,87723000,81454000,169177000
Tunesien,2009,6,111094000,102944000,214038000
Tunesien,2009,7,133200000,120809000,254009000
Tunesien,2009,8,87087000,104741000,191828000
Tunesien,2009,9,99136000,85025000,184161000
Tunesien,2009,10,116960000,107658000,224618000
Tunesien,2009,11,130448000,134861000,265309000
Tunesien,2009,12,115342000,104083000,219425000
Tunesien,2010,1,105238000,112799000,218037000
Tunesien,2010,2,101889000,125350000,227239000
Tunesien,2010,3,125647000,106377000,232024000
Tunesien,2010,4,114761000,131591000,246352000
Tunesien,2010,5,123175000,125643000,248818000
Tunesien,2010,6,223283000,122346000,345629000
Tunesien,2010,7,140114000,127977000,268091000
Tunesien,2010,8,123123000,105765000,228888000
Tunesien,2010,9,131305000,100365000,231670000
Tunesien,2010,10,127322000,108156000,235478000
Tunesien,2010,11,131433000,122422000,253855000
Tunesien,2010,12,147596000,109004000,256600000
Tunesien,2011,1,122116000,143506000,265622000
Tunesien,2011,2,134799000,104501000,239300000
Tunesien,2011,3,161741000,148428000,310169000
Tunesien,2011,4,158853000,115509000,274362000
Tunesien,2011,5,135783000,106154000,241937000
Tunesien,2011,6,126068000,152860000,278928000
Tunesien,2011,7,128553000,156401000,284954000
Tunesien,2011,8,103237000,137376000,240613000
Tunesien,2011,9,126150000,106550000,232700000
Tunesien,2011,10,107859000,131782000,239641000
Tunesien,2011,11,129112000,123529000,252641000
Tunesien,2011,12,111814000,97434000,209248000
Tunesien,2012,1,102965000,130382000,233347000
Tunesien,2012,2,100364000,102034000,202398000
Tunesien,2012,3,118420000,146515000,264935000
Tunesien,2012,4,105299000,106751000,212050000
Tunesien,2012,5,126159000,164031000,290190000
Tunesien,2012,6,144596000,121963000,266559000
Tunesien,2012,7,125739000,120669000,246408000
Tunesien,2012,8,104306000,117888000,222194000
Tunesien,2012,9,118770000,80878000,199648000
Tunesien,2012,10,129735000,123861000,253596000
Tunesien,2012,11,114743000,142616000,257359000
Tunesien,2012,12,110141000,77614000,187755000
Tunesien,2013,1,118802000,140260000,259062000
Tunesien,2013,2,103273000,106037000,209310000
Tunesien,2013,3,124490000,114771000,239261000
Tunesien,2013,4,125453000,120633000,246086000
Tunesien,2013,5,130612000,116923000,247535000
Tunesien,2013,6,121119000,133892000,255011000
Tunesien,2013,7,111015000,129705000,240720000
Tunesien,2013,8,83993000,123074000,207067000
Tunesien,2013,9,97278000,116049000,213327000
Tunesien,2013,10,106614000,128451000,235065000
Tunesien,2013,11,101197000,107629000,208826000
Tunesien,2013,12,93575000,157298000,250873000
Tunesien,2014,1,104993000,110922000,215915000
Tunesien,2014,2,117747000,138787000,256534000
Tunesien,2014,3,123155000,134855000,258010000
Tunesien,2014,4,114145000,131425000,245570000
Tunesien,2014,5,115614000,166972000,282586000
Tunesien,2014,6,112426000,179353000,291779000
Tunesien,2014,7,109606000,132229000,241835000
Tunesien,2014,8,89167000,105167000,194334000
Tunesien,2014,9,111084000,134304000,245388000
Tunesien,2014,10,107438000,107520000,214958000
Tunesien,2014,11,106215000,121654000,227869000
Tunesien,2014,12,99971000,152184000,252155000
Tunesien,2015,1,108211000,123418000,231629000
Tunesien,2015,2,109040000,132381000,241421000
Tunesien,2015,3,124295000,142980000,267275000
Tunesien,2015,4,120635000,143996000,264631000
Tunesien,2015,5,108536000,128054000,236590000
Tunesien,2015,6,119527000,151210000,270737000
Tunesien,2015,7,118359000,144937000,263296000
Tunesien,2015,8,95004000,131690000,226694000
Tunesien,2015,9,110273000,148201000,258474000
Tunesien,2015,10,106841000,121043000,227884000
Tunesien,2015,11,126680000,146061000,272741000
Tunesien,2015,12,104606000,138282000,242888000
Tunesien,2016,1,100227000,116372000,216599000
Tunesien,2016,2,116483000,143960000,260443000
Tunesien,2016,3,117981000,157561000,275542000
Tunesien,2016,4,130588000,113195000,243783000
Tunesien,2016,5,123070000,142462000,265532000
Tunesien,2016,6,129686000,147217000,276903000
Tunesien,2016,7,97545000,104451000,201996000
Tunesien,2016,8,102834000,154472000,257306000
Tunesien,2016,9,111877000,176275000,288152000
Tunesien,2016,10,109938000,124945000,234883000
Tunesien,2016,11,130344000,140597000,270941000
Tunesien,2016,12,111262000,113956000,225218000
Tunesien,2017,1,116001000,138626000,254627000
Tunesien,2017,2,113811000,141368000,255179000
Tunesien,2017,3,169117000,166636000,335753000
Tunesien,2017,4,137668000,131572000,269240000
Tunesien,2017,5,125764000,174221000,299985000
Tunesien,2017,6,133742000,160989000,294731000
Tunesien,2017,7,121531000,125366000,246897000
Tunesien,2017,8,119860000,155989000,275849000
Tunesien,2017,9,115100000,131896000,246996000
Tunesien,2017,10,130576000,149183000,279759000
Tunesien,2017,11,185807000,157570000,343377000
Tunesien,2017,12,113681000,135984000,249665000
Tunesien,2018,1,128519000,152462000,280981000
Tunesien,2018,2,122733000,170191000,292924000
Tunesien,2018,3,143746000,150889000,294635000
Tunesien,2018,4,140353000,146060000,286413000
Tunesien,2018,5,135599000,154451000,290050000
Tunesien,2018,6,123541000,147767000,271308000
Tunesien,2018,7,115280000,155577000,270857000
Tunesien,2018,8,105407000,143235000,248642000
Tunesien,2018,9,99585000,135028000,234613000
Tunesien,2018,10,135010000,161098000,296108000
Tunesien,2018,11,134058000,139719000,273777000
Tunesien,2018,12,109251000,122677000,231928000
Tunesien,2019,1,124942000,169456000,294398000
Tunesien,2019,2,114929000,143924000,258853000
Tunesien,2019,3,143023000,172580000,315603000
Tunesien,2019,4,133368000,189849000,323217000
Tunesien,2019,5,126488000,154472000,280960000
Tunesien,2019,6,115431000,139001000,254432000
Tunesien,2019,7,116925000,170564000,287489000
Tunesien,2019,8,102414000,133739000,236153000
Tunesien,2019,9,114256000,156022000,270278000
Tunesien,2019,10,131640000,175908000,307548000
Tunesien,2019,11,121964000,164186000,286150000
Tunesien,2019,12,106880000,121544000,228424000
Tunesien,2020,1,126787000,169795000,296582000
Tunesien,2020,2,122759000,169257000,292016000
Tunesien,2020,3,116646000,153225000,269871000
Tunesien,2020,4,49382000,42366000,91748000
Tunesien,2020,5,67054000,92717000,159771000
Tunesien,2020,6,89348000,139316000,228664000
Tunesien,2020,7,114909000,165775000,280684000
Tunesien,2020,8,89815000,126134000,215949000
Tunesien,2020,9,107898000,169481000,277379000
Tunesien,2020,10,116221000,172104000,288325000
Tunesien,2020,11,121097000,166401000,287498000
Tunesien,2020,12,115725000,151692000,267417000
Tunesien,2021,1,106201000,144670000,250871000
Tunesien,2021,2,105889000,171031000,276920000
Tunesien,2021,3,141118000,192861000,333979000
Tunesien,2021,4,117278000,179818000,297096000
Tunesien,2021,5,112743000,138833000,251576000
Tunesien,2021,6,130466000,188902000,319368000
Tunesien,2021,7,111369000,169700000,281069000
Tunesien,2021,8,101665000,145171000,246836000
Tunesien,2021,9,117788000,161995000,279783000
Tunesien,2021,10,114309000,156008000,270317000
Tunesien,2021,11,120428000,184601000,305029000
Tunesien,2021,12,122915000,166493000,289408000
Tunesien,2022,1,116250000,184566000,300816000
Tunesien,2022,2,128136000,210005000,338141000
Tunesien,2022,3,176054000,225893000,401947000
Tunesien,2022,4,153131000,202816000,355947000
Tunesien,2022,5,146328000,243219000,389547000
Tunesien,2022,6,150980000,255909000,406889000
Tunesien,2022,7,135669000,189319000,324988000
Tunesien,2022,8,129556000,198490000,328046000
Tunesien,2022,9,154848000,264518000,419366000
Tunesien,2022,10,142121000,238738000,380859000
Tunesien,2022,11,170255000,264186000,434441000
Tunesien,2022,12,138277000,194012000,332289000
Tunesien,2023,1,140832000,262119000,402951000
Tunesien,2023,2,162659000,246783000,409442000
Tunesien,2023,3,182238000,275371000,457609000
Tunesien,2023,4,134312000,206668000,340980000
Tunesien,2023,5,151278000,270776000,422054000
Tunesien,2023,6,174296000,291892000,466188000
Tunesien,2023,7,135969000,185074000,321043000
Tunesien,2023,8,148329000,208574000,356903000
Tunesien,2023,9,167942000,223561000,391503000
Tunesien,2023,10,155295000,254126000,409421000
Tunesien,2023,11,159987000,243665000,403652000
Tunesien,2023,12,119173000,188394000,307567000
Tunesien,2024,1,151172000,245229000,396401000
Tunesien,2024,2,175567000,256091000,431658000
Tunesien,2024,3,157598000,229917000,387515000
Tunesien,2024,4,166633000,224216000,390849000
Tunesien,2024,5,168740000,234124000,402864000
Tunesien,2024,6,158442000,223839000,382281000
Tunesien,2024,7,175220000,256079000,431299000
Tunesien,2024,8,152711000,222254000,374965000
Tunesien,2024,9,156401000,242105000,398506000
Tunesien,2024,10,169938000,271457000,441395000
Tunesien,2024,11,162907000,246489000,409396000
Tunesien,2024,12,136357000,192163000,328520000
Turkmenistan (ab 05/1992),2008,1,15174000,266000,15440000
Turkmenistan (ab 05/1992),2008,2,31856000,166000,32022000
Turkmenistan (ab 05/1992),2008,3,20643000,220000,20863000
Turkmenistan (ab 05/1992),2008,4,5777000,113000,5890000
Turkmenistan (ab 05/1992),2008,5,9301000,532000,9833000
Turkmenistan (ab 05/1992),2008,6,14551000,304000,14855000
Turkmenistan (ab 05/1992),2008,7,7984000,273000,8257000
Turkmenistan (ab 05/1992),2008,8,12399000,323000,12722000
Turkmenistan (ab 05/1992),2008,9,12258000,19107000,31365000
Turkmenistan (ab 05/1992),2008,10,23071000,16591000,39662000
Turkmenistan (ab 05/1992),2008,11,12998000,4948000,17946000
Turkmenistan (ab 05/1992),2008,12,15901000,5620000,21521000
Turkmenistan (ab 05/1992),2009,1,7607000,21635000,29242000
Turkmenistan (ab 05/1992),2009,2,12669000,8370000,21039000
Turkmenistan (ab 05/1992),2009,3,17816000,55000,17871000
Turkmenistan (ab 05/1992),2009,4,25905000,222000,26127000
Turkmenistan (ab 05/1992),2009,5,15161000,115000,15276000
Turkmenistan (ab 05/1992),2009,6,18539000,190000,18729000
Turkmenistan (ab 05/1992),2009,7,30327000,263000,30590000
Turkmenistan (ab 05/1992),2009,8,25375000,200000,25575000
Turkmenistan (ab 05/1992),2009,9,27247000,634000,27881000
Turkmenistan (ab 05/1992),2009,10,24063000,86000,24149000
Turkmenistan (ab 05/1992),2009,11,18144000,207000,18351000
Turkmenistan (ab 05/1992),2009,12,32465000,7050000,39515000
Turkmenistan (ab 05/1992),2010,1,13102000,6868000,19970000
Turkmenistan (ab 05/1992),2010,2,11217000,6716000,17933000
Turkmenistan (ab 05/1992),2010,3,31571000,7090000,38661000
Turkmenistan (ab 05/1992),2010,4,29510000,3807000,33317000
Turkmenistan (ab 05/1992),2010,5,17970000,13865000,31835000
Turkmenistan (ab 05/1992),2010,6,34845000,12446000,47291000
Turkmenistan (ab 05/1992),2010,7,33010000,11665000,44675000
Turkmenistan (ab 05/1992),2010,8,18422000,581000,19003000
Turkmenistan (ab 05/1992),2010,9,28110000,875000,28985000
Turkmenistan (ab 05/1992),2010,10,15739000,717000,16456000
Turkmenistan (ab 05/1992),2010,11,13238000,4511000,17749000
Turkmenistan (ab 05/1992),2010,12,13806000,754000,14560000
Turkmenistan (ab 05/1992),2011,1,14307000,561000,14868000
Turkmenistan (ab 05/1992),2011,2,18710000,752000,19462000
Turkmenistan (ab 05/1992),2011,3,36477000,6693000,43170000
Turkmenistan (ab 05/1992),2011,4,27292000,2030000,29322000
Turkmenistan (ab 05/1992),2011,5,25754000,245000,25999000
Turkmenistan (ab 05/1992),2011,6,20804000,546000,21350000
Turkmenistan (ab 05/1992),2011,7,38386000,1151000,39537000
Turkmenistan (ab 05/1992),2011,8,30293000,494000,30787000
Turkmenistan (ab 05/1992),2011,9,29055000,2154000,31209000
Turkmenistan (ab 05/1992),2011,10,23910000,379000,24289000
Turkmenistan (ab 05/1992),2011,11,20194000,26359000,46553000
Turkmenistan (ab 05/1992),2011,12,24740000,6689000,31429000
Turkmenistan (ab 05/1992),2012,1,14092000,38323000,52415000
Turkmenistan (ab 05/1992),2012,2,21871000,27220000,49091000
Turkmenistan (ab 05/1992),2012,3,26327000,409000,26736000
Turkmenistan (ab 05/1992),2012,4,15645000,590000,16235000
Turkmenistan (ab 05/1992),2012,5,26614000,342000,26956000
Turkmenistan (ab 05/1992),2012,6,32861000,3633000,36494000
Turkmenistan (ab 05/1992),2012,7,27972000,106000,28078000
Turkmenistan (ab 05/1992),2012,8,35958000,1225000,37183000
Turkmenistan (ab 05/1992),2012,9,25405000,2102000,27507000
Turkmenistan (ab 05/1992),2012,10,29690000,397000,30087000
Turkmenistan (ab 05/1992),2012,11,29348000,347000,29695000
Turkmenistan (ab 05/1992),2012,12,36312000,904000,37216000
Turkmenistan (ab 05/1992),2013,1,17863000,1539000,19402000
Turkmenistan (ab 05/1992),2013,2,20887000,713000,21600000
Turkmenistan (ab 05/1992),2013,3,26049000,845000,26894000
Turkmenistan (ab 05/1992),2013,4,34437000,354000,34791000
Turkmenistan (ab 05/1992),2013,5,37499000,697000,38196000
Turkmenistan (ab 05/1992),2013,6,62212000,793000,63005000
Turkmenistan (ab 05/1992),2013,7,27499000,556000,28055000
Turkmenistan (ab 05/1992),2013,8,25372000,1122000,26494000
Turkmenistan (ab 05/1992),2013,9,26031000,1383000,27414000
Turkmenistan (ab 05/1992),2013,10,31099000,904000,32003000
Turkmenistan (ab 05/1992),2013,11,43525000,355000,43880000
Turkmenistan (ab 05/1992),2013,12,35946000,449000,36395000
Turkmenistan (ab 05/1992),2014,1,23917000,572000,24489000
Turkmenistan (ab 05/1992),2014,2,18064000,727000,18791000
Turkmenistan (ab 05/1992),2014,3,21363000,15054000,36417000
Turkmenistan (ab 05/1992),2014,4,13793000,1184000,14977000
Turkmenistan (ab 05/1992),2014,5,25708000,14670000,40378000
Turkmenistan (ab 05/1992),2014,6,32955000,18765000,51720000
Turkmenistan (ab 05/1992),2014,7,32706000,17631000,50337000
Turkmenistan (ab 05/1992),2014,8,24446000,38480000,62926000
Turkmenistan (ab 05/1992),2014,9,17469000,16465000,33934000
Turkmenistan (ab 05/1992),2014,10,17880000,1110000,18990000
Turkmenistan (ab 05/1992),2014,11,26953000,13574000,40527000
Turkmenistan (ab 05/1992),2014,12,19461000,524000,19985000
Turkmenistan (ab 05/1992),2015,1,13971000,412000,14383000
Turkmenistan (ab 05/1992),2015,2,13641000,1505000,15146000
Turkmenistan (ab 05/1992),2015,3,20650000,726000,21376000
Turkmenistan (ab 05/1992),2015,4,21602000,439000,22041000
Turkmenistan (ab 05/1992),2015,5,46555000,467000,47022000
Turkmenistan (ab 05/1992),2015,6,22203000,783000,22986000
Turkmenistan (ab 05/1992),2015,7,27920000,630000,28550000
Turkmenistan (ab 05/1992),2015,8,36612000,1357000,37969000
Turkmenistan (ab 05/1992),2015,9,25939000,743000,26682000
Turkmenistan (ab 05/1992),2015,10,19565000,772000,20337000
Turkmenistan (ab 05/1992),2015,11,18025000,860000,18885000
Turkmenistan (ab 05/1992),2015,12,35842000,778000,36620000
Turkmenistan (ab 05/1992),2016,1,11769000,513000,12282000
Turkmenistan (ab 05/1992),2016,2,18599000,374000,18973000
Turkmenistan (ab 05/1992),2016,3,22951000,8855000,31806000
Turkmenistan (ab 05/1992),2016,4,53633000,33038000,86671000
Turkmenistan (ab 05/1992),2016,5,34084000,2378000,36462000
Turkmenistan (ab 05/1992),2016,6,50624000,570000,51194000
Turkmenistan (ab 05/1992),2016,7,32230000,476000,32706000
Turkmenistan (ab 05/1992),2016,8,30920000,466000,31386000
Turkmenistan (ab 05/1992),2016,9,24223000,2159000,26382000
Turkmenistan (ab 05/1992),2016,10,13779000,1059000,14838000
Turkmenistan (ab 05/1992),2016,11,25310000,590000,25900000
Turkmenistan (ab 05/1992),2016,12,34519000,689000,35208000
Turkmenistan (ab 05/1992),2017,1,12385000,1092000,13477000
Turkmenistan (ab 05/1992),2017,2,14147000,748000,14895000
Turkmenistan (ab 05/1992),2017,3,52616000,338000,52954000
Turkmenistan (ab 05/1992),2017,4,31699000,587000,32286000
Turkmenistan (ab 05/1992),2017,5,80258000,377000,80635000
Turkmenistan (ab 05/1992),2017,6,43089000,377000,43466000
Turkmenistan (ab 05/1992),2017,7,20338000,463000,20801000
Turkmenistan (ab 05/1992),2017,8,30490000,236000,30726000
Turkmenistan (ab 05/1992),2017,9,24611000,198000,24809000
Turkmenistan (ab 05/1992),2017,10,12799000,989000,13788000
Turkmenistan (ab 05/1992),2017,11,20256000,240000,20496000
Turkmenistan (ab 05/1992),2017,12,22543000,246000,22789000
Turkmenistan (ab 05/1992),2018,1,7949000,23000,7972000
Turkmenistan (ab 05/1992),2018,2,7980000,35000,8015000
Turkmenistan (ab 05/1992),2018,3,13609000,205000,13814000
Turkmenistan (ab 05/1992),2018,4,26944000,403000,27347000
Turkmenistan (ab 05/1992),2018,5,19519000,310000,19829000
Turkmenistan (ab 05/1992),2018,6,15494000,293000,15787000
Turkmenistan (ab 05/1992),2018,7,9069000,228000,9297000
Turkmenistan (ab 05/1992),2018,8,14421000,139000,14560000
Turkmenistan (ab 05/1992),2018,9,5667000,519000,6186000
Turkmenistan (ab 05/1992),2018,10,8067000,168000,8235000
Turkmenistan (ab 05/1992),2018,11,6290000,105000,6395000
Turkmenistan (ab 05/1992),2018,12,8933000,39000,8972000
Turkmenistan (ab 05/1992),2019,1,5377000,56000,5433000
Turkmenistan (ab 05/1992),2019,2,7451000,211000,7662000
Turkmenistan (ab 05/1992),2019,3,5619000,28000,5647000
Turkmenistan (ab 05/1992),2019,4,9805000,57000,9862000
Turkmenistan (ab 05/1992),2019,5,9830000,166000,9996000
Turkmenistan (ab 05/1992),2019,6,8314000,2000,8316000
Turkmenistan (ab 05/1992),2019,7,12319000,117000,12436000
Turkmenistan (ab 05/1992),2019,8,15815000,248000,16063000
Turkmenistan (ab 05/1992),2019,9,12102000,1000,12103000
Turkmenistan (ab 05/1992),2019,10,32397000,2000,32399000
Turkmenistan (ab 05/1992),2019,11,23364000,19000,23383000
Turkmenistan (ab 05/1992),2019,12,17479000,5000,17484000
Turkmenistan (ab 05/1992),2020,1,12346000,166000,12512000
Turkmenistan (ab 05/1992),2020,2,22786000,18000,22804000
Turkmenistan (ab 05/1992),2020,3,22723000,101000,22824000
Turkmenistan (ab 05/1992),2020,4,9165000,247000,9412000
Turkmenistan (ab 05/1992),2020,5,9128000,33000,9161000
Turkmenistan (ab 05/1992),2020,6,18089000,21000,18110000
Turkmenistan (ab 05/1992),2020,7,17305000,2000,17307000
Turkmenistan (ab 05/1992),2020,8,6813000,102000,6915000
Turkmenistan (ab 05/1992),2020,9,6081000,61000,6142000
Turkmenistan (ab 05/1992),2020,10,20435000,26000,20461000
Turkmenistan (ab 05/1992),2020,11,7519000,115000,7634000
Turkmenistan (ab 05/1992),2020,12,14935000,108000,15043000
Turkmenistan (ab 05/1992),2021,1,6034000,54000,6088000
Turkmenistan (ab 05/1992),2021,2,7277000,78000,7355000
Turkmenistan (ab 05/1992),2021,3,7384000,0,7384000
Turkmenistan (ab 05/1992),2021,4,7818000,46000,7864000
Turkmenistan (ab 05/1992),2021,5,11905000,143000,12048000
Turkmenistan (ab 05/1992),2021,6,34468000,26000,34494000
Turkmenistan (ab 05/1992),2021,7,17911000,21000,17932000
Turkmenistan (ab 05/1992),2021,8,11731000,309000,12040000
Turkmenistan (ab 05/1992),2021,9,25057000,17000,25074000
Turkmenistan (ab 05/1992),2021,10,24405000,78000,24483000
Turkmenistan (ab 05/1992),2021,11,15744000,12000,15756000
Turkmenistan (ab 05/1992),2021,12,12788000,0,12788000
Turkmenistan (ab 05/1992),2022,1,22407000,84000,22491000
Turkmenistan (ab 05/1992),2022,2,12689000,12000,12701000
Turkmenistan (ab 05/1992),2022,3,16739000,8000,16747000
Turkmenistan (ab 05/1992),2022,4,14289000,261000,14550000
Turkmenistan (ab 05/1992),2022,5,10867000,29340000,40207000
Turkmenistan (ab 05/1992),2022,6,12556000,384000,12940000
Turkmenistan (ab 05/1992),2022,7,11557000,214000,11771000
Turkmenistan (ab 05/1992),2022,8,10000000,444000,10444000
Turkmenistan (ab 05/1992),2022,9,13980000,265000,14245000
Turkmenistan (ab 05/1992),2022,10,29979000,217000,30196000
Turkmenistan (ab 05/1992),2022,11,27702000,2310000,30012000
Turkmenistan (ab 05/1992),2022,12,26367000,1140000,27507000
Turkmenistan (ab 05/1992),2023,1,14305000,296000,14601000
Turkmenistan (ab 05/1992),2023,2,9324000,9000,9333000
Turkmenistan (ab 05/1992),2023,3,18910000,467000,19377000
Turkmenistan (ab 05/1992),2023,4,13953000,130000,14083000
Turkmenistan (ab 05/1992),2023,5,18341000,3551000,21892000
Turkmenistan (ab 05/1992),2023,6,30163000,83000,30246000
Turkmenistan (ab 05/1992),2023,7,22497000,57000,22554000
Turkmenistan (ab 05/1992),2023,8,9070000,170000,9240000
Turkmenistan (ab 05/1992),2023,9,14958000,43000,15001000
Turkmenistan (ab 05/1992),2023,10,12355000,192000,12547000
Turkmenistan (ab 05/1992),2023,11,18726000,121000,18847000
Turkmenistan (ab 05/1992),2023,12,15258000,133000,15391000
Turkmenistan (ab 05/1992),2024,1,8589000,104000,8693000
Turkmenistan (ab 05/1992),2024,2,14822000,71000,14893000
Turkmenistan (ab 05/1992),2024,3,16302000,199000,16501000
Turkmenistan (ab 05/1992),2024,4,25020000,92000,25112000
Turkmenistan (ab 05/1992),2024,5,22411000,89000,22500000
Turkmenistan (ab 05/1992),2024,6,18743000,254000,18997000
Turkmenistan (ab 05/1992),2024,7,29986000,371000,30357000
Turkmenistan (ab 05/1992),2024,8,22057000,164000,22221000
Turkmenistan (ab 05/1992),2024,9,20462000,197000,20659000
Turkmenistan (ab 05/1992),2024,10,19666000,292000,19958000
Turkmenistan (ab 05/1992),2024,11,11958000,190000,12148000
Turkmenistan (ab 05/1992),2024,12,20169000,263000,20432000
Turks- und Caicosinseln,2008,1,62000,56000,118000
Turks- und Caicosinseln,2008,2,111000,28000,139000
Turks- und Caicosinseln,2008,3,32000,40000,72000
Turks- und Caicosinseln,2008,4,67000,0,67000
Turks- und Caicosinseln,2008,5,43000,61000,104000
Turks- und Caicosinseln,2008,6,60000,49000,109000
Turks- und Caicosinseln,2008,7,33000,80000,113000
Turks- und Caicosinseln,2008,8,60000,0,60000
Turks- und Caicosinseln,2008,9,21000,40000,61000
Turks- und Caicosinseln,2008,10,49000,0,49000
Turks- und Caicosinseln,2008,11,15000,0,15000
Turks- und Caicosinseln,2008,12,116000,0,116000
Turks- und Caicosinseln,2009,1,180000,0,180000
Turks- und Caicosinseln,2009,2,57000,0,57000
Turks- und Caicosinseln,2009,3,79000,1000,80000
Turks- und Caicosinseln,2009,4,127000,0,127000
Turks- und Caicosinseln,2009,5,71000,0,71000
Turks- und Caicosinseln,2009,6,41000,0,41000
Turks- und Caicosinseln,2009,7,14000,0,14000
Turks- und Caicosinseln,2009,8,25000,0,25000
Turks- und Caicosinseln,2009,9,0,0,0
Turks- und Caicosinseln,2009,10,12000,0,12000
Turks- und Caicosinseln,2009,11,126000,0,126000
Turks- und Caicosinseln,2009,12,105000,4000,109000
Turks- und Caicosinseln,2010,1,51000,0,51000
Turks- und Caicosinseln,2010,2,44000,0,44000
Turks- und Caicosinseln,2010,3,39000,0,39000
Turks- und Caicosinseln,2010,4,35000,0,35000
Turks- und Caicosinseln,2010,5,63000,0,63000
Turks- und Caicosinseln,2010,6,186000,0,186000
Turks- und Caicosinseln,2010,7,53000,0,53000
Turks- und Caicosinseln,2010,8,49000,0,49000
Turks- und Caicosinseln,2010,9,105000,0,105000
Turks- und Caicosinseln,2010,10,0,0,0
Turks- und Caicosinseln,2010,11,154000,0,154000
Turks- und Caicosinseln,2010,12,24000,0,24000
Turks- und Caicosinseln,2011,1,62000,0,62000
Turks- und Caicosinseln,2011,2,51000,1000,52000
Turks- und Caicosinseln,2011,3,56000,0,56000
Turks- und Caicosinseln,2011,4,37000,0,37000
Turks- und Caicosinseln,2011,5,20000,0,20000
Turks- und Caicosinseln,2011,6,16000,0,16000
Turks- und Caicosinseln,2011,7,50000,0,50000
Turks- und Caicosinseln,2011,8,14000,0,14000
Turks- und Caicosinseln,2011,9,1000,0,1000
Turks- und Caicosinseln,2011,10,89000,0,89000
Turks- und Caicosinseln,2011,11,28000,0,28000
Turks- und Caicosinseln,2011,12,50000,0,50000
Turks- und Caicosinseln,2012,1,12000,0,12000
Turks- und Caicosinseln,2012,2,63000,0,63000
Turks- und Caicosinseln,2012,3,35000,5000,40000
Turks- und Caicosinseln,2012,4,51000,0,51000
Turks- und Caicosinseln,2012,5,76000,7000,83000
Turks- und Caicosinseln,2012,6,83000,1000,84000
Turks- und Caicosinseln,2012,7,113000,0,113000
Turks- und Caicosinseln,2012,8,135000,0,135000
Turks- und Caicosinseln,2012,9,88000,0,88000
Turks- und Caicosinseln,2012,10,81000,1000,82000
Turks- und Caicosinseln,2012,11,118000,0,118000
Turks- und Caicosinseln,2012,12,11000,1000,12000
Turks- und Caicosinseln,2013,1,0,0,0
Turks- und Caicosinseln,2013,2,165000,0,165000
Turks- und Caicosinseln,2013,3,150000,0,150000
Turks- und Caicosinseln,2013,4,61000,0,61000
Turks- und Caicosinseln,2013,5,71000,0,71000
Turks- und Caicosinseln,2013,6,78000,0,78000
Turks- und Caicosinseln,2013,7,22000,0,22000
Turks- und Caicosinseln,2013,8,41000,18000,59000
Turks- und Caicosinseln,2013,9,123000,0,123000
Turks- und Caicosinseln,2013,10,555000,0,555000
Turks- und Caicosinseln,2013,11,96000,0,96000
Turks- und Caicosinseln,2013,12,47000,0,47000
Turks- und Caicosinseln,2014,1,18000,0,18000
Turks- und Caicosinseln,2014,2,76000,0,76000
Turks- und Caicosinseln,2014,3,28000,0,28000
Turks- und Caicosinseln,2014,4,35000,0,35000
Turks- und Caicosinseln,2014,5,34000,0,34000
Turks- und Caicosinseln,2014,6,35000,0,35000
Turks- und Caicosinseln,2014,7,631000,0,631000
Turks- und Caicosinseln,2014,8,7000,0,7000
Turks- und Caicosinseln,2014,9,64000,0,64000
Turks- und Caicosinseln,2014,10,84000,0,84000
Turks- und Caicosinseln,2014,11,156000,17000,173000
Turks- und Caicosinseln,2014,12,22000,0,22000
Turks- und Caicosinseln,2015,1,92000,0,92000
Turks- und Caicosinseln,2015,2,61000,0,61000
Turks- und Caicosinseln,2015,3,100000,0,100000
Turks- und Caicosinseln,2015,4,63000,0,63000
Turks- und Caicosinseln,2015,5,117000,0,117000
Turks- und Caicosinseln,2015,6,66000,0,66000
Turks- und Caicosinseln,2015,7,55000,0,55000
Turks- und Caicosinseln,2015,8,54000,0,54000
Turks- und Caicosinseln,2015,9,122000,0,122000
Turks- und Caicosinseln,2015,10,16000,0,16000
Turks- und Caicosinseln,2015,11,118000,0,118000
Turks- und Caicosinseln,2015,12,166000,0,166000
Turks- und Caicosinseln,2016,1,201000,0,201000
Turks- und Caicosinseln,2016,2,276000,0,276000
Turks- und Caicosinseln,2016,3,55000,0,55000
Turks- und Caicosinseln,2016,4,76000,0,76000
Turks- und Caicosinseln,2016,5,106000,0,106000
Turks- und Caicosinseln,2016,6,73000,0,73000
Turks- und Caicosinseln,2016,7,105000,0,105000
Turks- und Caicosinseln,2016,8,11000,0,11000
Turks- und Caicosinseln,2016,9,191000,0,191000
Turks- und Caicosinseln,2016,10,128000,0,128000
Turks- und Caicosinseln,2016,11,116000,0,116000
Turks- und Caicosinseln,2016,12,60000,0,60000
Turks- und Caicosinseln,2017,1,39000,0,39000
Turks- und Caicosinseln,2017,2,176000,0,176000
Turks- und Caicosinseln,2017,3,23000,0,23000
Turks- und Caicosinseln,2017,4,36000,19000,55000
Turks- und Caicosinseln,2017,5,137000,0,137000
Turks- und Caicosinseln,2017,6,112000,0,112000
Turks- und Caicosinseln,2017,7,103000,0,103000
Turks- und Caicosinseln,2017,8,54000,0,54000
Turks- und Caicosinseln,2017,9,67000,0,67000
Turks- und Caicosinseln,2017,10,26000,0,26000
Turks- und Caicosinseln,2017,11,154000,0,154000
Turks- und Caicosinseln,2017,12,38000,0,38000
Turks- und Caicosinseln,2018,1,48000,0,48000
Turks- und Caicosinseln,2018,2,75000,0,75000
Turks- und Caicosinseln,2018,3,138000,0,138000
Turks- und Caicosinseln,2018,4,23000,0,23000
Turks- und Caicosinseln,2018,5,37000,0,37000
Turks- und Caicosinseln,2018,6,150000,0,150000
Turks- und Caicosinseln,2018,7,54000,0,54000
Turks- und Caicosinseln,2018,8,128000,0,128000
Turks- und Caicosinseln,2018,9,71000,0,71000
Turks- und Caicosinseln,2018,10,70000,33000,103000
Turks- und Caicosinseln,2018,11,156000,0,156000
Turks- und Caicosinseln,2018,12,53000,0,53000
Turks- und Caicosinseln,2019,1,62000,0,62000
Turks- und Caicosinseln,2019,2,75000,0,75000
Turks- und Caicosinseln,2019,3,291000,39000,330000
Turks- und Caicosinseln,2019,4,32000,0,32000
Turks- und Caicosinseln,2019,5,101000,0,101000
Turks- und Caicosinseln,2019,6,221000,0,221000
Turks- und Caicosinseln,2019,7,92000,1000,93000
Turks- und Caicosinseln,2019,8,157000,0,157000
Turks- und Caicosinseln,2019,9,207000,0,207000
Turks- und Caicosinseln,2019,10,136000,1000,137000
Turks- und Caicosinseln,2019,11,235000,11000,246000
Turks- und Caicosinseln,2019,12,28000,0,28000
Turks- und Caicosinseln,2020,1,60000,0,60000
Turks- und Caicosinseln,2020,2,80000,0,80000
Turks- und Caicosinseln,2020,3,161000,0,161000
Turks- und Caicosinseln,2020,4,332000,0,332000
Turks- und Caicosinseln,2020,5,80000,1000,81000
Turks- und Caicosinseln,2020,6,33000,0,33000
Turks- und Caicosinseln,2020,7,50000,1000,51000
Turks- und Caicosinseln,2020,8,74000,0,74000
Turks- und Caicosinseln,2020,9,60000,0,60000
Turks- und Caicosinseln,2020,10,251000,5000,256000
Turks- und Caicosinseln,2020,11,87000,0,87000
Turks- und Caicosinseln,2020,12,200000,23000,223000
Turks- und Caicosinseln,2021,1,107000,0,107000
Turks- und Caicosinseln,2021,2,131000,0,131000
Turks- und Caicosinseln,2021,3,230000,0,230000
Turks- und Caicosinseln,2021,4,93000,0,93000
Turks- und Caicosinseln,2021,5,79000,0,79000
Turks- und Caicosinseln,2021,6,205000,0,205000
Turks- und Caicosinseln,2021,7,24000,0,24000
Turks- und Caicosinseln,2021,8,66000,0,66000
Turks- und Caicosinseln,2021,9,93000,0,93000
Turks- und Caicosinseln,2021,10,270000,0,270000
Turks- und Caicosinseln,2021,11,69000,56000,125000
Turks- und Caicosinseln,2021,12,144000,8000,152000
Turks- und Caicosinseln,2022,1,100000,18000,118000
Turks- und Caicosinseln,2022,2,207000,1000,208000
Turks- und Caicosinseln,2022,3,19000,10000,29000
Turks- und Caicosinseln,2022,4,214000,0,214000
Turks- und Caicosinseln,2022,5,181000,0,181000
Turks- und Caicosinseln,2022,6,297000,0,297000
Turks- und Caicosinseln,2022,7,71000,0,71000
Turks- und Caicosinseln,2022,8,264000,0,264000
Turks- und Caicosinseln,2022,9,328000,59000,387000
Turks- und Caicosinseln,2022,10,421000,0,421000
Turks- und Caicosinseln,2022,11,342000,0,342000
Turks- und Caicosinseln,2022,12,186000,0,186000
Turks- und Caicosinseln,2023,1,89000,0,89000
Turks- und Caicosinseln,2023,2,125000,0,125000
Turks- und Caicosinseln,2023,3,158000,0,158000
Turks- und Caicosinseln,2023,4,176000,0,176000
Turks- und Caicosinseln,2023,5,425000,0,425000
Turks- und Caicosinseln,2023,6,9000,0,9000
Turks- und Caicosinseln,2023,7,478000,0,478000
Turks- und Caicosinseln,2023,8,24000,0,24000
Turks- und Caicosinseln,2023,9,40000,0,40000
Turks- und Caicosinseln,2023,10,285000,0,285000
Turks- und Caicosinseln,2023,11,128000,0,128000
Turks- und Caicosinseln,2023,12,193000,0,193000
Turks- und Caicosinseln,2024,1,298000,0,298000
Turks- und Caicosinseln,2024,2,388000,0,388000
Turks- und Caicosinseln,2024,3,133000,0,133000
Turks- und Caicosinseln,2024,4,105000,0,105000
Turks- und Caicosinseln,2024,5,430000,0,430000
Turks- und Caicosinseln,2024,6,74000,0,74000
Turks- und Caicosinseln,2024,7,503000,16000,519000
Turks- und Caicosinseln,2024,8,104000,0,104000
Turks- und Caicosinseln,2024,9,64000,0,64000
Turks- und Caicosinseln,2024,10,378000,0,378000
Turks- und Caicosinseln,2024,11,381000,0,381000
Turks- und Caicosinseln,2024,12,180000,0,180000
Tuvalu,2008,1,0,0,0
Tuvalu,2008,2,4000,0,4000
Tuvalu,2008,3,0,2000,2000
Tuvalu,2008,4,101000,0,101000
Tuvalu,2008,5,53000,0,53000
Tuvalu,2008,6,1000,0,1000
Tuvalu,2008,7,2000,0,2000
Tuvalu,2008,8,0,0,0
Tuvalu,2008,9,27000,0,27000
Tuvalu,2008,10,9000,1000,10000
Tuvalu,2008,11,0,0,0
Tuvalu,2008,12,3000,0,3000
Tuvalu,2009,1,10000,0,10000
Tuvalu,2009,2,139000,0,139000
Tuvalu,2009,3,20000,0,20000
Tuvalu,2009,4,164000,1000,165000
Tuvalu,2009,5,6000,0,6000
Tuvalu,2009,6,0,0,0
Tuvalu,2009,7,7000,0,7000
Tuvalu,2009,8,1000,0,1000
Tuvalu,2009,9,0,0,0
Tuvalu,2009,10,0,0,0
Tuvalu,2009,11,0,0,0
Tuvalu,2009,12,0,0,0
Tuvalu,2010,1,0,0,0
Tuvalu,2010,2,0,0,0
Tuvalu,2010,3,0,0,0
Tuvalu,2010,4,0,0,0
Tuvalu,2010,5,0,0,0
Tuvalu,2010,6,0,0,0
Tuvalu,2010,7,0,0,0
Tuvalu,2010,8,0,0,0
Tuvalu,2010,9,0,0,0
Tuvalu,2010,10,0,0,0
Tuvalu,2010,11,0,0,0
Tuvalu,2010,12,0,0,0
Tuvalu,2011,1,0,0,0
Tuvalu,2011,2,0,0,0
Tuvalu,2011,3,0,0,0
Tuvalu,2011,4,0,0,0
Tuvalu,2011,5,0,0,0
Tuvalu,2011,6,0,0,0
Tuvalu,2011,7,0,0,0
Tuvalu,2011,8,0,0,0
Tuvalu,2011,9,0,0,0
Tuvalu,2011,10,0,0,0
Tuvalu,2011,11,0,0,0
Tuvalu,2011,12,0,0,0
Tuvalu,2012,1,0,0,0
Tuvalu,2012,2,0,0,0
Tuvalu,2012,3,0,0,0
Tuvalu,2012,4,0,0,0
Tuvalu,2012,5,0,0,0
Tuvalu,2012,6,0,0,0
Tuvalu,2012,7,0,0,0
Tuvalu,2012,8,0,0,0
Tuvalu,2012,9,0,0,0
Tuvalu,2012,10,0,0,0
Tuvalu,2012,11,0,0,0
Tuvalu,2012,12,0,1000,1000
Tuvalu,2013,1,0,0,0
Tuvalu,2013,2,0,0,0
Tuvalu,2013,3,0,0,0
Tuvalu,2013,4,0,3000,3000
Tuvalu,2013,5,0,0,0
Tuvalu,2013,6,0,0,0
Tuvalu,2013,7,0,4000,4000
Tuvalu,2013,8,0,0,0
Tuvalu,2013,9,0,2000,2000
Tuvalu,2013,10,0,0,0
Tuvalu,2013,11,0,0,0
Tuvalu,2013,12,0,0,0
Tuvalu,2014,1,1000,0,1000
Tuvalu,2014,2,0,0,0
Tuvalu,2014,3,0,0,0
Tuvalu,2014,4,0,0,0
Tuvalu,2014,5,0,0,0
Tuvalu,2014,6,0,0,0
Tuvalu,2014,7,0,0,0
Tuvalu,2014,8,0,0,0
Tuvalu,2014,9,0,0,0
Tuvalu,2014,10,0,0,0
Tuvalu,2014,11,1000,1000,2000
Tuvalu,2014,12,0,0,0
Tuvalu,2015,1,19000,0,19000
Tuvalu,2015,2,0,0,0
Tuvalu,2015,3,17000,0,17000
Tuvalu,2015,4,0,4000,4000
Tuvalu,2015,5,0,1000,1000
Tuvalu,2015,6,38000,0,38000
Tuvalu,2015,7,0,8000,8000
Tuvalu,2015,8,0,1000,1000
Tuvalu,2015,9,0,0,0
Tuvalu,2015,10,0,0,0
Tuvalu,2015,11,10000,0,10000
Tuvalu,2015,12,0,0,0
Tuvalu,2016,1,0,0,0
Tuvalu,2016,2,0,0,0
Tuvalu,2016,3,0,4000,4000
Tuvalu,2016,4,0,0,0
Tuvalu,2016,5,18000,0,18000
Tuvalu,2016,6,0,0,0
Tuvalu,2016,7,0,0,0
Tuvalu,2016,8,19000,0,19000
Tuvalu,2016,9,2000,0,2000
Tuvalu,2016,10,9000,0,9000
Tuvalu,2016,11,0,14000,14000
Tuvalu,2016,12,0,0,0
Tuvalu,2017,1,0,0,0
Tuvalu,2017,2,0,0,0
Tuvalu,2017,3,0,0,0
Tuvalu,2017,4,0,0,0
Tuvalu,2017,5,0,1000,1000
Tuvalu,2017,6,0,6000,6000
Tuvalu,2017,7,0,6000,6000
Tuvalu,2017,8,0,0,0
Tuvalu,2017,9,0,0,0
Tuvalu,2017,10,0,41000,41000
Tuvalu,2017,11,0,6000,6000
Tuvalu,2017,12,0,26000,26000
Tuvalu,2018,1,0,0,0
Tuvalu,2018,2,0,32000,32000
Tuvalu,2018,3,0,35000,35000
Tuvalu,2018,4,0,5000,5000
Tuvalu,2018,5,0,28000,28000
Tuvalu,2018,6,0,6000,6000
Tuvalu,2018,7,10000,0,10000
Tuvalu,2018,8,0,0,0
Tuvalu,2018,9,0,8000,8000
Tuvalu,2018,10,0,51000,51000
Tuvalu,2018,11,7000,8000,15000
Tuvalu,2018,12,6000,3000,9000
Tuvalu,2019,1,0,0,0
Tuvalu,2019,2,0,8000,8000
Tuvalu,2019,3,3000,2000,5000
Tuvalu,2019,4,4000,6000,10000
Tuvalu,2019,5,2000,0,2000
Tuvalu,2019,6,2000,13000,15000
Tuvalu,2019,7,0,0,0
Tuvalu,2019,8,0,77000,77000
Tuvalu,2019,9,0,2000,2000
Tuvalu,2019,10,0,4000,4000
Tuvalu,2019,11,0,0,0
Tuvalu,2019,12,0,14000,14000
Tuvalu,2020,1,72000,42000,114000
Tuvalu,2020,2,1000,4000,5000
Tuvalu,2020,3,0,4000,4000
Tuvalu,2020,4,15000,0,15000
Tuvalu,2020,5,0,0,0
Tuvalu,2020,6,0,0,0
Tuvalu,2020,7,0,0,0
Tuvalu,2020,8,0,0,0
Tuvalu,2020,9,0,0,0
Tuvalu,2020,10,0,0,0
Tuvalu,2020,11,0,0,0
Tuvalu,2020,12,0,0,0
Tuvalu,2021,1,0,0,0
Tuvalu,2021,2,27000,0,27000
Tuvalu,2021,3,81000,0,81000
Tuvalu,2021,4,0,0,0
Tuvalu,2021,5,0,0,0
Tuvalu,2021,6,0,0,0
Tuvalu,2021,7,0,0,0
Tuvalu,2021,8,0,0,0
Tuvalu,2021,9,0,0,0
Tuvalu,2021,10,0,0,0
Tuvalu,2021,11,0,0,0
Tuvalu,2021,12,0,0,0
Tuvalu,2022,1,0,1000,1000
Tuvalu,2022,2,0,0,0
Tuvalu,2022,3,78000,1764000,1842000
Tuvalu,2022,4,3000,0,3000
Tuvalu,2022,5,0,0,0
Tuvalu,2022,6,0,0,0
Tuvalu,2022,7,0,154000,154000
Tuvalu,2022,8,20000,0,20000
Tuvalu,2022,9,3000,0,3000
Tuvalu,2022,10,0,30000,30000
Tuvalu,2022,11,0,0,0
Tuvalu,2022,12,0,0,0
Tuvalu,2023,1,0,0,0
Tuvalu,2023,2,0,0,0
Tuvalu,2023,3,0,0,0
Tuvalu,2023,4,0,0,0
Tuvalu,2023,5,0,0,0
Tuvalu,2023,6,0,0,0
Tuvalu,2023,7,0,0,0
Tuvalu,2023,8,0,0,0
Tuvalu,2023,9,0,0,0
Tuvalu,2023,10,0,0,0
Tuvalu,2023,11,0,0,0
Tuvalu,2023,12,0,0,0
Tuvalu,2024,1,0,0,0
Tuvalu,2024,2,0,0,0
Tuvalu,2024,3,0,0,0
Tuvalu,2024,4,0,0,0
Tuvalu,2024,5,0,0,0
Tuvalu,2024,6,0,0,0
Tuvalu,2024,7,27000,0,27000
Tuvalu,2024,8,0,7000,7000
Tuvalu,2024,9,0,2000,2000
Tuvalu,2024,10,0,0,0
Tuvalu,2024,11,52000,0,52000
Tuvalu,2024,12,0,0,0
Türkei,2008,1,1387028000,859220000,2246248000
Türkei,2008,2,1367695000,858047000,2225742000
Türkei,2008,3,1291194000,833538000,2124732000
Türkei,2008,4,1369490000,883319000,2252809000
Türkei,2008,5,1312741000,818128000,2130869000
Türkei,2008,6,1449562000,821922000,2271484000
Türkei,2008,7,1258873000,857094000,2115967000
Türkei,2008,8,1127136000,720308000,1847444000
Türkei,2008,9,1347435000,800594000,2148029000
Türkei,2008,10,1269655000,835184000,2104839000
Türkei,2008,11,970985000,808671000,1779656000
Türkei,2008,12,977573000,639285000,1616858000
Türkei,2009,1,768939000,772099000,1541038000
Türkei,2009,2,785019000,761373000,1546392000
Türkei,2009,3,935985000,734659000,1670644000
Türkei,2009,4,859656000,691690000,1551346000
Türkei,2009,5,964097000,582041000,1546138000
Türkei,2009,6,997403000,692280000,1689683000
Türkei,2009,7,1146653000,696444000,1843097000
Türkei,2009,8,1020991000,650475000,1671466000
Türkei,2009,9,979430000,689573000,1669003000
Türkei,2009,10,1036503000,723943000,1760446000
Türkei,2009,11,1089034000,741288000,1830322000
Türkei,2009,12,1041205000,602602000,1643807000
Türkei,2010,1,941049000,735456000,1676505000
Türkei,2010,2,1052609000,722599000,1775208000
Türkei,2010,3,1309484000,853178000,2162662000
Türkei,2010,4,1280238000,763371000,2043609000
Türkei,2010,5,1232532000,774152000,2006684000
Türkei,2010,6,1534351000,855814000,2390165000
Türkei,2010,7,1415707000,830910000,2246617000
Türkei,2010,8,1289450000,873734000,2163184000
Türkei,2010,9,1451167000,832379000,2283546000
Türkei,2010,10,1559045000,941701000,2500746000
Türkei,2010,11,1602380000,918838000,2521218000
Türkei,2010,12,1584527000,914687000,2499214000
Türkei,2011,1,1376652000,974756000,2351408000
Türkei,2011,2,1632290000,927797000,2560087000
Türkei,2011,3,2197203000,1063763000,3260966000
Türkei,2011,4,1766478000,989976000,2756454000
Türkei,2011,5,1918161000,1003476000,2921637000
Türkei,2011,6,1704231000,987567000,2691798000
Türkei,2011,7,1704794000,962055000,2666849000
Türkei,2011,8,1560213000,1055163000,2615376000
Türkei,2011,9,1622210000,875071000,2497281000
Türkei,2011,10,1574028000,1033575000,2607603000
Türkei,2011,11,1516151000,953073000,2469224000
Türkei,2011,12,1545821000,964174000,2509995000
Türkei,2012,1,1418657000,1074818000,2493475000
Türkei,2012,2,1558715000,982565000,2541280000
Türkei,2012,3,1848425000,1080334000,2928759000
Türkei,2012,4,1557080000,1011545000,2568625000
Türkei,2012,5,1767037000,1016996000,2784033000
Türkei,2012,6,1832769000,988230000,2820999000
Türkei,2012,7,1761543000,1055876000,2817419000
Türkei,2012,8,1730242000,973321000,2703563000
Türkei,2012,9,1646143000,921863000,2568006000
Türkei,2012,10,1724580000,1108736000,2833316000
Türkei,2012,11,1860661000,982412000,2843073000
Türkei,2012,12,1394151000,874459000,2268610000
Türkei,2013,1,1755046000,1085081000,2840127000
Türkei,2013,2,1773460000,983201000,2756661000
Türkei,2013,3,1856611000,1002380000,2858991000
Türkei,2013,4,2015859000,1062580000,3078439000
Türkei,2013,5,1906283000,964656000,2870939000
Türkei,2013,6,2024801000,1005714000,3030515000
Türkei,2013,7,1859310000,1138043000,2997353000
Türkei,2013,8,1444450000,928740000,2373190000
Türkei,2013,9,1726463000,1035958000,2762421000
Türkei,2013,10,1718175000,1052898000,2771073000
Türkei,2013,11,1871586000,1063872000,2935458000
Türkei,2013,12,1419924000,975330000,2395254000
Türkei,2014,1,1538786000,1194666000,2733452000
Türkei,2014,2,1589545000,1028863000,2618408000
Türkei,2014,3,1666489000,1123544000,2790033000
Türkei,2014,4,1553617000,1109023000,2662640000
Türkei,2014,5,1528063000,1054050000,2582113000
Türkei,2014,6,1518735000,1122012000,2640747000
Türkei,2014,7,1630960000,1232257000,2863217000
Türkei,2014,8,1367622000,948529000,2316151000
Türkei,2014,9,1699124000,1177668000,2876792000
Türkei,2014,10,1716989000,1158271000,2875260000
Türkei,2014,11,1797236000,1143992000,2941228000
Türkei,2014,12,1638994000,1096370000,2735364000
Türkei,2015,1,1542924000,1191402000,2734326000
Türkei,2015,2,1737025000,1137915000,2874940000
Türkei,2015,3,2145281000,1260822000,3406103000
Türkei,2015,4,1982463000,1174747000,3157210000
Türkei,2015,5,1842190000,1091599000,2933789000
Türkei,2015,6,2132443000,1285697000,3418140000
Türkei,2015,7,2021470000,1256432000,3277902000
Türkei,2015,8,1674660000,1119024000,2793684000
Türkei,2015,9,1889574000,1269991000,3159565000
Türkei,2015,10,1858066000,1257514000,3115580000
Türkei,2015,11,1834617000,1311045000,3145662000
Türkei,2015,12,1623789000,1176292000,2800081000
Türkei,2016,1,1616661000,1291463000,2908124000
Türkei,2016,2,1935189000,1341948000,3277137000
Türkei,2016,3,1965029000,1361791000,3326820000
Türkei,2016,4,1989465000,1248088000,3237553000
Türkei,2016,5,1971577000,1312318000,3283895000
Türkei,2016,6,2085086000,1299227000,3384313000
Türkei,2016,7,1705089000,1127002000,2832091000
Türkei,2016,8,1775114000,1337675000,3112789000
Türkei,2016,9,1823956000,1215211000,3039167000
Türkei,2016,10,1625840000,1331977000,2957817000
Türkei,2016,11,1893258000,1427120000,3320378000
Türkei,2016,12,1466487000,1168583000,2635070000
Türkei,2017,1,1637836000,1379411000,3017247000
Türkei,2017,2,1604587000,1291398000,2895985000
Türkei,2017,3,1865444000,1405647000,3271091000
Türkei,2017,4,1661336000,1313143000,2974479000
Türkei,2017,5,1865432000,1409481000,3274913000
Türkei,2017,6,1830829000,1409361000,3240190000
Türkei,2017,7,1763807000,1311351000,3075158000
Türkei,2017,8,1787733000,1410727000,3198460000
Türkei,2017,9,1864437000,1219015000,3083452000
Türkei,2017,10,1886466000,1401198000,3287664000
Türkei,2017,11,2119626000,1486787000,3606413000
Türkei,2017,12,1582259000,1236244000,2818503000
Türkei,2018,1,1731001000,1513677000,3244678000
Türkei,2018,2,1738825000,1291560000,3030385000
Türkei,2018,3,1995900000,1497273000,3493173000
Türkei,2018,4,1851800000,1420603000,3272403000
Türkei,2018,5,1814422000,1386624000,3201046000
Türkei,2018,6,1802643000,1379586000,3182229000
Türkei,2018,7,1731108000,1423428000,3154536000
Türkei,2018,8,1277527000,1292398000,2569925000
Türkei,2018,9,1253145000,1163652000,2416797000
Türkei,2018,10,1358727000,1501700000,2860427000
Türkei,2018,11,1354911000,1424573000,2779484000
Türkei,2018,12,1253297000,1091134000,2344431000
Türkei,2019,1,1350924000,1484415000,2835339000
Türkei,2019,2,1600600000,1279478000,2880078000
Türkei,2019,3,1573242000,1362083000,2935325000
Türkei,2019,4,1487178000,1354830000,2842008000
Türkei,2019,5,1651389000,1313010000,2964399000
Türkei,2019,6,1834873000,1178576000,3013449000
Türkei,2019,7,1832303000,1465275000,3297578000
Türkei,2019,8,1437049000,1222789000,2659838000
Türkei,2019,9,1518527000,1241287000,2759814000
Türkei,2019,10,1800200000,1447632000,3247832000
Türkei,2019,11,1734703000,1364479000,3099182000
Türkei,2019,12,1761899000,1152326000,2914225000
Türkei,2020,1,1622663000,1445472000,3068135000
Türkei,2020,2,1846530000,1281074000,3127604000
Türkei,2020,3,1863105000,1342971000,3206076000
Türkei,2020,4,1319203000,983071000,2302274000
Türkei,2020,5,1248225000,936333000,2184558000
Türkei,2020,6,1657383000,1162645000,2820028000
Türkei,2020,7,1820756000,1429565000,3250321000
Türkei,2020,8,1663770000,1203544000,2867314000
Türkei,2020,9,2242650000,1427784000,3670434000
Türkei,2020,10,2418250000,1471384000,3889634000
Türkei,2020,11,2033383000,1424028000,3457411000
Türkei,2020,12,1877607000,1287348000,3164955000
Türkei,2021,1,1471059000,1375923000,2846982000
Türkei,2021,2,1696212000,1386448000,3082660000
Türkei,2021,3,2068900000,1620370000,3689270000
Türkei,2021,4,1811240000,1502763000,3314003000
Türkei,2021,5,1527336000,1328484000,2855820000
Türkei,2021,6,1988638000,1574288000,3562926000
Türkei,2021,7,1678142000,1605406000,3283548000
Türkei,2021,8,1878725000,1521657000,3400382000
Türkei,2021,9,1845140000,1648637000,3493777000
Türkei,2021,10,1648031000,1686694000,3334725000
Türkei,2021,11,1902556000,1693626000,3596182000
Türkei,2021,12,1792634000,1621518000,3414152000
Türkei,2022,1,1669230000,1946719000,3615949000
Türkei,2022,2,1881290000,1900256000,3781546000
Türkei,2022,3,2259034000,2206059000,4465093000
Türkei,2022,4,2135642000,2026998000,4162640000
Türkei,2022,5,2283033000,2049819000,4332852000
Türkei,2022,6,2147095000,2150766000,4297861000
Türkei,2022,7,2084085000,1950673000,4034758000
Türkei,2022,8,2354756000,2089578000,4444334000
Türkei,2022,9,2495983000,2119265000,4615248000
Türkei,2022,10,2351373000,2237713000,4589086000
Türkei,2022,11,2663047000,2171214000,4834261000
Türkei,2022,12,2648201000,1879198000,4527399000
Türkei,2023,1,2267374000,2244021000,4511395000
Türkei,2023,2,2633601000,2062662000,4696263000
Türkei,2023,3,3112890000,2276136000,5389026000
Türkei,2023,4,2314532000,1875848000,4190380000
Türkei,2023,5,2712788000,2059284000,4772072000
Türkei,2023,6,2543580000,2228350000,4771930000
Türkei,2023,7,2537061000,1847374000,4384435000
Türkei,2023,8,2534785000,1935397000,4470182000
Türkei,2023,9,2408328000,1918126000,4326454000
Türkei,2023,10,2717845000,2070526000,4788371000
Türkei,2023,11,2750401000,2076340000,4826741000
Türkei,2023,12,2178436000,1727067000,3905503000
Türkei,2024,1,2247180000,2134298000,4381478000
Türkei,2024,2,2411374000,2038393000,4449767000
Türkei,2024,3,2307770000,1926032000,4233802000
Türkei,2024,4,2268497000,1939497000,4207994000
Türkei,2024,5,2239826000,1886524000,4126350000
Türkei,2024,6,2137906000,1872438000,4010344000
Türkei,2024,7,2667347000,2026036000,4693383000
Türkei,2024,8,2355284000,1925962000,4281246000
Türkei,2024,9,2466314000,1923612000,4389926000
Türkei,2024,10,2533172000,2101347000,4634519000
Türkei,2024,11,2575309000,1946405000,4521714000
Türkei,2024,12,2073918000,1809177000,3883095000
Uganda,2008,1,8053000,7917000,15970000
Uganda,2008,2,3170000,8523000,11693000
Uganda,2008,3,3659000,6112000,9771000
Uganda,2008,4,4214000,4482000,8696000
Uganda,2008,5,2092000,5105000,7197000
Uganda,2008,6,6072000,6872000,12944000
Uganda,2008,7,3593000,5912000,9505000
Uganda,2008,8,3469000,4537000,8006000
Uganda,2008,9,7698000,4596000,12294000
Uganda,2008,10,10583000,5163000,15746000
Uganda,2008,11,11971000,5295000,17266000
Uganda,2008,12,3435000,5419000,8854000
Uganda,2009,1,3641000,5492000,9133000
Uganda,2009,2,3950000,5748000,9698000
Uganda,2009,3,5328000,8515000,13843000
Uganda,2009,4,5077000,7577000,12654000
Uganda,2009,5,3161000,5735000,8896000
Uganda,2009,6,4833000,3869000,8702000
Uganda,2009,7,9035000,3881000,12916000
Uganda,2009,8,3818000,4953000,8771000
Uganda,2009,9,5065000,5943000,11008000
Uganda,2009,10,8177000,7292000,15469000
Uganda,2009,11,3768000,6169000,9937000
Uganda,2009,12,6669000,4623000,11292000
Uganda,2010,1,3932000,4853000,8785000
Uganda,2010,2,8471000,6798000,15269000
Uganda,2010,3,14661000,8021000,22682000
Uganda,2010,4,7475000,10817000,18292000
Uganda,2010,5,9765000,5863000,15628000
Uganda,2010,6,13255000,6585000,19840000
Uganda,2010,7,8209000,8117000,16326000
Uganda,2010,8,11895000,8173000,20068000
Uganda,2010,9,5264000,6230000,11494000
Uganda,2010,10,7680000,7499000,15179000
Uganda,2010,11,4666000,4614000,9280000
Uganda,2010,12,4382000,7458000,11840000
Uganda,2011,1,9482000,10826000,20308000
Uganda,2011,2,4600000,8953000,13553000
Uganda,2011,3,9790000,5977000,15767000
Uganda,2011,4,9601000,6996000,16597000
Uganda,2011,5,6567000,3780000,10347000
Uganda,2011,6,4635000,4366000,9001000
Uganda,2011,7,5518000,7393000,12911000
Uganda,2011,8,4397000,7526000,11923000
Uganda,2011,9,6323000,9744000,16067000
Uganda,2011,10,17407000,13259000,30666000
Uganda,2011,11,4201000,10445000,14646000
Uganda,2011,12,17648000,8354000,26002000
Uganda,2012,1,5208000,9375000,14583000
Uganda,2012,2,7017000,11477000,18494000
Uganda,2012,3,4793000,13238000,18031000
Uganda,2012,4,4903000,10858000,15761000
Uganda,2012,5,4839000,5728000,10567000
Uganda,2012,6,14292000,3400000,17692000
Uganda,2012,7,14512000,6023000,20535000
Uganda,2012,8,13769000,5579000,19348000
Uganda,2012,9,9002000,5001000,14003000
Uganda,2012,10,6246000,6695000,12941000
Uganda,2012,11,5484000,3793000,9277000
Uganda,2012,12,4939000,5465000,10404000
Uganda,2013,1,8246000,8931000,17177000
Uganda,2013,2,4224000,8543000,12767000
Uganda,2013,3,4576000,5603000,10179000
Uganda,2013,4,5488000,8715000,14203000
Uganda,2013,5,4841000,10741000,15582000
Uganda,2013,6,9964000,4928000,14892000
Uganda,2013,7,5619000,11008000,16627000
Uganda,2013,8,4831000,9840000,14671000
Uganda,2013,9,6044000,7241000,13285000
Uganda,2013,10,7002000,5817000,12819000
Uganda,2013,11,6582000,7948000,14530000
Uganda,2013,12,4252000,4435000,8687000
Uganda,2014,1,7679000,7767000,15446000
Uganda,2014,2,15448000,6334000,21782000
Uganda,2014,3,5169000,6631000,11800000
Uganda,2014,4,4528000,11205000,15733000
Uganda,2014,5,4844000,6650000,11494000
Uganda,2014,6,7907000,16615000,24522000
Uganda,2014,7,6801000,9222000,16023000
Uganda,2014,8,4717000,5126000,9843000
Uganda,2014,9,13157000,4608000,17765000
Uganda,2014,10,8512000,6754000,15266000
Uganda,2014,11,4040000,6007000,10047000
Uganda,2014,12,12615000,6471000,19086000
Uganda,2015,1,6015000,5937000,11952000
Uganda,2015,2,4960000,7445000,12405000
Uganda,2015,3,7468000,6744000,14212000
Uganda,2015,4,7956000,8455000,16411000
Uganda,2015,5,5243000,10876000,16119000
Uganda,2015,6,5609000,8954000,14563000
Uganda,2015,7,5521000,8026000,13547000
Uganda,2015,8,9008000,9234000,18242000
Uganda,2015,9,8532000,7867000,16399000
Uganda,2015,10,5037000,10694000,15731000
Uganda,2015,11,8483000,6005000,14488000
Uganda,2015,12,6970000,8163000,15133000
Uganda,2016,1,3311000,6349000,9660000
Uganda,2016,2,7085000,5069000,12154000
Uganda,2016,3,7681000,8696000,16377000
Uganda,2016,4,10333000,5989000,16322000
Uganda,2016,5,5599000,7186000,12785000
Uganda,2016,6,12828000,9567000,22395000
Uganda,2016,7,10371000,7857000,18228000
Uganda,2016,8,6206000,8248000,14454000
Uganda,2016,9,6455000,8364000,14819000
Uganda,2016,10,7810000,8028000,15838000
Uganda,2016,11,8319000,8000000,16319000
Uganda,2016,12,9233000,6734000,15967000
Uganda,2017,1,3890000,9092000,12982000
Uganda,2017,2,3888000,9609000,13497000
Uganda,2017,3,16742000,8002000,24744000
Uganda,2017,4,7575000,7952000,15527000
Uganda,2017,5,7164000,6795000,13959000
Uganda,2017,6,10304000,7548000,17852000
Uganda,2017,7,9801000,6674000,16475000
Uganda,2017,8,5359000,12868000,18227000
Uganda,2017,9,19404000,10799000,30203000
Uganda,2017,10,6101000,8221000,14322000
Uganda,2017,11,9841000,10099000,19940000
Uganda,2017,12,5807000,7362000,13169000
Uganda,2018,1,5890000,7721000,13611000
Uganda,2018,2,5979000,9097000,15076000
Uganda,2018,3,8233000,10364000,18597000
Uganda,2018,4,7405000,9641000,17046000
Uganda,2018,5,6638000,10305000,16943000
Uganda,2018,6,10637000,6660000,17297000
Uganda,2018,7,7856000,11078000,18934000
Uganda,2018,8,8953000,7952000,16905000
Uganda,2018,9,8292000,8407000,16699000
Uganda,2018,10,11330000,7887000,19217000
Uganda,2018,11,10453000,6421000,16874000
Uganda,2018,12,12172000,4674000,16846000
Uganda,2019,1,8546000,9900000,18446000
Uganda,2019,2,8115000,5639000,13754000
Uganda,2019,3,15834000,7118000,22952000
Uganda,2019,4,4747000,8328000,13075000
Uganda,2019,5,6701000,7610000,14311000
Uganda,2019,6,5375000,6707000,12082000
Uganda,2019,7,7308000,5482000,12790000
Uganda,2019,8,7441000,6038000,13479000
Uganda,2019,9,7145000,7004000,14149000
Uganda,2019,10,16343000,5677000,22020000
Uganda,2019,11,14367000,8776000,23143000
Uganda,2019,12,7638000,6705000,14343000
Uganda,2020,1,17380000,9371000,26751000
Uganda,2020,2,10253000,5050000,15303000
Uganda,2020,3,7940000,7823000,15763000
Uganda,2020,4,12837000,6871000,19708000
Uganda,2020,5,10634000,6763000,17397000
Uganda,2020,6,12087000,9763000,21850000
Uganda,2020,7,7182000,7482000,14664000
Uganda,2020,8,6337000,6269000,12606000
Uganda,2020,9,16511000,6884000,23395000
Uganda,2020,10,9125000,7469000,16594000
Uganda,2020,11,15229000,9566000,24795000
Uganda,2020,12,7485000,7397000,14882000
Uganda,2021,1,4198000,7141000,11339000
Uganda,2021,2,8451000,6438000,14889000
Uganda,2021,3,7022000,9215000,16237000
Uganda,2021,4,14318000,7068000,21386000
Uganda,2021,5,8543000,11225000,19768000
Uganda,2021,6,20932000,12637000,33569000
Uganda,2021,7,8297000,10546000,18843000
Uganda,2021,8,6346000,6097000,12443000
Uganda,2021,9,8064000,12062000,20126000
Uganda,2021,10,11424000,13038000,24462000
Uganda,2021,11,9275000,12732000,22007000
Uganda,2021,12,8417000,8257000,16674000
Uganda,2022,1,6658000,16587000,23245000
Uganda,2022,2,6821000,15155000,21976000
Uganda,2022,3,8453000,10934000,19387000
Uganda,2022,4,5223000,12968000,18191000
Uganda,2022,5,7724000,20739000,28463000
Uganda,2022,6,18959000,16336000,35295000
Uganda,2022,7,6284000,15087000,21371000
Uganda,2022,8,12538000,9390000,21928000
Uganda,2022,9,12208000,13730000,25938000
Uganda,2022,10,10651000,12884000,23535000
Uganda,2022,11,12055000,13052000,25107000
Uganda,2022,12,11472000,7691000,19163000
Uganda,2023,1,5333000,12435000,17768000
Uganda,2023,2,8957000,7787000,16744000
Uganda,2023,3,12547000,15309000,27856000
Uganda,2023,4,18448000,10186000,28634000
Uganda,2023,5,9055000,14407000,23462000
Uganda,2023,6,9756000,23503000,33259000
Uganda,2023,7,12038000,13792000,25830000
Uganda,2023,8,8741000,11049000,19790000
Uganda,2023,9,10416000,13277000,23693000
Uganda,2023,10,8579000,21149000,29728000
Uganda,2023,11,12380000,29859000,42239000
Uganda,2023,12,9723000,11513000,21236000
Uganda,2024,1,11841000,15521000,27362000
Uganda,2024,2,7877000,12709000,20586000
Uganda,2024,3,8959000,9091000,18050000
Uganda,2024,4,15550000,12127000,27677000
Uganda,2024,5,7163000,13267000,20430000
Uganda,2024,6,10086000,12543000,22629000
Uganda,2024,7,12261000,7011000,19272000
Uganda,2024,8,10994000,13719000,24713000
Uganda,2024,9,8864000,23300000,32164000
Uganda,2024,10,9814000,49221000,59035000
Uganda,2024,11,15208000,40398000,55606000
Uganda,2024,12,8661000,32055000,40716000
Ukraine (ab 05/1992),2008,1,481800000,123131000,604931000
Ukraine (ab 05/1992),2008,2,560071000,149115000,709186000
Ukraine (ab 05/1992),2008,3,550530000,129368000,679898000
Ukraine (ab 05/1992),2008,4,563703000,158622000,722325000
Ukraine (ab 05/1992),2008,5,490272000,128218000,618490000
Ukraine (ab 05/1992),2008,6,563825000,133701000,697526000
Ukraine (ab 05/1992),2008,7,631566000,138633000,770199000
Ukraine (ab 05/1992),2008,8,555159000,141512000,696671000
Ukraine (ab 05/1992),2008,9,644911000,184603000,829514000
Ukraine (ab 05/1992),2008,10,587835000,165646000,753481000
Ukraine (ab 05/1992),2008,11,477673000,126373000,604046000
Ukraine (ab 05/1992),2008,12,372760000,101360000,474120000
Ukraine (ab 05/1992),2009,1,241034000,131936000,372970000
Ukraine (ab 05/1992),2009,2,263073000,100633000,363706000
Ukraine (ab 05/1992),2009,3,316756000,93471000,410227000
Ukraine (ab 05/1992),2009,4,275043000,79669000,354712000
Ukraine (ab 05/1992),2009,5,264556000,73566000,338122000
Ukraine (ab 05/1992),2009,6,288405000,109789000,398194000
Ukraine (ab 05/1992),2009,7,395824000,83296000,479120000
Ukraine (ab 05/1992),2009,8,272901000,83999000,356900000
Ukraine (ab 05/1992),2009,9,294777000,137951000,432728000
Ukraine (ab 05/1992),2009,10,314070000,100082000,414152000
Ukraine (ab 05/1992),2009,11,310136000,112070000,422206000
Ukraine (ab 05/1992),2009,12,309124000,126344000,435468000
Ukraine (ab 05/1992),2010,1,228548000,114390000,342938000
Ukraine (ab 05/1992),2010,2,293138000,106073000,399211000
Ukraine (ab 05/1992),2010,3,387225000,128765000,515990000
Ukraine (ab 05/1992),2010,4,336945000,99611000,436556000
Ukraine (ab 05/1992),2010,5,320382000,126552000,446934000
Ukraine (ab 05/1992),2010,6,367683000,167381000,535064000
Ukraine (ab 05/1992),2010,7,422563000,137122000,559685000
Ukraine (ab 05/1992),2010,8,417048000,115519000,532567000
Ukraine (ab 05/1992),2010,9,415568000,147715000,563283000
Ukraine (ab 05/1992),2010,10,401326000,164504000,565830000
Ukraine (ab 05/1992),2010,11,436680000,138466000,575146000
Ukraine (ab 05/1992),2010,12,370234000,160499000,530733000
Ukraine (ab 05/1992),2011,1,354008000,140814000,494822000
Ukraine (ab 05/1992),2011,2,373287000,180667000,553954000
Ukraine (ab 05/1992),2011,3,458574000,178062000,636636000
Ukraine (ab 05/1992),2011,4,381798000,192709000,574507000
Ukraine (ab 05/1992),2011,5,456287000,162609000,618896000
Ukraine (ab 05/1992),2011,6,434357000,141402000,575759000
Ukraine (ab 05/1992),2011,7,474116000,160551000,634667000
Ukraine (ab 05/1992),2011,8,479558000,165317000,644875000
Ukraine (ab 05/1992),2011,9,511931000,143567000,655498000
Ukraine (ab 05/1992),2011,10,488800000,143813000,632613000
Ukraine (ab 05/1992),2011,11,493172000,142930000,636102000
Ukraine (ab 05/1992),2011,12,444224000,140973000,585197000
Ukraine (ab 05/1992),2012,1,344333000,119511000,463844000
Ukraine (ab 05/1992),2012,2,425267000,138715000,563982000
Ukraine (ab 05/1992),2012,3,491683000,118793000,610476000
Ukraine (ab 05/1992),2012,4,492949000,120791000,613740000
Ukraine (ab 05/1992),2012,5,519525000,116297000,635822000
Ukraine (ab 05/1992),2012,6,505704000,121167000,626871000
Ukraine (ab 05/1992),2012,7,508853000,117679000,626532000
Ukraine (ab 05/1992),2012,8,506761000,120398000,627159000
Ukraine (ab 05/1992),2012,9,480091000,103701000,583792000
Ukraine (ab 05/1992),2012,10,541475000,121455000,662930000
Ukraine (ab 05/1992),2012,11,524647000,131870000,656517000
Ukraine (ab 05/1992),2012,12,413389000,97315000,510704000
Ukraine (ab 05/1992),2013,1,368317000,117123000,485440000
Ukraine (ab 05/1992),2013,2,467071000,133040000,600111000
Ukraine (ab 05/1992),2013,3,464173000,131363000,595536000
Ukraine (ab 05/1992),2013,4,527466000,149745000,677211000
Ukraine (ab 05/1992),2013,5,427518000,113253000,540771000
Ukraine (ab 05/1992),2013,6,459492000,136928000,596420000
Ukraine (ab 05/1992),2013,7,483709000,145938000,629647000
Ukraine (ab 05/1992),2013,8,465407000,115194000,580601000
Ukraine (ab 05/1992),2013,9,393695000,163387000,557082000
Ukraine (ab 05/1992),2013,10,453205000,122298000,575503000
Ukraine (ab 05/1992),2013,11,470747000,121238000,591985000
Ukraine (ab 05/1992),2013,12,393152000,119857000,513009000
Ukraine (ab 05/1992),2014,1,321820000,149572000,471392000
Ukraine (ab 05/1992),2014,2,329609000,128450000,458059000
Ukraine (ab 05/1992),2014,3,303165000,122286000,425451000
Ukraine (ab 05/1992),2014,4,300298000,139215000,439513000
Ukraine (ab 05/1992),2014,5,276657000,124139000,400796000
Ukraine (ab 05/1992),2014,6,298840000,128060000,426900000
Ukraine (ab 05/1992),2014,7,322940000,133679000,456619000
Ukraine (ab 05/1992),2014,8,273956000,129905000,403861000
Ukraine (ab 05/1992),2014,9,305556000,146544000,452100000
Ukraine (ab 05/1992),2014,10,303251000,154815000,458066000
Ukraine (ab 05/1992),2014,11,272654000,155406000,428060000
Ukraine (ab 05/1992),2014,12,270845000,116623000,387468000
Ukraine (ab 05/1992),2015,1,220015000,131852000,351867000
Ukraine (ab 05/1992),2015,2,238776000,149924000,388700000
Ukraine (ab 05/1992),2015,3,271420000,156738000,428158000
Ukraine (ab 05/1992),2015,4,240583000,143846000,384429000
Ukraine (ab 05/1992),2015,5,228985000,131137000,360122000
Ukraine (ab 05/1992),2015,6,252898000,155587000,408485000
Ukraine (ab 05/1992),2015,7,267269000,135751000,403020000
Ukraine (ab 05/1992),2015,8,262967000,122406000,385373000
Ukraine (ab 05/1992),2015,9,272898000,132828000,405726000
Ukraine (ab 05/1992),2015,10,284525000,136919000,421444000
Ukraine (ab 05/1992),2015,11,290684000,150895000,441579000
Ukraine (ab 05/1992),2015,12,245959000,131197000,377156000
Ukraine (ab 05/1992),2016,1,214831000,141547000,356378000
Ukraine (ab 05/1992),2016,2,320300000,151940000,472240000
Ukraine (ab 05/1992),2016,3,315661000,158184000,473845000
Ukraine (ab 05/1992),2016,4,307867000,147691000,455558000
Ukraine (ab 05/1992),2016,5,261562000,140127000,401689000
Ukraine (ab 05/1992),2016,6,306579000,151357000,457936000
Ukraine (ab 05/1992),2016,7,298027000,134480000,432507000
Ukraine (ab 05/1992),2016,8,314722000,141302000,456024000
Ukraine (ab 05/1992),2016,9,326069000,158815000,484884000
Ukraine (ab 05/1992),2016,10,294037000,146050000,440087000
Ukraine (ab 05/1992),2016,11,342260000,161665000,503925000
Ukraine (ab 05/1992),2016,12,302082000,158229000,460311000
Ukraine (ab 05/1992),2017,1,283166000,158220000,441386000
Ukraine (ab 05/1992),2017,2,380187000,152227000,532414000
Ukraine (ab 05/1992),2017,3,436324000,173812000,610136000
Ukraine (ab 05/1992),2017,4,342584000,154639000,497223000
Ukraine (ab 05/1992),2017,5,376423000,189391000,565814000
Ukraine (ab 05/1992),2017,6,369788000,181902000,551690000
Ukraine (ab 05/1992),2017,7,367949000,167889000,535838000
Ukraine (ab 05/1992),2017,8,398909000,189403000,588312000
Ukraine (ab 05/1992),2017,9,346713000,199289000,546002000
Ukraine (ab 05/1992),2017,10,339532000,262988000,602520000
Ukraine (ab 05/1992),2017,11,399976000,230629000,630605000
Ukraine (ab 05/1992),2017,12,350841000,179404000,530245000
Ukraine (ab 05/1992),2018,1,358513000,239665000,598178000
Ukraine (ab 05/1992),2018,2,379417000,213100000,592517000
Ukraine (ab 05/1992),2018,3,377779000,207489000,585268000
Ukraine (ab 05/1992),2018,4,362809000,207440000,570249000
Ukraine (ab 05/1992),2018,5,358903000,201670000,560573000
Ukraine (ab 05/1992),2018,6,378263000,192181000,570444000
Ukraine (ab 05/1992),2018,7,372305000,174166000,546471000
Ukraine (ab 05/1992),2018,8,422106000,211527000,633633000
Ukraine (ab 05/1992),2018,9,368238000,197156000,565394000
Ukraine (ab 05/1992),2018,10,402524000,288059000,690583000
Ukraine (ab 05/1992),2018,11,403164000,289147000,692311000
Ukraine (ab 05/1992),2018,12,340318000,228460000,568778000
Ukraine (ab 05/1992),2019,1,355521000,256852000,612373000
Ukraine (ab 05/1992),2019,2,376844000,225499000,602343000
Ukraine (ab 05/1992),2019,3,413228000,241935000,655163000
Ukraine (ab 05/1992),2019,4,434871000,244492000,679363000
Ukraine (ab 05/1992),2019,5,426625000,224024000,650649000
Ukraine (ab 05/1992),2019,6,371693000,206286000,577979000
Ukraine (ab 05/1992),2019,7,419031000,212102000,631133000
Ukraine (ab 05/1992),2019,8,424665000,243408000,668073000
Ukraine (ab 05/1992),2019,9,424163000,254707000,678870000
Ukraine (ab 05/1992),2019,10,423031000,307845000,730876000
Ukraine (ab 05/1992),2019,11,411103000,209220000,620323000
Ukraine (ab 05/1992),2019,12,361392000,247650000,609042000
Ukraine (ab 05/1992),2020,1,338960000,242752000,581712000
Ukraine (ab 05/1992),2020,2,433299000,221181000,654480000
Ukraine (ab 05/1992),2020,3,437689000,207756000,645445000
Ukraine (ab 05/1992),2020,4,329976000,142483000,472459000
Ukraine (ab 05/1992),2020,5,288676000,176104000,464780000
Ukraine (ab 05/1992),2020,6,364910000,170373000,535283000
Ukraine (ab 05/1992),2020,7,435158000,171459000,606617000
Ukraine (ab 05/1992),2020,8,377119000,185183000,562302000
Ukraine (ab 05/1992),2020,9,388547000,251544000,640091000
Ukraine (ab 05/1992),2020,10,424514000,249591000,674105000
Ukraine (ab 05/1992),2020,11,416164000,257497000,673661000
Ukraine (ab 05/1992),2020,12,362540000,244731000,607271000
Ukraine (ab 05/1992),2021,1,308967000,265643000,574610000
Ukraine (ab 05/1992),2021,2,392031000,234766000,626797000
Ukraine (ab 05/1992),2021,3,491271000,274943000,766214000
Ukraine (ab 05/1992),2021,4,434590000,237448000,672038000
Ukraine (ab 05/1992),2021,5,387199000,234914000,622113000
Ukraine (ab 05/1992),2021,6,462796000,243287000,706083000
Ukraine (ab 05/1992),2021,7,441992000,215334000,657326000
Ukraine (ab 05/1992),2021,8,440552000,225469000,666021000
Ukraine (ab 05/1992),2021,9,504481000,293362000,797843000
Ukraine (ab 05/1992),2021,10,496456000,300304000,796760000
Ukraine (ab 05/1992),2021,11,556703000,297710000,854413000
Ukraine (ab 05/1992),2021,12,478521000,288698000,767219000
Ukraine (ab 05/1992),2022,1,434617000,285523000,720140000
Ukraine (ab 05/1992),2022,2,374746000,265745000,640491000
Ukraine (ab 05/1992),2022,3,262778000,185496000,448274000
Ukraine (ab 05/1992),2022,4,283985000,209886000,493871000
Ukraine (ab 05/1992),2022,5,312793000,237621000,550414000
Ukraine (ab 05/1992),2022,6,484976000,222863000,707839000
Ukraine (ab 05/1992),2022,7,397856000,231750000,629606000
Ukraine (ab 05/1992),2022,8,352365000,232839000,585204000
Ukraine (ab 05/1992),2022,9,479035000,279334000,758369000
Ukraine (ab 05/1992),2022,10,522819000,347679000,870498000
Ukraine (ab 05/1992),2022,11,399575000,352369000,751944000
Ukraine (ab 05/1992),2022,12,501707000,300271000,801978000
Ukraine (ab 05/1992),2023,1,357109000,242104000,599213000
Ukraine (ab 05/1992),2023,2,388121000,226762000,614883000
Ukraine (ab 05/1992),2023,3,1164833000,228794000,1393627000
Ukraine (ab 05/1992),2023,4,419850000,190515000,610365000
Ukraine (ab 05/1992),2023,5,480518000,220814000,701332000
Ukraine (ab 05/1992),2023,6,565976000,227797000,793773000
Ukraine (ab 05/1992),2023,7,572632000,227530000,800162000
Ukraine (ab 05/1992),2023,8,567295000,215334000,782629000
Ukraine (ab 05/1992),2023,9,600002000,279150000,879152000
Ukraine (ab 05/1992),2023,10,605857000,309403000,915260000
Ukraine (ab 05/1992),2023,11,659691000,287619000,947310000
Ukraine (ab 05/1992),2023,12,606365000,232800000,839165000
Ukraine (ab 05/1992),2024,1,466735000,303804000,770539000
Ukraine (ab 05/1992),2024,2,569340000,267902000,837242000
Ukraine (ab 05/1992),2024,3,550692000,249288000,799980000
Ukraine (ab 05/1992),2024,4,611052000,287352000,898404000
Ukraine (ab 05/1992),2024,5,734690000,282931000,1017621000
Ukraine (ab 05/1992),2024,6,630887000,207425000,838312000
Ukraine (ab 05/1992),2024,7,662741000,248268000,911009000
Ukraine (ab 05/1992),2024,8,646276000,336210000,982486000
Ukraine (ab 05/1992),2024,9,974393000,324955000,1299348000
Ukraine (ab 05/1992),2024,10,622943000,408589000,1031532000
Ukraine (ab 05/1992),2024,11,827224000,298118000,1125342000
Ukraine (ab 05/1992),2024,12,881601000,286658000,1168259000
Ungarn,2008,1,1515870000,1498919000,3014789000
Ungarn,2008,2,1489832000,1433148000,2922980000
Ungarn,2008,3,1516596000,1452513000,2969109000
Ungarn,2008,4,1633987000,1558699000,3192686000
Ungarn,2008,5,1554660000,1373218000,2927878000
Ungarn,2008,6,1600400000,1425753000,3026153000
Ungarn,2008,7,1455653000,1415668000,2871321000
Ungarn,2008,8,1448960000,1333654000,2782614000
Ungarn,2008,9,1576510000,1462094000,3038604000
Ungarn,2008,10,1460078000,1394927000,2855005000
Ungarn,2008,11,1222252000,1461855000,2684107000
Ungarn,2008,12,885220000,1004607000,1889827000
Ungarn,2009,1,951602000,997145000,1948747000
Ungarn,2009,2,888955000,1048913000,1937868000
Ungarn,2009,3,1046794000,1297915000,2344709000
Ungarn,2009,4,960000000,1076930000,2036930000
Ungarn,2009,5,891293000,1091586000,1982879000
Ungarn,2009,6,991179000,1187828000,2179007000
Ungarn,2009,7,992210000,1193676000,2185886000
Ungarn,2009,8,826575000,965312000,1791887000
Ungarn,2009,9,1116997000,1282766000,2399763000
Ungarn,2009,10,1078821000,1293134000,2371955000
Ungarn,2009,11,1041928000,1266306000,2308234000
Ungarn,2009,12,888764000,1064095000,1952859000
Ungarn,2010,1,957976000,1072307000,2030283000
Ungarn,2010,2,1059674000,1260291000,2319965000
Ungarn,2010,3,1320578000,1489765000,2810343000
Ungarn,2010,4,1133090000,1274451000,2407541000
Ungarn,2010,5,1131890000,1316823000,2448713000
Ungarn,2010,6,1273698000,1511117000,2784815000
Ungarn,2010,7,1222122000,1385737000,2607859000
Ungarn,2010,8,1090599000,1142495000,2233094000
Ungarn,2010,9,1361511000,1510533000,2872044000
Ungarn,2010,10,1283922000,1560781000,2844703000
Ungarn,2010,11,1264132000,1452268000,2716400000
Ungarn,2010,12,1034251000,1411296000,2445547000
Ungarn,2011,1,1217301000,1316967000,2534268000
Ungarn,2011,2,1271102000,1528809000,2799911000
Ungarn,2011,3,1432240000,1694646000,3126886000
Ungarn,2011,4,1297219000,1468598000,2765817000
Ungarn,2011,5,1363489000,1591197000,2954686000
Ungarn,2011,6,1328657000,1507878000,2836535000
Ungarn,2011,7,1239776000,1517284000,2757060000
Ungarn,2011,8,1376099000,1438927000,2815026000
Ungarn,2011,9,1441692000,1645338000,3087030000
Ungarn,2011,10,1307688000,1585700000,2893388000
Ungarn,2011,11,1408992000,1577930000,2986922000
Ungarn,2011,12,1090273000,1334576000,2424849000
Ungarn,2012,1,1263798000,1471827000,2735625000
Ungarn,2012,2,1356285000,1634704000,2990989000
Ungarn,2012,3,1444371000,1660468000,3104839000
Ungarn,2012,4,1318940000,1513552000,2832492000
Ungarn,2012,5,1437869000,1613754000,3051623000
Ungarn,2012,6,1424390000,1631337000,3055727000
Ungarn,2012,7,1356030000,1544688000,2900718000
Ungarn,2012,8,1358686000,1438716000,2797402000
Ungarn,2012,9,1384285000,1583556000,2967841000
Ungarn,2012,10,1438320000,1642277000,3080597000
Ungarn,2012,11,1380181000,1572222000,2952403000
Ungarn,2012,12,1043998000,1159446000,2203444000
Ungarn,2013,1,1401729000,1461227000,2862956000
Ungarn,2013,2,1390188000,1529440000,2919628000
Ungarn,2013,3,1442708000,1632183000,3074891000
Ungarn,2013,4,1477966000,1668486000,3146452000
Ungarn,2013,5,1446427000,1587452000,3033879000
Ungarn,2013,6,1521337000,1636210000,3157547000
Ungarn,2013,7,1490479000,1632555000,3123034000
Ungarn,2013,8,1372997000,1424061000,2797058000
Ungarn,2013,9,1535973000,1742399000,3278372000
Ungarn,2013,10,1627102000,1886522000,3513624000
Ungarn,2013,11,1575354000,1802386000,3377740000
Ungarn,2013,12,1222134000,1488267000,2710401000
Ungarn,2014,1,1610205000,1693692000,3303897000
Ungarn,2014,2,1615819000,1809087000,3424906000
Ungarn,2014,3,1682504000,1877677000,3560181000
Ungarn,2014,4,1653402000,1939597000,3592999000
Ungarn,2014,5,1602086000,1815861000,3417947000
Ungarn,2014,6,1676487000,1871162000,3547649000
Ungarn,2014,7,1730303000,1964708000,3695011000
Ungarn,2014,8,1553191000,1492329000,3045520000
Ungarn,2014,9,1809768000,2013167000,3822935000
Ungarn,2014,10,1822147000,1983260000,3805407000
Ungarn,2014,11,1681374000,1923880000,3605254000
Ungarn,2014,12,1394716000,1587549000,2982265000
Ungarn,2015,1,1722623000,1726439000,3449062000
Ungarn,2015,2,1738417000,1918568000,3656985000
Ungarn,2015,3,1942030000,2122957000,4064987000
Ungarn,2015,4,1704263000,1968320000,3672583000
Ungarn,2015,5,1822859000,1911802000,3734661000
Ungarn,2015,6,1931847000,2092351000,4024198000
Ungarn,2015,7,1949745000,2138203000,4087948000
Ungarn,2015,8,1609191000,1645832000,3255023000
Ungarn,2015,9,1976863000,2140155000,4117018000
Ungarn,2015,10,1961278000,2152463000,4113741000
Ungarn,2015,11,1921731000,2162705000,4084436000
Ungarn,2015,12,1541232000,1797457000,3338689000
Ungarn,2016,1,1734853000,1766583000,3501436000
Ungarn,2016,2,1893523000,2130878000,4024401000
Ungarn,2016,3,1955454000,2059631000,4015085000
Ungarn,2016,4,1993050000,2223561000,4216611000
Ungarn,2016,5,1890768000,2048599000,3939367000
Ungarn,2016,6,2095368000,2229885000,4325253000
Ungarn,2016,7,1784358000,2041523000,3825881000
Ungarn,2016,8,1848105000,1903851000,3751956000
Ungarn,2016,9,2103970000,2305071000,4409041000
Ungarn,2016,10,1859577000,2171504000,4031081000
Ungarn,2016,11,2006133000,2321500000,4327633000
Ungarn,2016,12,1585603000,1791592000,3377195000
Ungarn,2017,1,2016690000,1967509000,3984199000
Ungarn,2017,2,2073384000,2192796000,4266180000
Ungarn,2017,3,2245873000,2291068000,4536941000
Ungarn,2017,4,2042361000,2112671000,4155032000
Ungarn,2017,5,2171866000,2332754000,4504620000
Ungarn,2017,6,2144539000,2215871000,4360410000
Ungarn,2017,7,1956532000,2095302000,4051834000
Ungarn,2017,8,2028433000,2056804000,4085237000
Ungarn,2017,9,2211202000,2431348000,4642550000
Ungarn,2017,10,2102954000,2239731000,4342685000
Ungarn,2017,11,2191044000,2496086000,4687130000
Ungarn,2017,12,1773515000,1953634000,3727149000
Ungarn,2018,1,2111914000,2200289000,4312203000
Ungarn,2018,2,2060953000,2296448000,4357401000
Ungarn,2018,3,2314152000,2454442000,4768594000
Ungarn,2018,4,2328048000,2338427000,4666475000
Ungarn,2018,5,2267354000,2404028000,4671382000
Ungarn,2018,6,2401935000,2501383000,4903318000
Ungarn,2018,7,2195842000,2232467000,4428309000
Ungarn,2018,8,2055713000,2018940000,4074653000
Ungarn,2018,9,2119257000,2132724000,4251981000
Ungarn,2018,10,2258874000,2421519000,4680393000
Ungarn,2018,11,2351054000,2443791000,4794845000
Ungarn,2018,12,1783065000,1930010000,3713075000
Ungarn,2019,1,2225177000,2233231000,4458408000
Ungarn,2019,2,2301941000,2413343000,4715284000
Ungarn,2019,3,2483093000,2412778000,4895871000
Ungarn,2019,4,2194987000,2506893000,4701880000
Ungarn,2019,5,2321651000,2538681000,4860332000
Ungarn,2019,6,2224731000,2346118000,4570849000
Ungarn,2019,7,2256438000,2388762000,4645200000
Ungarn,2019,8,2178193000,2092385000,4270578000
Ungarn,2019,9,2385538000,2692204000,5077742000
Ungarn,2019,10,2404624000,2588113000,4992737000
Ungarn,2019,11,2292656000,2533180000,4825836000
Ungarn,2019,12,1706623000,1904674000,3611297000
Ungarn,2020,1,2227931000,2314819000,4542750000
Ungarn,2020,2,2303518000,2497373000,4800891000
Ungarn,2020,3,2221258000,2290583000,4511841000
Ungarn,2020,4,1362027000,1377901000,2739928000
Ungarn,2020,5,1488026000,1675645000,3163671000
Ungarn,2020,6,1840136000,2241955000,4082091000
Ungarn,2020,7,2107303000,2409585000,4516888000
Ungarn,2020,8,2110906000,2233003000,4343909000
Ungarn,2020,9,2357172000,2809124000,5166296000
Ungarn,2020,10,2419711000,2609846000,5029557000
Ungarn,2020,11,2294789000,2758271000,5053060000
Ungarn,2020,12,1912387000,2276602000,4188989000
Ungarn,2021,1,1957677000,2051641000,4009318000
Ungarn,2021,2,2334209000,2597535000,4931744000
Ungarn,2021,3,2696214000,2836338000,5532552000
Ungarn,2021,4,2365485000,2459123000,4824608000
Ungarn,2021,5,2474389000,2438365000,4912754000
Ungarn,2021,6,2502195000,2571844000,5074039000
Ungarn,2021,7,2450274000,2489418000,4939692000
Ungarn,2021,8,2326538000,1975578000,4302116000
Ungarn,2021,9,2456782000,2530440000,4987222000
Ungarn,2021,10,2495188000,2436830000,4932018000
Ungarn,2021,11,2613313000,2880183000,5493496000
Ungarn,2021,12,2327166000,2355943000,4683109000
Ungarn,2022,1,2332750000,2459554000,4792304000
Ungarn,2022,2,2549111000,2823294000,5372405000
Ungarn,2022,3,2922241000,2951413000,5873654000
Ungarn,2022,4,2545326000,2574341000,5119667000
Ungarn,2022,5,2662839000,2906209000,5569048000
Ungarn,2022,6,2976757000,2797552000,5774309000
Ungarn,2022,7,2821544000,2774271000,5595815000
Ungarn,2022,8,3023708000,2665051000,5688759000
Ungarn,2022,9,3076465000,3277231000,6353696000
Ungarn,2022,10,2808340000,2986241000,5794581000
Ungarn,2022,11,2970813000,3312953000,6283766000
Ungarn,2022,12,2324582000,2648023000,4972605000
Ungarn,2023,1,2643363000,2859034000,5502397000
Ungarn,2023,2,2705987000,3120313000,5826300000
Ungarn,2023,3,3192645000,3460258000,6652903000
Ungarn,2023,4,2467207000,2901364000,5368571000
Ungarn,2023,5,2822288000,3230898000,6053186000
Ungarn,2023,6,3071871000,3483776000,6555647000
Ungarn,2023,7,2787401000,3021749000,5809150000
Ungarn,2023,8,2656573000,2861534000,5518107000
Ungarn,2023,9,2658468000,3190051000,5848519000
Ungarn,2023,10,2638683000,3082076000,5720759000
Ungarn,2023,11,2798119000,3321552000,6119671000
Ungarn,2023,12,2080681000,2458727000,4539408000
Ungarn,2024,1,2812802000,2875462000,5688264000
Ungarn,2024,2,2757123000,3293880000,6051003000
Ungarn,2024,3,3032100000,3028489000,6060589000
Ungarn,2024,4,2921600000,3215449000,6137049000
Ungarn,2024,5,2693852000,2729064000,5422916000
Ungarn,2024,6,2679980000,2874316000,5554296000
Ungarn,2024,7,2771240000,2835045000,5606285000
Ungarn,2024,8,2487196000,2650288000,5137484000
Ungarn,2024,9,2616471000,3087890000,5704361000
Ungarn,2024,10,2824846000,3025174000,5850020000
Ungarn,2024,11,2530488000,2851794000,5382282000
Ungarn,2024,12,2173187000,2486779000,4659966000
Uruguay,2008,1,10504000,18769000,29273000
Uruguay,2008,2,7659000,20376000,28035000
Uruguay,2008,3,8806000,23246000,32052000
Uruguay,2008,4,14635000,31484000,46119000
Uruguay,2008,5,9549000,24709000,34258000
Uruguay,2008,6,12189000,27724000,39913000
Uruguay,2008,7,14031000,41352000,55383000
Uruguay,2008,8,14244000,60978000,75222000
Uruguay,2008,9,14221000,33003000,47224000
Uruguay,2008,10,12775000,28480000,41255000
Uruguay,2008,11,10874000,27133000,38007000
Uruguay,2008,12,12382000,16611000,28993000
Uruguay,2009,1,15384000,23678000,39062000
Uruguay,2009,2,12035000,14259000,26294000
Uruguay,2009,3,13288000,20618000,33906000
Uruguay,2009,4,13128000,20449000,33577000
Uruguay,2009,5,7910000,20232000,28142000
Uruguay,2009,6,7220000,19748000,26968000
Uruguay,2009,7,14641000,21750000,36391000
Uruguay,2009,8,10865000,17726000,28591000
Uruguay,2009,9,9012000,20248000,29260000
Uruguay,2009,10,9273000,26489000,35762000
Uruguay,2009,11,15017000,23949000,38966000
Uruguay,2009,12,13857000,21407000,35264000
Uruguay,2010,1,11716000,22286000,34002000
Uruguay,2010,2,17004000,24180000,41184000
Uruguay,2010,3,21423000,31356000,52779000
Uruguay,2010,4,14910000,29446000,44356000
Uruguay,2010,5,15718000,37114000,52832000
Uruguay,2010,6,20364000,48134000,68498000
Uruguay,2010,7,24915000,56866000,81781000
Uruguay,2010,8,20508000,48840000,69348000
Uruguay,2010,9,20022000,42568000,62590000
Uruguay,2010,10,20708000,42022000,62730000
Uruguay,2010,11,23632000,27568000,51200000
Uruguay,2010,12,20360000,24389000,44749000
Uruguay,2011,1,24168000,27774000,51942000
Uruguay,2011,2,16328000,29893000,46221000
Uruguay,2011,3,23160000,29198000,52358000
Uruguay,2011,4,19797000,31167000,50964000
Uruguay,2011,5,23711000,72007000,95718000
Uruguay,2011,6,20839000,36037000,56876000
Uruguay,2011,7,21639000,33700000,55339000
Uruguay,2011,8,30844000,32556000,63400000
Uruguay,2011,9,23952000,43754000,67706000
Uruguay,2011,10,29956000,49575000,79531000
Uruguay,2011,11,25366000,30136000,55502000
Uruguay,2011,12,18914000,28178000,47092000
Uruguay,2012,1,31576000,27877000,59453000
Uruguay,2012,2,37491000,21623000,59114000
Uruguay,2012,3,28499000,26454000,54953000
Uruguay,2012,4,22916000,20808000,43724000
Uruguay,2012,5,33990000,29465000,63455000
Uruguay,2012,6,31733000,32997000,64730000
Uruguay,2012,7,33355000,23214000,56569000
Uruguay,2012,8,66384000,40141000,106525000
Uruguay,2012,9,28910000,41853000,70763000
Uruguay,2012,10,31205000,38002000,69207000
Uruguay,2012,11,35293000,57290000,92583000
Uruguay,2012,12,18506000,19584000,38090000
Uruguay,2013,1,21650000,22116000,43766000
Uruguay,2013,2,24587000,22936000,47523000
Uruguay,2013,3,30307000,18513000,48820000
Uruguay,2013,4,33730000,25911000,59641000
Uruguay,2013,5,30654000,17078000,47732000
Uruguay,2013,6,34642000,50727000,85369000
Uruguay,2013,7,40514000,48052000,88566000
Uruguay,2013,8,21676000,55590000,77266000
Uruguay,2013,9,20131000,42746000,62877000
Uruguay,2013,10,26713000,29502000,56215000
Uruguay,2013,11,39494000,18488000,57982000
Uruguay,2013,12,28512000,27645000,56157000
Uruguay,2014,1,38924000,18794000,57718000
Uruguay,2014,2,41737000,19350000,61087000
Uruguay,2014,3,45585000,19786000,65371000
Uruguay,2014,4,27619000,22718000,50337000
Uruguay,2014,5,27729000,19033000,46762000
Uruguay,2014,6,28360000,21750000,50110000
Uruguay,2014,7,34470000,20641000,55111000
Uruguay,2014,8,24484000,16681000,41165000
Uruguay,2014,9,35112000,23065000,58177000
Uruguay,2014,10,35437000,21247000,56684000
Uruguay,2014,11,22886000,17768000,40654000
Uruguay,2014,12,51151000,18082000,69233000
Uruguay,2015,1,25172000,19543000,44715000
Uruguay,2015,2,36218000,16053000,52271000
Uruguay,2015,3,32812000,23814000,56626000
Uruguay,2015,4,23483000,18838000,42321000
Uruguay,2015,5,25367000,17724000,43091000
Uruguay,2015,6,31279000,23741000,55020000
Uruguay,2015,7,28275000,34113000,62388000
Uruguay,2015,8,70290000,23560000,93850000
Uruguay,2015,9,25884000,29092000,54976000
Uruguay,2015,10,65088000,21033000,86121000
Uruguay,2015,11,44429000,18103000,62532000
Uruguay,2015,12,38764000,19204000,57968000
Uruguay,2016,1,41204000,24220000,65424000
Uruguay,2016,2,42017000,23767000,65784000
Uruguay,2016,3,20363000,26763000,47126000
Uruguay,2016,4,25613000,36399000,62012000
Uruguay,2016,5,18298000,37009000,55307000
Uruguay,2016,6,35483000,22679000,58162000
Uruguay,2016,7,21169000,61217000,82386000
Uruguay,2016,8,27292000,24095000,51387000
Uruguay,2016,9,33924000,25850000,59774000
Uruguay,2016,10,20751000,22033000,42784000
Uruguay,2016,11,32800000,32645000,65445000
Uruguay,2016,12,20813000,19414000,40227000
Uruguay,2017,1,29386000,26412000,55798000
Uruguay,2017,2,17764000,15346000,33110000
Uruguay,2017,3,20624000,20356000,40980000
Uruguay,2017,4,16056000,21554000,37610000
Uruguay,2017,5,23877000,21539000,45416000
Uruguay,2017,6,18882000,22403000,41285000
Uruguay,2017,7,19616000,25710000,45326000
Uruguay,2017,8,20042000,23686000,43728000
Uruguay,2017,9,20760000,26575000,47335000
Uruguay,2017,10,18787000,24333000,43120000
Uruguay,2017,11,19078000,30189000,49267000
Uruguay,2017,12,25703000,20515000,46218000
Uruguay,2018,1,24081000,25106000,49187000
Uruguay,2018,2,17176000,22293000,39469000
Uruguay,2018,3,23549000,26364000,49913000
Uruguay,2018,4,18494000,22556000,41050000
Uruguay,2018,5,19997000,27139000,47136000
Uruguay,2018,6,18947000,23837000,42784000
Uruguay,2018,7,17979000,27546000,45525000
Uruguay,2018,8,19995000,28131000,48126000
Uruguay,2018,9,17220000,23597000,40817000
Uruguay,2018,10,21695000,27547000,49242000
Uruguay,2018,11,16772000,18924000,35696000
Uruguay,2018,12,11547000,21473000,33020000
Uruguay,2019,1,17232000,28481000,45713000
Uruguay,2019,2,18562000,22986000,41548000
Uruguay,2019,3,18661000,28385000,47046000
Uruguay,2019,4,14709000,27681000,42390000
Uruguay,2019,5,19100000,26613000,45713000
Uruguay,2019,6,16762000,21572000,38334000
Uruguay,2019,7,22043000,24030000,46073000
Uruguay,2019,8,24474000,22498000,46972000
Uruguay,2019,9,22035000,40937000,62972000
Uruguay,2019,10,26817000,26413000,53230000
Uruguay,2019,11,21144000,21125000,42269000
Uruguay,2019,12,17252000,18739000,35991000
Uruguay,2020,1,20034000,19673000,39707000
Uruguay,2020,2,20688000,20951000,41639000
Uruguay,2020,3,20337000,21399000,41736000
Uruguay,2020,4,14706000,20920000,35626000
Uruguay,2020,5,22505000,13413000,35918000
Uruguay,2020,6,17042000,16155000,33197000
Uruguay,2020,7,14234000,11430000,25664000
Uruguay,2020,8,22854000,14192000,37046000
Uruguay,2020,9,20524000,19736000,40260000
Uruguay,2020,10,20898000,16818000,37716000
Uruguay,2020,11,24987000,16697000,41684000
Uruguay,2020,12,26244000,12210000,38454000
Uruguay,2021,1,21974000,12447000,34421000
Uruguay,2021,2,22693000,13672000,36365000
Uruguay,2021,3,37251000,16192000,53443000
Uruguay,2021,4,42383000,19061000,61444000
Uruguay,2021,5,28471000,18645000,47116000
Uruguay,2021,6,37306000,16064000,53370000
Uruguay,2021,7,41579000,16424000,58003000
Uruguay,2021,8,42511000,18905000,61416000
Uruguay,2021,9,41668000,21200000,62868000
Uruguay,2021,10,40436000,19073000,59509000
Uruguay,2021,11,51498000,19627000,71125000
Uruguay,2021,12,43087000,22347000,65434000
Uruguay,2022,1,29217000,20494000,49711000
Uruguay,2022,2,32036000,22632000,54668000
Uruguay,2022,3,25865000,21621000,47486000
Uruguay,2022,4,33328000,24254000,57582000
Uruguay,2022,5,30737000,34791000,65528000
Uruguay,2022,6,21964000,29310000,51274000
Uruguay,2022,7,37673000,28409000,66082000
Uruguay,2022,8,24591000,34707000,59298000
Uruguay,2022,9,30044000,30165000,60209000
Uruguay,2022,10,21526000,46551000,68077000
Uruguay,2022,11,31303000,27930000,59233000
Uruguay,2022,12,35606000,22461000,58067000
Uruguay,2023,1,27703000,18444000,46147000
Uruguay,2023,2,35261000,53761000,89022000
Uruguay,2023,3,29671000,34943000,64614000
Uruguay,2023,4,20498000,32190000,52688000
Uruguay,2023,5,35393000,31359000,66752000
Uruguay,2023,6,32674000,32172000,64846000
Uruguay,2023,7,30116000,25089000,55205000
Uruguay,2023,8,29260000,23222000,52482000
Uruguay,2023,9,31617000,25934000,57551000
Uruguay,2023,10,30715000,28468000,59183000
Uruguay,2023,11,25971000,22954000,48925000
Uruguay,2023,12,23080000,21231000,44311000
Uruguay,2024,1,40404000,27810000,68214000
Uruguay,2024,2,33620000,20595000,54215000
Uruguay,2024,3,31462000,27527000,58989000
Uruguay,2024,4,42344000,29593000,71937000
Uruguay,2024,5,27506000,30763000,58269000
Uruguay,2024,6,20169000,30987000,51156000
Uruguay,2024,7,28445000,30397000,58842000
Uruguay,2024,8,32734000,21895000,54629000
Uruguay,2024,9,32418000,38560000,70978000
Uruguay,2024,10,30731000,26442000,57173000
Uruguay,2024,11,29306000,35647000,64953000
Uruguay,2024,12,26285000,25625000,51910000
Usbekistan (ab 05/1992),2008,1,30109000,4881000,34990000
Usbekistan (ab 05/1992),2008,2,30948000,5090000,36038000
Usbekistan (ab 05/1992),2008,3,32390000,6196000,38586000
Usbekistan (ab 05/1992),2008,4,28854000,3486000,32340000
Usbekistan (ab 05/1992),2008,5,20887000,2464000,23351000
Usbekistan (ab 05/1992),2008,6,17737000,2068000,19805000
Usbekistan (ab 05/1992),2008,7,25409000,5456000,30865000
Usbekistan (ab 05/1992),2008,8,18039000,2924000,20963000
Usbekistan (ab 05/1992),2008,9,29864000,3295000,33159000
Usbekistan (ab 05/1992),2008,10,28430000,5631000,34061000
Usbekistan (ab 05/1992),2008,11,24062000,2674000,26736000
Usbekistan (ab 05/1992),2008,12,21532000,2036000,23568000
Usbekistan (ab 05/1992),2009,1,10313000,1501000,11814000
Usbekistan (ab 05/1992),2009,2,16337000,2137000,18474000
Usbekistan (ab 05/1992),2009,3,18725000,2235000,20960000
Usbekistan (ab 05/1992),2009,4,35556000,3110000,38666000
Usbekistan (ab 05/1992),2009,5,27519000,2149000,29668000
Usbekistan (ab 05/1992),2009,6,22674000,1675000,24349000
Usbekistan (ab 05/1992),2009,7,45452000,2333000,47785000
Usbekistan (ab 05/1992),2009,8,54135000,1356000,55491000
Usbekistan (ab 05/1992),2009,9,24944000,3422000,28366000
Usbekistan (ab 05/1992),2009,10,28936000,3067000,32003000
Usbekistan (ab 05/1992),2009,11,24474000,2048000,26522000
Usbekistan (ab 05/1992),2009,12,22257000,1476000,23733000
Usbekistan (ab 05/1992),2010,1,22069000,2534000,24603000
Usbekistan (ab 05/1992),2010,2,15952000,2904000,18856000
Usbekistan (ab 05/1992),2010,3,24531000,2379000,26910000
Usbekistan (ab 05/1992),2010,4,30167000,3494000,33661000
Usbekistan (ab 05/1992),2010,5,26735000,2715000,29450000
Usbekistan (ab 05/1992),2010,6,26287000,3293000,29580000
Usbekistan (ab 05/1992),2010,7,64426000,4574000,69000000
Usbekistan (ab 05/1992),2010,8,65448000,8000000,73448000
Usbekistan (ab 05/1992),2010,9,32978000,3054000,36032000
Usbekistan (ab 05/1992),2010,10,28419000,2567000,30986000
Usbekistan (ab 05/1992),2010,11,30604000,1758000,32362000
Usbekistan (ab 05/1992),2010,12,168976000,1663000,170639000
Usbekistan (ab 05/1992),2011,1,17100000,3102000,20202000
Usbekistan (ab 05/1992),2011,2,33997000,3785000,37782000
Usbekistan (ab 05/1992),2011,3,81937000,4071000,86008000
Usbekistan (ab 05/1992),2011,4,31332000,5271000,36603000
Usbekistan (ab 05/1992),2011,5,73003000,1922000,74925000
Usbekistan (ab 05/1992),2011,6,33166000,1170000,34336000
Usbekistan (ab 05/1992),2011,7,26045000,1924000,27969000
Usbekistan (ab 05/1992),2011,8,29036000,2030000,31066000
Usbekistan (ab 05/1992),2011,9,29719000,1700000,31419000
Usbekistan (ab 05/1992),2011,10,26501000,1708000,28209000
Usbekistan (ab 05/1992),2011,11,69371000,2304000,71675000
Usbekistan (ab 05/1992),2011,12,35820000,1994000,37814000
Usbekistan (ab 05/1992),2012,1,19819000,2182000,22001000
Usbekistan (ab 05/1992),2012,2,25856000,1544000,27400000
Usbekistan (ab 05/1992),2012,3,29523000,1717000,31240000
Usbekistan (ab 05/1992),2012,4,27512000,1675000,29187000
Usbekistan (ab 05/1992),2012,5,27522000,1717000,29239000
Usbekistan (ab 05/1992),2012,6,51737000,1875000,53612000
Usbekistan (ab 05/1992),2012,7,25726000,2434000,28160000
Usbekistan (ab 05/1992),2012,8,24074000,1757000,25831000
Usbekistan (ab 05/1992),2012,9,42389000,2787000,45176000
Usbekistan (ab 05/1992),2012,10,27899000,2630000,30529000
Usbekistan (ab 05/1992),2012,11,53758000,2362000,56120000
Usbekistan (ab 05/1992),2012,12,37315000,1947000,39262000
Usbekistan (ab 05/1992),2013,1,26789000,2327000,29116000
Usbekistan (ab 05/1992),2013,2,44627000,1914000,46541000
Usbekistan (ab 05/1992),2013,3,44222000,2348000,46570000
Usbekistan (ab 05/1992),2013,4,29800000,1783000,31583000
Usbekistan (ab 05/1992),2013,5,20771000,2003000,22774000
Usbekistan (ab 05/1992),2013,6,41961000,1257000,43218000
Usbekistan (ab 05/1992),2013,7,39456000,1685000,41141000
Usbekistan (ab 05/1992),2013,8,30476000,1797000,32273000
Usbekistan (ab 05/1992),2013,9,44407000,1117000,45524000
Usbekistan (ab 05/1992),2013,10,32841000,1441000,34282000
Usbekistan (ab 05/1992),2013,11,29821000,1568000,31389000
Usbekistan (ab 05/1992),2013,12,31680000,1429000,33109000
Usbekistan (ab 05/1992),2014,1,25263000,862000,26125000
Usbekistan (ab 05/1992),2014,2,22548000,1156000,23704000
Usbekistan (ab 05/1992),2014,3,33863000,1840000,35703000
Usbekistan (ab 05/1992),2014,4,33472000,1737000,35209000
Usbekistan (ab 05/1992),2014,5,63534000,1679000,65213000
Usbekistan (ab 05/1992),2014,6,48458000,1381000,49839000
Usbekistan (ab 05/1992),2014,7,53327000,1145000,54472000
Usbekistan (ab 05/1992),2014,8,48087000,1425000,49512000
Usbekistan (ab 05/1992),2014,9,51584000,1867000,53451000
Usbekistan (ab 05/1992),2014,10,39427000,2327000,41754000
Usbekistan (ab 05/1992),2014,11,39978000,1358000,41336000
Usbekistan (ab 05/1992),2014,12,36766000,1933000,38699000
Usbekistan (ab 05/1992),2015,1,26438000,1640000,28078000
Usbekistan (ab 05/1992),2015,2,34553000,1608000,36161000
Usbekistan (ab 05/1992),2015,3,36359000,1069000,37428000
Usbekistan (ab 05/1992),2015,4,37792000,972000,38764000
Usbekistan (ab 05/1992),2015,5,25436000,1386000,26822000
Usbekistan (ab 05/1992),2015,6,42953000,1392000,44345000
Usbekistan (ab 05/1992),2015,7,39859000,1595000,41454000
Usbekistan (ab 05/1992),2015,8,29895000,1670000,31565000
Usbekistan (ab 05/1992),2015,9,30366000,1753000,32119000
Usbekistan (ab 05/1992),2015,10,34158000,1802000,35960000
Usbekistan (ab 05/1992),2015,11,40559000,1321000,41880000
Usbekistan (ab 05/1992),2015,12,41923000,1679000,43602000
Usbekistan (ab 05/1992),2016,1,33432000,2371000,35803000
Usbekistan (ab 05/1992),2016,2,40731000,1710000,42441000
Usbekistan (ab 05/1992),2016,3,44370000,2000000,46370000
Usbekistan (ab 05/1992),2016,4,38582000,1439000,40021000
Usbekistan (ab 05/1992),2016,5,36794000,1703000,38497000
Usbekistan (ab 05/1992),2016,6,31371000,2053000,33424000
Usbekistan (ab 05/1992),2016,7,30218000,1149000,31367000
Usbekistan (ab 05/1992),2016,8,54028000,1710000,55738000
Usbekistan (ab 05/1992),2016,9,26350000,2267000,28617000
Usbekistan (ab 05/1992),2016,10,25559000,4177000,29736000
Usbekistan (ab 05/1992),2016,11,33939000,1788000,35727000
Usbekistan (ab 05/1992),2016,12,38471000,2051000,40522000
Usbekistan (ab 05/1992),2017,1,25249000,1449000,26698000
Usbekistan (ab 05/1992),2017,2,45380000,2208000,47588000
Usbekistan (ab 05/1992),2017,3,65303000,1156000,66459000
Usbekistan (ab 05/1992),2017,4,44391000,2106000,46497000
Usbekistan (ab 05/1992),2017,5,40698000,2419000,43117000
Usbekistan (ab 05/1992),2017,6,49152000,1852000,51004000
Usbekistan (ab 05/1992),2017,7,38358000,1456000,39814000
Usbekistan (ab 05/1992),2017,8,43406000,2133000,45539000
Usbekistan (ab 05/1992),2017,9,54291000,2199000,56490000
Usbekistan (ab 05/1992),2017,10,42388000,2570000,44958000
Usbekistan (ab 05/1992),2017,11,66932000,2221000,69153000
Usbekistan (ab 05/1992),2017,12,67226000,2070000,69296000
Usbekistan (ab 05/1992),2018,1,39432000,2252000,41684000
Usbekistan (ab 05/1992),2018,2,39060000,1522000,40582000
Usbekistan (ab 05/1992),2018,3,54920000,2117000,57037000
Usbekistan (ab 05/1992),2018,4,47712000,1511000,49223000
Usbekistan (ab 05/1992),2018,5,47736000,1897000,49633000
Usbekistan (ab 05/1992),2018,6,63702000,2929000,66631000
Usbekistan (ab 05/1992),2018,7,48269000,2072000,50341000
Usbekistan (ab 05/1992),2018,8,53061000,2240000,55301000
Usbekistan (ab 05/1992),2018,9,61575000,2644000,64219000
Usbekistan (ab 05/1992),2018,10,70153000,1795000,71948000
Usbekistan (ab 05/1992),2018,11,110490000,2956000,113446000
Usbekistan (ab 05/1992),2018,12,51081000,3368000,54449000
Usbekistan (ab 05/1992),2019,1,37846000,2921000,40767000
Usbekistan (ab 05/1992),2019,2,42206000,3433000,45639000
Usbekistan (ab 05/1992),2019,3,124598000,2405000,127003000
Usbekistan (ab 05/1992),2019,4,140187000,2885000,143072000
Usbekistan (ab 05/1992),2019,5,61143000,3259000,64402000
Usbekistan (ab 05/1992),2019,6,67449000,2554000,70003000
Usbekistan (ab 05/1992),2019,7,60194000,4345000,64539000
Usbekistan (ab 05/1992),2019,8,54392000,1485000,55877000
Usbekistan (ab 05/1992),2019,9,81113000,2155000,83268000
Usbekistan (ab 05/1992),2019,10,61811000,2008000,63819000
Usbekistan (ab 05/1992),2019,11,77641000,2126000,79767000
Usbekistan (ab 05/1992),2019,12,67150000,2037000,69187000
Usbekistan (ab 05/1992),2020,1,44525000,3806000,48331000
Usbekistan (ab 05/1992),2020,2,53622000,3468000,57090000
Usbekistan (ab 05/1992),2020,3,50624000,2364000,52988000
Usbekistan (ab 05/1992),2020,4,38617000,2281000,40898000
Usbekistan (ab 05/1992),2020,5,33672000,2769000,36441000
Usbekistan (ab 05/1992),2020,6,47370000,1935000,49305000
Usbekistan (ab 05/1992),2020,7,76828000,2403000,79231000
Usbekistan (ab 05/1992),2020,8,50465000,1862000,52327000
Usbekistan (ab 05/1992),2020,9,48856000,2560000,51416000
Usbekistan (ab 05/1992),2020,10,48382000,3209000,51591000
Usbekistan (ab 05/1992),2020,11,58601000,2799000,61400000
Usbekistan (ab 05/1992),2020,12,50099000,2339000,52438000
Usbekistan (ab 05/1992),2021,1,30088000,1783000,31871000
Usbekistan (ab 05/1992),2021,2,36583000,2675000,39258000
Usbekistan (ab 05/1992),2021,3,61499000,4759000,66258000
Usbekistan (ab 05/1992),2021,4,47410000,5322000,52732000
Usbekistan (ab 05/1992),2021,5,39092000,4155000,43247000
Usbekistan (ab 05/1992),2021,6,51830000,4455000,56285000
Usbekistan (ab 05/1992),2021,7,43211000,4254000,47465000
Usbekistan (ab 05/1992),2021,8,42571000,4738000,47309000
Usbekistan (ab 05/1992),2021,9,68387000,5255000,73642000
Usbekistan (ab 05/1992),2021,10,41064000,5491000,46555000
Usbekistan (ab 05/1992),2021,11,57321000,7245000,64566000
Usbekistan (ab 05/1992),2021,12,52956000,4784000,57740000
Usbekistan (ab 05/1992),2022,1,42418000,19346000,61764000
Usbekistan (ab 05/1992),2022,2,131054000,3993000,135047000
Usbekistan (ab 05/1992),2022,3,228597000,7815000,236412000
Usbekistan (ab 05/1992),2022,4,47117000,7923000,55040000
Usbekistan (ab 05/1992),2022,5,53427000,5799000,59226000
Usbekistan (ab 05/1992),2022,6,63583000,4158000,67741000
Usbekistan (ab 05/1992),2022,7,87737000,3763000,91500000
Usbekistan (ab 05/1992),2022,8,84898000,5723000,90621000
Usbekistan (ab 05/1992),2022,9,74319000,7302000,81621000
Usbekistan (ab 05/1992),2022,10,69660000,11924000,81584000
Usbekistan (ab 05/1992),2022,11,85288000,5336000,90624000
Usbekistan (ab 05/1992),2022,12,345563000,6808000,352371000
Usbekistan (ab 05/1992),2023,1,58301000,4323000,62624000
Usbekistan (ab 05/1992),2023,2,70314000,7157000,77471000
Usbekistan (ab 05/1992),2023,3,118320000,6826000,125146000
Usbekistan (ab 05/1992),2023,4,69283000,7964000,77247000
Usbekistan (ab 05/1992),2023,5,88361000,7596000,95957000
Usbekistan (ab 05/1992),2023,6,102169000,6614000,108783000
Usbekistan (ab 05/1992),2023,7,65764000,5755000,71519000
Usbekistan (ab 05/1992),2023,8,95211000,8134000,103345000
Usbekistan (ab 05/1992),2023,9,92399000,3923000,96322000
Usbekistan (ab 05/1992),2023,10,86668000,4890000,91558000
Usbekistan (ab 05/1992),2023,11,76034000,8158000,84192000
Usbekistan (ab 05/1992),2023,12,77622000,4648000,82270000
Usbekistan (ab 05/1992),2024,1,61051000,5590000,66641000
Usbekistan (ab 05/1992),2024,2,77402000,6797000,84199000
Usbekistan (ab 05/1992),2024,3,80648000,6411000,87059000
Usbekistan (ab 05/1992),2024,4,89448000,6892000,96340000
Usbekistan (ab 05/1992),2024,5,79320000,5822000,85142000
Usbekistan (ab 05/1992),2024,6,79821000,4873000,84694000
Usbekistan (ab 05/1992),2024,7,68600000,10585000,79185000
Usbekistan (ab 05/1992),2024,8,163363000,8809000,172172000
Usbekistan (ab 05/1992),2024,9,111442000,6527000,117969000
Usbekistan (ab 05/1992),2024,10,91054000,8377000,99431000
Usbekistan (ab 05/1992),2024,11,111947000,9163000,121110000
Usbekistan (ab 05/1992),2024,12,70249000,8635000,78884000
Vanuatu,2008,1,1000,9000,10000
Vanuatu,2008,2,91000,5000,96000
Vanuatu,2008,3,101000,15000,116000
Vanuatu,2008,4,96000,15000,111000
Vanuatu,2008,5,3000,15000,18000
Vanuatu,2008,6,88000,18000,106000
Vanuatu,2008,7,26000,10000,36000
Vanuatu,2008,8,102000,6000,108000
Vanuatu,2008,9,88000,11000,99000
Vanuatu,2008,10,6000,27000,33000
Vanuatu,2008,11,34000,0,34000
Vanuatu,2008,12,167000,19000,186000
Vanuatu,2009,1,31000,41000,72000
Vanuatu,2009,2,123000,35000,158000
Vanuatu,2009,3,145000,11000,156000
Vanuatu,2009,4,23000,24000,47000
Vanuatu,2009,5,91000,4000,95000
Vanuatu,2009,6,2721000,6000,2727000
Vanuatu,2009,7,21000,30000,51000
Vanuatu,2009,8,11000,4000,15000
Vanuatu,2009,9,22000,19000,41000
Vanuatu,2009,10,167000,19000,186000
Vanuatu,2009,11,25000,23000,48000
Vanuatu,2009,12,42000,11000,53000
Vanuatu,2010,1,6000,83000,89000
Vanuatu,2010,2,39000,757000,796000
Vanuatu,2010,3,35000,166000,201000
Vanuatu,2010,4,20000,7000,27000
Vanuatu,2010,5,18000,123000,141000
Vanuatu,2010,6,12000,255000,267000
Vanuatu,2010,7,19000,319000,338000
Vanuatu,2010,8,50000,111000,161000
Vanuatu,2010,9,171000,11000,182000
Vanuatu,2010,10,64000,74000,138000
Vanuatu,2010,11,9000,49000,58000
Vanuatu,2010,12,34000,22000,56000
Vanuatu,2011,1,7000,0,7000
Vanuatu,2011,2,3000,0,3000
Vanuatu,2011,3,5000,11000,16000
Vanuatu,2011,4,10000,14000,24000
Vanuatu,2011,5,23000,48000,71000
Vanuatu,2011,6,38000,0,38000
Vanuatu,2011,7,11000,14000,25000
Vanuatu,2011,8,10000,5000,15000
Vanuatu,2011,9,8000,4000,12000
Vanuatu,2011,10,18000,20000,38000
Vanuatu,2011,11,27000,0,27000
Vanuatu,2011,12,8000,24000,32000
Vanuatu,2012,1,3000,40000,43000
Vanuatu,2012,2,69000,6000,75000
Vanuatu,2012,3,5000,5000,10000
Vanuatu,2012,4,0,0,0
Vanuatu,2012,5,9000,10000,19000
Vanuatu,2012,6,18000,3000,21000
Vanuatu,2012,7,17000,35000,52000
Vanuatu,2012,8,29000,38000,67000
Vanuatu,2012,9,30000,2000,32000
Vanuatu,2012,10,93000,38000,131000
Vanuatu,2012,11,1000,0,1000
Vanuatu,2012,12,23000,4000,27000
Vanuatu,2013,1,8000,0,8000
Vanuatu,2013,2,61000,0,61000
Vanuatu,2013,3,225000,0,225000
Vanuatu,2013,4,75000,3000,78000
Vanuatu,2013,5,21000,26000,47000
Vanuatu,2013,6,66000,0,66000
Vanuatu,2013,7,70000,8000,78000
Vanuatu,2013,8,9000,70000,79000
Vanuatu,2013,9,14000,0,14000
Vanuatu,2013,10,48000,0,48000
Vanuatu,2013,11,22000,3000,25000
Vanuatu,2013,12,39000,0,39000
Vanuatu,2014,1,25000,0,25000
Vanuatu,2014,2,14000,0,14000
Vanuatu,2014,3,47000,3000,50000
Vanuatu,2014,4,3000,7000,10000
Vanuatu,2014,5,7000,10000,17000
Vanuatu,2014,6,26000,5000,31000
Vanuatu,2014,7,45000,3000,48000
Vanuatu,2014,8,54000,0,54000
Vanuatu,2014,9,53000,0,53000
Vanuatu,2014,10,55000,86000,141000
Vanuatu,2014,11,6000,4000,10000
Vanuatu,2014,12,3000,0,3000
Vanuatu,2015,1,82000,0,82000
Vanuatu,2015,2,17000,4000,21000
Vanuatu,2015,3,1000,6000,7000
Vanuatu,2015,4,54000,0,54000
Vanuatu,2015,5,102000,0,102000
Vanuatu,2015,6,205000,0,205000
Vanuatu,2015,7,119000,0,119000
Vanuatu,2015,8,19000,0,19000
Vanuatu,2015,9,46000,5000,51000
Vanuatu,2015,10,27000,0,27000
Vanuatu,2015,11,45000,0,45000
Vanuatu,2015,12,48000,0,48000
Vanuatu,2016,1,11000,0,11000
Vanuatu,2016,2,14000,2000,16000
Vanuatu,2016,3,35000,0,35000
Vanuatu,2016,4,85000,20000,105000
Vanuatu,2016,5,99000,0,99000
Vanuatu,2016,6,216000,0,216000
Vanuatu,2016,7,61000,0,61000
Vanuatu,2016,8,5000,0,5000
Vanuatu,2016,9,288000,1000,289000
Vanuatu,2016,10,87000,0,87000
Vanuatu,2016,11,39000,1000,40000
Vanuatu,2016,12,59000,0,59000
Vanuatu,2017,1,23000,0,23000
Vanuatu,2017,2,95000,0,95000
Vanuatu,2017,3,114000,0,114000
Vanuatu,2017,4,13000,0,13000
Vanuatu,2017,5,149000,0,149000
Vanuatu,2017,6,13000,0,13000
Vanuatu,2017,7,212000,0,212000
Vanuatu,2017,8,96000,0,96000
Vanuatu,2017,9,41000,0,41000
Vanuatu,2017,10,42000,0,42000
Vanuatu,2017,11,85000,0,85000
Vanuatu,2017,12,55000,0,55000
Vanuatu,2018,1,127000,0,127000
Vanuatu,2018,2,45000,0,45000
Vanuatu,2018,3,75000,0,75000
Vanuatu,2018,4,53000,7000,60000
Vanuatu,2018,5,50000,0,50000
Vanuatu,2018,6,334000,0,334000
Vanuatu,2018,7,12000,0,12000
Vanuatu,2018,8,2000,0,2000
Vanuatu,2018,9,125000,0,125000
Vanuatu,2018,10,2000,0,2000
Vanuatu,2018,11,31000,0,31000
Vanuatu,2018,12,27000,0,27000
Vanuatu,2019,1,41000,0,41000
Vanuatu,2019,2,17000,0,17000
Vanuatu,2019,3,29000,0,29000
Vanuatu,2019,4,34000,0,34000
Vanuatu,2019,5,50000,0,50000
Vanuatu,2019,6,0,0,0
Vanuatu,2019,7,242000,0,242000
Vanuatu,2019,8,66000,0,66000
Vanuatu,2019,9,16000,22000,38000
Vanuatu,2019,10,119000,10000,129000
Vanuatu,2019,11,38000,0,38000
Vanuatu,2019,12,13000,13000,26000
Vanuatu,2020,1,23000,0,23000
Vanuatu,2020,2,0,7000,7000
Vanuatu,2020,3,83000,0,83000
Vanuatu,2020,4,0,0,0
Vanuatu,2020,5,14000,0,14000
Vanuatu,2020,6,13000,0,13000
Vanuatu,2020,7,30000,0,30000
Vanuatu,2020,8,31000,0,31000
Vanuatu,2020,9,19000,114000,133000
Vanuatu,2020,10,19000,22000,41000
Vanuatu,2020,11,15000,0,15000
Vanuatu,2020,12,119000,0,119000
Vanuatu,2021,1,77000,0,77000
Vanuatu,2021,2,4000,0,4000
Vanuatu,2021,3,111000,0,111000
Vanuatu,2021,4,25000,0,25000
Vanuatu,2021,5,35000,0,35000
Vanuatu,2021,6,49000,0,49000
Vanuatu,2021,7,15000,40000,55000
Vanuatu,2021,8,23000,0,23000
Vanuatu,2021,9,31000,0,31000
Vanuatu,2021,10,33000,0,33000
Vanuatu,2021,11,24000,0,24000
Vanuatu,2021,12,74000,0,74000
Vanuatu,2022,1,16000,0,16000
Vanuatu,2022,2,23000,0,23000
Vanuatu,2022,3,1000,0,1000
Vanuatu,2022,4,16000,0,16000
Vanuatu,2022,5,8000,0,8000
Vanuatu,2022,6,26000,0,26000
Vanuatu,2022,7,20000,0,20000
Vanuatu,2022,8,18000,0,18000
Vanuatu,2022,9,67000,0,67000
Vanuatu,2022,10,291000,0,291000
Vanuatu,2022,11,37000,0,37000
Vanuatu,2022,12,18000,0,18000
Vanuatu,2023,1,87000,0,87000
Vanuatu,2023,2,11000,0,11000
Vanuatu,2023,3,25000,0,25000
Vanuatu,2023,4,23000,0,23000
Vanuatu,2023,5,55000,0,55000
Vanuatu,2023,6,164000,0,164000
Vanuatu,2023,7,8000,0,8000
Vanuatu,2023,8,22000,0,22000
Vanuatu,2023,9,32000,0,32000
Vanuatu,2023,10,5000,0,5000
Vanuatu,2023,11,179000,0,179000
Vanuatu,2023,12,6000,0,6000
Vanuatu,2024,1,13000,0,13000
Vanuatu,2024,2,126000,0,126000
Vanuatu,2024,3,31000,0,31000
Vanuatu,2024,4,9000,0,9000
Vanuatu,2024,5,143000,0,143000
Vanuatu,2024,6,278000,0,278000
Vanuatu,2024,7,1000,0,1000
Vanuatu,2024,8,29000,3000,32000
Vanuatu,2024,9,13000,0,13000
Vanuatu,2024,10,62000,0,62000
Vanuatu,2024,11,8000,0,8000
Vanuatu,2024,12,90000,0,90000
Vereinigte Arabische Emirate,2008,1,486090000,61629000,547719000
Vereinigte Arabische Emirate,2008,2,528238000,42363000,570601000
Vereinigte Arabische Emirate,2008,3,451048000,41639000,492687000
Vereinigte Arabische Emirate,2008,4,618222000,29255000,647477000
Vereinigte Arabische Emirate,2008,5,509847000,44384000,554231000
Vereinigte Arabische Emirate,2008,6,655951000,45320000,701271000
Vereinigte Arabische Emirate,2008,7,809971000,44405000,854376000
Vereinigte Arabische Emirate,2008,8,605987000,38404000,644391000
Vereinigte Arabische Emirate,2008,9,692706000,42391000,735097000
Vereinigte Arabische Emirate,2008,10,868894000,40590000,909484000
Vereinigte Arabische Emirate,2008,11,925303000,30181000,955484000
Vereinigte Arabische Emirate,2008,12,1012344000,42473000,1054817000
Vereinigte Arabische Emirate,2009,1,573312000,42737000,616049000
Vereinigte Arabische Emirate,2009,2,511982000,51604000,563586000
Vereinigte Arabische Emirate,2009,3,565847000,44490000,610337000
Vereinigte Arabische Emirate,2009,4,453602000,57934000,511536000
Vereinigte Arabische Emirate,2009,5,418500000,43423000,461923000
Vereinigte Arabische Emirate,2009,6,507635000,29866000,537501000
Vereinigte Arabische Emirate,2009,7,523604000,34805000,558409000
Vereinigte Arabische Emirate,2009,8,406430000,28862000,435292000
Vereinigte Arabische Emirate,2009,9,424684000,28864000,453548000
Vereinigte Arabische Emirate,2009,10,458472000,29755000,488227000
Vereinigte Arabische Emirate,2009,11,471999000,41306000,513305000
Vereinigte Arabische Emirate,2009,12,841507000,38055000,879562000
Vereinigte Arabische Emirate,2010,1,562925000,32707000,595632000
Vereinigte Arabische Emirate,2010,2,466109000,42271000,508380000
Vereinigte Arabische Emirate,2010,3,581677000,43917000,625594000
Vereinigte Arabische Emirate,2010,4,436918000,42273000,479191000
Vereinigte Arabische Emirate,2010,5,660566000,40011000,700577000
Vereinigte Arabische Emirate,2010,6,667690000,42701000,710391000
Vereinigte Arabische Emirate,2010,7,684554000,39009000,723563000
Vereinigte Arabische Emirate,2010,8,618016000,41469000,659485000
Vereinigte Arabische Emirate,2010,9,756180000,52488000,808668000
Vereinigte Arabische Emirate,2010,10,569145000,49057000,618202000
Vereinigte Arabische Emirate,2010,11,992004000,47069000,1039073000
Vereinigte Arabische Emirate,2010,12,579374000,43668000,623042000
Vereinigte Arabische Emirate,2011,1,417495000,55088000,472583000
Vereinigte Arabische Emirate,2011,2,486109000,78105000,564214000
Vereinigte Arabische Emirate,2011,3,590640000,74227000,664867000
Vereinigte Arabische Emirate,2011,4,466876000,67495000,534371000
Vereinigte Arabische Emirate,2011,5,520822000,81736000,602558000
Vereinigte Arabische Emirate,2011,6,516497000,58065000,574562000
Vereinigte Arabische Emirate,2011,7,585832000,79923000,665755000
Vereinigte Arabische Emirate,2011,8,551539000,128357000,679896000
Vereinigte Arabische Emirate,2011,9,566686000,70308000,636994000
Vereinigte Arabische Emirate,2011,10,933039000,122005000,1055044000
Vereinigte Arabische Emirate,2011,11,749786000,153972000,903758000
Vereinigte Arabische Emirate,2011,12,1128564000,61588000,1190152000
Vereinigte Arabische Emirate,2012,1,502775000,51519000,554294000
Vereinigte Arabische Emirate,2012,2,775847000,67239000,843086000
Vereinigte Arabische Emirate,2012,3,674662000,75026000,749688000
Vereinigte Arabische Emirate,2012,4,743534000,80617000,824151000
Vereinigte Arabische Emirate,2012,5,588573000,79325000,667898000
Vereinigte Arabische Emirate,2012,6,662989000,58725000,721714000
Vereinigte Arabische Emirate,2012,7,662258000,52293000,714551000
Vereinigte Arabische Emirate,2012,8,955537000,57006000,1012543000
Vereinigte Arabische Emirate,2012,9,1020268000,65048000,1085316000
Vereinigte Arabische Emirate,2012,10,873643000,58016000,931659000
Vereinigte Arabische Emirate,2012,11,1072110000,85245000,1157355000
Vereinigte Arabische Emirate,2012,12,1241426000,48954000,1290380000
Vereinigte Arabische Emirate,2013,1,490960000,59415000,550375000
Vereinigte Arabische Emirate,2013,2,592282000,53165000,645447000
Vereinigte Arabische Emirate,2013,3,542326000,74014000,616340000
Vereinigte Arabische Emirate,2013,4,568263000,54831000,623094000
Vereinigte Arabische Emirate,2013,5,983484000,65496000,1048980000
Vereinigte Arabische Emirate,2013,6,948734000,60610000,1009344000
Vereinigte Arabische Emirate,2013,7,619790000,149706000,769496000
Vereinigte Arabische Emirate,2013,8,736126000,48627000,784753000
Vereinigte Arabische Emirate,2013,9,832048000,81289000,913337000
Vereinigte Arabische Emirate,2013,10,1099443000,51262000,1150705000
Vereinigte Arabische Emirate,2013,11,1192756000,50327000,1243083000
Vereinigte Arabische Emirate,2013,12,1293992000,50230000,1344222000
Vereinigte Arabische Emirate,2014,1,557099000,60141000,617240000
Vereinigte Arabische Emirate,2014,2,877840000,55976000,933816000
Vereinigte Arabische Emirate,2014,3,1131329000,64819000,1196148000
Vereinigte Arabische Emirate,2014,4,598862000,66222000,665084000
Vereinigte Arabische Emirate,2014,5,800625000,60143000,860768000
Vereinigte Arabische Emirate,2014,6,816220000,55867000,872087000
Vereinigte Arabische Emirate,2014,7,812467000,65333000,877800000
Vereinigte Arabische Emirate,2014,8,789696000,55498000,845194000
Vereinigte Arabische Emirate,2014,9,1203467000,70221000,1273688000
Vereinigte Arabische Emirate,2014,10,1378580000,75593000,1454173000
Vereinigte Arabische Emirate,2014,11,925589000,64896000,990485000
Vereinigte Arabische Emirate,2014,12,1472338000,53361000,1525699000
Vereinigte Arabische Emirate,2015,1,840713000,71767000,912480000
Vereinigte Arabische Emirate,2015,2,983944000,73508000,1057452000
Vereinigte Arabische Emirate,2015,3,795994000,86360000,882354000
Vereinigte Arabische Emirate,2015,4,1455401000,82445000,1537846000
Vereinigte Arabische Emirate,2015,5,1210893000,105074000,1315967000
Vereinigte Arabische Emirate,2015,6,1016557000,75797000,1092354000
Vereinigte Arabische Emirate,2015,7,1710606000,64584000,1775190000
Vereinigte Arabische Emirate,2015,8,1379627000,68642000,1448269000
Vereinigte Arabische Emirate,2015,9,1088944000,76385000,1165329000
Vereinigte Arabische Emirate,2015,10,1336413000,63504000,1399917000
Vereinigte Arabische Emirate,2015,11,1145278000,66901000,1212179000
Vereinigte Arabische Emirate,2015,12,1636201000,60203000,1696404000
Vereinigte Arabische Emirate,2016,1,920380000,72306000,992686000
Vereinigte Arabische Emirate,2016,2,970565000,71818000,1042383000
Vereinigte Arabische Emirate,2016,3,1241010000,81911000,1322921000
Vereinigte Arabische Emirate,2016,4,1468310000,67322000,1535632000
Vereinigte Arabische Emirate,2016,5,1413873000,76068000,1489941000
Vereinigte Arabische Emirate,2016,6,1198039000,94546000,1292585000
Vereinigte Arabische Emirate,2016,7,645761000,72957000,718718000
Vereinigte Arabische Emirate,2016,8,1576481000,64390000,1640871000
Vereinigte Arabische Emirate,2016,9,669828000,71630000,741458000
Vereinigte Arabische Emirate,2016,10,876002000,71587000,947589000
Vereinigte Arabische Emirate,2016,11,1255550000,78001000,1333551000
Vereinigte Arabische Emirate,2016,12,2223339000,66110000,2289449000
Vereinigte Arabische Emirate,2017,1,651650000,82195000,733845000
Vereinigte Arabische Emirate,2017,2,916377000,80638000,997015000
Vereinigte Arabische Emirate,2017,3,1384689000,107671000,1492360000
Vereinigte Arabische Emirate,2017,4,527996000,86162000,614158000
Vereinigte Arabische Emirate,2017,5,1287105000,98752000,1385857000
Vereinigte Arabische Emirate,2017,6,626003000,85207000,711210000
Vereinigte Arabische Emirate,2017,7,876985000,82288000,959273000
Vereinigte Arabische Emirate,2017,8,901523000,89742000,991265000
Vereinigte Arabische Emirate,2017,9,899746000,88697000,988443000
Vereinigte Arabische Emirate,2017,10,860903000,68285000,929188000
Vereinigte Arabische Emirate,2017,11,1248762000,95945000,1344707000
Vereinigte Arabische Emirate,2017,12,899437000,81521000,980958000
Vereinigte Arabische Emirate,2018,1,467157000,83847000,551004000
Vereinigte Arabische Emirate,2018,2,505581000,68496000,574077000
Vereinigte Arabische Emirate,2018,3,483810000,76430000,560240000
Vereinigte Arabische Emirate,2018,4,737306000,76834000,814140000
Vereinigte Arabische Emirate,2018,5,484627000,82468000,567095000
Vereinigte Arabische Emirate,2018,6,781853000,162284000,944137000
Vereinigte Arabische Emirate,2018,7,546049000,92098000,638147000
Vereinigte Arabische Emirate,2018,8,553309000,115045000,668354000
Vereinigte Arabische Emirate,2018,9,878918000,109038000,987956000
Vereinigte Arabische Emirate,2018,10,545998000,185587000,731585000
Vereinigte Arabische Emirate,2018,11,1190653000,88149000,1278802000
Vereinigte Arabische Emirate,2018,12,1125296000,79013000,1204309000
Vereinigte Arabische Emirate,2019,1,463863000,80445000,544308000
Vereinigte Arabische Emirate,2019,2,481515000,99425000,580940000
Vereinigte Arabische Emirate,2019,3,567520000,84751000,652271000
Vereinigte Arabische Emirate,2019,4,600546000,72532000,673078000
Vereinigte Arabische Emirate,2019,5,883538000,187553000,1071091000
Vereinigte Arabische Emirate,2019,6,855816000,75392000,931208000
Vereinigte Arabische Emirate,2019,7,972893000,81747000,1054640000
Vereinigte Arabische Emirate,2019,8,528004000,71827000,599831000
Vereinigte Arabische Emirate,2019,9,537892000,93197000,631089000
Vereinigte Arabische Emirate,2019,10,969709000,80207000,1049916000
Vereinigte Arabische Emirate,2019,11,653063000,71014000,724077000
Vereinigte Arabische Emirate,2019,12,1220552000,51620000,1272172000
Vereinigte Arabische Emirate,2020,1,534246000,84662000,618908000
Vereinigte Arabische Emirate,2020,2,560829000,74155000,634984000
Vereinigte Arabische Emirate,2020,3,626591000,71477000,698068000
Vereinigte Arabische Emirate,2020,4,384638000,57378000,442016000
Vereinigte Arabische Emirate,2020,5,347802000,37624000,385426000
Vereinigte Arabische Emirate,2020,6,419229000,54118000,473347000
Vereinigte Arabische Emirate,2020,7,457630000,46049000,503679000
Vereinigte Arabische Emirate,2020,8,520689000,37804000,558493000
Vereinigte Arabische Emirate,2020,9,498901000,38455000,537356000
Vereinigte Arabische Emirate,2020,10,535688000,43692000,579380000
Vereinigte Arabische Emirate,2020,11,506001000,45780000,551781000
Vereinigte Arabische Emirate,2020,12,1469369000,68213000,1537582000
Vereinigte Arabische Emirate,2021,1,377680000,108074000,485754000
Vereinigte Arabische Emirate,2021,2,436469000,63092000,499561000
Vereinigte Arabische Emirate,2021,3,567678000,64302000,631980000
Vereinigte Arabische Emirate,2021,4,527104000,71775000,598879000
Vereinigte Arabische Emirate,2021,5,679352000,72140000,751492000
Vereinigte Arabische Emirate,2021,6,702241000,73249000,775490000
Vereinigte Arabische Emirate,2021,7,449605000,62972000,512577000
Vereinigte Arabische Emirate,2021,8,525409000,64641000,590050000
Vereinigte Arabische Emirate,2021,9,512746000,67035000,579781000
Vereinigte Arabische Emirate,2021,10,732349000,72684000,805033000
Vereinigte Arabische Emirate,2021,11,560149000,74393000,634542000
Vereinigte Arabische Emirate,2021,12,1059601000,60958000,1120559000
Vereinigte Arabische Emirate,2022,1,493944000,103744000,597688000
Vereinigte Arabische Emirate,2022,2,571205000,99712000,670917000
Vereinigte Arabische Emirate,2022,3,582452000,122869000,705321000
Vereinigte Arabische Emirate,2022,4,503415000,131376000,634791000
Vereinigte Arabische Emirate,2022,5,542588000,130011000,672599000
Vereinigte Arabische Emirate,2022,6,579488000,131648000,711136000
Vereinigte Arabische Emirate,2022,7,619447000,117507000,736954000
Vereinigte Arabische Emirate,2022,8,650243000,111603000,761846000
Vereinigte Arabische Emirate,2022,9,847088000,315488000,1162576000
Vereinigte Arabische Emirate,2022,10,626571000,106556000,733127000
Vereinigte Arabische Emirate,2022,11,787665000,684406000,1472071000
Vereinigte Arabische Emirate,2022,12,792019000,164956000,956975000
Vereinigte Arabische Emirate,2023,1,690230000,570152000,1260382000
Vereinigte Arabische Emirate,2023,2,692840000,682649000,1375489000
Vereinigte Arabische Emirate,2023,3,775178000,860958000,1636136000
Vereinigte Arabische Emirate,2023,4,647679000,901796000,1549475000
Vereinigte Arabische Emirate,2023,5,674038000,816137000,1490175000
Vereinigte Arabische Emirate,2023,6,672503000,326113000,998616000
Vereinigte Arabische Emirate,2023,7,664796000,253441000,918237000
Vereinigte Arabische Emirate,2023,8,733715000,343873000,1077588000
Vereinigte Arabische Emirate,2023,9,692366000,215523000,907889000
Vereinigte Arabische Emirate,2023,10,816955000,337754000,1154709000
Vereinigte Arabische Emirate,2023,11,826691000,121278000,947969000
Vereinigte Arabische Emirate,2023,12,715268000,159496000,874764000
Vereinigte Arabische Emirate,2024,1,704386000,172158000,876544000
Vereinigte Arabische Emirate,2024,2,814595000,84132000,898727000
Vereinigte Arabische Emirate,2024,3,749491000,169177000,918668000
Vereinigte Arabische Emirate,2024,4,815530000,94030000,909560000
Vereinigte Arabische Emirate,2024,5,734227000,95314000,829541000
Vereinigte Arabische Emirate,2024,6,720535000,76188000,796723000
Vereinigte Arabische Emirate,2024,7,837387000,190990000,1028377000
Vereinigte Arabische Emirate,2024,8,783264000,169723000,952987000
Vereinigte Arabische Emirate,2024,9,828266000,254758000,1083024000
Vereinigte Arabische Emirate,2024,10,926506000,102912000,1029418000
Vereinigte Arabische Emirate,2024,11,979939000,245947000,1225886000
Vereinigte Arabische Emirate,2024,12,810772000,226920000,1037692000
Vereinigte Republik Tansania,2008,1,8827000,7621000,16448000
Vereinigte Republik Tansania,2008,2,12895000,6208000,19103000
Vereinigte Republik Tansania,2008,3,11910000,6519000,18429000
Vereinigte Republik Tansania,2008,4,11839000,9996000,21835000
Vereinigte Republik Tansania,2008,5,11277000,6777000,18054000
Vereinigte Republik Tansania,2008,6,7988000,6823000,14811000
Vereinigte Republik Tansania,2008,7,16332000,5421000,21753000
Vereinigte Republik Tansania,2008,8,13640000,4465000,18105000
Vereinigte Republik Tansania,2008,9,24691000,6171000,30862000
Vereinigte Republik Tansania,2008,10,9068000,3972000,13040000
Vereinigte Republik Tansania,2008,11,12721000,4126000,16847000
Vereinigte Republik Tansania,2008,12,13381000,3897000,17278000
Vereinigte Republik Tansania,2009,1,13168000,8779000,21947000
Vereinigte Republik Tansania,2009,2,17290000,8484000,25774000
Vereinigte Republik Tansania,2009,3,15669000,8255000,23924000
Vereinigte Republik Tansania,2009,4,21907000,6468000,28375000
Vereinigte Republik Tansania,2009,5,4819000,3269000,8088000
Vereinigte Republik Tansania,2009,6,7077000,5642000,12719000
Vereinigte Republik Tansania,2009,7,9492000,7324000,16816000
Vereinigte Republik Tansania,2009,8,16829000,5618000,22447000
Vereinigte Republik Tansania,2009,9,6714000,5191000,11905000
Vereinigte Republik Tansania,2009,10,9642000,4338000,13980000
Vereinigte Republik Tansania,2009,11,9597000,7495000,17092000
Vereinigte Republik Tansania,2009,12,8787000,4307000,13094000
Vereinigte Republik Tansania,2010,1,5148000,6428000,11576000
Vereinigte Republik Tansania,2010,2,7404000,7823000,15227000
Vereinigte Republik Tansania,2010,3,6855000,7128000,13983000
Vereinigte Republik Tansania,2010,4,9655000,4871000,14526000
Vereinigte Republik Tansania,2010,5,9555000,6319000,15874000
Vereinigte Republik Tansania,2010,6,13178000,7607000,20785000
Vereinigte Republik Tansania,2010,7,11410000,4881000,16291000
Vereinigte Republik Tansania,2010,8,10840000,4258000,15098000
Vereinigte Republik Tansania,2010,9,11002000,10940000,21942000
Vereinigte Republik Tansania,2010,10,9233000,9040000,18273000
Vereinigte Republik Tansania,2010,11,10490000,4297000,14787000
Vereinigte Republik Tansania,2010,12,9302000,7099000,16401000
Vereinigte Republik Tansania,2011,1,7790000,7967000,15757000
Vereinigte Republik Tansania,2011,2,8323000,13242000,21565000
Vereinigte Republik Tansania,2011,3,11580000,10307000,21887000
Vereinigte Republik Tansania,2011,4,9022000,6891000,15913000
Vereinigte Republik Tansania,2011,5,9739000,10813000,20552000
Vereinigte Republik Tansania,2011,6,12417000,14406000,26823000
Vereinigte Republik Tansania,2011,7,8878000,21815000,30693000
Vereinigte Republik Tansania,2011,8,14676000,8040000,22716000
Vereinigte Republik Tansania,2011,9,12429000,18579000,31008000
Vereinigte Republik Tansania,2011,10,6733000,14337000,21070000
Vereinigte Republik Tansania,2011,11,18314000,19535000,37849000
Vereinigte Republik Tansania,2011,12,13463000,15695000,29158000
Vereinigte Republik Tansania,2012,1,10114000,12342000,22456000
Vereinigte Republik Tansania,2012,2,17455000,7153000,24608000
Vereinigte Republik Tansania,2012,3,15451000,13844000,29295000
Vereinigte Republik Tansania,2012,4,10258000,18451000,28709000
Vereinigte Republik Tansania,2012,5,13010000,16304000,29314000
Vereinigte Republik Tansania,2012,6,32583000,8016000,40599000
Vereinigte Republik Tansania,2012,7,11981000,17911000,29892000
Vereinigte Republik Tansania,2012,8,15162000,14914000,30076000
Vereinigte Republik Tansania,2012,9,10315000,7756000,18071000
Vereinigte Republik Tansania,2012,10,11826000,5404000,17230000
Vereinigte Republik Tansania,2012,11,14988000,11102000,26090000
Vereinigte Republik Tansania,2012,12,11181000,5903000,17084000
Vereinigte Republik Tansania,2013,1,14339000,15816000,30155000
Vereinigte Republik Tansania,2013,2,10107000,19847000,29954000
Vereinigte Republik Tansania,2013,3,9479000,6637000,16116000
Vereinigte Republik Tansania,2013,4,10258000,17963000,28221000
Vereinigte Republik Tansania,2013,5,12747000,11380000,24127000
Vereinigte Republik Tansania,2013,6,13099000,5641000,18740000
Vereinigte Republik Tansania,2013,7,21621000,11375000,32996000
Vereinigte Republik Tansania,2013,8,11909000,5905000,17814000
Vereinigte Republik Tansania,2013,9,8835000,8079000,16914000
Vereinigte Republik Tansania,2013,10,13155000,9450000,22605000
Vereinigte Republik Tansania,2013,11,9321000,12262000,21583000
Vereinigte Republik Tansania,2013,12,8970000,6176000,15146000
Vereinigte Republik Tansania,2014,1,7800000,19992000,27792000
Vereinigte Republik Tansania,2014,2,13641000,16671000,30312000
Vereinigte Republik Tansania,2014,3,21611000,8622000,30233000
Vereinigte Republik Tansania,2014,4,13144000,9732000,22876000
Vereinigte Republik Tansania,2014,5,7481000,7874000,15355000
Vereinigte Republik Tansania,2014,6,14909000,6879000,21788000
Vereinigte Republik Tansania,2014,7,15691000,14484000,30175000
Vereinigte Republik Tansania,2014,8,16985000,13250000,30235000
Vereinigte Republik Tansania,2014,9,23237000,15744000,38981000
Vereinigte Republik Tansania,2014,10,18162000,21112000,39274000
Vereinigte Republik Tansania,2014,11,6311000,11952000,18263000
Vereinigte Republik Tansania,2014,12,12242000,16450000,28692000
Vereinigte Republik Tansania,2015,1,6398000,13963000,20361000
Vereinigte Republik Tansania,2015,2,8996000,12394000,21390000
Vereinigte Republik Tansania,2015,3,9605000,16512000,26117000
Vereinigte Republik Tansania,2015,4,9122000,20444000,29566000
Vereinigte Republik Tansania,2015,5,9143000,8638000,17781000
Vereinigte Republik Tansania,2015,6,8733000,11048000,19781000
Vereinigte Republik Tansania,2015,7,9181000,17691000,26872000
Vereinigte Republik Tansania,2015,8,9413000,10553000,19966000
Vereinigte Republik Tansania,2015,9,21390000,14324000,35714000
Vereinigte Republik Tansania,2015,10,10375000,15432000,25807000
Vereinigte Republik Tansania,2015,11,7972000,12302000,20274000
Vereinigte Republik Tansania,2015,12,9266000,14018000,23284000
Vereinigte Republik Tansania,2016,1,7454000,12138000,19592000
Vereinigte Republik Tansania,2016,2,8864000,8428000,17292000
Vereinigte Republik Tansania,2016,3,19164000,14609000,33773000
Vereinigte Republik Tansania,2016,4,11691000,7445000,19136000
Vereinigte Republik Tansania,2016,5,12682000,9940000,22622000
Vereinigte Republik Tansania,2016,6,17530000,15415000,32945000
Vereinigte Republik Tansania,2016,7,9427000,14837000,24264000
Vereinigte Republik Tansania,2016,8,9664000,9427000,19091000
Vereinigte Republik Tansania,2016,9,9408000,22618000,32026000
Vereinigte Republik Tansania,2016,10,10417000,15975000,26392000
Vereinigte Republik Tansania,2016,11,8793000,19109000,27902000
Vereinigte Republik Tansania,2016,12,11596000,18842000,30438000
Vereinigte Republik Tansania,2017,1,8161000,11031000,19192000
Vereinigte Republik Tansania,2017,2,18609000,5230000,23839000
Vereinigte Republik Tansania,2017,3,15404000,24957000,40361000
Vereinigte Republik Tansania,2017,4,18108000,10600000,28708000
Vereinigte Republik Tansania,2017,5,13716000,9281000,22997000
Vereinigte Republik Tansania,2017,6,13421000,18744000,32165000
Vereinigte Republik Tansania,2017,7,8105000,5063000,13168000
Vereinigte Republik Tansania,2017,8,12003000,6507000,18510000
Vereinigte Republik Tansania,2017,9,21487000,6737000,28224000
Vereinigte Republik Tansania,2017,10,7788000,7700000,15488000
Vereinigte Republik Tansania,2017,11,13004000,7951000,20955000
Vereinigte Republik Tansania,2017,12,7656000,4915000,12571000
Vereinigte Republik Tansania,2018,1,13406000,6243000,19649000
Vereinigte Republik Tansania,2018,2,13589000,4639000,18228000
Vereinigte Republik Tansania,2018,3,16450000,6769000,23219000
Vereinigte Republik Tansania,2018,4,8861000,5375000,14236000
Vereinigte Republik Tansania,2018,5,8022000,4837000,12859000
Vereinigte Republik Tansania,2018,6,8530000,3158000,11688000
Vereinigte Republik Tansania,2018,7,19001000,12554000,31555000
Vereinigte Republik Tansania,2018,8,13464000,6990000,20454000
Vereinigte Republik Tansania,2018,9,13512000,4194000,17706000
Vereinigte Republik Tansania,2018,10,10799000,2871000,13670000
Vereinigte Republik Tansania,2018,11,11347000,5673000,17020000
Vereinigte Republik Tansania,2018,12,12450000,6374000,18824000
Vereinigte Republik Tansania,2019,1,10528000,11494000,22022000
Vereinigte Republik Tansania,2019,2,17788000,10020000,27808000
Vereinigte Republik Tansania,2019,3,15641000,8566000,24207000
Vereinigte Republik Tansania,2019,4,17685000,7537000,25222000
Vereinigte Republik Tansania,2019,5,15967000,8403000,24370000
Vereinigte Republik Tansania,2019,6,15713000,6363000,22076000
Vereinigte Republik Tansania,2019,7,15279000,4635000,19914000
Vereinigte Republik Tansania,2019,8,11019000,3848000,14867000
Vereinigte Republik Tansania,2019,9,14519000,2521000,17040000
Vereinigte Republik Tansania,2019,10,12808000,2895000,15703000
Vereinigte Republik Tansania,2019,11,13287000,6366000,19653000
Vereinigte Republik Tansania,2019,12,14261000,8742000,23003000
Vereinigte Republik Tansania,2020,1,10803000,4654000,15457000
Vereinigte Republik Tansania,2020,2,19397000,3403000,22800000
Vereinigte Republik Tansania,2020,3,18720000,7115000,25835000
Vereinigte Republik Tansania,2020,4,13237000,8841000,22078000
Vereinigte Republik Tansania,2020,5,9717000,4480000,14197000
Vereinigte Republik Tansania,2020,6,13064000,3592000,16656000
Vereinigte Republik Tansania,2020,7,10383000,3733000,14116000
Vereinigte Republik Tansania,2020,8,13495000,3662000,17157000
Vereinigte Republik Tansania,2020,9,11018000,8850000,19868000
Vereinigte Republik Tansania,2020,10,12348000,5664000,18012000
Vereinigte Republik Tansania,2020,11,16814000,9530000,26344000
Vereinigte Republik Tansania,2020,12,8947000,6592000,15539000
Vereinigte Republik Tansania,2021,1,5945000,7012000,12957000
Vereinigte Republik Tansania,2021,2,15778000,7002000,22780000
Vereinigte Republik Tansania,2021,3,9208000,14814000,24022000
Vereinigte Republik Tansania,2021,4,9034000,8892000,17926000
Vereinigte Republik Tansania,2021,5,11230000,7562000,18792000
Vereinigte Republik Tansania,2021,6,10204000,12978000,23182000
Vereinigte Republik Tansania,2021,7,11867000,4643000,16510000
Vereinigte Republik Tansania,2021,8,14255000,3658000,17913000
Vereinigte Republik Tansania,2021,9,13248000,3906000,17154000
Vereinigte Republik Tansania,2021,10,13548000,4636000,18184000
Vereinigte Republik Tansania,2021,11,14875000,6885000,21760000
Vereinigte Republik Tansania,2021,12,11846000,13632000,25478000
Vereinigte Republik Tansania,2022,1,10575000,21226000,31801000
Vereinigte Republik Tansania,2022,2,9653000,7704000,17357000
Vereinigte Republik Tansania,2022,3,17206000,22723000,39929000
Vereinigte Republik Tansania,2022,4,16335000,15542000,31877000
Vereinigte Republik Tansania,2022,5,12330000,14040000,26370000
Vereinigte Republik Tansania,2022,6,35475000,9189000,44664000
Vereinigte Republik Tansania,2022,7,18223000,11892000,30115000
Vereinigte Republik Tansania,2022,8,19236000,9566000,28802000
Vereinigte Republik Tansania,2022,9,20261000,15705000,35966000
Vereinigte Republik Tansania,2022,10,19355000,13726000,33081000
Vereinigte Republik Tansania,2022,11,10814000,5540000,16354000
Vereinigte Republik Tansania,2022,12,16276000,12573000,28849000
Vereinigte Republik Tansania,2023,1,13978000,7839000,21817000
Vereinigte Republik Tansania,2023,2,15282000,22424000,37706000
Vereinigte Republik Tansania,2023,3,13005000,24533000,37538000
Vereinigte Republik Tansania,2023,4,13824000,15536000,29360000
Vereinigte Republik Tansania,2023,5,17563000,15162000,32725000
Vereinigte Republik Tansania,2023,6,15098000,18246000,33344000
Vereinigte Republik Tansania,2023,7,11975000,21759000,33734000
Vereinigte Republik Tansania,2023,8,13512000,19183000,32695000
Vereinigte Republik Tansania,2023,9,12265000,8560000,20825000
Vereinigte Republik Tansania,2023,10,15973000,11087000,27060000
Vereinigte Republik Tansania,2023,11,22037000,10743000,32780000
Vereinigte Republik Tansania,2023,12,19623000,6972000,26595000
Vereinigte Republik Tansania,2024,1,12553000,12120000,24673000
Vereinigte Republik Tansania,2024,2,27278000,14828000,42106000
Vereinigte Republik Tansania,2024,3,16658000,14146000,30804000
Vereinigte Republik Tansania,2024,4,9882000,14083000,23965000
Vereinigte Republik Tansania,2024,5,13254000,12940000,26194000
Vereinigte Republik Tansania,2024,6,22633000,12762000,35395000
Vereinigte Republik Tansania,2024,7,35922000,11016000,46938000
Vereinigte Republik Tansania,2024,8,24390000,7069000,31459000
Vereinigte Republik Tansania,2024,9,18088000,8498000,26586000
Vereinigte Republik Tansania,2024,10,33358000,9318000,42676000
Vereinigte Republik Tansania,2024,11,30916000,11006000,41922000
Vereinigte Republik Tansania,2024,12,23336000,25850000,49186000
Vereinigte Staaten von Amerika,2008,1,6306142000,3644939000,9951081000
Vereinigte Staaten von Amerika,2008,2,6439082000,3699967000,10139049000
Vereinigte Staaten von Amerika,2008,3,5974032000,3732011000,9706043000
Vereinigte Staaten von Amerika,2008,4,6216426000,4185542000,10401968000
Vereinigte Staaten von Amerika,2008,5,5196516000,3648760000,8845276000
Vereinigte Staaten von Amerika,2008,6,6663215000,3957978000,10621193000
Vereinigte Staaten von Amerika,2008,7,5895525000,4102410000,9997935000
Vereinigte Staaten von Amerika,2008,8,5475762000,3578795000,9054557000
Vereinigte Staaten von Amerika,2008,9,6329913000,3888896000,10218809000
Vereinigte Staaten von Amerika,2008,10,6309928000,3873429000,10183357000
Vereinigte Staaten von Amerika,2008,11,5813389000,3986970000,9800359000
Vereinigte Staaten von Amerika,2008,12,4808275000,4163831000,8972106000
Vereinigte Staaten von Amerika,2009,1,4328018000,3470883000,7798901000
Vereinigte Staaten von Amerika,2009,2,4636286000,3583035000,8219321000
Vereinigte Staaten von Amerika,2009,3,4858796000,4068831000,8927627000
Vereinigte Staaten von Amerika,2009,4,4673230000,3287860000,7961090000
Vereinigte Staaten von Amerika,2009,5,3891972000,3175978000,7067950000
Vereinigte Staaten von Amerika,2009,6,4933731000,2970627000,7904358000
Vereinigte Staaten von Amerika,2009,7,4974121000,3145876000,8119997000
Vereinigte Staaten von Amerika,2009,8,3603419000,2823442000,6426861000
Vereinigte Staaten von Amerika,2009,9,4344541000,3061023000,7405564000
Vereinigte Staaten von Amerika,2009,10,4641955000,3138106000,7780061000
Vereinigte Staaten von Amerika,2009,11,5199434000,3319208000,8518642000
Vereinigte Staaten von Amerika,2009,12,4270853000,3237644000,7508497000
Vereinigte Staaten von Amerika,2010,1,3761359000,3320430000,7081789000
Vereinigte Staaten von Amerika,2010,2,4478529000,2897805000,7376334000
Vereinigte Staaten von Amerika,2010,3,6397864000,3968595000,10366459000
Vereinigte Staaten von Amerika,2010,4,5145024000,3508519000,8653543000
Vereinigte Staaten von Amerika,2010,5,5191927000,3502742000,8694669000
Vereinigte Staaten von Amerika,2010,6,5867007000,4183928000,10050935000
Vereinigte Staaten von Amerika,2010,7,5974487000,4037928000,10012415000
Vereinigte Staaten von Amerika,2010,8,5088498000,3893479000,8981977000
Vereinigte Staaten von Amerika,2010,9,6031455000,3921285000,9952740000
Vereinigte Staaten von Amerika,2010,10,5856359000,3843105000,9699464000
Vereinigte Staaten von Amerika,2010,11,6474163000,4311114000,10785277000
Vereinigte Staaten von Amerika,2010,12,5307489000,3852150000,9159639000
Vereinigte Staaten von Amerika,2011,1,5225327000,3878855000,9104182000
Vereinigte Staaten von Amerika,2011,2,5871940000,4020513000,9892453000
Vereinigte Staaten von Amerika,2011,3,6528394000,4261860000,10790254000
Vereinigte Staaten von Amerika,2011,4,5487147000,3912054000,9399201000
Vereinigte Staaten von Amerika,2011,5,6217305000,4570058000,10787363000
Vereinigte Staaten von Amerika,2011,6,5952290000,3776751000,9729041000
Vereinigte Staaten von Amerika,2011,7,6165821000,3673426000,9839247000
Vereinigte Staaten von Amerika,2011,8,6081070000,3983159000,10064229000
Vereinigte Staaten von Amerika,2011,9,6507818000,3770246000,10278064000
Vereinigte Staaten von Amerika,2011,10,6521324000,4286148000,10807472000
Vereinigte Staaten von Amerika,2011,11,6764498000,4202912000,10967410000
Vereinigte Staaten von Amerika,2011,12,6452696000,4195477000,10648173000
Vereinigte Staaten von Amerika,2012,1,7064424000,3804319000,10868743000
Vereinigte Staaten von Amerika,2012,2,6922558000,4145202000,11067760000
Vereinigte Staaten von Amerika,2012,3,7398196000,4565166000,11963362000
Vereinigte Staaten von Amerika,2012,4,6493479000,4284297000,10777776000
Vereinigte Staaten von Amerika,2012,5,6804667000,4349618000,11154285000
Vereinigte Staaten von Amerika,2012,6,7042676000,4526599000,11569275000
Vereinigte Staaten von Amerika,2012,7,8000937000,4380450000,12381387000
Vereinigte Staaten von Amerika,2012,8,7676441000,4373192000,12049633000
Vereinigte Staaten von Amerika,2012,9,7999129000,4072439000,12071568000
Vereinigte Staaten von Amerika,2012,10,8067972000,4707127000,12775099000
Vereinigte Staaten von Amerika,2012,11,7569868000,4233657000,11803525000
Vereinigte Staaten von Amerika,2012,12,5931005000,3628371000,9559376000
Vereinigte Staaten von Amerika,2013,1,6890470000,4193105000,11083575000
Vereinigte Staaten von Amerika,2013,2,6911185000,3649040000,10560225000
Vereinigte Staaten von Amerika,2013,3,7953862000,4409486000,12363348000
Vereinigte Staaten von Amerika,2013,4,7678834000,4019182000,11698016000
Vereinigte Staaten von Amerika,2013,5,6830597000,4353724000,11184321000
Vereinigte Staaten von Amerika,2013,6,6992595000,3975933000,10968528000
Vereinigte Staaten von Amerika,2013,7,7530341000,4070148000,11600489000
Vereinigte Staaten von Amerika,2013,8,7265648000,3937806000,11203454000
Vereinigte Staaten von Amerika,2013,9,7929566000,3928118000,11857684000
Vereinigte Staaten von Amerika,2013,10,8406761000,4336846000,12743607000
Vereinigte Staaten von Amerika,2013,11,8547336000,4204751000,12752087000
Vereinigte Staaten von Amerika,2013,12,6410637000,3503799000,9914436000
Vereinigte Staaten von Amerika,2014,1,7202766000,3771662000,10974428000
Vereinigte Staaten von Amerika,2014,2,7607660000,4159990000,11767650000
Vereinigte Staaten von Amerika,2014,3,7848315000,4320532000,12168847000
Vereinigte Staaten von Amerika,2014,4,7663869000,4527062000,12190931000
Vereinigte Staaten von Amerika,2014,5,7532463000,4097187000,11629650000
Vereinigte Staaten von Amerika,2014,6,7271514000,4298794000,11570308000
Vereinigte Staaten von Amerika,2014,7,8754863000,3784562000,12539425000
Vereinigte Staaten von Amerika,2014,8,7160512000,4145788000,11306300000
Vereinigte Staaten von Amerika,2014,9,9639863000,3965525000,13605388000
Vereinigte Staaten von Amerika,2014,10,9014424000,4334084000,13348508000
Vereinigte Staaten von Amerika,2014,11,8284167000,3824406000,12108573000
Vereinigte Staaten von Amerika,2014,12,7947358000,3976947000,11924305000
Vereinigte Staaten von Amerika,2015,1,7727737000,4362320000,12090057000
Vereinigte Staaten von Amerika,2015,2,8793968000,4877981000,13671949000
Vereinigte Staaten von Amerika,2015,3,10704405000,5603783000,16308188000
Vereinigte Staaten von Amerika,2015,4,9811715000,5492378000,15304093000
Vereinigte Staaten von Amerika,2015,5,8607970000,4501885000,13109855000
Vereinigte Staaten von Amerika,2015,6,9905639000,5127957000,15033596000
Vereinigte Staaten von Amerika,2015,7,10505409000,5156783000,15662192000
Vereinigte Staaten von Amerika,2015,8,8513507000,4535894000,13049401000
Vereinigte Staaten von Amerika,2015,9,10679489000,5022566000,15702055000
Vereinigte Staaten von Amerika,2015,10,10194667000,5332798000,15527465000
Vereinigte Staaten von Amerika,2015,11,9502430000,5233397000,14735827000
Vereinigte Staaten von Amerika,2015,12,8786509000,4969636000,13756145000
Vereinigte Staaten von Amerika,2016,1,7427917000,4529391000,11957308000
Vereinigte Staaten von Amerika,2016,2,8913703000,4852591000,13766294000
Vereinigte Staaten von Amerika,2016,3,10528298000,5290544000,15818842000
Vereinigte Staaten von Amerika,2016,4,9055915000,4821726000,13877641000
Vereinigte Staaten von Amerika,2016,5,7850424000,4762781000,12613205000
Vereinigte Staaten von Amerika,2016,6,9495054000,4701479000,14196533000
Vereinigte Staaten von Amerika,2016,7,8811786000,4732386000,13544172000
Vereinigte Staaten von Amerika,2016,8,8497820000,4894452000,13392272000
Vereinigte Staaten von Amerika,2016,9,9078781000,4730664000,13809445000
Vereinigte Staaten von Amerika,2016,10,8771570000,4645516000,13417086000
Vereinigte Staaten von Amerika,2016,11,9762259000,5292210000,15054469000
Vereinigte Staaten von Amerika,2016,12,8628948000,4714213000,13343161000
Vereinigte Staaten von Amerika,2017,1,8942448000,4974724000,13917172000
Vereinigte Staaten von Amerika,2017,2,9124930000,4686160000,13811090000
Vereinigte Staaten von Amerika,2017,3,11251517000,6126003000,17377520000
Vereinigte Staaten von Amerika,2017,4,8246877000,4973271000,13220148000
Vereinigte Staaten von Amerika,2017,5,9492962000,5489783000,14982745000
Vereinigte Staaten von Amerika,2017,6,8803594000,5274091000,14077685000
Vereinigte Staaten von Amerika,2017,7,9162595000,4737849000,13900444000
Vereinigte Staaten von Amerika,2017,8,8995066000,5103033000,14098099000
Vereinigte Staaten von Amerika,2017,9,9193520000,4984415000,14177935000
Vereinigte Staaten von Amerika,2017,10,9174464000,5198943000,14373407000
Vereinigte Staaten von Amerika,2017,11,10346876000,5480640000,15827516000
Vereinigte Staaten von Amerika,2017,12,9070330000,4873252000,13943582000
Vereinigte Staaten von Amerika,2018,1,8562594000,5096123000,13658717000
Vereinigte Staaten von Amerika,2018,2,8657029000,5169427000,13826456000
Vereinigte Staaten von Amerika,2018,3,10900815000,5294258000,16195073000
Vereinigte Staaten von Amerika,2018,4,9323986000,5602382000,14926368000
Vereinigte Staaten von Amerika,2018,5,8496470000,5536750000,14033220000
Vereinigte Staaten von Amerika,2018,6,9933732000,5276456000,15210188000
Vereinigte Staaten von Amerika,2018,7,10086075000,5479958000,15566033000
Vereinigte Staaten von Amerika,2018,8,9421221000,5330258000,14751479000
Vereinigte Staaten von Amerika,2018,9,9262319000,5423162000,14685481000
Vereinigte Staaten von Amerika,2018,10,10057388000,5853063000,15910451000
Vereinigte Staaten von Amerika,2018,11,10162694000,5686809000,15849503000
Vereinigte Staaten von Amerika,2018,12,8476256000,4744624000,13220880000
Vereinigte Staaten von Amerika,2019,1,9479262000,5780036000,15259298000
Vereinigte Staaten von Amerika,2019,2,9066707000,5942650000,15009357000
Vereinigte Staaten von Amerika,2019,3,10615842000,5948774000,16564616000
Vereinigte Staaten von Amerika,2019,4,9784022000,5773292000,15557314000
Vereinigte Staaten von Amerika,2019,5,10194873000,6074463000,16269336000
Vereinigte Staaten von Amerika,2019,6,9237204000,5380270000,14617474000
Vereinigte Staaten von Amerika,2019,7,11257724000,6082762000,17340486000
Vereinigte Staaten von Amerika,2019,8,9742504000,5723826000,15466330000
Vereinigte Staaten von Amerika,2019,9,9911275000,6053507000,15964782000
Vereinigte Staaten von Amerika,2019,10,11069671000,7150193000,18219864000
Vereinigte Staaten von Amerika,2019,11,9873647000,5912609000,15786256000
Vereinigte Staaten von Amerika,2019,12,8447406000,5511740000,13959146000
Vereinigte Staaten von Amerika,2020,1,9021741000,6127577000,15149318000
Vereinigte Staaten von Amerika,2020,2,9532309000,5861501000,15393810000
Vereinigte Staaten von Amerika,2020,3,10225530000,6525809000,16751339000
Vereinigte Staaten von Amerika,2020,4,6289004000,6057109000,12346113000
Vereinigte Staaten von Amerika,2020,5,6464527000,4425322000,10889849000
Vereinigte Staaten von Amerika,2020,6,7292050000,4438073000,11730123000
Vereinigte Staaten von Amerika,2020,7,9223675000,5234340000,14458015000
Vereinigte Staaten von Amerika,2020,8,7608842000,5599468000,13208310000
Vereinigte Staaten von Amerika,2020,9,9251524000,6210604000,15462128000
Vereinigte Staaten von Amerika,2020,10,9847267000,5777445000,15624712000
Vereinigte Staaten von Amerika,2020,11,9573904000,5829647000,15403551000
Vereinigte Staaten von Amerika,2020,12,9145655000,5607263000,14752918000
Vereinigte Staaten von Amerika,2021,1,8449113000,4758835000,13207948000
Vereinigte Staaten von Amerika,2021,2,9482008000,5124264000,14606272000
Vereinigte Staaten von Amerika,2021,3,11150883000,6700009000,17850892000
Vereinigte Staaten von Amerika,2021,4,10062330000,6146836000,16209166000
Vereinigte Staaten von Amerika,2021,5,9079248000,5860349000,14939597000
Vereinigte Staaten von Amerika,2021,6,10243931000,6828816000,17072747000
Vereinigte Staaten von Amerika,2021,7,10834764000,5480963000,16315727000
Vereinigte Staaten von Amerika,2021,8,9396476000,6296641000,15693117000
Vereinigte Staaten von Amerika,2021,9,10710266000,6326469000,17036735000
Vereinigte Staaten von Amerika,2021,10,10890361000,6070417000,16960778000
Vereinigte Staaten von Amerika,2021,11,10997812000,6354730000,17352542000
Vereinigte Staaten von Amerika,2021,12,10682470000,6367175000,17049645000
Vereinigte Staaten von Amerika,2022,1,9962358000,6430011000,16392369000
Vereinigte Staaten von Amerika,2022,2,10940742000,6127255000,17067997000
Vereinigte Staaten von Amerika,2022,3,13817680000,7699239000,21516919000
Vereinigte Staaten von Amerika,2022,4,11910880000,6847208000,18758088000
Vereinigte Staaten von Amerika,2022,5,13444620000,7970150000,21414770000
Vereinigte Staaten von Amerika,2022,6,14329124000,8531656000,22860780000
Vereinigte Staaten von Amerika,2022,7,12397067000,7990708000,20387775000
Vereinigte Staaten von Amerika,2022,8,13326932000,8374208000,21701140000
Vereinigte Staaten von Amerika,2022,9,15328661000,8414547000,23743208000
Vereinigte Staaten von Amerika,2022,10,13952492000,8359499000,22311991000
Vereinigte Staaten von Amerika,2022,11,14394750000,8788749000,23183499000
Vereinigte Staaten von Amerika,2022,12,12402945000,7812302000,20215247000
Vereinigte Staaten von Amerika,2023,1,12100365000,8418127000,20518492000
Vereinigte Staaten von Amerika,2023,2,13123955000,7422102000,20546057000
Vereinigte Staaten von Amerika,2023,3,14606264000,8931763000,23538027000
Vereinigte Staaten von Amerika,2023,4,11948206000,7684780000,19632986000
Vereinigte Staaten von Amerika,2023,5,12488484000,7490473000,19978957000
Vereinigte Staaten von Amerika,2023,6,13866287000,7741547000,21607834000
Vereinigte Staaten von Amerika,2023,7,13608095000,7444454000,21052549000
Vereinigte Staaten von Amerika,2023,8,13068021000,7989283000,21057304000
Vereinigte Staaten von Amerika,2023,9,13216072000,7498414000,20714486000
Vereinigte Staaten von Amerika,2023,10,14335875000,7973359000,22309234000
Vereinigte Staaten von Amerika,2023,11,14184256000,8317150000,22501406000
Vereinigte Staaten von Amerika,2023,12,11383978000,7722733000,19106711000
Vereinigte Staaten von Amerika,2024,1,11934147000,7935229000,19869376000
Vereinigte Staaten von Amerika,2024,2,13826026000,7245774000,21071800000
Vereinigte Staaten von Amerika,2024,3,14368072000,7886765000,22254837000
Vereinigte Staaten von Amerika,2024,4,14369070000,8067547000,22436617000
Vereinigte Staaten von Amerika,2024,5,13267252000,7698311000,20965563000
Vereinigte Staaten von Amerika,2024,6,12979476000,7056143000,20035619000
Vereinigte Staaten von Amerika,2024,7,14179539000,8065986000,22245525000
Vereinigte Staaten von Amerika,2024,8,12656827000,7875844000,20532671000
Vereinigte Staaten von Amerika,2024,9,14609720000,7573312000,22183032000
Vereinigte Staaten von Amerika,2024,10,13352299000,7807669000,21159968000
Vereinigte Staaten von Amerika,2024,11,14326513000,7308069000,21634582000
Vereinigte Staaten von Amerika,2024,12,11535843000,6861900000,18397743000
Vereinigtes Königreich,2008,1,5687812000,3400169000,9087981000
Vereinigtes Königreich,2008,2,5732813000,3391871000,9124684000
Vereinigtes Königreich,2008,3,5615625000,3316199000,8931824000
Vereinigtes Königreich,2008,4,5750284000,3790344000,9540628000
Vereinigtes Königreich,2008,5,5021434000,3271177000,8292611000
Vereinigtes Königreich,2008,6,5789047000,3789430000,9578477000
Vereinigtes Königreich,2008,7,6068546000,3462320000,9530866000
Vereinigtes Königreich,2008,8,4947936000,3408848000,8356784000
Vereinigtes Königreich,2008,9,5687254000,3522638000,9209892000
Vereinigtes Königreich,2008,10,5564276000,3745717000,9309993000
Vereinigtes Königreich,2008,11,4516578000,3427096000,7943674000
Vereinigtes Königreich,2008,12,3793822000,3120213000,6914035000
Vereinigtes Königreich,2009,1,4150360000,2472125000,6622485000
Vereinigtes Königreich,2009,2,4058198000,2568479000,6626677000
Vereinigtes Königreich,2009,3,4616833000,2777498000,7394331000
Vereinigtes Königreich,2009,4,4147000000,2502346000,6649346000
Vereinigtes Königreich,2009,5,3991933000,2698809000,6690742000
Vereinigtes Königreich,2009,6,4436747000,2819508000,7256255000
Vereinigtes Königreich,2009,7,4987426000,2815635000,7803061000
Vereinigtes Königreich,2009,8,4109641000,2552621000,6662262000
Vereinigtes Königreich,2009,9,5070691000,2969534000,8040225000
Vereinigtes Königreich,2009,10,4908919000,3081630000,7990549000
Vereinigtes Königreich,2009,11,4498504000,2488463000,6986967000
Vereinigtes Königreich,2009,12,4263631000,2705744000,6969375000
Vereinigtes Königreich,2010,1,4323985000,2647541000,6971526000
Vereinigtes Königreich,2010,2,4534550000,2891571000,7426121000
Vereinigtes Königreich,2010,3,5319928000,3248145000,8568073000
Vereinigtes Königreich,2010,4,4504684000,2796987000,7301671000
Vereinigtes Königreich,2010,5,4492833000,3071908000,7564741000
Vereinigtes Königreich,2010,6,5175581000,3129699000,8305280000
Vereinigtes Königreich,2010,7,5026479000,3094985000,8121464000
Vereinigtes Königreich,2010,8,4741346000,3130769000,7872115000
Vereinigtes Königreich,2010,9,5488621000,3361052000,8849673000
Vereinigtes Königreich,2010,10,5357587000,3479686000,8837273000
Vereinigtes Königreich,2010,11,5171954000,3645306000,8817260000
Vereinigtes Königreich,2010,12,4528298000,3425085000,7953383000
Vereinigtes Königreich,2011,1,5125257000,3298305000,8423562000
Vereinigtes Königreich,2011,2,5406267000,3441347000,8847614000
Vereinigtes Königreich,2011,3,6309448000,4020553000,10330001000
Vereinigtes Königreich,2011,4,5056304000,3633294000,8689598000
Vereinigtes Königreich,2011,5,5529519000,3602638000,9132157000
Vereinigtes Königreich,2011,6,5212781000,3461936000,8674717000
Vereinigtes Königreich,2011,7,5405250000,3849075000,9254325000
Vereinigtes Königreich,2011,8,5228002000,3544929000,8772931000
Vereinigtes Königreich,2011,9,5854551000,4214720000,10069271000
Vereinigtes Königreich,2011,10,5621217000,4214287000,9835504000
Vereinigtes Königreich,2011,11,5790614000,3932414000,9723028000
Vereinigtes Königreich,2011,12,5030436000,3527224000,8557660000
Vereinigtes Königreich,2012,1,5710012000,3368904000,9078916000
Vereinigtes Königreich,2012,2,6079744000,3409712000,9489456000
Vereinigtes Königreich,2012,3,6183799000,3794612000,9978411000
Vereinigtes Königreich,2012,4,5782516000,3418118000,9200634000
Vereinigtes Königreich,2012,5,5993298000,3486572000,9479870000
Vereinigtes Königreich,2012,6,5798750000,3289073000,9087823000
Vereinigtes Königreich,2012,7,6271053000,3754674000,10025727000
Vereinigtes Königreich,2012,8,6212384000,2950454000,9162838000
Vereinigtes Königreich,2012,9,5995055000,3474814000,9469869000
Vereinigtes Königreich,2012,10,6029113000,3382784000,9411897000
Vereinigtes Königreich,2012,11,5884946000,3936452000,9821398000
Vereinigtes Königreich,2012,12,4906567000,3202463000,8109030000
Vereinigtes Königreich,2013,1,5961835000,3581959000,9543794000
Vereinigtes Königreich,2013,2,6013454000,3390634000,9404088000
Vereinigtes Königreich,2013,3,5880238000,3435524000,9315762000
Vereinigtes Königreich,2013,4,5901485000,3360723000,9262208000
Vereinigtes Königreich,2013,5,5555534000,3342477000,8898011000
Vereinigtes Königreich,2013,6,6000520000,3034621000,9035141000
Vereinigtes Königreich,2013,7,6382930000,3067859000,9450789000
Vereinigtes Königreich,2013,8,5508960000,3167649000,8676609000
Vereinigtes Königreich,2013,9,6223819000,3133694000,9357513000
Vereinigtes Königreich,2013,10,6459134000,3448128000,9907262000
Vereinigtes Königreich,2013,11,5996318000,3367321000,9363639000
Vereinigtes Königreich,2013,12,5396059000,3134998000,8531057000
Vereinigtes Königreich,2014,1,6333486000,2778475000,9111961000
Vereinigtes Königreich,2014,2,6774439000,3476777000,10251216000
Vereinigtes Königreich,2014,3,6591798000,3701765000,10293563000
Vereinigtes Königreich,2014,4,6284794000,3198806000,9483600000
Vereinigtes Königreich,2014,5,6422869000,3355834000,9778703000
Vereinigtes Königreich,2014,6,6340646000,3205640000,9546286000
Vereinigtes Königreich,2014,7,7383211000,3081754000,10464965000
Vereinigtes Königreich,2014,8,5804249000,3050105000,8854354000
Vereinigtes Königreich,2014,9,7269090000,3309959000,10579049000
Vereinigtes Königreich,2014,10,6984375000,3291684000,10276059000
Vereinigtes Königreich,2014,11,6848042000,3230818000,10078860000
Vereinigtes Königreich,2014,12,6126101000,2863110000,8989211000
Vereinigtes Königreich,2015,1,6820808000,3110668000,9931476000
Vereinigtes Königreich,2015,2,7391222000,3028223000,10419445000
Vereinigtes Königreich,2015,3,8298632000,3752886000,12051518000
Vereinigtes Königreich,2015,4,7284730000,3303216000,10587946000
Vereinigtes Königreich,2015,5,6984444000,3205238000,10189682000
Vereinigtes Königreich,2015,6,7704166000,3175517000,10879683000
Vereinigtes Königreich,2015,7,8116230000,3282183000,11398413000
Vereinigtes Königreich,2015,8,6503076000,3013962000,9517038000
Vereinigtes Königreich,2015,9,8060819000,3239976000,11300795000
Vereinigtes Königreich,2015,10,7753554000,3349235000,11102789000
Vereinigtes Königreich,2015,11,7735550000,3101090000,10836640000
Vereinigtes Königreich,2015,12,6364640000,2851628000,9216268000
Vereinigtes Königreich,2016,1,6935065000,2696912000,9631977000
Vereinigtes Königreich,2016,2,7874040000,3286379000,11160419000
Vereinigtes Königreich,2016,3,8011151000,2971212000,10982363000
Vereinigtes Königreich,2016,4,7318540000,3032808000,10351348000
Vereinigtes Königreich,2016,5,6716177000,2931525000,9647702000
Vereinigtes Königreich,2016,6,7820159000,2888978000,10709137000
Vereinigtes Königreich,2016,7,6869266000,2848319000,9717585000
Vereinigtes Königreich,2016,8,6873265000,2704655000,9577920000
Vereinigtes Königreich,2016,9,7779155000,3221935000,11001090000
Vereinigtes Königreich,2016,10,6506116000,2890582000,9396698000
Vereinigtes Königreich,2016,11,7221355000,3234769000,10456124000
Vereinigtes Königreich,2016,12,6014394000,2945858000,8960252000
Vereinigtes Königreich,2017,1,6795460000,2885878000,9681338000
Vereinigtes Königreich,2017,2,7466622000,2957603000,10424225000
Vereinigtes Königreich,2017,3,8234778000,3635923000,11870701000
Vereinigtes Königreich,2017,4,6696245000,2968837000,9665082000
Vereinigtes Königreich,2017,5,7240385000,3026415000,10266800000
Vereinigtes Königreich,2017,6,7297441000,2891564000,10189005000
Vereinigtes Königreich,2017,7,7028628000,3192883000,10221511000
Vereinigtes Königreich,2017,8,6655932000,2842285000,9498217000
Vereinigtes Königreich,2017,9,7381217000,3081420000,10462637000
Vereinigtes Königreich,2017,10,7061955000,3230569000,10292524000
Vereinigtes Königreich,2017,11,7449628000,3249950000,10699578000
Vereinigtes Königreich,2017,12,6105186000,2852418000,8957604000
Vereinigtes Königreich,2018,1,7277121000,3045401000,10322522000
Vereinigtes Königreich,2018,2,7010113000,2898392000,9908505000
Vereinigtes Königreich,2018,3,7365347000,3173987000,10539334000
Vereinigtes Königreich,2018,4,7127989000,2955204000,10083193000
Vereinigtes Königreich,2018,5,6977671000,4058954000,11036625000
Vereinigtes Königreich,2018,6,7005076000,3086973000,10092049000
Vereinigtes Königreich,2018,7,6739694000,2907926000,9647620000
Vereinigtes Königreich,2018,8,6334176000,2644366000,8978542000
Vereinigtes Königreich,2018,9,6550159000,2921485000,9471644000
Vereinigtes Königreich,2018,10,7083478000,3278140000,10361618000
Vereinigtes Königreich,2018,11,7139101000,3249323000,10388424000
Vereinigtes Königreich,2018,12,5553805000,2804454000,8358259000
Vereinigtes Königreich,2019,1,7129434000,3201081000,10330515000
Vereinigtes Königreich,2019,2,7570196000,3082681000,10652877000
Vereinigtes Königreich,2019,3,8169701000,3639896000,11809597000
Vereinigtes Königreich,2019,4,5602067000,2837148000,8439215000
Vereinigtes Königreich,2019,5,6543360000,2683573000,9226933000
Vereinigtes Königreich,2019,6,5967797000,3076420000,9044217000
Vereinigtes Königreich,2019,7,6280943000,3216061000,9497004000
Vereinigtes Königreich,2019,8,6028721000,3138382000,9167103000
Vereinigtes Königreich,2019,9,7258869000,3265575000,10524444000
Vereinigtes Königreich,2019,10,7385162000,3589011000,10974173000
Vereinigtes Königreich,2019,11,6065308000,3482979000,9548287000
Vereinigtes Königreich,2019,12,5164619000,3183711000,8348330000
Vereinigtes Königreich,2020,1,6023005000,3585044000,9608049000
Vereinigtes Königreich,2020,2,6132959000,3692312000,9825271000
Vereinigtes Königreich,2020,3,7443793000,3078749000,10522542000
Vereinigtes Königreich,2020,4,3251561000,3060884000,6312445000
Vereinigtes Königreich,2020,5,3433918000,2125793000,5559711000
Vereinigtes Königreich,2020,6,4987698000,2415330000,7403028000
Vereinigtes Königreich,2020,7,5504648000,2454409000,7959057000
Vereinigtes Königreich,2020,8,5639598000,2483711000,8123309000
Vereinigtes Königreich,2020,9,6377807000,2858974000,9236781000
Vereinigtes Königreich,2020,10,6462561000,2941361000,9403922000
Vereinigtes Königreich,2020,11,6467851000,3151938000,9619789000
Vereinigtes Königreich,2020,12,5360658000,3169583000,8530241000
Vereinigtes Königreich,2021,1,4299695000,1740740000,6040435000
Vereinigtes Königreich,2021,2,5325284000,2752073000,8077357000
Vereinigtes Königreich,2021,3,6453506000,3218168000,9671674000
Vereinigtes Königreich,2021,4,5168100000,3093569000,8261669000
Vereinigtes Königreich,2021,5,5007514000,2750266000,7757780000
Vereinigtes Königreich,2021,6,5496027000,2739770000,8235797000
Vereinigtes Königreich,2021,7,5926240000,2860652000,8786892000
Vereinigtes Königreich,2021,8,4729620000,2314988000,7044608000
Vereinigtes Königreich,2021,9,5788710000,2337423000,8126133000
Vereinigtes Königreich,2021,10,5718769000,2891269000,8610038000
Vereinigtes Königreich,2021,11,6130794000,2926919000,9057713000
Vereinigtes Königreich,2021,12,4958050000,2619501000,7577551000
Vereinigtes Königreich,2022,1,5453822000,2841200000,8295022000
Vereinigtes Königreich,2022,2,5872012000,2765640000,8637652000
Vereinigtes Königreich,2022,3,6557556000,4150590000,10708146000
Vereinigtes Königreich,2022,4,6124526000,3571186000,9695712000
Vereinigtes Königreich,2022,5,5960630000,3647685000,9608315000
Vereinigtes Königreich,2022,6,6086364000,3492986000,9579350000
Vereinigtes Königreich,2022,7,5751755000,3157756000,8909511000
Vereinigtes Königreich,2022,8,5897798000,3357019000,9254817000
Vereinigtes Königreich,2022,9,6561241000,3911586000,10472827000
Vereinigtes Königreich,2022,10,6304416000,3123977000,9428393000
Vereinigtes Königreich,2022,11,8153219000,3392840000,11546059000
Vereinigtes Königreich,2022,12,5043438000,3039042000,8082480000
Vereinigtes Königreich,2023,1,6032142000,3087053000,9119195000
Vereinigtes Königreich,2023,2,6309905000,3265375000,9575280000
Vereinigtes Königreich,2023,3,7550050000,3528789000,11078839000
Vereinigtes Königreich,2023,4,5610886000,2950131000,8561017000
Vereinigtes Königreich,2023,5,6476103000,3250580000,9726683000
Vereinigtes Königreich,2023,6,6818445000,3399700000,10218145000
Vereinigtes Königreich,2023,7,6244322000,2884899000,9129221000
Vereinigtes Königreich,2023,8,5796046000,2812144000,8608190000
Vereinigtes Königreich,2023,9,6480000000,3146391000,9626391000
Vereinigtes Königreich,2023,10,6877848000,2785748000,9663596000
Vereinigtes Königreich,2023,11,8200070000,3042409000,11242479000
Vereinigtes Königreich,2023,12,6031369000,2616623000,8647992000
Vereinigtes Königreich,2024,1,6801166000,3182945000,9984111000
Vereinigtes Königreich,2024,2,6866715000,3105492000,9972207000
Vereinigtes Königreich,2024,3,6874068000,2956870000,9830938000
Vereinigtes Königreich,2024,4,7385313000,3052870000,10438183000
Vereinigtes Königreich,2024,5,6451448000,2682318000,9133766000
Vereinigtes Königreich,2024,6,6621953000,3037751000,9659704000
Vereinigtes Königreich,2024,7,6726525000,3708333000,10434858000
Vereinigtes Königreich,2024,8,6211779000,2687208000,8898987000
Vereinigtes Königreich,2024,9,6565464000,2983709000,9549173000
Vereinigtes Königreich,2024,10,7076124000,3017037000,10093161000
Vereinigtes Königreich,2024,11,7508321000,3232439000,10740760000
Vereinigtes Königreich,2024,12,5274166000,2726305000,8000471000
Vertrauliche Länder,2008,1,0,0,0
Vertrauliche Länder,2008,2,0,0,0
Vertrauliche Länder,2008,3,0,0,0
Vertrauliche Länder,2008,4,0,0,0
Vertrauliche Länder,2008,5,0,0,0
Vertrauliche Länder,2008,6,0,0,0
Vertrauliche Länder,2008,7,0,0,0
Vertrauliche Länder,2008,8,0,0,0
Vertrauliche Länder,2008,9,0,0,0
Vertrauliche Länder,2008,10,0,0,0
Vertrauliche Länder,2008,11,0,0,0
Vertrauliche Länder,2008,12,0,0,0
Vertrauliche Länder,2009,1,0,0,0
Vertrauliche Länder,2009,2,0,0,0
Vertrauliche Länder,2009,3,0,0,0
Vertrauliche Länder,2009,4,0,0,0
Vertrauliche Länder,2009,5,0,0,0
Vertrauliche Länder,2009,6,0,0,0
Vertrauliche Länder,2009,7,0,0,0
Vertrauliche Länder,2009,8,0,0,0
Vertrauliche Länder,2009,9,0,0,0
Vertrauliche Länder,2009,10,0,0,0
Vertrauliche Länder,2009,11,0,0,0
Vertrauliche Länder,2009,12,0,0,0
Vertrauliche Länder,2010,1,0,0,0
Vertrauliche Länder,2010,2,0,0,0
Vertrauliche Länder,2010,3,0,0,0
Vertrauliche Länder,2010,4,0,0,0
Vertrauliche Länder,2010,5,0,0,0
Vertrauliche Länder,2010,6,0,0,0
Vertrauliche Länder,2010,7,0,0,0
Vertrauliche Länder,2010,8,0,0,0
Vertrauliche Länder,2010,9,0,0,0
Vertrauliche Länder,2010,10,0,0,0
Vertrauliche Länder,2010,11,0,0,0
Vertrauliche Länder,2010,12,0,0,0
Vertrauliche Länder,2011,1,0,0,0
Vertrauliche Länder,2011,2,0,0,0
Vertrauliche Länder,2011,3,0,0,0
Vertrauliche Länder,2011,4,0,0,0
Vertrauliche Länder,2011,5,0,0,0
Vertrauliche Länder,2011,6,0,0,0
Vertrauliche Länder,2011,7,0,0,0
Vertrauliche Länder,2011,8,0,0,0
Vertrauliche Länder,2011,9,0,0,0
Vertrauliche Länder,2011,10,0,0,0
Vertrauliche Länder,2011,11,0,0,0
Vertrauliche Länder,2011,12,0,0,0
Vertrauliche Länder,2012,1,0,0,0
Vertrauliche Länder,2012,2,0,0,0
Vertrauliche Länder,2012,3,0,0,0
Vertrauliche Länder,2012,4,0,0,0
Vertrauliche Länder,2012,5,0,0,0
Vertrauliche Länder,2012,6,0,0,0
Vertrauliche Länder,2012,7,0,0,0
Vertrauliche Länder,2012,8,0,0,0
Vertrauliche Länder,2012,9,0,0,0
Vertrauliche Länder,2012,10,0,0,0
Vertrauliche Länder,2012,11,0,0,0
Vertrauliche Länder,2012,12,0,0,0
Vertrauliche Länder,2013,1,0,0,0
Vertrauliche Länder,2013,2,0,0,0
Vertrauliche Länder,2013,3,0,0,0
Vertrauliche Länder,2013,4,0,0,0
Vertrauliche Länder,2013,5,0,0,0
Vertrauliche Länder,2013,6,0,0,0
Vertrauliche Länder,2013,7,0,0,0
Vertrauliche Länder,2013,8,0,0,0
Vertrauliche Länder,2013,9,0,0,0
Vertrauliche Länder,2013,10,0,0,0
Vertrauliche Länder,2013,11,0,0,0
Vertrauliche Länder,2013,12,0,0,0
Vertrauliche Länder,2014,1,0,0,0
Vertrauliche Länder,2014,2,0,0,0
Vertrauliche Länder,2014,3,0,0,0
Vertrauliche Länder,2014,4,0,0,0
Vertrauliche Länder,2014,5,0,0,0
Vertrauliche Länder,2014,6,0,0,0
Vertrauliche Länder,2014,7,0,0,0
Vertrauliche Länder,2014,8,0,0,0
Vertrauliche Länder,2014,9,0,0,0
Vertrauliche Länder,2014,10,0,0,0
Vertrauliche Länder,2014,11,0,0,0
Vertrauliche Länder,2014,12,0,0,0
Vertrauliche Länder,2015,1,0,0,0
Vertrauliche Länder,2015,2,0,0,0
Vertrauliche Länder,2015,3,0,0,0
Vertrauliche Länder,2015,4,0,0,0
Vertrauliche Länder,2015,5,0,0,0
Vertrauliche Länder,2015,6,0,0,0
Vertrauliche Länder,2015,7,0,0,0
Vertrauliche Länder,2015,8,0,0,0
Vertrauliche Länder,2015,9,0,0,0
Vertrauliche Länder,2015,10,0,0,0
Vertrauliche Länder,2015,11,0,0,0
Vertrauliche Länder,2015,12,0,0,0
Vertrauliche Länder,2016,1,0,0,0
Vertrauliche Länder,2016,2,0,0,0
Vertrauliche Länder,2016,3,0,0,0
Vertrauliche Länder,2016,4,0,0,0
Vertrauliche Länder,2016,5,0,0,0
Vertrauliche Länder,2016,6,0,0,0
Vertrauliche Länder,2016,7,0,0,0
Vertrauliche Länder,2016,8,0,0,0
Vertrauliche Länder,2016,9,0,0,0
Vertrauliche Länder,2016,10,0,0,0
Vertrauliche Länder,2016,11,0,0,0
Vertrauliche Länder,2016,12,0,0,0
Vertrauliche Länder,2017,1,0,0,0
Vertrauliche Länder,2017,2,0,0,0
Vertrauliche Länder,2017,3,0,0,0
Vertrauliche Länder,2017,4,0,0,0
Vertrauliche Länder,2017,5,0,0,0
Vertrauliche Länder,2017,6,0,0,0
Vertrauliche Länder,2017,7,0,0,0
Vertrauliche Länder,2017,8,0,0,0
Vertrauliche Länder,2017,9,0,0,0
Vertrauliche Länder,2017,10,0,0,0
Vertrauliche Länder,2017,11,0,0,0
Vertrauliche Länder,2017,12,0,0,0
Vertrauliche Länder,2018,1,0,0,0
Vertrauliche Länder,2018,2,0,0,0
Vertrauliche Länder,2018,3,0,0,0
Vertrauliche Länder,2018,4,0,0,0
Vertrauliche Länder,2018,5,0,0,0
Vertrauliche Länder,2018,6,0,0,0
Vertrauliche Länder,2018,7,0,0,0
Vertrauliche Länder,2018,8,0,0,0
Vertrauliche Länder,2018,9,0,0,0
Vertrauliche Länder,2018,10,0,0,0
Vertrauliche Länder,2018,11,0,0,0
Vertrauliche Länder,2018,12,0,0,0
Vertrauliche Länder,2019,1,0,0,0
Vertrauliche Länder,2019,2,0,0,0
Vertrauliche Länder,2019,3,0,0,0
Vertrauliche Länder,2019,4,0,0,0
Vertrauliche Länder,2019,5,0,0,0
Vertrauliche Länder,2019,6,0,0,0
Vertrauliche Länder,2019,7,0,0,0
Vertrauliche Länder,2019,8,0,0,0
Vertrauliche Länder,2019,9,0,0,0
Vertrauliche Länder,2019,10,0,0,0
Vertrauliche Länder,2019,11,0,0,0
Vertrauliche Länder,2019,12,0,0,0
Vertrauliche Länder,2020,1,0,0,0
Vertrauliche Länder,2020,2,0,0,0
Vertrauliche Länder,2020,3,0,0,0
Vertrauliche Länder,2020,4,0,0,0
Vertrauliche Länder,2020,5,0,0,0
Vertrauliche Länder,2020,6,0,0,0
Vertrauliche Länder,2020,7,0,0,0
Vertrauliche Länder,2020,8,0,0,0
Vertrauliche Länder,2020,9,0,0,0
Vertrauliche Länder,2020,10,0,0,0
Vertrauliche Länder,2020,11,0,0,0
Vertrauliche Länder,2020,12,0,0,0
Vertrauliche Länder,2021,1,0,0,0
Vertrauliche Länder,2021,2,0,0,0
Vertrauliche Länder,2021,3,0,0,0
Vertrauliche Länder,2021,4,0,0,0
Vertrauliche Länder,2021,5,0,0,0
Vertrauliche Länder,2021,6,0,0,0
Vertrauliche Länder,2021,7,0,0,0
Vertrauliche Länder,2021,8,0,0,0
Vertrauliche Länder,2021,9,0,0,0
Vertrauliche Länder,2021,10,0,0,0
Vertrauliche Länder,2021,11,0,0,0
Vertrauliche Länder,2021,12,0,0,0
Vertrauliche Länder,2022,1,0,0,0
Vertrauliche Länder,2022,2,0,0,0
Vertrauliche Länder,2022,3,0,0,0
Vertrauliche Länder,2022,4,0,0,0
Vertrauliche Länder,2022,5,0,0,0
Vertrauliche Länder,2022,6,0,0,0
Vertrauliche Länder,2022,7,0,0,0
Vertrauliche Länder,2022,8,0,0,0
Vertrauliche Länder,2022,9,0,0,0
Vertrauliche Länder,2022,10,0,0,0
Vertrauliche Länder,2022,11,0,0,0
Vertrauliche Länder,2022,12,0,0,0
Vertrauliche Länder,2023,1,0,0,0
Vertrauliche Länder,2023,2,0,0,0
Vertrauliche Länder,2023,3,0,0,0
Vertrauliche Länder,2023,4,0,0,0
Vertrauliche Länder,2023,5,0,0,0
Vertrauliche Länder,2023,6,0,0,0
Vertrauliche Länder,2023,7,0,0,0
Vertrauliche Länder,2023,8,0,0,0
Vertrauliche Länder,2023,9,0,0,0
Vertrauliche Länder,2023,10,0,0,0
Vertrauliche Länder,2023,11,0,0,0
Vertrauliche Länder,2023,12,0,0,0
Vertrauliche Länder,2024,1,0,0,0
Vertrauliche Länder,2024,2,0,0,0
Vertrauliche Länder,2024,3,0,0,0
Vertrauliche Länder,2024,4,0,0,0
Vertrauliche Länder,2024,5,0,0,0
Vertrauliche Länder,2024,6,0,0,0
Vertrauliche Länder,2024,7,0,0,0
Vertrauliche Länder,2024,8,0,0,0
Vertrauliche Länder,2024,9,0,0,0
Vertrauliche Länder,2024,10,0,0,0
Vertrauliche Länder,2024,11,0,0,0
Vertrauliche Länder,2024,12,0,0,0
Vietnam,2008,1,133318000,249322000,382640000
Vietnam,2008,2,71082000,222089000,293171000
Vietnam,2008,3,78461000,184880000,263341000
Vietnam,2008,4,83888000,185128000,269016000
Vietnam,2008,5,65199000,150609000,215808000
Vietnam,2008,6,68637000,171044000,239681000
Vietnam,2008,7,71859000,216536000,288395000
Vietnam,2008,8,115783000,211349000,327132000
Vietnam,2008,9,63276000,196721000,259997000
Vietnam,2008,10,70495000,161184000,231679000
Vietnam,2008,11,58505000,210909000,269414000
Vietnam,2008,12,120842000,242605000,363447000
Vietnam,2009,1,63090000,239765000,302855000
Vietnam,2009,2,53497000,216621000,270118000
Vietnam,2009,3,83501000,191897000,275398000
Vietnam,2009,4,119410000,160193000,279603000
Vietnam,2009,5,84944000,152219000,237163000
Vietnam,2009,6,78880000,173518000,252398000
Vietnam,2009,7,73927000,233115000,307042000
Vietnam,2009,8,88959000,196652000,285611000
Vietnam,2009,9,86861000,224282000,311143000
Vietnam,2009,10,109602000,153958000,263560000
Vietnam,2009,11,96316000,200035000,296351000
Vietnam,2009,12,185590000,165580000,351170000
Vietnam,2010,1,65671000,238331000,304002000
Vietnam,2010,2,67778000,220695000,288473000
Vietnam,2010,3,193392000,271114000,464506000
Vietnam,2010,4,134216000,208705000,342921000
Vietnam,2010,5,230615000,175092000,405707000
Vietnam,2010,6,144429000,218432000,362861000
Vietnam,2010,7,95662000,310658000,406320000
Vietnam,2010,8,90883000,274860000,365743000
Vietnam,2010,9,102830000,280087000,382917000
Vietnam,2010,10,149252000,226548000,375800000
Vietnam,2010,11,101228000,251160000,352388000
Vietnam,2010,12,106579000,270672000,377251000
Vietnam,2011,1,70987000,330330000,401317000
Vietnam,2011,2,76900000,317421000,394321000
Vietnam,2011,3,116292000,393858000,510150000
Vietnam,2011,4,174108000,261989000,436097000
Vietnam,2011,5,144831000,270724000,415555000
Vietnam,2011,6,171354000,259507000,430861000
Vietnam,2011,7,194842000,323127000,517969000
Vietnam,2011,8,177844000,426471000,604315000
Vietnam,2011,9,120130000,367549000,487679000
Vietnam,2011,10,106490000,330551000,437041000
Vietnam,2011,11,179455000,406817000,586272000
Vietnam,2011,12,234430000,313730000,548160000
Vietnam,2012,1,84753000,441075000,525828000
Vietnam,2012,2,101585000,451840000,553425000
Vietnam,2012,3,115608000,395647000,511255000
Vietnam,2012,4,90402000,365954000,456356000
Vietnam,2012,5,88300000,363507000,451807000
Vietnam,2012,6,163670000,385694000,549364000
Vietnam,2012,7,86916000,451859000,538775000
Vietnam,2012,8,351924000,532429000,884353000
Vietnam,2012,9,80669000,452063000,532732000
Vietnam,2012,10,275607000,491180000,766787000
Vietnam,2012,11,165304000,458829000,624133000
Vietnam,2012,12,347074000,332932000,680006000
Vietnam,2013,1,150815000,618894000,769709000
Vietnam,2013,2,153993000,533475000,687468000
Vietnam,2013,3,214701000,460281000,674982000
Vietnam,2013,4,163328000,518702000,682030000
Vietnam,2013,5,107690000,432047000,539737000
Vietnam,2013,6,101472000,425884000,527356000
Vietnam,2013,7,119452000,505963000,625415000
Vietnam,2013,8,230912000,477683000,708595000
Vietnam,2013,9,135818000,478045000,613863000
Vietnam,2013,10,112255000,420311000,532566000
Vietnam,2013,11,117166000,402578000,519744000
Vietnam,2013,12,236387000,340767000,577154000
Vietnam,2014,1,119429000,553298000,672727000
Vietnam,2014,2,262023000,453006000,715029000
Vietnam,2014,3,163679000,457791000,621470000
Vietnam,2014,4,124441000,481223000,605664000
Vietnam,2014,5,113401000,414784000,528185000
Vietnam,2014,6,148479000,431507000,579986000
Vietnam,2014,7,155519000,551013000,706532000
Vietnam,2014,8,126140000,542589000,668729000
Vietnam,2014,9,196340000,586158000,782498000
Vietnam,2014,10,145953000,510852000,656805000
Vietnam,2014,11,234529000,560059000,794588000
Vietnam,2014,12,185756000,507401000,693157000
Vietnam,2015,1,116405000,663139000,779544000
Vietnam,2015,2,122141000,660774000,782915000
Vietnam,2015,3,229940000,694006000,923946000
Vietnam,2015,4,143131000,585518000,728649000
Vietnam,2015,5,147903000,590434000,738337000
Vietnam,2015,6,158196000,697510000,855706000
Vietnam,2015,7,250559000,734658000,985217000
Vietnam,2015,8,242293000,720144000,962437000
Vietnam,2015,9,171053000,708524000,879577000
Vietnam,2015,10,168635000,657649000,826284000
Vietnam,2015,11,289872000,710123000,999995000
Vietnam,2015,12,249267000,619669000,868936000
Vietnam,2016,1,188463000,783233000,971696000
Vietnam,2016,2,146629000,829160000,975789000
Vietnam,2016,3,175816000,705250000,881066000
Vietnam,2016,4,162963000,673015000,835978000
Vietnam,2016,5,216068000,708627000,924695000
Vietnam,2016,6,213392000,719342000,932734000
Vietnam,2016,7,247216000,721891000,969107000
Vietnam,2016,8,243495000,799528000,1043023000
Vietnam,2016,9,224321000,727773000,952094000
Vietnam,2016,10,277444000,726321000,1003765000
Vietnam,2016,11,250231000,741638000,991869000
Vietnam,2016,12,260184000,670330000,930514000
Vietnam,2017,1,153234000,823193000,976427000
Vietnam,2017,2,190638000,697241000,887879000
Vietnam,2017,3,235906000,808430000,1044336000
Vietnam,2017,4,267160000,768668000,1035828000
Vietnam,2017,5,400578000,855010000,1255588000
Vietnam,2017,6,276190000,788356000,1064546000
Vietnam,2017,7,207206000,760808000,968014000
Vietnam,2017,8,302724000,874986000,1177710000
Vietnam,2017,9,193623000,870714000,1064337000
Vietnam,2017,10,280508000,801876000,1082384000
Vietnam,2017,11,455015000,801735000,1256750000
Vietnam,2017,12,511027000,780099000,1291126000
Vietnam,2018,1,300685000,920351000,1221036000
Vietnam,2018,2,231112000,843490000,1074602000
Vietnam,2018,3,262224000,817956000,1080180000
Vietnam,2018,4,244360000,739014000,983374000
Vietnam,2018,5,235272000,795485000,1030757000
Vietnam,2018,6,239420000,905374000,1144794000
Vietnam,2018,7,254838000,822146000,1076984000
Vietnam,2018,8,457195000,879396000,1336591000
Vietnam,2018,9,288991000,909780000,1198771000
Vietnam,2018,10,269713000,800330000,1070043000
Vietnam,2018,11,664249000,706068000,1370317000
Vietnam,2018,12,661375000,629091000,1290466000
Vietnam,2019,1,256499000,895337000,1151836000
Vietnam,2019,2,329055000,817614000,1146669000
Vietnam,2019,3,224466000,849197000,1073663000
Vietnam,2019,4,465782000,817828000,1283610000
Vietnam,2019,5,508251000,718394000,1226645000
Vietnam,2019,6,202356000,729024000,931380000
Vietnam,2019,7,387988000,860548000,1248536000
Vietnam,2019,8,229458000,807866000,1037324000
Vietnam,2019,9,379502000,864419000,1243921000
Vietnam,2019,10,389104000,831130000,1220234000
Vietnam,2019,11,298344000,811466000,1109810000
Vietnam,2019,12,633827000,718025000,1351852000
Vietnam,2020,1,269548000,944795000,1214343000
Vietnam,2020,2,225189000,845977000,1071166000
Vietnam,2020,3,264686000,967144000,1231830000
Vietnam,2020,4,192877000,692651000,885528000
Vietnam,2020,5,212168000,753942000,966110000
Vietnam,2020,6,237532000,937230000,1174762000
Vietnam,2020,7,256801000,863472000,1120273000
Vietnam,2020,8,216046000,925303000,1141349000
Vietnam,2020,9,247575000,970783000,1218358000
Vietnam,2020,10,271669000,848686000,1120355000
Vietnam,2020,11,259375000,851345000,1110720000
Vietnam,2020,12,314319000,745603000,1059922000
Vietnam,2021,1,237539000,892435000,1129974000
Vietnam,2021,2,389386000,850744000,1240130000
Vietnam,2021,3,289147000,964476000,1253623000
Vietnam,2021,4,309222000,839771000,1148993000
Vietnam,2021,5,267290000,890681000,1157971000
Vietnam,2021,6,413328000,937373000,1350701000
Vietnam,2021,7,270272000,852980000,1123252000
Vietnam,2021,8,292429000,988215000,1280644000
Vietnam,2021,9,276251000,863809000,1140060000
Vietnam,2021,10,260364000,839689000,1100053000
Vietnam,2021,11,333097000,854510000,1187607000
Vietnam,2021,12,406435000,905459000,1311894000
Vietnam,2022,1,227342000,984502000,1211844000
Vietnam,2022,2,265087000,951986000,1217073000
Vietnam,2022,3,262309000,1155880000,1418189000
Vietnam,2022,4,253869000,1113812000,1367681000
Vietnam,2022,5,289654000,1247186000,1536840000
Vietnam,2022,6,307976000,1170389000,1478365000
Vietnam,2022,7,239481000,1249370000,1488851000
Vietnam,2022,8,267964000,1440054000,1708018000
Vietnam,2022,9,373227000,1453262000,1826489000
Vietnam,2022,10,266688000,1505993000,1772681000
Vietnam,2022,11,304222000,1419770000,1723992000
Vietnam,2022,12,346416000,1071300000,1417716000
Vietnam,2023,1,215310000,1254864000,1470174000
Vietnam,2023,2,271308000,1163334000,1434642000
Vietnam,2023,3,321014000,1103511000,1424525000
Vietnam,2023,4,262640000,987120000,1249760000
Vietnam,2023,5,482393000,1061263000,1543656000
Vietnam,2023,6,270105000,1082377000,1352482000
Vietnam,2023,7,276254000,1215322000,1491576000
Vietnam,2023,8,253882000,1131855000,1385737000
Vietnam,2023,9,257416000,1167698000,1425114000
Vietnam,2023,10,391919000,1181111000,1573030000
Vietnam,2023,11,256043000,1203046000,1459089000
Vietnam,2023,12,272223000,997484000,1269707000
Vietnam,2024,1,239994000,1220710000,1460704000
Vietnam,2024,2,307610000,1269267000,1576877000
Vietnam,2024,3,277759000,1141160000,1418919000
Vietnam,2024,4,287974000,1220969000,1508943000
Vietnam,2024,5,234917000,1164079000,1398996000
Vietnam,2024,6,257705000,1269054000,1526759000
Vietnam,2024,7,270010000,1317874000,1587884000
Vietnam,2024,8,249640000,1237144000,1486784000
Vietnam,2024,9,243402000,1408033000,1651435000
Vietnam,2024,10,393268000,1361353000,1754621000
Vietnam,2024,11,392617000,1314714000,1707331000
Vietnam,2024,12,571985000,1166220000,1738205000
Wallis und Futuna,2008,1,0,0,0
Wallis und Futuna,2008,2,4000,0,4000
Wallis und Futuna,2008,3,0,0,0
Wallis und Futuna,2008,4,0,0,0
Wallis und Futuna,2008,5,0,0,0
Wallis und Futuna,2008,6,22000,0,22000
Wallis und Futuna,2008,7,57000,0,57000
Wallis und Futuna,2008,8,0,0,0
Wallis und Futuna,2008,9,29000,0,29000
Wallis und Futuna,2008,10,0,0,0
Wallis und Futuna,2008,11,32000,1000,33000
Wallis und Futuna,2008,12,3000,0,3000
Wallis und Futuna,2009,1,0,0,0
Wallis und Futuna,2009,2,2000,0,2000
Wallis und Futuna,2009,3,18000,0,18000
Wallis und Futuna,2009,4,15000,0,15000
Wallis und Futuna,2009,5,3000,0,3000
Wallis und Futuna,2009,6,34000,0,34000
Wallis und Futuna,2009,7,0,0,0
Wallis und Futuna,2009,8,36000,0,36000
Wallis und Futuna,2009,9,1000,0,1000
Wallis und Futuna,2009,10,0,0,0
Wallis und Futuna,2009,11,0,0,0
Wallis und Futuna,2009,12,0,0,0
Wallis und Futuna,2010,1,34000,0,34000
Wallis und Futuna,2010,2,0,0,0
Wallis und Futuna,2010,3,0,0,0
Wallis und Futuna,2010,4,31000,0,31000
Wallis und Futuna,2010,5,0,0,0
Wallis und Futuna,2010,6,0,0,0
Wallis und Futuna,2010,7,0,0,0
Wallis und Futuna,2010,8,0,0,0
Wallis und Futuna,2010,9,24000,0,24000
Wallis und Futuna,2010,10,0,0,0
Wallis und Futuna,2010,11,0,0,0
Wallis und Futuna,2010,12,0,0,0
Wallis und Futuna,2011,1,0,0,0
Wallis und Futuna,2011,2,26000,0,26000
Wallis und Futuna,2011,3,24000,0,24000
Wallis und Futuna,2011,4,0,0,0
Wallis und Futuna,2011,5,0,0,0
Wallis und Futuna,2011,6,31000,0,31000
Wallis und Futuna,2011,7,0,0,0
Wallis und Futuna,2011,8,0,0,0
Wallis und Futuna,2011,9,0,0,0
Wallis und Futuna,2011,10,24000,0,24000
Wallis und Futuna,2011,11,0,0,0
Wallis und Futuna,2011,12,11000,0,11000
Wallis und Futuna,2012,1,27000,0,27000
Wallis und Futuna,2012,2,23000,0,23000
Wallis und Futuna,2012,3,0,0,0
Wallis und Futuna,2012,4,0,0,0
Wallis und Futuna,2012,5,2000,0,2000
Wallis und Futuna,2012,6,34000,0,34000
Wallis und Futuna,2012,7,3000,0,3000
Wallis und Futuna,2012,8,35000,0,35000
Wallis und Futuna,2012,9,0,0,0
Wallis und Futuna,2012,10,3000,0,3000
Wallis und Futuna,2012,11,80000,0,80000
Wallis und Futuna,2012,12,3000,0,3000
Wallis und Futuna,2013,1,0,0,0
Wallis und Futuna,2013,2,35000,0,35000
Wallis und Futuna,2013,3,0,0,0
Wallis und Futuna,2013,4,4000,0,4000
Wallis und Futuna,2013,5,1000,0,1000
Wallis und Futuna,2013,6,33000,0,33000
Wallis und Futuna,2013,7,0,0,0
Wallis und Futuna,2013,8,0,0,0
Wallis und Futuna,2013,9,0,0,0
Wallis und Futuna,2013,10,7000,0,7000
Wallis und Futuna,2013,11,0,0,0
Wallis und Futuna,2013,12,37000,0,37000
Wallis und Futuna,2014,1,31000,0,31000
Wallis und Futuna,2014,2,3000,0,3000
Wallis und Futuna,2014,3,31000,0,31000
Wallis und Futuna,2014,4,3000,0,3000
Wallis und Futuna,2014,5,8000,0,8000
Wallis und Futuna,2014,6,0,0,0
Wallis und Futuna,2014,7,0,0,0
Wallis und Futuna,2014,8,1000,0,1000
Wallis und Futuna,2014,9,4000,0,4000
Wallis und Futuna,2014,10,0,0,0
Wallis und Futuna,2014,11,29000,0,29000
Wallis und Futuna,2014,12,0,0,0
Wallis und Futuna,2015,1,31000,0,31000
Wallis und Futuna,2015,2,0,0,0
Wallis und Futuna,2015,3,37000,0,37000
Wallis und Futuna,2015,4,4000,0,4000
Wallis und Futuna,2015,5,1000,0,1000
Wallis und Futuna,2015,6,9000,0,9000
Wallis und Futuna,2015,7,2000,0,2000
Wallis und Futuna,2015,8,28000,0,28000
Wallis und Futuna,2015,9,0,0,0
Wallis und Futuna,2015,10,1000,0,1000
Wallis und Futuna,2015,11,7000,0,7000
Wallis und Futuna,2015,12,29000,0,29000
Wallis und Futuna,2016,1,3000,0,3000
Wallis und Futuna,2016,2,2000,0,2000
Wallis und Futuna,2016,3,6000,0,6000
Wallis und Futuna,2016,4,20000,0,20000
Wallis und Futuna,2016,5,1000,0,1000
Wallis und Futuna,2016,6,0,0,0
Wallis und Futuna,2016,7,24000,0,24000
Wallis und Futuna,2016,8,3000,0,3000
Wallis und Futuna,2016,9,5000,0,5000
Wallis und Futuna,2016,10,10000,0,10000
Wallis und Futuna,2016,11,26000,0,26000
Wallis und Futuna,2016,12,2000,0,2000
Wallis und Futuna,2017,1,28000,0,28000
Wallis und Futuna,2017,2,6000,0,6000
Wallis und Futuna,2017,3,29000,0,29000
Wallis und Futuna,2017,4,0,0,0
Wallis und Futuna,2017,5,1000,0,1000
Wallis und Futuna,2017,6,0,0,0
Wallis und Futuna,2017,7,26000,0,26000
Wallis und Futuna,2017,8,1000,0,1000
Wallis und Futuna,2017,9,31000,0,31000
Wallis und Futuna,2017,10,0,0,0
Wallis und Futuna,2017,11,1000,0,1000
Wallis und Futuna,2017,12,25000,0,25000
Wallis und Futuna,2018,1,26000,0,26000
Wallis und Futuna,2018,2,0,0,0
Wallis und Futuna,2018,3,3000,0,3000
Wallis und Futuna,2018,4,0,0,0
Wallis und Futuna,2018,5,1000,0,1000
Wallis und Futuna,2018,6,32000,0,32000
Wallis und Futuna,2018,7,1000,0,1000
Wallis und Futuna,2018,8,0,0,0
Wallis und Futuna,2018,9,0,0,0
Wallis und Futuna,2018,10,12000,0,12000
Wallis und Futuna,2018,11,1000,0,1000
Wallis und Futuna,2018,12,11000,0,11000
Wallis und Futuna,2019,1,1000,0,1000
Wallis und Futuna,2019,2,1000,0,1000
Wallis und Futuna,2019,3,25000,0,25000
Wallis und Futuna,2019,4,0,0,0
Wallis und Futuna,2019,5,0,0,0
Wallis und Futuna,2019,6,2000,0,2000
Wallis und Futuna,2019,7,0,0,0
Wallis und Futuna,2019,8,13000,0,13000
Wallis und Futuna,2019,9,11000,0,11000
Wallis und Futuna,2019,10,43000,0,43000
Wallis und Futuna,2019,11,13000,0,13000
Wallis und Futuna,2019,12,0,0,0
Wallis und Futuna,2020,1,19000,0,19000
Wallis und Futuna,2020,2,1000,0,1000
Wallis und Futuna,2020,3,13000,0,13000
Wallis und Futuna,2020,4,8000,0,8000
Wallis und Futuna,2020,5,12000,0,12000
Wallis und Futuna,2020,6,0,0,0
Wallis und Futuna,2020,7,50000,0,50000
Wallis und Futuna,2020,8,11000,0,11000
Wallis und Futuna,2020,9,11000,0,11000
Wallis und Futuna,2020,10,12000,7000,19000
Wallis und Futuna,2020,11,1000,0,1000
Wallis und Futuna,2020,12,0,0,0
Wallis und Futuna,2021,1,0,0,0
Wallis und Futuna,2021,2,16000,0,16000
Wallis und Futuna,2021,3,1000,0,1000
Wallis und Futuna,2021,4,0,1000,1000
Wallis und Futuna,2021,5,49000,0,49000
Wallis und Futuna,2021,6,0,0,0
Wallis und Futuna,2021,7,0,0,0
Wallis und Futuna,2021,8,4000,0,4000
Wallis und Futuna,2021,9,68000,0,68000
Wallis und Futuna,2021,10,6000,0,6000
Wallis und Futuna,2021,11,1000,0,1000
Wallis und Futuna,2021,12,0,0,0
Wallis und Futuna,2022,1,1000,0,1000
Wallis und Futuna,2022,2,59000,0,59000
Wallis und Futuna,2022,3,4000,0,4000
Wallis und Futuna,2022,4,0,0,0
Wallis und Futuna,2022,5,19000,0,19000
Wallis und Futuna,2022,6,0,0,0
Wallis und Futuna,2022,7,0,0,0
Wallis und Futuna,2022,8,5000,0,5000
Wallis und Futuna,2022,9,57000,0,57000
Wallis und Futuna,2022,10,0,0,0
Wallis und Futuna,2022,11,0,13000,13000
Wallis und Futuna,2022,12,20000,0,20000
Wallis und Futuna,2023,1,0,0,0
Wallis und Futuna,2023,2,0,0,0
Wallis und Futuna,2023,3,1000,0,1000
Wallis und Futuna,2023,4,0,0,0
Wallis und Futuna,2023,5,7000,0,7000
Wallis und Futuna,2023,6,8000,0,8000
Wallis und Futuna,2023,7,0,0,0
Wallis und Futuna,2023,8,0,0,0
Wallis und Futuna,2023,9,24000,0,24000
Wallis und Futuna,2023,10,0,0,0
Wallis und Futuna,2023,11,3000,0,3000
Wallis und Futuna,2023,12,0,0,0
Wallis und Futuna,2024,1,0,0,0
Wallis und Futuna,2024,2,0,0,0
Wallis und Futuna,2024,3,105000,0,105000
Wallis und Futuna,2024,4,0,0,0
Wallis und Futuna,2024,5,0,0,0
Wallis und Futuna,2024,6,3000,0,3000
Wallis und Futuna,2024,7,64000,0,64000
Wallis und Futuna,2024,8,50000,0,50000
Wallis und Futuna,2024,9,2000,0,2000
Wallis und Futuna,2024,10,56000,0,56000
Wallis und Futuna,2024,11,2000,0,2000
Wallis und Futuna,2024,12,0,0,0
Weihnachtsinsel (ab 2001),2008,1,13000,0,13000
Weihnachtsinsel (ab 2001),2008,2,0,0,0
Weihnachtsinsel (ab 2001),2008,3,28000,0,28000
Weihnachtsinsel (ab 2001),2008,4,0,0,0
Weihnachtsinsel (ab 2001),2008,5,1000,0,1000
Weihnachtsinsel (ab 2001),2008,6,23000,0,23000
Weihnachtsinsel (ab 2001),2008,7,0,0,0
Weihnachtsinsel (ab 2001),2008,8,0,0,0
Weihnachtsinsel (ab 2001),2008,9,0,0,0
Weihnachtsinsel (ab 2001),2008,10,0,0,0
Weihnachtsinsel (ab 2001),2008,11,3000,0,3000
Weihnachtsinsel (ab 2001),2008,12,48000,0,48000
Weihnachtsinsel (ab 2001),2009,1,4000,1000,5000
Weihnachtsinsel (ab 2001),2009,2,54000,2000,56000
Weihnachtsinsel (ab 2001),2009,3,34000,1000,35000
Weihnachtsinsel (ab 2001),2009,4,32000,0,32000
Weihnachtsinsel (ab 2001),2009,5,4000,0,4000
Weihnachtsinsel (ab 2001),2009,6,1000,0,1000
Weihnachtsinsel (ab 2001),2009,7,0,0,0
Weihnachtsinsel (ab 2001),2009,8,0,0,0
Weihnachtsinsel (ab 2001),2009,9,34000,2000,36000
Weihnachtsinsel (ab 2001),2009,10,0,5000,5000
Weihnachtsinsel (ab 2001),2009,11,0,0,0
Weihnachtsinsel (ab 2001),2009,12,9000,2000,11000
Weihnachtsinsel (ab 2001),2010,1,0,3000,3000
Weihnachtsinsel (ab 2001),2010,2,0,0,0
Weihnachtsinsel (ab 2001),2010,3,0,4000,4000
Weihnachtsinsel (ab 2001),2010,4,0,2000,2000
Weihnachtsinsel (ab 2001),2010,5,0,2000,2000
Weihnachtsinsel (ab 2001),2010,6,0,0,0
Weihnachtsinsel (ab 2001),2010,7,0,1000,1000
Weihnachtsinsel (ab 2001),2010,8,0,2000,2000
Weihnachtsinsel (ab 2001),2010,9,0,0,0
Weihnachtsinsel (ab 2001),2010,10,0,3000,3000
Weihnachtsinsel (ab 2001),2010,11,0,3000,3000
Weihnachtsinsel (ab 2001),2010,12,0,3000,3000
Weihnachtsinsel (ab 2001),2011,1,0,3000,3000
Weihnachtsinsel (ab 2001),2011,2,0,9000,9000
Weihnachtsinsel (ab 2001),2011,3,0,4000,4000
Weihnachtsinsel (ab 2001),2011,4,0,0,0
Weihnachtsinsel (ab 2001),2011,5,0,1000,1000
Weihnachtsinsel (ab 2001),2011,6,0,0,0
Weihnachtsinsel (ab 2001),2011,7,0,1000,1000
Weihnachtsinsel (ab 2001),2011,8,0,0,0
Weihnachtsinsel (ab 2001),2011,9,0,1000,1000
Weihnachtsinsel (ab 2001),2011,10,0,1000,1000
Weihnachtsinsel (ab 2001),2011,11,0,1000,1000
Weihnachtsinsel (ab 2001),2011,12,0,0,0
Weihnachtsinsel (ab 2001),2012,1,0,1000,1000
Weihnachtsinsel (ab 2001),2012,2,0,2000,2000
Weihnachtsinsel (ab 2001),2012,3,0,5000,5000
Weihnachtsinsel (ab 2001),2012,4,0,0,0
Weihnachtsinsel (ab 2001),2012,5,0,3000,3000
Weihnachtsinsel (ab 2001),2012,6,0,4000,4000
Weihnachtsinsel (ab 2001),2012,7,0,0,0
Weihnachtsinsel (ab 2001),2012,8,0,0,0
Weihnachtsinsel (ab 2001),2012,9,0,0,0
Weihnachtsinsel (ab 2001),2012,10,0,3000,3000
Weihnachtsinsel (ab 2001),2012,11,0,1000,1000
Weihnachtsinsel (ab 2001),2012,12,0,0,0
Weihnachtsinsel (ab 2001),2013,1,0,3000,3000
Weihnachtsinsel (ab 2001),2013,2,0,4000,4000
Weihnachtsinsel (ab 2001),2013,3,0,4000,4000
Weihnachtsinsel (ab 2001),2013,4,0,5000,5000
Weihnachtsinsel (ab 2001),2013,5,0,3000,3000
Weihnachtsinsel (ab 2001),2013,6,0,8000,8000
Weihnachtsinsel (ab 2001),2013,7,0,2000,2000
Weihnachtsinsel (ab 2001),2013,8,0,4000,4000
Weihnachtsinsel (ab 2001),2013,9,0,7000,7000
Weihnachtsinsel (ab 2001),2013,10,0,0,0
Weihnachtsinsel (ab 2001),2013,11,0,3000,3000
Weihnachtsinsel (ab 2001),2013,12,0,1000,1000
Weihnachtsinsel (ab 2001),2014,1,0,2000,2000
Weihnachtsinsel (ab 2001),2014,2,0,1000,1000
Weihnachtsinsel (ab 2001),2014,3,0,3000,3000
Weihnachtsinsel (ab 2001),2014,4,0,3000,3000
Weihnachtsinsel (ab 2001),2014,5,0,5000,5000
Weihnachtsinsel (ab 2001),2014,6,0,4000,4000
Weihnachtsinsel (ab 2001),2014,7,0,8000,8000
Weihnachtsinsel (ab 2001),2014,8,0,3000,3000
Weihnachtsinsel (ab 2001),2014,9,0,4000,4000
Weihnachtsinsel (ab 2001),2014,10,0,9000,9000
Weihnachtsinsel (ab 2001),2014,11,0,5000,5000
Weihnachtsinsel (ab 2001),2014,12,0,4000,4000
Weihnachtsinsel (ab 2001),2015,1,0,5000,5000
Weihnachtsinsel (ab 2001),2015,2,0,12000,12000
Weihnachtsinsel (ab 2001),2015,3,0,5000,5000
Weihnachtsinsel (ab 2001),2015,4,0,5000,5000
Weihnachtsinsel (ab 2001),2015,5,0,2000,2000
Weihnachtsinsel (ab 2001),2015,6,0,2000,2000
Weihnachtsinsel (ab 2001),2015,7,0,0,0
Weihnachtsinsel (ab 2001),2015,8,0,0,0
Weihnachtsinsel (ab 2001),2015,9,0,0,0
Weihnachtsinsel (ab 2001),2015,10,7000,43000,50000
Weihnachtsinsel (ab 2001),2015,11,0,83000,83000
Weihnachtsinsel (ab 2001),2015,12,0,0,0
Weihnachtsinsel (ab 2001),2016,1,0,0,0
Weihnachtsinsel (ab 2001),2016,2,0,0,0
Weihnachtsinsel (ab 2001),2016,3,0,0,0
Weihnachtsinsel (ab 2001),2016,4,0,0,0
Weihnachtsinsel (ab 2001),2016,5,0,0,0
Weihnachtsinsel (ab 2001),2016,6,0,0,0
Weihnachtsinsel (ab 2001),2016,7,0,0,0
Weihnachtsinsel (ab 2001),2016,8,0,1000,1000
Weihnachtsinsel (ab 2001),2016,9,0,0,0
Weihnachtsinsel (ab 2001),2016,10,0,0,0
Weihnachtsinsel (ab 2001),2016,11,0,0,0
Weihnachtsinsel (ab 2001),2016,12,0,0,0
Weihnachtsinsel (ab 2001),2017,1,0,0,0
Weihnachtsinsel (ab 2001),2017,2,0,0,0
Weihnachtsinsel (ab 2001),2017,3,0,0,0
Weihnachtsinsel (ab 2001),2017,4,0,0,0
Weihnachtsinsel (ab 2001),2017,5,0,0,0
Weihnachtsinsel (ab 2001),2017,6,0,0,0
Weihnachtsinsel (ab 2001),2017,7,0,0,0
Weihnachtsinsel (ab 2001),2017,8,0,0,0
Weihnachtsinsel (ab 2001),2017,9,0,0,0
Weihnachtsinsel (ab 2001),2017,10,0,0,0
Weihnachtsinsel (ab 2001),2017,11,0,0,0
Weihnachtsinsel (ab 2001),2017,12,0,0,0
Weihnachtsinsel (ab 2001),2018,1,0,0,0
Weihnachtsinsel (ab 2001),2018,2,0,0,0
Weihnachtsinsel (ab 2001),2018,3,0,0,0
Weihnachtsinsel (ab 2001),2018,4,0,0,0
Weihnachtsinsel (ab 2001),2018,5,0,0,0
Weihnachtsinsel (ab 2001),2018,6,0,0,0
Weihnachtsinsel (ab 2001),2018,7,0,0,0
Weihnachtsinsel (ab 2001),2018,8,0,0,0
Weihnachtsinsel (ab 2001),2018,9,0,0,0
Weihnachtsinsel (ab 2001),2018,10,0,0,0
Weihnachtsinsel (ab 2001),2018,11,3000,0,3000
Weihnachtsinsel (ab 2001),2018,12,0,0,0
Weihnachtsinsel (ab 2001),2019,1,0,0,0
Weihnachtsinsel (ab 2001),2019,2,141000,0,141000
Weihnachtsinsel (ab 2001),2019,3,0,0,0
Weihnachtsinsel (ab 2001),2019,4,0,0,0
Weihnachtsinsel (ab 2001),2019,5,0,0,0
Weihnachtsinsel (ab 2001),2019,6,0,0,0
Weihnachtsinsel (ab 2001),2019,7,2000,0,2000
Weihnachtsinsel (ab 2001),2019,8,0,1000,1000
Weihnachtsinsel (ab 2001),2019,9,0,0,0
Weihnachtsinsel (ab 2001),2019,10,0,0,0
Weihnachtsinsel (ab 2001),2019,11,0,0,0
Weihnachtsinsel (ab 2001),2019,12,0,0,0
Weihnachtsinsel (ab 2001),2020,1,0,0,0
Weihnachtsinsel (ab 2001),2020,2,0,0,0
Weihnachtsinsel (ab 2001),2020,3,0,0,0
Weihnachtsinsel (ab 2001),2020,4,0,1000,1000
Weihnachtsinsel (ab 2001),2020,5,0,0,0
Weihnachtsinsel (ab 2001),2020,6,0,0,0
Weihnachtsinsel (ab 2001),2020,7,0,0,0
Weihnachtsinsel (ab 2001),2020,8,0,0,0
Weihnachtsinsel (ab 2001),2020,9,0,9000,9000
Weihnachtsinsel (ab 2001),2020,10,0,1000,1000
Weihnachtsinsel (ab 2001),2020,11,0,1000,1000
Weihnachtsinsel (ab 2001),2020,12,0,13000,13000
Weihnachtsinsel (ab 2001),2021,1,0,0,0
Weihnachtsinsel (ab 2001),2021,2,0,0,0
Weihnachtsinsel (ab 2001),2021,3,0,0,0
Weihnachtsinsel (ab 2001),2021,4,0,0,0
Weihnachtsinsel (ab 2001),2021,5,0,0,0
Weihnachtsinsel (ab 2001),2021,6,0,10000,10000
Weihnachtsinsel (ab 2001),2021,7,0,0,0
Weihnachtsinsel (ab 2001),2021,8,0,110000,110000
Weihnachtsinsel (ab 2001),2021,9,0,0,0
Weihnachtsinsel (ab 2001),2021,10,0,48000,48000
Weihnachtsinsel (ab 2001),2021,11,0,0,0
Weihnachtsinsel (ab 2001),2021,12,0,0,0
Weihnachtsinsel (ab 2001),2022,1,0,170000,170000
Weihnachtsinsel (ab 2001),2022,2,0,36000,36000
Weihnachtsinsel (ab 2001),2022,3,0,0,0
Weihnachtsinsel (ab 2001),2022,4,3000,16000,19000
Weihnachtsinsel (ab 2001),2022,5,0,0,0
Weihnachtsinsel (ab 2001),2022,6,0,0,0
Weihnachtsinsel (ab 2001),2022,7,0,58000,58000
Weihnachtsinsel (ab 2001),2022,8,8000,0,8000
Weihnachtsinsel (ab 2001),2022,9,0,0,0
Weihnachtsinsel (ab 2001),2022,10,0,0,0
Weihnachtsinsel (ab 2001),2022,11,0,0,0
Weihnachtsinsel (ab 2001),2022,12,0,0,0
Weihnachtsinsel (ab 2001),2023,1,0,0,0
Weihnachtsinsel (ab 2001),2023,2,0,0,0
Weihnachtsinsel (ab 2001),2023,3,0,19000,19000
Weihnachtsinsel (ab 2001),2023,4,0,46000,46000
Weihnachtsinsel (ab 2001),2023,5,0,0,0
Weihnachtsinsel (ab 2001),2023,6,0,0,0
Weihnachtsinsel (ab 2001),2023,7,0,0,0
Weihnachtsinsel (ab 2001),2023,8,0,0,0
Weihnachtsinsel (ab 2001),2023,9,0,265000,265000
Weihnachtsinsel (ab 2001),2023,10,0,0,0
Weihnachtsinsel (ab 2001),2023,11,0,0,0
Weihnachtsinsel (ab 2001),2023,12,0,0,0
Weihnachtsinsel (ab 2001),2024,1,0,0,0
Weihnachtsinsel (ab 2001),2024,2,0,0,0
Weihnachtsinsel (ab 2001),2024,3,0,0,0
Weihnachtsinsel (ab 2001),2024,4,0,353000,353000
Weihnachtsinsel (ab 2001),2024,5,0,0,0
Weihnachtsinsel (ab 2001),2024,6,0,61000,61000
Weihnachtsinsel (ab 2001),2024,7,0,0,0
Weihnachtsinsel (ab 2001),2024,8,0,7000,7000
Weihnachtsinsel (ab 2001),2024,9,0,0,0
Weihnachtsinsel (ab 2001),2024,10,0,0,0
Weihnachtsinsel (ab 2001),2024,11,0,51000,51000
Weihnachtsinsel (ab 2001),2024,12,0,22000,22000
Westsahara (ab 2013),2008,1,0,0,0
Westsahara (ab 2013),2008,2,0,0,0
Westsahara (ab 2013),2008,3,0,0,0
Westsahara (ab 2013),2008,4,0,0,0
Westsahara (ab 2013),2008,5,0,0,0
Westsahara (ab 2013),2008,6,0,0,0
Westsahara (ab 2013),2008,7,0,0,0
Westsahara (ab 2013),2008,8,0,0,0
Westsahara (ab 2013),2008,9,0,0,0
Westsahara (ab 2013),2008,10,0,0,0
Westsahara (ab 2013),2008,11,0,0,0
Westsahara (ab 2013),2008,12,0,0,0
Westsahara (ab 2013),2009,1,0,0,0
Westsahara (ab 2013),2009,2,0,0,0
Westsahara (ab 2013),2009,3,0,0,0
Westsahara (ab 2013),2009,4,0,0,0
Westsahara (ab 2013),2009,5,0,0,0
Westsahara (ab 2013),2009,6,0,0,0
Westsahara (ab 2013),2009,7,0,0,0
Westsahara (ab 2013),2009,8,0,0,0
Westsahara (ab 2013),2009,9,0,0,0
Westsahara (ab 2013),2009,10,0,0,0
Westsahara (ab 2013),2009,11,0,0,0
Westsahara (ab 2013),2009,12,0,0,0
Westsahara (ab 2013),2010,1,0,0,0
Westsahara (ab 2013),2010,2,0,0,0
Westsahara (ab 2013),2010,3,0,0,0
Westsahara (ab 2013),2010,4,0,0,0
Westsahara (ab 2013),2010,5,0,0,0
Westsahara (ab 2013),2010,6,0,0,0
Westsahara (ab 2013),2010,7,0,0,0
Westsahara (ab 2013),2010,8,0,0,0
Westsahara (ab 2013),2010,9,0,0,0
Westsahara (ab 2013),2010,10,0,0,0
Westsahara (ab 2013),2010,11,0,0,0
Westsahara (ab 2013),2010,12,0,0,0
Westsahara (ab 2013),2011,1,0,0,0
Westsahara (ab 2013),2011,2,0,0,0
Westsahara (ab 2013),2011,3,0,0,0
Westsahara (ab 2013),2011,4,0,0,0
Westsahara (ab 2013),2011,5,0,0,0
Westsahara (ab 2013),2011,6,0,0,0
Westsahara (ab 2013),2011,7,0,0,0
Westsahara (ab 2013),2011,8,0,0,0
Westsahara (ab 2013),2011,9,0,0,0
Westsahara (ab 2013),2011,10,0,0,0
Westsahara (ab 2013),2011,11,0,0,0
Westsahara (ab 2013),2011,12,0,0,0
Westsahara (ab 2013),2012,1,0,0,0
Westsahara (ab 2013),2012,2,0,0,0
Westsahara (ab 2013),2012,3,0,0,0
Westsahara (ab 2013),2012,4,0,0,0
Westsahara (ab 2013),2012,5,0,0,0
Westsahara (ab 2013),2012,6,0,0,0
Westsahara (ab 2013),2012,7,0,0,0
Westsahara (ab 2013),2012,8,0,0,0
Westsahara (ab 2013),2012,9,0,0,0
Westsahara (ab 2013),2012,10,0,0,0
Westsahara (ab 2013),2012,11,0,0,0
Westsahara (ab 2013),2012,12,0,0,0
Westsahara (ab 2013),2013,1,8000,0,8000
Westsahara (ab 2013),2013,2,0,0,0
Westsahara (ab 2013),2013,3,2000,0,2000
Westsahara (ab 2013),2013,4,0,0,0
Westsahara (ab 2013),2013,5,0,0,0
Westsahara (ab 2013),2013,6,13000,0,13000
Westsahara (ab 2013),2013,7,0,0,0
Westsahara (ab 2013),2013,8,0,0,0
Westsahara (ab 2013),2013,9,0,0,0
Westsahara (ab 2013),2013,10,0,0,0
Westsahara (ab 2013),2013,11,0,0,0
Westsahara (ab 2013),2013,12,53000,0,53000
Westsahara (ab 2013),2014,1,0,0,0
Westsahara (ab 2013),2014,2,0,0,0
Westsahara (ab 2013),2014,3,0,9000,9000
Westsahara (ab 2013),2014,4,44000,0,44000
Westsahara (ab 2013),2014,5,34000,0,34000
Westsahara (ab 2013),2014,6,0,0,0
Westsahara (ab 2013),2014,7,41000,0,41000
Westsahara (ab 2013),2014,8,44000,0,44000
Westsahara (ab 2013),2014,9,0,0,0
Westsahara (ab 2013),2014,10,38000,0,38000
Westsahara (ab 2013),2014,11,0,0,0
Westsahara (ab 2013),2014,12,0,0,0
Westsahara (ab 2013),2015,1,0,0,0
Westsahara (ab 2013),2015,2,0,0,0
Westsahara (ab 2013),2015,3,0,0,0
Westsahara (ab 2013),2015,4,0,0,0
Westsahara (ab 2013),2015,5,14000,0,14000
Westsahara (ab 2013),2015,6,153000,0,153000
Westsahara (ab 2013),2015,7,23000,0,23000
Westsahara (ab 2013),2015,8,0,0,0
Westsahara (ab 2013),2015,9,0,0,0
Westsahara (ab 2013),2015,10,0,0,0
Westsahara (ab 2013),2015,11,0,0,0
Westsahara (ab 2013),2015,12,67000,0,67000
Westsahara (ab 2013),2016,1,0,0,0
Westsahara (ab 2013),2016,2,0,0,0
Westsahara (ab 2013),2016,3,21000,0,21000
Westsahara (ab 2013),2016,4,9000,0,9000
Westsahara (ab 2013),2016,5,0,0,0
Westsahara (ab 2013),2016,6,0,0,0
Westsahara (ab 2013),2016,7,0,0,0
Westsahara (ab 2013),2016,8,27000,0,27000
Westsahara (ab 2013),2016,9,0,0,0
Westsahara (ab 2013),2016,10,16000,0,16000
Westsahara (ab 2013),2016,11,11000,0,11000
Westsahara (ab 2013),2016,12,0,0,0
Westsahara (ab 2013),2017,1,24000,0,24000
Westsahara (ab 2013),2017,2,6000,0,6000
Westsahara (ab 2013),2017,3,0,0,0
Westsahara (ab 2013),2017,4,0,0,0
Westsahara (ab 2013),2017,5,0,0,0
Westsahara (ab 2013),2017,6,4000,0,4000
Westsahara (ab 2013),2017,7,3000,0,3000
Westsahara (ab 2013),2017,8,3000,0,3000
Westsahara (ab 2013),2017,9,0,0,0
Westsahara (ab 2013),2017,10,0,0,0
Westsahara (ab 2013),2017,11,0,0,0
Westsahara (ab 2013),2017,12,0,0,0
Westsahara (ab 2013),2018,1,0,0,0
Westsahara (ab 2013),2018,2,0,0,0
Westsahara (ab 2013),2018,3,0,0,0
Westsahara (ab 2013),2018,4,7000,0,7000
Westsahara (ab 2013),2018,5,13000,0,13000
Westsahara (ab 2013),2018,6,23000,0,23000
Westsahara (ab 2013),2018,7,0,0,0
Westsahara (ab 2013),2018,8,13000,0,13000
Westsahara (ab 2013),2018,9,1000,0,1000
Westsahara (ab 2013),2018,10,0,0,0
Westsahara (ab 2013),2018,11,3000,0,3000
Westsahara (ab 2013),2018,12,0,0,0
Westsahara (ab 2013),2019,1,11000,0,11000
Westsahara (ab 2013),2019,2,20000,0,20000
Westsahara (ab 2013),2019,3,0,8000,8000
Westsahara (ab 2013),2019,4,0,0,0
Westsahara (ab 2013),2019,5,0,0,0
Westsahara (ab 2013),2019,6,0,0,0
Westsahara (ab 2013),2019,7,13000,0,13000
Westsahara (ab 2013),2019,8,0,0,0
Westsahara (ab 2013),2019,9,0,0,0
Westsahara (ab 2013),2019,10,3000,0,3000
Westsahara (ab 2013),2019,11,0,0,0
Westsahara (ab 2013),2019,12,0,0,0
Westsahara (ab 2013),2020,1,14000,0,14000
Westsahara (ab 2013),2020,2,0,0,0
Westsahara (ab 2013),2020,3,0,0,0
Westsahara (ab 2013),2020,4,0,0,0
Westsahara (ab 2013),2020,5,0,0,0
Westsahara (ab 2013),2020,6,0,0,0
Westsahara (ab 2013),2020,7,0,0,0
Westsahara (ab 2013),2020,8,0,5000,5000
Westsahara (ab 2013),2020,9,0,0,0
Westsahara (ab 2013),2020,10,0,0,0
Westsahara (ab 2013),2020,11,0,0,0
Westsahara (ab 2013),2020,12,0,0,0
Westsahara (ab 2013),2021,1,0,0,0
Westsahara (ab 2013),2021,2,64000,0,64000
Westsahara (ab 2013),2021,3,1000,0,1000
Westsahara (ab 2013),2021,4,0,0,0
Westsahara (ab 2013),2021,5,1000,0,1000
Westsahara (ab 2013),2021,6,1000,0,1000
Westsahara (ab 2013),2021,7,0,0,0
Westsahara (ab 2013),2021,8,0,1000,1000
Westsahara (ab 2013),2021,9,0,0,0
Westsahara (ab 2013),2021,10,3000,0,3000
Westsahara (ab 2013),2021,11,0,0,0
Westsahara (ab 2013),2021,12,2000,0,2000
Westsahara (ab 2013),2022,1,1000,1000,2000
Westsahara (ab 2013),2022,2,3000,0,3000
Westsahara (ab 2013),2022,3,1000,7000,8000
Westsahara (ab 2013),2022,4,6000,9000,15000
Westsahara (ab 2013),2022,5,0,7000,7000
Westsahara (ab 2013),2022,6,0,5000,5000
Westsahara (ab 2013),2022,7,0,6000,6000
Westsahara (ab 2013),2022,8,0,7000,7000
Westsahara (ab 2013),2022,9,4000,6000,10000
Westsahara (ab 2013),2022,10,0,8000,8000
Westsahara (ab 2013),2022,11,0,10000,10000
Westsahara (ab 2013),2022,12,0,14000,14000
Westsahara (ab 2013),2023,1,3000,10000,13000
Westsahara (ab 2013),2023,2,7000,4000,11000
Westsahara (ab 2013),2023,3,43000,5000,48000
Westsahara (ab 2013),2023,4,0,6000,6000
Westsahara (ab 2013),2023,5,56000,7000,63000
Westsahara (ab 2013),2023,6,2000,4000,6000
Westsahara (ab 2013),2023,7,1000,3000,4000
Westsahara (ab 2013),2023,8,5000,4000,9000
Westsahara (ab 2013),2023,9,12000,4000,16000
Westsahara (ab 2013),2023,10,0,4000,4000
Westsahara (ab 2013),2023,11,0,19000,19000
Westsahara (ab 2013),2023,12,0,10000,10000
Westsahara (ab 2013),2024,1,0,8000,8000
Westsahara (ab 2013),2024,2,0,8000,8000
Westsahara (ab 2013),2024,3,8000,7000,15000
Westsahara (ab 2013),2024,4,0,7000,7000
Westsahara (ab 2013),2024,5,0,6000,6000
Westsahara (ab 2013),2024,6,0,4000,4000
Westsahara (ab 2013),2024,7,0,4000,4000
Westsahara (ab 2013),2024,8,0,5000,5000
Westsahara (ab 2013),2024,9,0,4000,4000
Westsahara (ab 2013),2024,10,0,2000,2000
Westsahara (ab 2013),2024,11,0,7000,7000
Westsahara (ab 2013),2024,12,1000,8000,9000
Zentralafrikanische Republik,2008,1,118000,15000,133000
Zentralafrikanische Republik,2008,2,340000,289000,629000
Zentralafrikanische Republik,2008,3,256000,30000,286000
Zentralafrikanische Republik,2008,4,283000,110000,393000
Zentralafrikanische Republik,2008,5,261000,54000,315000
Zentralafrikanische Republik,2008,6,209000,1000,210000
Zentralafrikanische Republik,2008,7,359000,112000,471000
Zentralafrikanische Republik,2008,8,155000,327000,482000
Zentralafrikanische Republik,2008,9,92000,151000,243000
Zentralafrikanische Republik,2008,10,83000,0,83000
Zentralafrikanische Republik,2008,11,172000,116000,288000
Zentralafrikanische Republik,2008,12,157000,2000,159000
Zentralafrikanische Republik,2009,1,74000,185000,259000
Zentralafrikanische Republik,2009,2,178000,617000,795000
Zentralafrikanische Republik,2009,3,678000,332000,1010000
Zentralafrikanische Republik,2009,4,244000,864000,1108000
Zentralafrikanische Republik,2009,5,136000,65000,201000
Zentralafrikanische Republik,2009,6,223000,42000,265000
Zentralafrikanische Republik,2009,7,200000,140000,340000
Zentralafrikanische Republik,2009,8,513000,57000,570000
Zentralafrikanische Republik,2009,9,209000,194000,403000
Zentralafrikanische Republik,2009,10,448000,60000,508000
Zentralafrikanische Republik,2009,11,123000,55000,178000
Zentralafrikanische Republik,2009,12,187000,82000,269000
Zentralafrikanische Republik,2010,1,120000,80000,200000
Zentralafrikanische Republik,2010,2,394000,161000,555000
Zentralafrikanische Republik,2010,3,389000,329000,718000
Zentralafrikanische Republik,2010,4,76000,74000,150000
Zentralafrikanische Republik,2010,5,1092000,254000,1346000
Zentralafrikanische Republik,2010,6,464000,170000,634000
Zentralafrikanische Republik,2010,7,341000,221000,562000
Zentralafrikanische Republik,2010,8,157000,46000,203000
Zentralafrikanische Republik,2010,9,60000,8000,68000
Zentralafrikanische Republik,2010,10,699000,139000,838000
Zentralafrikanische Republik,2010,11,333000,10000,343000
Zentralafrikanische Republik,2010,12,256000,76000,332000
Zentralafrikanische Republik,2011,1,162000,93000,255000
Zentralafrikanische Republik,2011,2,107000,83000,190000
Zentralafrikanische Republik,2011,3,387000,34000,421000
Zentralafrikanische Republik,2011,4,181000,229000,410000
Zentralafrikanische Republik,2011,5,144000,240000,384000
Zentralafrikanische Republik,2011,6,128000,386000,514000
Zentralafrikanische Republik,2011,7,229000,33000,262000
Zentralafrikanische Republik,2011,8,131000,148000,279000
Zentralafrikanische Republik,2011,9,242000,150000,392000
Zentralafrikanische Republik,2011,10,265000,7000,272000
Zentralafrikanische Republik,2011,11,301000,74000,375000
Zentralafrikanische Republik,2011,12,224000,100000,324000
Zentralafrikanische Republik,2012,1,138000,121000,259000
Zentralafrikanische Republik,2012,2,363000,15000,378000
Zentralafrikanische Republik,2012,3,429000,7000,436000
Zentralafrikanische Republik,2012,4,136000,7000,143000
Zentralafrikanische Republik,2012,5,258000,226000,484000
Zentralafrikanische Republik,2012,6,322000,176000,498000
Zentralafrikanische Republik,2012,7,83000,90000,173000
Zentralafrikanische Republik,2012,8,94000,300000,394000
Zentralafrikanische Republik,2012,9,714000,29000,743000
Zentralafrikanische Republik,2012,10,374000,30000,404000
Zentralafrikanische Republik,2012,11,135000,123000,258000
Zentralafrikanische Republik,2012,12,275000,64000,339000
Zentralafrikanische Republik,2013,1,99000,199000,298000
Zentralafrikanische Republik,2013,2,164000,75000,239000
Zentralafrikanische Republik,2013,3,40000,95000,135000
Zentralafrikanische Republik,2013,4,146000,69000,215000
Zentralafrikanische Republik,2013,5,13000,3000,16000
Zentralafrikanische Republik,2013,6,44000,29000,73000
Zentralafrikanische Republik,2013,7,71000,213000,284000
Zentralafrikanische Republik,2013,8,156000,165000,321000
Zentralafrikanische Republik,2013,9,73000,50000,123000
Zentralafrikanische Republik,2013,10,41000,147000,188000
Zentralafrikanische Republik,2013,11,38000,109000,147000
Zentralafrikanische Republik,2013,12,398000,207000,605000
Zentralafrikanische Republik,2014,1,249000,174000,423000
Zentralafrikanische Republik,2014,2,64000,134000,198000
Zentralafrikanische Republik,2014,3,257000,4000,261000
Zentralafrikanische Republik,2014,4,309000,154000,463000
Zentralafrikanische Republik,2014,5,298000,33000,331000
Zentralafrikanische Republik,2014,6,269000,54000,323000
Zentralafrikanische Republik,2014,7,454000,125000,579000
Zentralafrikanische Republik,2014,8,164000,57000,221000
Zentralafrikanische Republik,2014,9,812000,176000,988000
Zentralafrikanische Republik,2014,10,328000,325000,653000
Zentralafrikanische Republik,2014,11,679000,145000,824000
Zentralafrikanische Republik,2014,12,2602000,74000,2676000
Zentralafrikanische Republik,2015,1,184000,3000,187000
Zentralafrikanische Republik,2015,2,287000,95000,382000
Zentralafrikanische Republik,2015,3,887000,153000,1040000
Zentralafrikanische Republik,2015,4,313000,159000,472000
Zentralafrikanische Republik,2015,5,462000,56000,518000
Zentralafrikanische Republik,2015,6,783000,37000,820000
Zentralafrikanische Republik,2015,7,596000,112000,708000
Zentralafrikanische Republik,2015,8,35000,117000,152000
Zentralafrikanische Republik,2015,9,666000,288000,954000
Zentralafrikanische Republik,2015,10,1400000,79000,1479000
Zentralafrikanische Republik,2015,11,577000,201000,778000
Zentralafrikanische Republik,2015,12,3453000,161000,3614000
Zentralafrikanische Republik,2016,1,610000,467000,1077000
Zentralafrikanische Republik,2016,2,370000,100000,470000
Zentralafrikanische Republik,2016,3,725000,266000,991000
Zentralafrikanische Republik,2016,4,282000,2000,284000
Zentralafrikanische Republik,2016,5,289000,113000,402000
Zentralafrikanische Republik,2016,6,996000,253000,1249000
Zentralafrikanische Republik,2016,7,883000,4000,887000
Zentralafrikanische Republik,2016,8,270000,8000,278000
Zentralafrikanische Republik,2016,9,611000,99000,710000
Zentralafrikanische Republik,2016,10,505000,194000,699000
Zentralafrikanische Republik,2016,11,699000,168000,867000
Zentralafrikanische Republik,2016,12,1892000,4000,1896000
Zentralafrikanische Republik,2017,1,824000,42000,866000
Zentralafrikanische Republik,2017,2,435000,175000,610000
Zentralafrikanische Republik,2017,3,743000,5000,748000
Zentralafrikanische Republik,2017,4,390000,290000,680000
Zentralafrikanische Republik,2017,5,286000,90000,376000
Zentralafrikanische Republik,2017,6,1115000,44000,1159000
Zentralafrikanische Republik,2017,7,330000,243000,573000
Zentralafrikanische Republik,2017,8,8191000,4000,8195000
Zentralafrikanische Republik,2017,9,338000,37000,375000
Zentralafrikanische Republik,2017,10,511000,173000,684000
Zentralafrikanische Republik,2017,11,862000,129000,991000
Zentralafrikanische Republik,2017,12,2049000,21000,2070000
Zentralafrikanische Republik,2018,1,146000,180000,326000
Zentralafrikanische Republik,2018,2,135000,7000,142000
Zentralafrikanische Republik,2018,3,372000,21000,393000
Zentralafrikanische Republik,2018,4,163000,202000,365000
Zentralafrikanische Republik,2018,5,480000,14000,494000
Zentralafrikanische Republik,2018,6,1434000,224000,1658000
Zentralafrikanische Republik,2018,7,699000,457000,1156000
Zentralafrikanische Republik,2018,8,706000,239000,945000
Zentralafrikanische Republik,2018,9,1878000,5000,1883000
Zentralafrikanische Republik,2018,10,3112000,46000,3158000
Zentralafrikanische Republik,2018,11,559000,74000,633000
Zentralafrikanische Republik,2018,12,459000,70000,529000
Zentralafrikanische Republik,2019,1,270000,176000,446000
Zentralafrikanische Republik,2019,2,1737000,12000,1749000
Zentralafrikanische Republik,2019,3,1541000,124000,1665000
Zentralafrikanische Republik,2019,4,348000,374000,722000
Zentralafrikanische Republik,2019,5,534000,25000,559000
Zentralafrikanische Republik,2019,6,528000,53000,581000
Zentralafrikanische Republik,2019,7,504000,145000,649000
Zentralafrikanische Republik,2019,8,948000,94000,1042000
Zentralafrikanische Republik,2019,9,454000,110000,564000
Zentralafrikanische Republik,2019,10,1327000,31000,1358000
Zentralafrikanische Republik,2019,11,1094000,56000,1150000
Zentralafrikanische Republik,2019,12,332000,1000,333000
Zentralafrikanische Republik,2020,1,461000,90000,551000
Zentralafrikanische Republik,2020,2,219000,11000,230000
Zentralafrikanische Republik,2020,3,313000,29000,342000
Zentralafrikanische Republik,2020,4,531000,242000,773000
Zentralafrikanische Republik,2020,5,500000,211000,711000
Zentralafrikanische Republik,2020,6,599000,94000,693000
Zentralafrikanische Republik,2020,7,1010000,238000,1248000
Zentralafrikanische Republik,2020,8,463000,5000,468000
Zentralafrikanische Republik,2020,9,1370000,35000,1405000
Zentralafrikanische Republik,2020,10,233000,37000,270000
Zentralafrikanische Republik,2020,11,511000,111000,622000
Zentralafrikanische Republik,2020,12,401000,191000,592000
Zentralafrikanische Republik,2021,1,931000,10000,941000
Zentralafrikanische Republik,2021,2,197000,231000,428000
Zentralafrikanische Republik,2021,3,559000,98000,657000
Zentralafrikanische Republik,2021,4,390000,46000,436000
Zentralafrikanische Republik,2021,5,642000,16000,658000
Zentralafrikanische Republik,2021,6,1237000,247000,1484000
Zentralafrikanische Republik,2021,7,1248000,8000,1256000
Zentralafrikanische Republik,2021,8,206000,15000,221000
Zentralafrikanische Republik,2021,9,894000,350000,1244000
Zentralafrikanische Republik,2021,10,371000,384000,755000
Zentralafrikanische Republik,2021,11,2192000,141000,2333000
Zentralafrikanische Republik,2021,12,231000,45000,276000
Zentralafrikanische Republik,2022,1,1326000,31000,1357000
Zentralafrikanische Republik,2022,2,733000,398000,1131000
Zentralafrikanische Republik,2022,3,388000,211000,599000
Zentralafrikanische Republik,2022,4,694000,187000,881000
Zentralafrikanische Republik,2022,5,486000,397000,883000
Zentralafrikanische Republik,2022,6,629000,43000,672000
Zentralafrikanische Republik,2022,7,233000,92000,325000
Zentralafrikanische Republik,2022,8,949000,341000,1290000
Zentralafrikanische Republik,2022,9,1326000,313000,1639000
Zentralafrikanische Republik,2022,10,347000,137000,484000
Zentralafrikanische Republik,2022,11,187000,430000,617000
Zentralafrikanische Republik,2022,12,559000,267000,826000
Zentralafrikanische Republik,2023,1,1375000,104000,1479000
Zentralafrikanische Republik,2023,2,651000,607000,1258000
Zentralafrikanische Republik,2023,3,1088000,226000,1314000
Zentralafrikanische Republik,2023,4,540000,194000,734000
Zentralafrikanische Republik,2023,5,475000,188000,663000
Zentralafrikanische Republik,2023,6,417000,36000,453000
Zentralafrikanische Republik,2023,7,765000,227000,992000
Zentralafrikanische Republik,2023,8,153000,146000,299000
Zentralafrikanische Republik,2023,9,272000,158000,430000
Zentralafrikanische Republik,2023,10,382000,166000,548000
Zentralafrikanische Republik,2023,11,217000,136000,353000
Zentralafrikanische Republik,2023,12,532000,196000,728000
Zentralafrikanische Republik,2024,1,322000,316000,638000
Zentralafrikanische Republik,2024,2,636000,212000,848000
Zentralafrikanische Republik,2024,3,422000,378000,800000
Zentralafrikanische Republik,2024,4,732000,180000,912000
Zentralafrikanische Republik,2024,5,228000,5000,233000
Zentralafrikanische Republik,2024,6,409000,2000,411000
Zentralafrikanische Republik,2024,7,199000,68000,267000
Zentralafrikanische Republik,2024,8,224000,2000,226000
Zentralafrikanische Republik,2024,9,171000,138000,309000
Zentralafrikanische Republik,2024,10,320000,155000,475000
Zentralafrikanische Republik,2024,11,433000,374000,807000
Zentralafrikanische Republik,2024,12,486000,10000,496000
Zypern,2008,1,58504000,14401000,72905000
Zypern,2008,2,59959000,14404000,74363000
Zypern,2008,3,60004000,50003000,110007000
Zypern,2008,4,62583000,10982000,73565000
Zypern,2008,5,59691000,13913000,73604000
Zypern,2008,6,65851000,15844000,81695000
Zypern,2008,7,64762000,18362000,83124000
Zypern,2008,8,48434000,10566000,59000000
Zypern,2008,9,61902000,11250000,73152000
Zypern,2008,10,61350000,18181000,79531000
Zypern,2008,11,94756000,13023000,107779000
Zypern,2008,12,62245000,6610000,68855000
Zypern,2009,1,38243000,12245000,50488000
Zypern,2009,2,52607000,11798000,64405000
Zypern,2009,3,70000000,13964000,83964000
Zypern,2009,4,42018000,12984000,55002000
Zypern,2009,5,43136000,13319000,56455000
Zypern,2009,6,53211000,11586000,64797000
Zypern,2009,7,46887000,9200000,56087000
Zypern,2009,8,44085000,22508000,66593000
Zypern,2009,9,52585000,9438000,62023000
Zypern,2009,10,67232000,15508000,82740000
Zypern,2009,11,62524000,20268000,82792000
Zypern,2009,12,62041000,11648000,73689000
Zypern,2010,1,49088000,15623000,64711000
Zypern,2010,2,55271000,15893000,71164000
Zypern,2010,3,62400000,18298000,80698000
Zypern,2010,4,50401000,20925000,71326000
Zypern,2010,5,55426000,55385000,110811000
Zypern,2010,6,60014000,31607000,91621000
Zypern,2010,7,71179000,18432000,89611000
Zypern,2010,8,57257000,15555000,72812000
Zypern,2010,9,58749000,10999000,69748000
Zypern,2010,10,65603000,15479000,81082000
Zypern,2010,11,66112000,14575000,80687000
Zypern,2010,12,56114000,17766000,73880000
Zypern,2011,1,50101000,12611000,62712000
Zypern,2011,2,53891000,10342000,64233000
Zypern,2011,3,56341000,92865000,149206000
Zypern,2011,4,61001000,15970000,76971000
Zypern,2011,5,64600000,10791000,75391000
Zypern,2011,6,59094000,11879000,70973000
Zypern,2011,7,65287000,14635000,79922000
Zypern,2011,8,52101000,9434000,61535000
Zypern,2011,9,67991000,18537000,86528000
Zypern,2011,10,100417000,11340000,111757000
Zypern,2011,11,59790000,16058000,75848000
Zypern,2011,12,51137000,11664000,62801000
Zypern,2012,1,65622000,8367000,73989000
Zypern,2012,2,45833000,10227000,56060000
Zypern,2012,3,57795000,10055000,67850000
Zypern,2012,4,44055000,15144000,59199000
Zypern,2012,5,57560000,8668000,66228000
Zypern,2012,6,58531000,9621000,68152000
Zypern,2012,7,58226000,9618000,67844000
Zypern,2012,8,56438000,10585000,67023000
Zypern,2012,9,53805000,7856000,61661000
Zypern,2012,10,61543000,9830000,71373000
Zypern,2012,11,60806000,15189000,75995000
Zypern,2012,12,48546000,16966000,65512000
Zypern,2013,1,78265000,8044000,86309000
Zypern,2013,2,102312000,7677000,109989000
Zypern,2013,3,56803000,9475000,66278000
Zypern,2013,4,42569000,8583000,51152000
Zypern,2013,5,42194000,14489000,56683000
Zypern,2013,6,51178000,11816000,62994000
Zypern,2013,7,49114000,11313000,60427000
Zypern,2013,8,46292000,8138000,54430000
Zypern,2013,9,109505000,6439000,115944000
Zypern,2013,10,54749000,10988000,65737000
Zypern,2013,11,43912000,10841000,54753000
Zypern,2013,12,187840000,9304000,197144000
Zypern,2014,1,36320000,7287000,43607000
Zypern,2014,2,43518000,5381000,48899000
Zypern,2014,3,46223000,8398000,54621000
Zypern,2014,4,44703000,7385000,52088000
Zypern,2014,5,47242000,8879000,56121000
Zypern,2014,6,45429000,8032000,53461000
Zypern,2014,7,52581000,9871000,62452000
Zypern,2014,8,43644000,8477000,52121000
Zypern,2014,9,60272000,7415000,67687000
Zypern,2014,10,46878000,7678000,54556000
Zypern,2014,11,44990000,6744000,51734000
Zypern,2014,12,59893000,7070000,66963000
Zypern,2015,1,39065000,4646000,43711000
Zypern,2015,2,41751000,8727000,50478000
Zypern,2015,3,46875000,10351000,57226000
Zypern,2015,4,40013000,9356000,49369000
Zypern,2015,5,45933000,11951000,57884000
Zypern,2015,6,48384000,9618000,58002000
Zypern,2015,7,65829000,8017000,73846000
Zypern,2015,8,41321000,7896000,49217000
Zypern,2015,9,49514000,11651000,61165000
Zypern,2015,10,46526000,7816000,54342000
Zypern,2015,11,50684000,8800000,59484000
Zypern,2015,12,38817000,9777000,48594000
Zypern,2016,1,42482000,11730000,54212000
Zypern,2016,2,41147000,12760000,53907000
Zypern,2016,3,48343000,14171000,62514000
Zypern,2016,4,49743000,10842000,60585000
Zypern,2016,5,52776000,16846000,69622000
Zypern,2016,6,49900000,14327000,64227000
Zypern,2016,7,153621000,12342000,165963000
Zypern,2016,8,45356000,10464000,55820000
Zypern,2016,9,49273000,12409000,61682000
Zypern,2016,10,51089000,10724000,61813000
Zypern,2016,11,51478000,10732000,62210000
Zypern,2016,12,48147000,8039000,56186000
Zypern,2017,1,40785000,8527000,49312000
Zypern,2017,2,46852000,15840000,62692000
Zypern,2017,3,54032000,6354000,60386000
Zypern,2017,4,47248000,11456000,58704000
Zypern,2017,5,53748000,6453000,60201000
Zypern,2017,6,45479000,9120000,54599000
Zypern,2017,7,50704000,9201000,59905000
Zypern,2017,8,57591000,9343000,66934000
Zypern,2017,9,47797000,12379000,60176000
Zypern,2017,10,51212000,11523000,62735000
Zypern,2017,11,57632000,10928000,68560000
Zypern,2017,12,47201000,7302000,54503000
Zypern,2018,1,51126000,6030000,57156000
Zypern,2018,2,63114000,10562000,73676000
Zypern,2018,3,55749000,6861000,62610000
Zypern,2018,4,53761000,6356000,60117000
Zypern,2018,5,55057000,10098000,65155000
Zypern,2018,6,49398000,10997000,60395000
Zypern,2018,7,49594000,9700000,59294000
Zypern,2018,8,64709000,8718000,73427000
Zypern,2018,9,47770000,8170000,55940000
Zypern,2018,10,52692000,7988000,60680000
Zypern,2018,11,49767000,18121000,67888000
Zypern,2018,12,50378000,5146000,55524000
Zypern,2019,1,50214000,6761000,56975000
Zypern,2019,2,49104000,8741000,57845000
Zypern,2019,3,54507000,12056000,66563000
Zypern,2019,4,46906000,12290000,59196000
Zypern,2019,5,47033000,11091000,58124000
Zypern,2019,6,61042000,10396000,71438000
Zypern,2019,7,51502000,11622000,63124000
Zypern,2019,8,52667000,12337000,65004000
Zypern,2019,9,58356000,7461000,65817000
Zypern,2019,10,56104000,11774000,67878000
Zypern,2019,11,53287000,8657000,61944000
Zypern,2019,12,50543000,8756000,59299000
Zypern,2020,1,46913000,8408000,55321000
Zypern,2020,2,246997000,6780000,253777000
Zypern,2020,3,41457000,7860000,49317000
Zypern,2020,4,34685000,9517000,44202000
Zypern,2020,5,35063000,10707000,45770000
Zypern,2020,6,48402000,9749000,58151000
Zypern,2020,7,51447000,9934000,61381000
Zypern,2020,8,43044000,9540000,52584000
Zypern,2020,9,45458000,8168000,53626000
Zypern,2020,10,47216000,8644000,55860000
Zypern,2020,11,56012000,9985000,65997000
Zypern,2020,12,54327000,16601000,70928000
Zypern,2021,1,49864000,10410000,60274000
Zypern,2021,2,45413000,8277000,53690000
Zypern,2021,3,55984000,15943000,71927000
Zypern,2021,4,58735000,19960000,78695000
Zypern,2021,5,53366000,15565000,68931000
Zypern,2021,6,52101000,25346000,77447000
Zypern,2021,7,91415000,39101000,130516000
Zypern,2021,8,55198000,9728000,64926000
Zypern,2021,9,49467000,8448000,57915000
Zypern,2021,10,52089000,7325000,59414000
Zypern,2021,11,54260000,7012000,61272000
Zypern,2021,12,58772000,9862000,68634000
Zypern,2022,1,79662000,9975000,89637000
Zypern,2022,2,60697000,74064000,134761000
Zypern,2022,3,70464000,34442000,104906000
Zypern,2022,4,52370000,12075000,64445000
Zypern,2022,5,57768000,13908000,71676000
Zypern,2022,6,62561000,12563000,75124000
Zypern,2022,7,58963000,21575000,80538000
Zypern,2022,8,57359000,11419000,68778000
Zypern,2022,9,67347000,13775000,81122000
Zypern,2022,10,60156000,20436000,80592000
Zypern,2022,11,73545000,9182000,82727000
Zypern,2022,12,67597000,38726000,106323000
Zypern,2023,1,64983000,7605000,72588000
Zypern,2023,2,67219000,8882000,76101000
Zypern,2023,3,78533000,27065000,105598000
Zypern,2023,4,58750000,11193000,69943000
Zypern,2023,5,77667000,16034000,93701000
Zypern,2023,6,75308000,11074000,86382000
Zypern,2023,7,67881000,10122000,78003000
Zypern,2023,8,65871000,9720000,75591000
Zypern,2023,9,67013000,7865000,74878000
Zypern,2023,10,71441000,7728000,79169000
Zypern,2023,11,73082000,6894000,79976000
Zypern,2023,12,59480000,7456000,66936000
Zypern,2024,1,65836000,10262000,76098000
Zypern,2024,2,70528000,9225000,79753000
Zypern,2024,3,65662000,11360000,77022000
Zypern,2024,4,69743000,12779000,82522000
Zypern,2024,5,85704000,11790000,97494000
Zypern,2024,6,63519000,11902000,75421000
Zypern,2024,7,77053000,12320000,89373000
Zypern,2024,8,64031000,11450000,75481000
Zypern,2024,9,69715000,7741000,77456000
Zypern,2024,10,73404000,11392000,84796000
Zypern,2024,11,77057000,9954000,87011000
Zypern,2024,12,65004000,8475000,73479000
Ägypten,2008,1,183548000,78316000,261864000
Ägypten,2008,2,192045000,66533000,258578000
Ägypten,2008,3,202178000,56862000,259040000
Ägypten,2008,4,236318000,140204000,376522000
Ägypten,2008,5,194532000,142645000,337177000
Ägypten,2008,6,264699000,146554000,411253000
Ägypten,2008,7,235981000,118076000,354057000
Ägypten,2008,8,225466000,101805000,327271000
Ägypten,2008,9,210129000,101293000,311422000
Ägypten,2008,10,238144000,85243000,323387000
Ägypten,2008,11,277939000,98141000,376080000
Ägypten,2008,12,267999000,47198000,315197000
Ägypten,2009,1,205589000,83769000,289358000
Ägypten,2009,2,232834000,63750000,296584000
Ägypten,2009,3,219209000,54291000,273500000
Ägypten,2009,4,218796000,80867000,299663000
Ägypten,2009,5,212258000,51031000,263289000
Ägypten,2009,6,201856000,80322000,282178000
Ägypten,2009,7,227416000,98312000,325728000
Ägypten,2009,8,232853000,94818000,327671000
Ägypten,2009,9,215664000,68982000,284646000
Ägypten,2009,10,225351000,40208000,265559000
Ägypten,2009,11,234511000,53247000,287758000
Ägypten,2009,12,258683000,60391000,319074000
Ägypten,2010,1,183407000,78616000,262023000
Ägypten,2010,2,234330000,54894000,289224000
Ägypten,2010,3,331080000,42851000,373931000
Ägypten,2010,4,299120000,96254000,395374000
Ägypten,2010,5,249899000,98952000,348851000
Ägypten,2010,6,274656000,72214000,346870000
Ägypten,2010,7,239644000,73007000,312651000
Ägypten,2010,8,258748000,107876000,366624000
Ägypten,2010,9,267527000,97164000,364691000
Ägypten,2010,10,213191000,42816000,256007000
Ägypten,2010,11,234565000,154420000,388985000
Ägypten,2010,12,237726000,43170000,280896000
Ägypten,2011,1,188829000,66189000,255018000
Ägypten,2011,2,186651000,164362000,351013000
Ägypten,2011,3,216136000,97595000,313731000
Ägypten,2011,4,183384000,184221000,367605000
Ägypten,2011,5,203434000,106682000,310116000
Ägypten,2011,6,212631000,214685000,427316000
Ägypten,2011,7,186402000,288037000,474439000
Ägypten,2011,8,198565000,92457000,291022000
Ägypten,2011,9,199149000,106699000,305848000
Ägypten,2011,10,179353000,92814000,272167000
Ägypten,2011,11,188993000,125415000,314408000
Ägypten,2011,12,224370000,139151000,363521000
Ägypten,2012,1,165274000,125800000,291074000
Ägypten,2012,2,222838000,122378000,345216000
Ägypten,2012,3,262346000,265765000,528111000
Ägypten,2012,4,211447000,101750000,313197000
Ägypten,2012,5,222855000,147687000,370542000
Ägypten,2012,6,214125000,140352000,354477000
Ägypten,2012,7,236588000,80067000,316655000
Ägypten,2012,8,219430000,110117000,329547000
Ägypten,2012,9,220921000,56585000,277506000
Ägypten,2012,10,222476000,82554000,305030000
Ägypten,2012,11,227956000,90814000,318770000
Ägypten,2012,12,218173000,90581000,308754000
Ägypten,2013,1,205311000,138055000,343366000
Ägypten,2013,2,213307000,169520000,382827000
Ägypten,2013,3,235847000,116772000,352619000
Ägypten,2013,4,236655000,146777000,383432000
Ägypten,2013,5,193001000,64568000,257569000
Ägypten,2013,6,202500000,128775000,331275000
Ägypten,2013,7,190352000,114478000,304830000
Ägypten,2013,8,176559000,118095000,294654000
Ägypten,2013,9,187241000,76409000,263650000
Ägypten,2013,10,176247000,132596000,308843000
Ägypten,2013,11,189031000,184806000,373837000
Ägypten,2013,12,174694000,97581000,272275000
Ägypten,2014,1,205993000,176792000,382785000
Ägypten,2014,2,225539000,127973000,353512000
Ägypten,2014,3,232601000,122495000,355096000
Ägypten,2014,4,232187000,126673000,358860000
Ägypten,2014,5,223426000,112745000,336171000
Ägypten,2014,6,212714000,103397000,316111000
Ägypten,2014,7,278426000,230612000,509038000
Ägypten,2014,8,204743000,168264000,373007000
Ägypten,2014,9,257102000,78635000,335737000
Ägypten,2014,10,258053000,80459000,338512000
Ägypten,2014,11,254930000,99586000,354516000
Ägypten,2014,12,279199000,100312000,379511000
Ägypten,2015,1,236929000,171997000,408926000
Ägypten,2015,2,263849000,129432000,393281000
Ägypten,2015,3,307613000,98605000,406218000
Ägypten,2015,4,298880000,126821000,425701000
Ägypten,2015,5,253910000,93553000,347463000
Ägypten,2015,6,308377000,251801000,560178000
Ägypten,2015,7,292095000,176880000,468975000
Ägypten,2015,8,230562000,144608000,375170000
Ägypten,2015,9,265108000,212551000,477659000
Ägypten,2015,10,266773000,128432000,395205000
Ägypten,2015,11,255911000,83986000,339897000
Ägypten,2015,12,342149000,119830000,461979000
Ägypten,2016,1,172693000,73390000,246083000
Ägypten,2016,2,351710000,81269000,432979000
Ägypten,2016,3,511996000,96226000,608222000
Ägypten,2016,4,487334000,92693000,580027000
Ägypten,2016,5,377303000,67911000,445214000
Ägypten,2016,6,353084000,139155000,492239000
Ägypten,2016,7,275704000,83851000,359555000
Ägypten,2016,8,346804000,137446000,484250000
Ägypten,2016,9,329602000,64741000,394343000
Ägypten,2016,10,359933000,119682000,479615000
Ägypten,2016,11,385204000,90908000,476112000
Ägypten,2016,12,454213000,87304000,541517000
Ägypten,2017,1,386039000,115422000,501461000
Ägypten,2017,2,714455000,104722000,819177000
Ägypten,2017,3,461305000,111007000,572312000
Ägypten,2017,4,312871000,112314000,425185000
Ägypten,2017,5,366898000,127385000,494283000
Ägypten,2017,6,292381000,84261000,376642000
Ägypten,2017,7,232883000,104691000,337574000
Ägypten,2017,8,284212000,121972000,406184000
Ägypten,2017,9,233151000,143728000,376879000
Ägypten,2017,10,500614000,98528000,599142000
Ägypten,2017,11,274217000,131026000,405243000
Ägypten,2017,12,300044000,111323000,411367000
Ägypten,2018,1,228178000,109920000,338098000
Ägypten,2018,2,251166000,116120000,367286000
Ägypten,2018,3,256191000,100862000,357053000
Ägypten,2018,4,351091000,143257000,494348000
Ägypten,2018,5,224582000,122739000,347321000
Ägypten,2018,6,269393000,128712000,398105000
Ägypten,2018,7,300350000,127908000,428258000
Ägypten,2018,8,253404000,145373000,398777000
Ägypten,2018,9,264114000,99482000,363596000
Ägypten,2018,10,296213000,51761000,347974000
Ägypten,2018,11,320729000,99576000,420305000
Ägypten,2018,12,271438000,58322000,329760000
Ägypten,2019,1,281485000,110128000,391613000
Ägypten,2019,2,251084000,127806000,378890000
Ägypten,2019,3,347034000,127528000,474562000
Ägypten,2019,4,298717000,71187000,369904000
Ägypten,2019,5,315738000,133579000,449317000
Ägypten,2019,6,307230000,154091000,461321000
Ägypten,2019,7,319316000,180845000,500161000
Ägypten,2019,8,278593000,70801000,349394000
Ägypten,2019,9,262822000,136665000,399487000
Ägypten,2019,10,305899000,124441000,430340000
Ägypten,2019,11,346489000,113593000,460082000
Ägypten,2019,12,300469000,121541000,422010000
Ägypten,2020,1,303924000,96968000,400892000
Ägypten,2020,2,292984000,91967000,384951000
Ägypten,2020,3,344123000,91165000,435288000
Ägypten,2020,4,496955000,66054000,563009000
Ägypten,2020,5,254405000,80259000,334664000
Ägypten,2020,6,361768000,90898000,452666000
Ägypten,2020,7,289042000,114314000,403356000
Ägypten,2020,8,220503000,93154000,313657000
Ägypten,2020,9,305941000,89015000,394956000
Ägypten,2020,10,370133000,87961000,458094000
Ägypten,2020,11,456996000,87694000,544690000
Ägypten,2020,12,324617000,61651000,386268000
Ägypten,2021,1,274225000,62690000,336915000
Ägypten,2021,2,298990000,120244000,419234000
Ägypten,2021,3,358530000,86651000,445181000
Ägypten,2021,4,365156000,72993000,438149000
Ägypten,2021,5,298312000,92369000,390681000
Ägypten,2021,6,299602000,109063000,408665000
Ägypten,2021,7,604759000,90238000,694997000
Ägypten,2021,8,298412000,82090000,380502000
Ägypten,2021,9,395647000,81438000,477085000
Ägypten,2021,10,227408000,93468000,320876000
Ägypten,2021,11,372178000,62825000,435003000
Ägypten,2021,12,353437000,67044000,420481000
Ägypten,2022,1,283900000,67853000,351753000
Ägypten,2022,2,327673000,74190000,401863000
Ägypten,2022,3,343523000,114853000,458376000
Ägypten,2022,4,248845000,154142000,402987000
Ägypten,2022,5,297536000,98628000,396164000
Ägypten,2022,6,362851000,95621000,458472000
Ägypten,2022,7,285209000,103622000,388831000
Ägypten,2022,8,347614000,145682000,493296000
Ägypten,2022,9,315590000,129304000,444894000
Ägypten,2022,10,640696000,135885000,776581000
Ägypten,2022,11,387332000,83442000,470774000
Ägypten,2022,12,349519000,106887000,456406000
Ägypten,2023,1,229524000,150699000,380223000
Ägypten,2023,2,378267000,128884000,507151000
Ägypten,2023,3,454305000,97124000,551429000
Ägypten,2023,4,245766000,79382000,325148000
Ägypten,2023,5,676583000,137608000,814191000
Ägypten,2023,6,489047000,159404000,648451000
Ägypten,2023,7,388835000,160282000,549117000
Ägypten,2023,8,391601000,129438000,521039000
Ägypten,2023,9,477601000,116743000,594344000
Ägypten,2023,10,397035000,138093000,535128000
Ägypten,2023,11,446272000,128851000,575123000
Ägypten,2023,12,789642000,72167000,861809000
Ägypten,2024,1,313647000,138221000,451868000
Ägypten,2024,2,295028000,101156000,396184000
Ägypten,2024,3,334122000,132097000,466219000
Ägypten,2024,4,329006000,149322000,478328000
Ägypten,2024,5,297728000,153249000,450977000
Ägypten,2024,6,311360000,125696000,437056000
Ägypten,2024,7,354732000,139950000,494682000
Ägypten,2024,8,371999000,98089000,470088000
Ägypten,2024,9,288164000,136938000,425102000
Ägypten,2024,10,344879000,98890000,443769000
Ägypten,2024,11,362544000,109308000,471852000
Ägypten,2024,12,319281000,160651000,479932000
Äquatorialguinea,2008,1,1954000,2225000,4179000
Äquatorialguinea,2008,2,1465000,1249000,2714000
Äquatorialguinea,2008,3,1522000,875000,2397000
Äquatorialguinea,2008,4,1466000,7627000,9093000
Äquatorialguinea,2008,5,859000,1619000,2478000
Äquatorialguinea,2008,6,1496000,3000,1499000
Äquatorialguinea,2008,7,1388000,50988000,52376000
Äquatorialguinea,2008,8,3097000,32014000,35111000
Äquatorialguinea,2008,9,2006000,4737000,6743000
Äquatorialguinea,2008,10,1596000,2980000,4576000
Äquatorialguinea,2008,11,2891000,527000,3418000
Äquatorialguinea,2008,12,3083000,15000,3098000
Äquatorialguinea,2009,1,3647000,338000,3985000
Äquatorialguinea,2009,2,2451000,0,2451000
Äquatorialguinea,2009,3,1336000,149000,1485000
Äquatorialguinea,2009,4,2037000,541000,2578000
Äquatorialguinea,2009,5,1578000,409000,1987000
Äquatorialguinea,2009,6,1872000,53000,1925000
Äquatorialguinea,2009,7,2020000,425000,2445000
Äquatorialguinea,2009,8,943000,148000,1091000
Äquatorialguinea,2009,9,1777000,663000,2440000
Äquatorialguinea,2009,10,1065000,98000,1163000
Äquatorialguinea,2009,11,2376000,389000,2765000
Äquatorialguinea,2009,12,2064000,391000,2455000
Äquatorialguinea,2010,1,916000,901000,1817000
Äquatorialguinea,2010,2,1892000,212000,2104000
Äquatorialguinea,2010,3,1797000,217000,2014000
Äquatorialguinea,2010,4,1197000,1091000,2288000
Äquatorialguinea,2010,5,1981000,235000,2216000
Äquatorialguinea,2010,6,1177000,441000,1618000
Äquatorialguinea,2010,7,2723000,0,2723000
Äquatorialguinea,2010,8,1458000,450000,1908000
Äquatorialguinea,2010,9,2198000,0,2198000
Äquatorialguinea,2010,10,1424000,0,1424000
Äquatorialguinea,2010,11,3742000,0,3742000
Äquatorialguinea,2010,12,3045000,276000,3321000
Äquatorialguinea,2011,1,2628000,349000,2977000
Äquatorialguinea,2011,2,6792000,1000,6793000
Äquatorialguinea,2011,3,4018000,34000,4052000
Äquatorialguinea,2011,4,2525000,42000,2567000
Äquatorialguinea,2011,5,3146000,0,3146000
Äquatorialguinea,2011,6,4075000,60000,4135000
Äquatorialguinea,2011,7,2608000,1354000,3962000
Äquatorialguinea,2011,8,2607000,20000,2627000
Äquatorialguinea,2011,9,2196000,18000,2214000
Äquatorialguinea,2011,10,3023000,0,3023000
Äquatorialguinea,2011,11,2458000,22802000,25260000
Äquatorialguinea,2011,12,1866000,4763000,6629000
Äquatorialguinea,2012,1,1352000,389000,1741000
Äquatorialguinea,2012,2,3696000,31000,3727000
Äquatorialguinea,2012,3,1270000,402000,1672000
Äquatorialguinea,2012,4,1052000,1302000,2354000
Äquatorialguinea,2012,5,1420000,2372000,3792000
Äquatorialguinea,2012,6,2624000,15406000,18030000
Äquatorialguinea,2012,7,1934000,14731000,16665000
Äquatorialguinea,2012,8,3987000,14190000,18177000
Äquatorialguinea,2012,9,2030000,14570000,16600000
Äquatorialguinea,2012,10,3714000,7124000,10838000
Äquatorialguinea,2012,11,5762000,1402000,7164000
Äquatorialguinea,2012,12,5792000,2176000,7968000
Äquatorialguinea,2013,1,2062000,4735000,6797000
Äquatorialguinea,2013,2,1966000,14167000,16133000
Äquatorialguinea,2013,3,1983000,5924000,7907000
Äquatorialguinea,2013,4,2137000,30392000,32529000
Äquatorialguinea,2013,5,1716000,1206000,2922000
Äquatorialguinea,2013,6,2179000,1494000,3673000
Äquatorialguinea,2013,7,3170000,9412000,12582000
Äquatorialguinea,2013,8,3026000,1470000,4496000
Äquatorialguinea,2013,9,1758000,1866000,3624000
Äquatorialguinea,2013,10,2273000,6693000,8966000
Äquatorialguinea,2013,11,1851000,1768000,3619000
Äquatorialguinea,2013,12,1062000,2194000,3256000
Äquatorialguinea,2014,1,1140000,3012000,4152000
Äquatorialguinea,2014,2,1330000,1461000,2791000
Äquatorialguinea,2014,3,1052000,1274000,2326000
Äquatorialguinea,2014,4,1342000,1860000,3202000
Äquatorialguinea,2014,5,2291000,17724000,20015000
Äquatorialguinea,2014,6,2278000,1189000,3467000
Äquatorialguinea,2014,7,2438000,2622000,5060000
Äquatorialguinea,2014,8,838000,3320000,4158000
Äquatorialguinea,2014,9,1229000,2787000,4016000
Äquatorialguinea,2014,10,1488000,2725000,4213000
Äquatorialguinea,2014,11,1800000,2529000,4329000
Äquatorialguinea,2014,12,2018000,23532000,25550000
Äquatorialguinea,2015,1,1348000,2022000,3370000
Äquatorialguinea,2015,2,3434000,21292000,24726000
Äquatorialguinea,2015,3,1872000,5304000,7176000
Äquatorialguinea,2015,4,3947000,9360000,13307000
Äquatorialguinea,2015,5,1494000,25174000,26668000
Äquatorialguinea,2015,6,2156000,1096000,3252000
Äquatorialguinea,2015,7,1381000,2289000,3670000
Äquatorialguinea,2015,8,4295000,1188000,5483000
Äquatorialguinea,2015,9,1685000,1560000,3245000
Äquatorialguinea,2015,10,2190000,1160000,3350000
Äquatorialguinea,2015,11,1335000,968000,2303000
Äquatorialguinea,2015,12,1809000,1016000,2825000
Äquatorialguinea,2016,1,1033000,1252000,2285000
Äquatorialguinea,2016,2,962000,827000,1789000
Äquatorialguinea,2016,3,2414000,590000,3004000
Äquatorialguinea,2016,4,1121000,1084000,2205000
Äquatorialguinea,2016,5,1226000,1217000,2443000
Äquatorialguinea,2016,6,1588000,869000,2457000
Äquatorialguinea,2016,7,1044000,1614000,2658000
Äquatorialguinea,2016,8,1520000,2871000,4391000
Äquatorialguinea,2016,9,1391000,23553000,24944000
Äquatorialguinea,2016,10,985000,16845000,17830000
Äquatorialguinea,2016,11,1558000,26214000,27772000
Äquatorialguinea,2016,12,1847000,11189000,13036000
Äquatorialguinea,2017,1,1618000,22953000,24571000
Äquatorialguinea,2017,2,1073000,28787000,29860000
Äquatorialguinea,2017,3,1215000,2914000,4129000
Äquatorialguinea,2017,4,467000,2852000,3319000
Äquatorialguinea,2017,5,1515000,3521000,5036000
Äquatorialguinea,2017,6,997000,2947000,3944000
Äquatorialguinea,2017,7,1706000,3993000,5699000
Äquatorialguinea,2017,8,1228000,2868000,4096000
Äquatorialguinea,2017,9,790000,1783000,2573000
Äquatorialguinea,2017,10,1036000,1374000,2410000
Äquatorialguinea,2017,11,1666000,1543000,3209000
Äquatorialguinea,2017,12,1615000,22604000,24219000
Äquatorialguinea,2018,1,2391000,24936000,27327000
Äquatorialguinea,2018,2,1120000,1968000,3088000
Äquatorialguinea,2018,3,1698000,2981000,4679000
Äquatorialguinea,2018,4,1151000,2841000,3992000
Äquatorialguinea,2018,5,1717000,1993000,3710000
Äquatorialguinea,2018,6,1102000,22592000,23694000
Äquatorialguinea,2018,7,1659000,6239000,7898000
Äquatorialguinea,2018,8,1314000,3145000,4459000
Äquatorialguinea,2018,9,978000,1329000,2307000
Äquatorialguinea,2018,10,1801000,1895000,3696000
Äquatorialguinea,2018,11,2114000,1745000,3859000
Äquatorialguinea,2018,12,1498000,2233000,3731000
Äquatorialguinea,2019,1,1866000,2176000,4042000
Äquatorialguinea,2019,2,2031000,3252000,5283000
Äquatorialguinea,2019,3,2207000,24719000,26926000
Äquatorialguinea,2019,4,1815000,33631000,35446000
Äquatorialguinea,2019,5,2054000,2511000,4565000
Äquatorialguinea,2019,6,1441000,3340000,4781000
Äquatorialguinea,2019,7,1156000,2056000,3212000
Äquatorialguinea,2019,8,1630000,3259000,4889000
Äquatorialguinea,2019,9,1183000,1896000,3079000
Äquatorialguinea,2019,10,1441000,1032000,2473000
Äquatorialguinea,2019,11,1232000,2171000,3403000
Äquatorialguinea,2019,12,3648000,1564000,5212000
Äquatorialguinea,2020,1,1907000,1551000,3458000
Äquatorialguinea,2020,2,1530000,1731000,3261000
Äquatorialguinea,2020,3,1582000,1860000,3442000
Äquatorialguinea,2020,4,1387000,502000,1889000
Äquatorialguinea,2020,5,1045000,1525000,2570000
Äquatorialguinea,2020,6,512000,1673000,2185000
Äquatorialguinea,2020,7,1089000,851000,1940000
Äquatorialguinea,2020,8,1365000,742000,2107000
Äquatorialguinea,2020,9,1178000,1264000,2442000
Äquatorialguinea,2020,10,1673000,461000,2134000
Äquatorialguinea,2020,11,1943000,1124000,3067000
Äquatorialguinea,2020,12,528000,1719000,2247000
Äquatorialguinea,2021,1,1416000,1274000,2690000
Äquatorialguinea,2021,2,2833000,2167000,5000000
Äquatorialguinea,2021,3,1414000,1927000,3341000
Äquatorialguinea,2021,4,687000,2197000,2884000
Äquatorialguinea,2021,5,1385000,1379000,2764000
Äquatorialguinea,2021,6,1455000,4920000,6375000
Äquatorialguinea,2021,7,1449000,1887000,3336000
Äquatorialguinea,2021,8,762000,4073000,4835000
Äquatorialguinea,2021,9,1576000,1988000,3564000
Äquatorialguinea,2021,10,1696000,1070000,2766000
Äquatorialguinea,2021,11,1966000,2333000,4299000
Äquatorialguinea,2021,12,1100000,3061000,4161000
Äquatorialguinea,2022,1,675000,2869000,3544000
Äquatorialguinea,2022,2,1542000,1461000,3003000
Äquatorialguinea,2022,3,1206000,3110000,4316000
Äquatorialguinea,2022,4,1360000,3359000,4719000
Äquatorialguinea,2022,5,1922000,67799000,69721000
Äquatorialguinea,2022,6,1640000,52190000,53830000
Äquatorialguinea,2022,7,1865000,29755000,31620000
Äquatorialguinea,2022,8,1192000,5898000,7090000
Äquatorialguinea,2022,9,1206000,23376000,24582000
Äquatorialguinea,2022,10,1949000,50727000,52676000
Äquatorialguinea,2022,11,1449000,83049000,84498000
Äquatorialguinea,2022,12,1614000,38374000,39988000
Äquatorialguinea,2023,1,391000,9161000,9552000
Äquatorialguinea,2023,2,1223000,6486000,7709000
Äquatorialguinea,2023,3,1352000,12206000,13558000
Äquatorialguinea,2023,4,1042000,11614000,12656000
Äquatorialguinea,2023,5,1260000,10664000,11924000
Äquatorialguinea,2023,6,1424000,9263000,10687000
Äquatorialguinea,2023,7,2338000,10126000,12464000
Äquatorialguinea,2023,8,1420000,10014000,11434000
Äquatorialguinea,2023,9,1257000,6411000,7668000
Äquatorialguinea,2023,10,3053000,7208000,10261000
Äquatorialguinea,2023,11,2799000,7831000,10630000
Äquatorialguinea,2023,12,5549000,15489000,21038000
Äquatorialguinea,2024,1,1892000,46269000,48161000
Äquatorialguinea,2024,2,2118000,7614000,9732000
Äquatorialguinea,2024,3,2206000,8415000,10621000
Äquatorialguinea,2024,4,1683000,7067000,8750000
Äquatorialguinea,2024,5,2454000,6500000,8954000
Äquatorialguinea,2024,6,496000,12982000,13478000
Äquatorialguinea,2024,7,2070000,9439000,11509000
Äquatorialguinea,2024,8,1067000,9328000,10395000
Äquatorialguinea,2024,9,1702000,7601000,9303000
Äquatorialguinea,2024,10,1422000,6776000,8198000
Äquatorialguinea,2024,11,2738000,4392000,7130000
Äquatorialguinea,2024,12,1388000,10325000,11713000
Äthiopien,2008,1,10055000,5124000,15179000
Äthiopien,2008,2,10286000,5031000,15317000
Äthiopien,2008,3,12119000,5263000,17382000
Äthiopien,2008,4,8165000,5614000,13779000
Äthiopien,2008,5,7921000,8956000,16877000
Äthiopien,2008,6,8967000,9429000,18396000
Äthiopien,2008,7,8681000,11789000,20470000
Äthiopien,2008,8,6386000,12654000,19040000
Äthiopien,2008,9,5536000,11205000,16741000
Äthiopien,2008,10,11990000,10636000,22626000
Äthiopien,2008,11,8198000,11836000,20034000
Äthiopien,2008,12,8985000,10919000,19904000
Äthiopien,2009,1,10412000,12002000,22414000
Äthiopien,2009,2,10095000,4104000,14199000
Äthiopien,2009,3,9165000,7792000,16957000
Äthiopien,2009,4,10393000,6624000,17017000
Äthiopien,2009,5,4506000,7178000,11684000
Äthiopien,2009,6,8498000,11486000,19984000
Äthiopien,2009,7,9512000,14384000,23896000
Äthiopien,2009,8,6170000,13271000,19441000
Äthiopien,2009,9,16759000,7875000,24634000
Äthiopien,2009,10,14690000,9435000,24125000
Äthiopien,2009,11,11677000,17044000,28721000
Äthiopien,2009,12,13884000,9549000,23433000
Äthiopien,2010,1,21534000,5459000,26993000
Äthiopien,2010,2,7091000,5887000,12978000
Äthiopien,2010,3,8617000,6964000,15581000
Äthiopien,2010,4,5910000,7488000,13398000
Äthiopien,2010,5,8885000,10172000,19057000
Äthiopien,2010,6,11152000,23351000,34503000
Äthiopien,2010,7,11932000,18949000,30881000
Äthiopien,2010,8,8775000,23952000,32727000
Äthiopien,2010,9,18848000,17559000,36407000
Äthiopien,2010,10,9570000,13013000,22583000
Äthiopien,2010,11,10569000,15965000,26534000
Äthiopien,2010,12,17789000,13201000,30990000
Äthiopien,2011,1,8090000,24602000,32692000
Äthiopien,2011,2,7965000,17207000,25172000
Äthiopien,2011,3,13537000,13995000,27532000
Äthiopien,2011,4,9717000,14147000,23864000
Äthiopien,2011,5,11974000,21215000,33189000
Äthiopien,2011,6,6796000,26556000,33352000
Äthiopien,2011,7,6242000,23977000,30219000
Äthiopien,2011,8,11362000,26121000,37483000
Äthiopien,2011,9,8935000,25432000,34367000
Äthiopien,2011,10,16103000,24119000,40222000
Äthiopien,2011,11,10024000,13107000,23131000
Äthiopien,2011,12,11736000,16963000,28699000
Äthiopien,2012,1,7645000,7375000,15020000
Äthiopien,2012,2,10935000,7918000,18853000
Äthiopien,2012,3,19312000,7675000,26987000
Äthiopien,2012,4,9627000,15510000,25137000
Äthiopien,2012,5,13395000,13659000,27054000
Äthiopien,2012,6,19664000,29331000,48995000
Äthiopien,2012,7,17684000,24746000,42430000
Äthiopien,2012,8,12784000,25026000,37810000
Äthiopien,2012,9,12753000,19029000,31782000
Äthiopien,2012,10,16203000,19612000,35815000
Äthiopien,2012,11,10898000,20204000,31102000
Äthiopien,2012,12,17892000,17366000,35258000
Äthiopien,2013,1,12246000,18573000,30819000
Äthiopien,2013,2,10049000,11969000,22018000
Äthiopien,2013,3,12018000,11850000,23868000
Äthiopien,2013,4,19525000,17712000,37237000
Äthiopien,2013,5,14509000,11714000,26223000
Äthiopien,2013,6,14043000,11094000,25137000
Äthiopien,2013,7,11479000,17688000,29167000
Äthiopien,2013,8,13908000,19572000,33480000
Äthiopien,2013,9,11909000,10672000,22581000
Äthiopien,2013,10,14191000,11082000,25273000
Äthiopien,2013,11,20656000,13660000,34316000
Äthiopien,2013,12,18378000,6063000,24441000
Äthiopien,2014,1,14685000,9652000,24337000
Äthiopien,2014,2,26079000,7206000,33285000
Äthiopien,2014,3,21209000,16997000,38206000
Äthiopien,2014,4,25343000,8623000,33966000
Äthiopien,2014,5,14611000,15431000,30042000
Äthiopien,2014,6,18989000,17404000,36393000
Äthiopien,2014,7,25867000,19941000,45808000
Äthiopien,2014,8,20692000,10444000,31136000
Äthiopien,2014,9,20775000,13524000,34299000
Äthiopien,2014,10,15123000,24242000,39365000
Äthiopien,2014,11,12994000,26224000,39218000
Äthiopien,2014,12,20468000,15564000,36032000
Äthiopien,2015,1,35179000,10713000,45892000
Äthiopien,2015,2,21218000,11112000,32330000
Äthiopien,2015,3,17791000,11875000,29666000
Äthiopien,2015,4,20500000,13752000,34252000
Äthiopien,2015,5,22862000,15336000,38198000
Äthiopien,2015,6,23186000,22754000,45940000
Äthiopien,2015,7,22077000,14852000,36929000
Äthiopien,2015,8,23717000,13915000,37632000
Äthiopien,2015,9,21111000,15588000,36699000
Äthiopien,2015,10,17967000,16504000,34471000
Äthiopien,2015,11,23991000,13475000,37466000
Äthiopien,2015,12,53211000,13397000,66608000
Äthiopien,2016,1,14452000,19006000,33458000
Äthiopien,2016,2,32447000,10674000,43121000
Äthiopien,2016,3,32320000,13162000,45482000
Äthiopien,2016,4,30056000,10336000,40392000
Äthiopien,2016,5,26917000,13696000,40613000
Äthiopien,2016,6,26166000,15268000,41434000
Äthiopien,2016,7,33225000,12543000,45768000
Äthiopien,2016,8,37033000,22734000,59767000
Äthiopien,2016,9,32126000,18803000,50929000
Äthiopien,2016,10,25425000,13448000,38873000
Äthiopien,2016,11,22990000,15020000,38010000
Äthiopien,2016,12,30697000,12546000,43243000
Äthiopien,2017,1,31005000,10357000,41362000
Äthiopien,2017,2,19975000,8683000,28658000
Äthiopien,2017,3,28667000,9605000,38272000
Äthiopien,2017,4,23856000,14147000,38003000
Äthiopien,2017,5,35317000,18968000,54285000
Äthiopien,2017,6,25463000,13657000,39120000
Äthiopien,2017,7,27957000,16145000,44102000
Äthiopien,2017,8,29581000,19648000,49229000
Äthiopien,2017,9,19948000,21365000,41313000
Äthiopien,2017,10,20822000,11300000,32122000
Äthiopien,2017,11,33500000,14386000,47886000
Äthiopien,2017,12,31860000,13542000,45402000
Äthiopien,2018,1,18309000,12913000,31222000
Äthiopien,2018,2,22427000,8576000,31003000
Äthiopien,2018,3,25125000,9115000,34240000
Äthiopien,2018,4,14629000,14053000,28682000
Äthiopien,2018,5,15764000,11020000,26784000
Äthiopien,2018,6,28980000,14212000,43192000
Äthiopien,2018,7,22424000,11815000,34239000
Äthiopien,2018,8,20065000,21015000,41080000
Äthiopien,2018,9,18635000,16662000,35297000
Äthiopien,2018,10,21932000,11462000,33394000
Äthiopien,2018,11,19892000,14855000,34747000
Äthiopien,2018,12,24148000,7799000,31947000
Äthiopien,2019,1,19947000,11011000,30958000
Äthiopien,2019,2,28205000,6400000,34605000
Äthiopien,2019,3,32608000,7733000,40341000
Äthiopien,2019,4,26494000,9660000,36154000
Äthiopien,2019,5,18489000,12094000,30583000
Äthiopien,2019,6,15479000,11972000,27451000
Äthiopien,2019,7,28920000,14628000,43548000
Äthiopien,2019,8,32371000,13879000,46250000
Äthiopien,2019,9,38380000,16474000,54854000
Äthiopien,2019,10,27798000,14451000,42249000
Äthiopien,2019,11,22027000,17666000,39693000
Äthiopien,2019,12,16999000,10658000,27657000
Äthiopien,2020,1,18931000,13822000,32753000
Äthiopien,2020,2,18515000,9867000,28382000
Äthiopien,2020,3,20919000,7769000,28688000
Äthiopien,2020,4,23104000,20923000,44027000
Äthiopien,2020,5,25506000,15754000,41260000
Äthiopien,2020,6,33154000,13513000,46667000
Äthiopien,2020,7,19220000,14320000,33540000
Äthiopien,2020,8,13927000,13339000,27266000
Äthiopien,2020,9,15162000,10573000,25735000
Äthiopien,2020,10,21922000,11472000,33394000
Äthiopien,2020,11,12744000,13619000,26363000
Äthiopien,2020,12,14103000,10718000,24821000
Äthiopien,2021,1,11336000,9756000,21092000
Äthiopien,2021,2,12540000,7624000,20164000
Äthiopien,2021,3,15713000,8376000,24089000
Äthiopien,2021,4,16152000,10232000,26384000
Äthiopien,2021,5,11543000,15665000,27208000
Äthiopien,2021,6,16947000,19789000,36736000
Äthiopien,2021,7,17457000,18226000,35683000
Äthiopien,2021,8,9804000,15880000,25684000
Äthiopien,2021,9,13684000,23232000,36916000
Äthiopien,2021,10,9332000,21298000,30630000
Äthiopien,2021,11,8043000,31269000,39312000
Äthiopien,2021,12,9008000,19868000,28876000
Äthiopien,2022,1,8076000,27741000,35817000
Äthiopien,2022,2,17267000,24773000,42040000
Äthiopien,2022,3,13041000,17151000,30192000
Äthiopien,2022,4,7454000,20008000,27462000
Äthiopien,2022,5,15700000,27227000,42927000
Äthiopien,2022,6,9435000,22251000,31686000
Äthiopien,2022,7,13312000,25371000,38683000
Äthiopien,2022,8,14552000,33754000,48306000
Äthiopien,2022,9,8668000,36895000,45563000
Äthiopien,2022,10,11094000,22835000,33929000
Äthiopien,2022,11,10992000,32186000,43178000
Äthiopien,2022,12,11062000,21415000,32477000
Äthiopien,2023,1,10439000,20134000,30573000
Äthiopien,2023,2,8917000,9685000,18602000
Äthiopien,2023,3,13612000,10541000,24153000
Äthiopien,2023,4,8525000,10916000,19441000
Äthiopien,2023,5,11335000,12189000,23524000
Äthiopien,2023,6,10120000,16992000,27112000
Äthiopien,2023,7,8481000,14961000,23442000
Äthiopien,2023,8,19498000,15261000,34759000
Äthiopien,2023,9,17737000,14124000,31861000
Äthiopien,2023,10,17772000,10362000,28134000
Äthiopien,2023,11,33683000,11848000,45531000
Äthiopien,2023,12,18583000,15909000,34492000
Äthiopien,2024,1,14160000,8271000,22431000
Äthiopien,2024,2,9192000,4747000,13939000
Äthiopien,2024,3,9966000,5592000,15558000
Äthiopien,2024,4,9428000,8749000,18177000
Äthiopien,2024,5,15886000,9661000,25547000
Äthiopien,2024,6,13027000,10546000,23573000
Äthiopien,2024,7,11796000,24156000,35952000
Äthiopien,2024,8,9875000,19913000,29788000
Äthiopien,2024,9,13559000,49041000,62600000
Äthiopien,2024,10,8542000,35239000,43781000
Äthiopien,2024,11,11254000,41998000,53252000
Äthiopien,2024,12,8359000,21878000,30237000
Österreich,2008,1,4348357000,2635533000,6983890000
Österreich,2008,2,4547641000,2735361000,7283002000
Österreich,2008,3,4642377000,2796164000,7438541000
Österreich,2008,4,4981813000,2941299000,7923112000
Österreich,2008,5,4495740000,2795646000,7291386000
Österreich,2008,6,4753924000,2992149000,7746073000
Österreich,2008,7,4612492000,2890430000,7502922000
Österreich,2008,8,4153773000,2521526000,6675299000
Österreich,2008,9,4800746000,3029096000,7829842000
Österreich,2008,10,5152588000,2995938000,8148526000
Österreich,2008,11,4409419000,2660772000,7070191000
Österreich,2008,12,3789719000,2186159000,5975878000
Österreich,2009,1,3789078000,2208353000,5997431000
Österreich,2009,2,3546842000,2152159000,5699001000
Österreich,2009,3,4031535000,2327101000,6358636000
Österreich,2009,4,3897997000,2255393000,6153390000
Österreich,2009,5,3485238000,2221528000,5706766000
Österreich,2009,6,3727810000,2172712000,5900522000
Österreich,2009,7,3922937000,2466546000,6389483000
Österreich,2009,8,3583896000,1932750000,5516646000
Österreich,2009,9,4321045000,2528729000,6849774000
Österreich,2009,10,4190444000,2618462000,6808906000
Österreich,2009,11,4064635000,2467256000,6531891000
Österreich,2009,12,3532005000,2214152000,5746157000
Österreich,2010,1,3592901000,2101869000,5694770000
Österreich,2010,2,3789990000,2369867000,6159857000
Österreich,2010,3,4733387000,2862072000,7595459000
Österreich,2010,4,4163361000,2595132000,6758493000
Österreich,2010,5,4231763000,2753313000,6985076000
Österreich,2010,6,4404085000,2932842000,7336927000
Österreich,2010,7,4351823000,2858823000,7210646000
Österreich,2010,8,4245219000,2581390000,6826609000
Österreich,2010,9,4782750000,3012405000,7795155000
Österreich,2010,10,4796452000,3059635000,7856087000
Österreich,2010,11,4785311000,2997369000,7782680000
Österreich,2010,12,4279258000,2888026000,7167284000
Österreich,2011,1,4294213000,2611083000,6905296000
Österreich,2011,2,4636045000,2904963000,7541008000
Österreich,2011,3,5381281000,3419642000,8800923000
Österreich,2011,4,4751994000,3082533000,7834527000
Österreich,2011,5,5013353000,3251623000,8264976000
Österreich,2011,6,4756582000,3148895000,7905477000
Österreich,2011,7,4632476000,3128959000,7761435000
Österreich,2011,8,4717565000,2869643000,7587208000
Österreich,2011,9,5203491000,3294690000,8498181000
Österreich,2011,10,4810603000,3123393000,7933996000
Österreich,2011,11,5125991000,3286099000,8412090000
Österreich,2011,12,4347277000,2906827000,7254104000
Österreich,2012,1,4489082000,2745174000,7234256000
Österreich,2012,2,4912075000,3095433000,8007508000
Österreich,2012,3,5135887000,3279508000,8415395000
Österreich,2012,4,4724068000,3016139000,7740207000
Österreich,2012,5,4700976000,3112383000,7813359000
Österreich,2012,6,4670036000,3130002000,7800038000
Österreich,2012,7,4659130000,3121691000,7780821000
Österreich,2012,8,4529062000,2833226000,7362288000
Österreich,2012,9,4806816000,3087342000,7894158000
Österreich,2012,10,5230729000,3352610000,8583339000
Österreich,2012,11,4750242000,3023622000,7773864000
Österreich,2012,12,3943275000,2596088000,6539363000
Österreich,2013,1,4479898000,2846672000,7326570000
Österreich,2013,2,4455920000,2974766000,7430686000
Österreich,2013,3,4844093000,3210761000,8054854000
Österreich,2013,4,4793374000,3212128000,8005502000
Österreich,2013,5,4452056000,2956966000,7409022000
Österreich,2013,6,4744495000,3126077000,7870572000
Österreich,2013,7,4736153000,3177192000,7913345000
Österreich,2013,8,4553741000,2864643000,7418384000
Österreich,2013,9,4972840000,3055242000,8028082000
Österreich,2013,10,5189629000,3334618000,8524247000
Österreich,2013,11,4842108000,3096714000,7938822000
Österreich,2013,12,4152951000,2878683000,7031634000
Österreich,2014,1,4563441000,2846260000,7409701000
Österreich,2014,2,4572947000,2981544000,7554491000
Österreich,2014,3,4832795000,3152099000,7984894000
Österreich,2014,4,4730683000,3028963000,7759646000
Österreich,2014,5,4517613000,3066667000,7584280000
Österreich,2014,6,4593885000,2970816000,7564701000
Österreich,2014,7,4837753000,3280531000,8118284000
Österreich,2014,8,4172651000,2590043000,6762694000
Österreich,2014,9,5065214000,3219690000,8284904000
Österreich,2014,10,5151174000,3241186000,8392360000
Österreich,2014,11,4684172000,3025867000,7710039000
Österreich,2014,12,4084936000,2813856000,6898792000
Österreich,2015,1,4322955000,2776253000,7099208000
Österreich,2015,2,4628505000,2980431000,7608936000
Österreich,2015,3,5190353000,3327636000,8517989000
Österreich,2015,4,4689780000,3197992000,7887772000
Österreich,2015,5,4619931000,3011806000,7631737000
Österreich,2015,6,5058485000,3158141000,8216626000
Österreich,2015,7,5076010000,3325113000,8401123000
Österreich,2015,8,4477970000,2764118000,7242088000
Österreich,2015,9,5330335000,3385671000,8716006000
Österreich,2015,10,5236980000,3333505000,8570485000
Österreich,2015,11,5288206000,3301202000,8589408000
Österreich,2015,12,4297580000,2688617000,6986197000
Österreich,2016,1,4497317000,2864587000,7361904000
Österreich,2016,2,4868007000,3187325000,8055332000
Österreich,2016,3,5305024000,3385910000,8690934000
Österreich,2016,4,5172805000,3248620000,8421425000
Österreich,2016,5,4752454000,3071161000,7823615000
Österreich,2016,6,5151225000,3364396000,8515621000
Österreich,2016,7,4749033000,3276123000,8025156000
Österreich,2016,8,4869098000,2989711000,7858809000
Österreich,2016,9,5343566000,3456976000,8800542000
Österreich,2016,10,5097013000,3260581000,8357594000
Österreich,2016,11,5409707000,3435895000,8845602000
Österreich,2016,12,4563018000,3002071000,7565089000
Österreich,2017,1,4715343000,3186162000,7901505000
Österreich,2017,2,4994984000,3245826000,8240810000
Österreich,2017,3,5560574000,3662475000,9223049000
Österreich,2017,4,5181013000,3239154000,8420167000
Österreich,2017,5,5381225000,3501520000,8882745000
Österreich,2017,6,5198508000,3322013000,8520521000
Österreich,2017,7,5119998000,3387818000,8507816000
Österreich,2017,8,4948978000,3228663000,8177641000
Österreich,2017,9,5563994000,3615043000,9179037000
Österreich,2017,10,5472404000,3497359000,8969763000
Österreich,2017,11,5771236000,3625835000,9397071000
Österreich,2017,12,4747959000,3174280000,7922239000
Österreich,2018,1,5245455000,3355308000,8600763000
Österreich,2018,2,5155848000,3462701000,8618549000
Österreich,2018,3,5636909000,3730471000,9367380000
Österreich,2018,4,5601291000,3728179000,9329470000
Österreich,2018,5,5190341000,3433452000,8623793000
Österreich,2018,6,5526853000,3651251000,9178104000
Österreich,2018,7,5458323000,3756531000,9214854000
Österreich,2018,8,5177561000,3440331000,8617892000
Österreich,2018,9,5566710000,3630265000,9196975000
Österreich,2018,10,6004668000,3908102000,9912770000
Österreich,2018,11,5801768000,3775713000,9577481000
Österreich,2018,12,4661137000,3121425000,7782562000
Österreich,2019,1,5426910000,3592519000,9019429000
Österreich,2019,2,5555539000,3632719000,9188258000
Österreich,2019,3,5948581000,3845214000,9793795000
Österreich,2019,4,5750893000,3878419000,9629312000
Österreich,2019,5,5851458000,3945715000,9797173000
Österreich,2019,6,5385076000,3719985000,9105061000
Österreich,2019,7,5546184000,3910166000,9456350000
Österreich,2019,8,5035260000,3150784000,8186044000
Österreich,2019,9,5574300000,3819614000,9393914000
Österreich,2019,10,5895266000,3760594000,9655860000
Österreich,2019,11,5520290000,3656535000,9176825000
Österreich,2019,12,4586509000,3146939000,7733448000
Österreich,2020,1,5347388000,3367892000,8715280000
Österreich,2020,2,5398709000,3642691000,9041400000
Österreich,2020,3,5264104000,3584246000,8848350000
Österreich,2020,4,3957206000,2799530000,6756736000
Österreich,2020,5,4321184000,2752895000,7074079000
Österreich,2020,6,4843870000,3292678000,8136548000
Österreich,2020,7,4947261000,3706116000,8653377000
Österreich,2020,8,4758169000,2893247000,7651416000
Österreich,2020,9,5501405000,3638736000,9140141000
Österreich,2020,10,5653453000,3689796000,9343249000
Österreich,2020,11,5563197000,3803431000,9366628000
Österreich,2020,12,4561785000,3283086000,7844871000
Österreich,2021,1,4908087000,3331473000,8239560000
Österreich,2021,2,5543118000,3667529000,9210647000
Österreich,2021,3,6647122000,4275259000,10922381000
Österreich,2021,4,6010292000,3734203000,9744495000
Österreich,2021,5,5855269000,3799257000,9654526000
Österreich,2021,6,6192550000,4146712000,10339262000
Österreich,2021,7,6116817000,4121094000,10237911000
Österreich,2021,8,5593026000,3483755000,9076781000
Österreich,2021,9,6403641000,4217128000,10620769000
Österreich,2021,10,6441675000,4247101000,10688776000
Österreich,2021,11,6740205000,4283450000,11023655000
Österreich,2021,12,5933252000,4184846000,10118098000
Österreich,2022,1,6521547000,4023895000,10545442000
Österreich,2022,2,6745186000,4381851000,11127037000
Österreich,2022,3,8361085000,5233354000,13594439000
Österreich,2022,4,6994154000,4592682000,11586836000
Österreich,2022,5,7598705000,5130017000,12728722000
Österreich,2022,6,7698575000,4817110000,12515685000
Österreich,2022,7,7754431000,5282194000,13036625000
Österreich,2022,8,7935924000,4913863000,12849787000
Österreich,2022,9,8628788000,5487303000,14116091000
Österreich,2022,10,7418803000,4839085000,12257888000
Österreich,2022,11,7989563000,5033231000,13022794000
Österreich,2022,12,6633705000,4426789000,11060494000
Österreich,2023,1,7150692000,4246319000,11397011000
Österreich,2023,2,6888715000,4549209000,11437924000
Österreich,2023,3,7866122000,5281751000,13147873000
Österreich,2023,4,6406437000,4357671000,10764108000
Österreich,2023,5,6761820000,4776925000,11538745000
Österreich,2023,6,6971055000,4789892000,11760947000
Österreich,2023,7,6448501000,4454915000,10903416000
Österreich,2023,8,6360037000,4035548000,10395585000
Österreich,2023,9,6688364000,4498540000,11186904000
Österreich,2023,10,6535806000,4353776000,10889582000
Österreich,2023,11,6840562000,4639632000,11480194000
Österreich,2023,12,5436428000,3760002000,9196430000
Österreich,2024,1,6603707000,4148151000,10751858000
Österreich,2024,2,6583126000,4305004000,10888130000
Österreich,2024,3,6858973000,4367024000,11225997000
Österreich,2024,4,6973745000,4733010000,11706755000
Österreich,2024,5,6261293000,4163313000,10424606000
Österreich,2024,6,6151597000,4288352000,10439949000
Österreich,2024,7,6499232000,4685677000,11184909000
Österreich,2024,8,5958822000,3755244000,9714066000
Österreich,2024,9,6365904000,4453541000,10819445000
Österreich,2024,10,6750347000,4622703000,11373050000
Österreich,2024,11,6526787000,4260505000,10787292000
Österreich,2024,12,5694688000,3689716000,9384404000
